TraderType,Time,EnterQty,BuyEnterQty,SellEnterQty,BuyExecutedQty,BuyExecutedPx,SellExecutedQty,SellExecutedPx,CanceledQty
1, 09:06:00-000, 3039, 3039, 0, 822, 1347.93, 0, 0.00, 0
1, 09:07:00-000, 0, 0, 0, 0, 0.00, 0, 0.00, 2207
1, 09:08:00-000, 0, 0, 0, 0, 0.00, 0, 0.00, 10
1, 09:13:00-000, 3109, 2287, 822, 1202, 1347.78, 822, 1347.20, 0
1, 09:14:00-000, 8, 5, 3, 0, 0.00, 3, 1354.00, 1085
1, 09:15:00-000, 29, 17, 12, 8, 1347.87, 12, 1347.83, 0
1, 09:16:00-000, 170, 110, 60, 50, 1347.91, 60, 1349.39, 26
1, 09:17:00-000, 214, 147, 67, 48, 1348.95, 67, 1351.54, 30
1, 09:18:00-000, 640, 373, 267, 168, 1349.65, 267, 1354.88, 133
1, 09:19:00-000, 391, 248, 143, 131, 1347.67, 143, 1348.83, 143
1, 09:20:00-000, 813, 459, 354, 405, 1347.86, 354, 1347.76, 101
1, 09:21:00-000, 358, 241, 117, 144, 1348.68, 117, 1349.49, 97
1, 09:22:00-000, 577, 385, 192, 167, 1347.59, 191, 1350.69, 161
1, 09:23:00-000, 296, 178, 118, 131, 1347.85, 118, 1347.94, 125
1, 09:24:00-000, 621, 412, 209, 238, 1347.99, 209, 1349.41, 138
1, 09:25:00-000, 329, 196, 133, 125, 1348.57, 132, 1351.12, 94
1, 09:26:00-000, 611, 425, 186, 131, 1349.48, 186, 1350.00, 154
1, 09:27:00-000, 334, 203, 131, 141, 1349.34, 131, 1349.35, 175
1, 09:28:00-000, 663, 399, 264, 177, 1348.49, 264, 1348.13, 188
1, 09:29:00-000, 254, 145, 109, 142, 1347.66, 109, 1347.46, 120
1, 09:30:00-000, 595, 358, 237, 246, 1346.98, 237, 1346.49, 64
1, 09:31:00-000, 265, 186, 79, 88, 1349.23, 79, 1349.72, 97
1, 09:32:00-000, 630, 425, 205, 271, 1348.39, 205, 1347.72, 127
1, 09:33:00-000, 400, 275, 125, 167, 1347.99, 125, 1347.54, 102
1, 09:34:00-000, 570, 353, 217, 253, 1348.37, 217, 1347.96, 131
1, 09:35:00-000, 300, 207, 93, 108, 1348.25, 93, 1348.59, 100
1, 09:36:00-000, 703, 460, 243, 276, 1348.79, 243, 1349.06, 102
1, 09:37:00-000, 345, 222, 123, 81, 1348.36, 123, 1348.49, 169
1, 09:38:00-000, 595, 373, 222, 232, 1347.94, 220, 1347.76, 150
1, 09:39:00-000, 307, 145, 162, 142, 1348.22, 162, 1347.54, 107
1, 09:40:00-000, 661, 412, 249, 233, 1348.12, 249, 1347.29, 102
1, 09:41:00-000, 288, 191, 97, 116, 1347.27, 97, 1348.09, 109
1, 09:42:00-000, 681, 439, 242, 246, 1347.81, 242, 1347.98, 98
1, 09:43:00-000, 303, 193, 110, 124, 1348.21, 110, 1347.79, 145
1, 09:44:00-000, 669, 364, 305, 235, 1348.03, 305, 1348.29, 125
1, 09:45:00-000, 286, 183, 103, 94, 1348.35, 103, 1348.06, 112
1, 09:46:00-000, 627, 384, 243, 238, 1347.84, 243, 1347.74, 111
1, 09:47:00-000, 290, 194, 96, 102, 1349.34, 96, 1348.91, 116
1, 09:48:00-000, 601, 400, 201, 242, 1348.69, 200, 1348.30, 114
1, 09:49:00-000, 307, 177, 130, 151, 1347.05, 131, 1347.22, 120
1, 09:50:00-000, 656, 422, 234, 246, 1347.44, 234, 1347.17, 78
1, 09:51:00-000, 286, 148, 138, 119, 1347.52, 138, 1347.17, 116
1, 09:52:00-000, 637, 410, 227, 229, 1349.14, 227, 1348.79, 90
1, 09:53:00-000, 342, 191, 151, 149, 1347.93, 151, 1347.77, 133
1, 09:54:00-000, 612, 355, 257, 226, 1348.38, 257, 1347.70, 79
1, 09:55:00-000, 293, 170, 123, 123, 1347.36, 123, 1347.87, 89
1, 09:56:00-000, 589, 366, 223, 221, 1347.74, 223, 1347.37, 93
1, 09:57:00-000, 315, 197, 118, 125, 1347.47, 113, 1347.72, 90
1, 09:58:00-000, 545, 301, 244, 238, 1347.54, 249, 1347.12, 98
1, 09:59:00-000, 296, 186, 110, 121, 1347.41, 110, 1346.90, 58
1, 10:00:00-000, 640, 407, 233, 247, 1347.72, 233, 1346.80, 128
1, 10:01:00-000, 308, 157, 151, 131, 1346.83, 151, 1346.52, 76
1, 10:02:00-000, 562, 321, 241, 240, 1347.54, 241, 1346.95, 62
1, 10:03:00-000, 281, 160, 121, 129, 1347.96, 121, 1346.96, 63
1, 10:04:00-000, 616, 355, 261, 267, 1348.49, 261, 1347.75, 56
1, 10:05:00-000, 316, 205, 111, 100, 1348.76, 111, 1348.34, 76
1, 10:06:00-000, 632, 426, 206, 296, 1348.84, 206, 1348.06, 123
1, 10:07:00-000, 279, 149, 130, 103, 1348.00, 130, 1347.26, 97
1, 10:08:00-000, 600, 353, 247, 269, 1347.90, 247, 1347.78, 86
1, 10:09:00-000, 337, 213, 124, 118, 1348.04, 124, 1347.75, 58
1, 10:10:00-000, 598, 361, 237, 268, 1347.94, 237, 1347.98, 102
1, 10:11:00-000, 253, 144, 109, 98, 1347.18, 109, 1346.48, 81
1, 10:12:00-000, 692, 413, 279, 314, 1347.59, 279, 1346.82, 27
1, 10:13:00-000, 322, 201, 121, 141, 1347.88, 121, 1348.15, 107
1, 10:14:00-000, 569, 291, 278, 217, 1348.20, 278, 1347.85, 61
1, 10:15:00-000, 323, 182, 141, 150, 1347.47, 137, 1346.95, 74
1, 10:16:00-000, 655, 367, 288, 277, 1347.69, 292, 1347.24, 34
1, 10:17:00-000, 305, 166, 139, 128, 1346.85, 139, 1346.64, 70
1, 10:18:00-000, 552, 334, 218, 203, 1348.74, 218, 1348.95, 115
1, 10:19:00-000, 327, 208, 119, 122, 1348.23, 119, 1348.01, 81
1, 10:20:00-000, 523, 292, 231, 218, 1346.99, 231, 1346.86, 109
1, 10:21:00-000, 329, 197, 132, 111, 1349.37, 132, 1348.92, 47
1, 10:22:00-000, 655, 378, 277, 282, 1347.66, 277, 1347.59, 96
1, 10:23:00-000, 338, 198, 140, 158, 1348.40, 140, 1347.60, 88
1, 10:24:00-000, 677, 367, 310, 244, 1348.20, 310, 1347.63, 83
1, 10:25:00-000, 297, 187, 110, 153, 1347.33, 110, 1347.10, 57
1, 10:26:00-000, 555, 349, 206, 241, 1347.52, 206, 1346.77, 60
1, 10:27:00-000, 304, 182, 122, 128, 1346.98, 122, 1346.21, 100
1, 10:28:00-000, 620, 383, 237, 273, 1347.58, 237, 1347.29, 77
1, 10:29:00-000, 270, 133, 137, 122, 1346.79, 137, 1347.07, 73
1, 10:30:00-000, 592, 360, 232, 230, 1347.92, 232, 1347.31, 70
1, 10:31:00-000, 371, 255, 116, 157, 1347.88, 116, 1347.71, 72
1, 10:32:00-000, 678, 352, 326, 293, 1347.51, 326, 1346.97, 108
1, 10:33:00-000, 286, 154, 132, 122, 1347.38, 132, 1346.16, 62
1, 10:34:00-000, 596, 342, 254, 266, 1347.09, 254, 1346.12, 52
1, 10:35:00-000, 256, 169, 87, 103, 1348.08, 87, 1347.08, 71
1, 10:36:00-000, 611, 354, 257, 259, 1347.90, 257, 1347.56, 93
1, 10:37:00-000, 294, 184, 110, 123, 1348.32, 110, 1347.25, 61
1, 10:38:00-000, 646, 340, 306, 265, 1348.17, 306, 1346.76, 82
1, 10:39:00-000, 325, 203, 122, 151, 1347.04, 122, 1346.02, 49
1, 10:40:00-000, 657, 389, 268, 246, 1347.54, 268, 1347.01, 102
1, 10:41:00-000, 231, 133, 98, 73, 1348.63, 98, 1348.20, 91
1, 10:42:00-000, 626, 352, 274, 257, 1347.78, 274, 1347.18, 86
1, 10:43:00-000, 301, 205, 96, 119, 1349.11, 96, 1348.82, 79
1, 10:44:00-000, 650, 417, 233, 262, 1349.06, 233, 1348.80, 101
1, 10:45:00-000, 358, 198, 160, 145, 1347.97, 160, 1347.44, 104
1, 10:46:00-000, 694, 453, 241, 272, 1348.72, 241, 1348.03, 121
1, 10:47:00-000, 311, 150, 161, 133, 1347.98, 161, 1347.02, 120
1, 10:48:00-000, 628, 380, 248, 206, 1348.05, 248, 1347.34, 74
1, 10:49:00-000, 332, 203, 129, 150, 1348.02, 129, 1347.59, 125
1, 10:50:00-000, 664, 417, 247, 224, 1347.62, 247, 1348.08, 72
1, 10:51:00-000, 334, 192, 142, 123, 1348.15, 142, 1348.65, 157
1, 10:52:00-000, 647, 383, 264, 300, 1347.96, 264, 1346.79, 83
1, 10:53:00-000, 342, 203, 139, 111, 1348.97, 139, 1348.02, 98
1, 10:54:00-000, 640, 373, 267, 282, 1347.52, 267, 1347.68, 91
1, 10:55:00-000, 259, 162, 97, 119, 1348.09, 97, 1346.98, 81
1, 10:56:00-000, 531, 273, 258, 221, 1347.37, 257, 1346.67, 74
1, 10:57:00-000, 283, 152, 131, 100, 1348.19, 132, 1347.81, 43
1, 10:58:00-000, 713, 468, 245, 291, 1348.01, 245, 1346.85, 80
1, 10:59:00-000, 263, 169, 94, 123, 1347.76, 94, 1347.14, 126
1, 11:00:00-000, 667, 407, 260, 259, 1347.98, 260, 1347.26, 87
1, 11:01:00-000, 339, 146, 193, 184, 1347.16, 193, 1346.63, 46
1, 11:02:00-000, 557, 369, 188, 223, 1347.64, 188, 1347.78, 78
1, 11:03:00-000, 255, 125, 130, 126, 1346.86, 130, 1346.75, 79
1, 11:04:00-000, 593, 335, 258, 236, 1348.15, 257, 1348.73, 70
1, 11:05:00-000, 304, 168, 136, 113, 1347.69, 137, 1346.18, 65
1, 11:06:00-000, 705, 396, 309, 278, 1347.11, 309, 1346.41, 64
1, 11:07:00-000, 314, 182, 132, 138, 1348.24, 132, 1347.37, 104
1, 11:08:00-000, 670, 394, 276, 272, 1347.57, 276, 1347.62, 61
1, 11:09:00-000, 297, 211, 86, 97, 1349.36, 86, 1347.83, 110
1, 11:10:00-000, 616, 334, 282, 227, 1348.19, 282, 1348.44, 130
1, 11:11:00-000, 296, 207, 89, 135, 1348.91, 89, 1347.89, 75
1, 11:12:00-000, 616, 414, 202, 287, 1349.20, 202, 1348.82, 99
1, 11:13:00-000, 364, 226, 138, 122, 1348.34, 138, 1347.99, 106
1, 11:14:00-000, 621, 371, 250, 285, 1347.53, 250, 1347.10, 120
1, 11:15:00-000, 319, 184, 135, 143, 1346.96, 135, 1345.96, 62
1, 11:16:00-000, 663, 387, 276, 262, 1347.85, 276, 1347.54, 50
1, 11:17:00-000, 331, 186, 145, 134, 1347.65, 145, 1347.22, 94
1, 11:18:00-000, 608, 368, 240, 262, 1348.11, 240, 1347.06, 88
1, 11:19:00-000, 334, 187, 147, 136, 1346.95, 147, 1346.31, 85
1, 11:20:00-000, 653, 364, 289, 272, 1347.40, 288, 1347.44, 61
1, 11:21:00-000, 323, 241, 82, 111, 1349.97, 83, 1349.43, 101
1, 11:22:00-000, 544, 258, 286, 220, 1347.34, 286, 1347.33, 127
1, 11:23:00-000, 308, 139, 169, 104, 1347.62, 169, 1345.26, 43
1, 11:24:00-000, 648, 378, 270, 255, 1348.27, 270, 1347.35, 74
1, 11:25:00-000, 318, 218, 100, 85, 1350.04, 100, 1350.25, 71
1, 11:26:00-000, 635, 371, 264, 244, 1348.71, 264, 1348.61, 153
1, 11:27:00-000, 312, 199, 113, 122, 1349.05, 113, 1347.73, 109
1, 11:28:00-000, 623, 384, 239, 266, 1348.08, 239, 1346.81, 110
1, 11:29:00-000, 313, 198, 115, 139, 1349.48, 115, 1348.47, 84
1, 11:30:00-000, 573, 326, 247, 242, 1347.59, 247, 1347.13, 79
1, 11:31:00-000, 314, 212, 102, 111, 1348.29, 102, 1348.09, 68
1, 11:32:00-000, 617, 366, 251, 269, 1348.06, 251, 1347.15, 123
1, 11:33:00-000, 286, 177, 109, 123, 1348.64, 109, 1347.96, 84
1, 11:34:00-000, 617, 339, 278, 266, 1348.13, 278, 1347.88, 52
1, 11:35:00-000, 302, 184, 118, 119, 1348.10, 118, 1347.24, 75
1, 11:36:00-000, 631, 373, 258, 286, 1347.09, 258, 1346.16, 81
1, 11:37:00-000, 258, 180, 78, 87, 1347.88, 78, 1347.17, 74
1, 11:38:00-000, 611, 311, 300, 264, 1347.54, 300, 1346.95, 66
1, 11:39:00-000, 305, 169, 136, 136, 1347.31, 136, 1346.44, 56
1, 11:40:00-000, 564, 325, 239, 199, 1348.86, 239, 1348.30, 71
1, 11:41:00-000, 313, 184, 129, 104, 1347.73, 129, 1347.77, 106
1, 11:42:00-000, 663, 354, 309, 250, 1347.76, 309, 1347.07, 109
1, 11:43:00-000, 222, 131, 91, 102, 1347.44, 91, 1346.37, 68
1, 11:44:00-000, 559, 379, 180, 233, 1349.00, 180, 1347.82, 60
1, 11:45:00-000, 353, 231, 122, 193, 1348.14, 122, 1347.47, 69
1, 11:46:00-000, 616, 368, 248, 262, 1347.78, 248, 1347.29, 111
1, 11:47:00-000, 330, 213, 117, 131, 1348.26, 117, 1347.55, 83
1, 11:48:00-000, 522, 336, 186, 253, 1348.26, 186, 1347.67, 88
1, 11:49:00-000, 318, 185, 133, 121, 1348.23, 133, 1347.32, 67
1, 11:50:00-000, 712, 427, 285, 268, 1347.88, 285, 1347.65, 93
1, 11:51:00-000, 377, 224, 153, 159, 1347.44, 153, 1346.94, 92
1, 11:52:00-000, 625, 343, 282, 260, 1348.23, 282, 1347.79, 134
1, 11:53:00-000, 288, 177, 111, 135, 1347.42, 111, 1346.62, 54
1, 11:54:00-000, 573, 329, 244, 254, 1347.81, 244, 1346.71, 65
1, 11:55:00-000, 341, 210, 131, 139, 1347.75, 131, 1347.35, 58
1, 11:56:00-000, 625, 335, 290, 226, 1348.16, 290, 1347.84, 99
1, 11:57:00-000, 301, 189, 112, 120, 1347.60, 112, 1347.29, 74
1, 11:58:00-000, 532, 309, 223, 233, 1347.38, 223, 1346.43, 65
1, 11:59:00-000, 359, 206, 153, 161, 1347.44, 153, 1346.76, 76
1, 12:00:00-000, 738, 409, 329, 312, 1348.15, 329, 1347.17, 76
1, 12:01:00-000, 234, 145, 89, 116, 1347.51, 89, 1347.50, 66
1, 12:02:00-000, 661, 372, 289, 278, 1347.75, 289, 1347.13, 53
1, 12:03:00-000, 266, 165, 101, 94, 1348.23, 101, 1348.55, 64
1, 12:04:00-000, 663, 362, 301, 275, 1347.33, 301, 1347.07, 96
1, 12:05:00-000, 317, 190, 127, 105, 1347.86, 127, 1347.47, 67
1, 12:06:00-000, 620, 363, 257, 250, 1347.71, 257, 1347.41, 117
1, 12:07:00-000, 347, 209, 138, 123, 1348.51, 138, 1347.71, 95
1, 12:08:00-000, 629, 392, 237, 305, 1347.70, 237, 1347.26, 81
1, 12:09:00-000, 328, 193, 135, 121, 1347.19, 135, 1346.87, 73
1, 12:10:00-000, 602, 358, 244, 233, 1347.57, 244, 1347.61, 97
1, 12:11:00-000, 309, 173, 136, 137, 1347.36, 136, 1346.87, 98
1, 12:12:00-000, 699, 412, 287, 260, 1347.76, 287, 1347.35, 88
1, 12:13:00-000, 352, 237, 115, 170, 1348.28, 115, 1347.93, 75
1, 12:14:00-000, 617, 354, 263, 251, 1348.53, 263, 1348.06, 102
1, 12:15:00-000, 312, 186, 126, 118, 1348.27, 126, 1347.93, 95
1, 12:16:00-000, 592, 362, 230, 221, 1348.42, 230, 1347.75, 77
1, 12:17:00-000, 335, 198, 137, 148, 1347.84, 137, 1347.28, 120
1, 12:18:00-000, 647, 384, 263, 298, 1347.09, 263, 1346.99, 68
1, 12:19:00-000, 294, 166, 128, 143, 1347.36, 128, 1346.80, 82
1, 12:20:00-000, 544, 296, 248, 157, 1348.56, 248, 1347.64, 65
1, 12:21:00-000, 283, 189, 94, 116, 1347.83, 94, 1347.42, 99
1, 12:22:00-000, 643, 310, 333, 191, 1347.64, 333, 1347.03, 110
1, 12:23:00-000, 319, 184, 135, 120, 1348.28, 135, 1347.03, 87
1, 12:24:00-000, 625, 372, 253, 255, 1348.04, 253, 1346.99, 102
1, 12:25:00-000, 258, 157, 101, 121, 1347.71, 101, 1347.19, 88
1, 12:26:00-000, 622, 378, 244, 245, 1348.17, 244, 1346.99, 64
1, 12:27:00-000, 290, 171, 119, 154, 1348.00, 119, 1347.38, 81
1, 12:28:00-000, 584, 340, 244, 223, 1347.50, 244, 1346.98, 64
1, 12:29:00-000, 309, 198, 111, 163, 1348.23, 111, 1346.91, 81
1, 12:30:00-000, 616, 396, 220, 270, 1348.35, 220, 1347.52, 60
1, 12:31:00-000, 295, 197, 98, 134, 1348.16, 98, 1347.60, 96
1, 12:32:00-000, 571, 363, 208, 240, 1348.59, 208, 1347.69, 105
1, 12:33:00-000, 332, 192, 140, 154, 1347.64, 137, 1347.06, 80
1, 12:34:00-000, 647, 348, 299, 207, 1348.01, 302, 1346.85, 106
1, 12:35:00-000, 274, 159, 115, 116, 1348.00, 115, 1348.04, 92
1, 12:36:00-000, 543, 306, 237, 221, 1347.43, 237, 1346.48, 57
1, 12:37:00-000, 305, 188, 117, 121, 1348.14, 117, 1347.90, 56
1, 12:38:00-000, 581, 319, 262, 231, 1347.67, 262, 1347.21, 66
1, 12:39:00-000, 280, 173, 107, 109, 1349.34, 107, 1348.37, 95
1, 12:40:00-000, 643, 408, 235, 266, 1348.07, 235, 1347.61, 71
1, 12:41:00-000, 297, 179, 118, 114, 1348.88, 118, 1348.34, 118
1, 12:42:00-000, 553, 271, 282, 209, 1347.40, 282, 1347.02, 67
1, 12:43:00-000, 276, 159, 117, 123, 1347.55, 117, 1346.32, 76
1, 12:44:00-000, 597, 382, 215, 209, 1348.34, 215, 1347.85, 78
1, 12:45:00-000, 371, 216, 155, 152, 1348.43, 155, 1347.00, 115
1, 12:46:00-000, 550, 350, 200, 236, 1348.20, 200, 1347.82, 101
1, 12:47:00-000, 307, 215, 92, 121, 1348.32, 92, 1347.63, 97
1, 12:48:00-000, 583, 345, 238, 296, 1348.38, 238, 1347.60, 77
1, 12:49:00-000, 292, 194, 98, 93, 1349.04, 98, 1347.44, 68
1, 12:50:00-000, 560, 279, 281, 229, 1347.48, 281, 1347.27, 110
1, 12:51:00-000, 287, 159, 128, 117, 1346.56, 128, 1345.36, 42
1, 12:52:00-000, 659, 387, 272, 276, 1347.43, 272, 1346.53, 65
1, 12:53:00-000, 292, 195, 97, 115, 1349.38, 97, 1348.45, 80
1, 12:54:00-000, 616, 387, 229, 245, 1348.74, 229, 1347.98, 106
1, 12:55:00-000, 330, 177, 153, 153, 1347.89, 153, 1346.88, 79
1, 12:56:00-000, 575, 351, 224, 270, 1347.54, 224, 1346.72, 72
1, 12:57:00-000, 336, 223, 113, 103, 1349.54, 113, 1349.94, 79
1, 12:58:00-000, 610, 377, 233, 287, 1348.32, 233, 1348.11, 121
1, 12:59:00-000, 354, 193, 161, 132, 1348.36, 161, 1347.53, 62
1, 13:00:00-000, 547, 316, 231, 220, 1347.97, 231, 1347.19, 112
1, 13:01:00-000, 332, 191, 141, 138, 1347.89, 141, 1347.27, 70
1, 13:02:00-000, 641, 363, 278, 275, 1348.24, 278, 1347.94, 58
1, 13:03:00-000, 317, 173, 144, 116, 1347.75, 144, 1347.58, 61
1, 13:04:00-000, 631, 355, 276, 254, 1348.38, 276, 1347.34, 101
1, 13:05:00-000, 309, 139, 170, 101, 1346.65, 169, 1346.68, 60
1, 13:06:00-000, 586, 398, 188, 212, 1349.06, 189, 1348.72, 83
1, 13:07:00-000, 332, 203, 129, 133, 1348.67, 129, 1348.46, 133
1, 13:08:00-000, 535, 328, 207, 241, 1347.92, 207, 1347.29, 131
1, 13:09:00-000, 280, 174, 106, 91, 1350.18, 106, 1348.61, 61
1, 13:10:00-000, 647, 397, 250, 268, 1348.08, 250, 1347.37, 108
1, 13:11:00-000, 279, 156, 123, 107, 1347.76, 123, 1347.61, 84
1, 13:12:00-000, 552, 356, 196, 230, 1348.89, 196, 1348.80, 73
1, 13:13:00-000, 349, 188, 161, 88, 1348.37, 161, 1347.93, 108
1, 13:14:00-000, 616, 382, 234, 203, 1347.49, 234, 1347.26, 149
1, 13:15:00-000, 336, 182, 154, 144, 1348.59, 154, 1348.28, 112
1, 13:16:00-000, 565, 342, 223, 220, 1348.07, 223, 1347.10, 92
1, 13:17:00-000, 353, 195, 158, 155, 1348.61, 158, 1347.32, 67
1, 13:18:00-000, 644, 446, 198, 312, 1348.70, 198, 1347.86, 87
1, 13:19:00-000, 326, 227, 99, 137, 1348.71, 99, 1347.13, 109
1, 13:20:00-000, 595, 371, 224, 287, 1348.29, 223, 1347.30, 97
1, 13:21:00-000, 280, 184, 96, 120, 1349.16, 97, 1348.40, 77
1, 13:22:00-000, 578, 317, 261, 246, 1347.89, 261, 1347.21, 75
1, 13:23:00-000, 338, 215, 123, 123, 1348.57, 123, 1346.48, 69
1, 13:24:00-000, 651, 323, 328, 270, 1347.55, 328, 1347.07, 83
1, 13:25:00-000, 283, 170, 113, 119, 1347.43, 113, 1346.85, 50
1, 13:26:00-000, 608, 336, 272, 239, 1348.12, 272, 1347.48, 59
1, 13:27:00-000, 268, 160, 108, 108, 1348.10, 108, 1347.08, 80
1, 13:28:00-000, 625, 395, 230, 259, 1348.33, 230, 1348.02, 106
1, 13:29:00-000, 290, 181, 109, 154, 1348.20, 109, 1346.85, 71
1, 13:30:00-000, 609, 336, 273, 232, 1348.53, 273, 1348.00, 64
1, 13:31:00-000, 331, 176, 155, 141, 1348.21, 155, 1347.03, 63
1, 13:32:00-000, 650, 361, 289, 309, 1347.65, 289, 1346.48, 59
1, 13:33:00-000, 302, 179, 123, 124, 1347.46, 123, 1346.87, 55
1, 13:34:00-000, 588, 315, 273, 243, 1347.98, 270, 1347.37, 68
1, 13:35:00-000, 333, 198, 135, 121, 1348.40, 138, 1348.39, 62
1, 13:36:00-000, 567, 333, 234, 251, 1348.08, 234, 1347.17, 83
1, 13:37:00-000, 316, 180, 136, 130, 1348.20, 136, 1347.34, 74
1, 13:38:00-000, 611, 336, 275, 237, 1347.59, 275, 1346.55, 65
1, 13:39:00-000, 305, 159, 146, 131, 1347.84, 146, 1346.36, 74
1, 13:40:00-000, 619, 393, 226, 256, 1348.28, 226, 1347.21, 85
1, 13:41:00-000, 380, 196, 184, 161, 1348.28, 184, 1347.68, 65
1, 13:42:00-000, 588, 361, 227, 246, 1348.64, 227, 1348.72, 81
1, 13:43:00-000, 311, 197, 114, 124, 1347.67, 114, 1347.95, 84
1, 13:44:00-000, 551, 320, 231, 183, 1347.94, 231, 1347.06, 98
1, 13:45:00-000, 414, 247, 167, 173, 1347.52, 167, 1346.79, 71
1, 13:46:00-000, 677, 415, 262, 294, 1347.87, 262, 1347.51, 134
1, 13:47:00-000, 282, 143, 139, 151, 1346.83, 139, 1346.75, 79
1, 13:48:00-000, 549, 355, 194, 236, 1347.47, 194, 1346.68, 47
1, 13:49:00-000, 267, 160, 107, 114, 1348.74, 107, 1348.51, 72
1, 13:50:00-000, 588, 344, 244, 227, 1347.92, 244, 1347.63, 83
1, 13:51:00-000, 264, 157, 107, 118, 1347.80, 107, 1346.66, 95
1, 13:52:00-000, 605, 316, 289, 240, 1347.06, 289, 1346.39, 70
1, 13:53:00-000, 346, 195, 151, 124, 1347.60, 151, 1347.11, 48
1, 13:54:00-000, 635, 371, 264, 238, 1347.55, 264, 1347.11, 91
1, 13:55:00-000, 308, 182, 126, 127, 1347.27, 126, 1347.28, 111
1, 13:56:00-000, 541, 305, 236, 226, 1348.10, 236, 1347.54, 93
1, 13:57:00-000, 384, 205, 179, 156, 1347.80, 179, 1347.82, 49
1, 13:58:00-000, 512, 299, 213, 190, 1347.40, 213, 1347.35, 61
1, 13:59:00-000, 374, 224, 150, 159, 1349.00, 150, 1348.29, 75
1, 14:00:00-000, 668, 408, 260, 310, 1347.75, 260, 1347.09, 78
1, 14:01:00-000, 351, 242, 109, 165, 1347.61, 109, 1347.40, 95
1, 14:02:00-000, 579, 338, 241, 232, 1347.86, 241, 1347.71, 71
1, 14:03:00-000, 274, 166, 108, 139, 1347.17, 108, 1347.08, 96
1, 14:04:00-000, 615, 412, 203, 264, 1348.46, 203, 1347.48, 90
1, 14:05:00-000, 295, 177, 118, 155, 1347.86, 118, 1346.93, 73
1, 14:06:00-000, 513, 270, 243, 204, 1347.27, 243, 1346.73, 66
1, 14:07:00-000, 305, 162, 143, 153, 1347.41, 143, 1346.55, 43
1, 14:08:00-000, 637, 324, 313, 237, 1347.28, 313, 1346.66, 48
1, 14:09:00-000, 318, 172, 146, 118, 1347.97, 146, 1347.57, 65
1, 14:10:00-000, 622, 345, 277, 229, 1348.08, 277, 1347.54, 76
1, 14:11:00-000, 319, 175, 144, 129, 1347.05, 144, 1347.04, 89
1, 14:12:00-000, 546, 297, 249, 221, 1347.84, 249, 1346.14, 90
1, 14:13:00-000, 304, 185, 119, 132, 1347.96, 119, 1347.37, 44
1, 14:14:00-000, 626, 409, 217, 272, 1348.57, 217, 1347.70, 62
1, 14:15:00-000, 301, 190, 111, 133, 1349.23, 111, 1349.06, 92
1, 14:16:00-000, 632, 395, 237, 235, 1347.80, 237, 1347.46, 111
1, 14:17:00-000, 324, 194, 130, 110, 1348.72, 130, 1348.24, 118
1, 14:18:00-000, 709, 408, 301, 265, 1347.61, 301, 1346.50, 119
1, 14:19:00-000, 290, 168, 122, 141, 1347.03, 122, 1346.50, 104
1, 14:20:00-000, 620, 351, 269, 266, 1347.57, 269, 1347.29, 64
1, 14:21:00-000, 285, 184, 101, 127, 1348.39, 101, 1347.94, 72
1, 14:22:00-000, 584, 353, 231, 289, 1347.72, 231, 1346.76, 53
1, 14:23:00-000, 310, 171, 139, 111, 1348.00, 139, 1347.28, 62
1, 14:24:00-000, 600, 376, 224, 226, 1348.50, 224, 1347.94, 93
1, 14:25:00-000, 365, 221, 144, 160, 1347.83, 144, 1348.14, 105
1, 14:26:00-000, 523, 299, 224, 235, 1347.49, 224, 1346.78, 80
1, 14:27:00-000, 361, 230, 131, 148, 1348.29, 131, 1347.37, 65
1, 14:28:00-000, 576, 293, 283, 228, 1347.27, 283, 1346.53, 68
1, 14:29:00-000, 306, 173, 133, 131, 1347.16, 133, 1346.50, 75
1, 14:30:00-000, 625, 386, 239, 240, 1347.51, 239, 1347.33, 72
1, 14:31:00-000, 362, 224, 138, 132, 1348.06, 138, 1346.73, 102
1, 14:32:00-000, 601, 333, 268, 195, 1348.31, 268, 1347.70, 141
1, 14:33:00-000, 313, 196, 117, 136, 1348.45, 117, 1347.44, 103
1, 14:34:00-000, 572, 336, 236, 229, 1347.80, 236, 1347.42, 82
1, 14:35:00-000, 355, 209, 146, 168, 1347.83, 146, 1347.70, 53
1, 14:36:00-000, 576, 346, 230, 219, 1347.94, 230, 1347.10, 95
1, 14:37:00-000, 371, 255, 116, 156, 1349.00, 116, 1347.61, 85
1, 14:38:00-000, 490, 278, 212, 211, 1348.03, 212, 1347.00, 133
1, 14:39:00-000, 388, 206, 182, 163, 1347.32, 182, 1346.79, 54
1, 14:40:00-000, 600, 404, 196, 244, 1348.43, 196, 1348.55, 84
1, 14:41:00-000, 298, 164, 134, 155, 1347.93, 134, 1346.65, 77
1, 14:42:00-000, 654, 386, 268, 252, 1347.49, 268, 1347.55, 78
1, 14:43:00-000, 279, 172, 107, 116, 1348.68, 107, 1348.39, 100
1, 14:44:00-000, 634, 376, 258, 266, 1348.29, 258, 1347.18, 65
1, 14:45:00-000, 234, 129, 105, 84, 1347.62, 105, 1347.11, 107
1, 14:46:00-000, 591, 350, 241, 244, 1347.77, 241, 1347.39, 70
1, 14:47:00-000, 359, 227, 132, 138, 1347.76, 132, 1347.34, 84
1, 14:48:00-000, 610, 375, 235, 252, 1347.96, 235, 1348.04, 87
1, 14:49:00-000, 343, 203, 140, 134, 1348.59, 140, 1347.44, 111
1, 14:50:00-000, 568, 325, 243, 271, 1348.06, 243, 1347.06, 83
1, 14:51:00-000, 340, 202, 138, 142, 1347.60, 138, 1347.32, 45
1, 14:52:00-000, 661, 369, 292, 261, 1348.04, 292, 1347.33, 120
1, 14:53:00-000, 300, 200, 100, 111, 1347.85, 100, 1347.54, 54
1, 14:54:00-000, 593, 345, 248, 278, 1347.02, 248, 1346.74, 78
1, 14:55:00-000, 307, 196, 111, 131, 1348.13, 111, 1347.96, 72
1, 14:56:00-000, 616, 324, 292, 274, 1347.11, 292, 1345.81, 79
1, 14:57:00-000, 302, 182, 120, 120, 1347.93, 120, 1347.08, 54
1, 14:58:00-000, 605, 323, 282, 244, 1348.58, 282, 1346.82, 64
1, 14:59:00-000, 285, 148, 137, 99, 1347.65, 137, 1346.32, 72
1, 15:00:00-000, 640, 355, 285, 269, 1347.51, 285, 1346.53, 46
1, 15:01:00-000, 323, 215, 108, 159, 1347.51, 108, 1346.50, 62
1, 15:02:00-000, 583, 331, 252, 239, 1347.98, 252, 1347.44, 93
1, 15:03:00-000, 283, 158, 125, 101, 1348.49, 125, 1347.95, 65
1, 15:04:00-000, 664, 441, 223, 274, 1348.39, 223, 1347.85, 102
1, 15:05:00-000, 306, 181, 125, 155, 1348.15, 125, 1347.38, 102
1, 15:06:00-000, 536, 324, 212, 196, 1347.85, 212, 1348.10, 56
1, 15:07:00-000, 271, 155, 116, 117, 1348.32, 116, 1348.18, 104
1, 15:08:00-000, 674, 422, 252, 263, 1348.01, 252, 1347.17, 62
1, 15:09:00-000, 341, 173, 168, 152, 1348.66, 168, 1347.61, 118
1, 15:10:00-000, 684, 388, 296, 299, 1348.37, 296, 1347.73, 74
1, 15:11:00-000, 360, 222, 138, 170, 1347.54, 137, 1346.74, 69
1, 15:12:00-000, 572, 356, 216, 243, 1348.16, 217, 1347.39, 88
1, 15:13:00-000, 350, 219, 131, 156, 1348.64, 131, 1348.05, 70
1, 15:14:00-000, 534, 275, 259, 236, 1347.28, 259, 1347.13, 50
1, 15:15:00-000, 337, 199, 138, 132, 1348.43, 138, 1347.58, 73
1, 15:16:00-000, 649, 344, 305, 235, 1348.17, 305, 1348.23, 68
1, 15:17:00-000, 329, 207, 122, 189, 1348.56, 122, 1347.61, 77
1, 15:18:00-000, 642, 365, 277, 306, 1347.23, 277, 1346.52, 48
1, 15:19:00-000, 336, 156, 180, 164, 1346.49, 178, 1346.25, 32
1, 15:20:00-000, 589, 345, 244, 271, 1347.23, 246, 1346.60, 38
1, 15:21:00-000, 341, 201, 140, 131, 1347.67, 140, 1346.59, 56
1, 15:22:00-000, 656, 382, 274, 318, 1347.68, 274, 1346.45, 65
1, 15:23:00-000, 232, 132, 100, 107, 1347.19, 100, 1345.91, 68
1, 15:24:00-000, 602, 355, 247, 282, 1348.43, 247, 1346.92, 30
1, 15:25:00-000, 355, 175, 180, 123, 1347.41, 180, 1346.74, 71
1, 15:26:00-000, 617, 312, 305, 236, 1347.30, 305, 1346.58, 66
1, 15:27:00-000, 350, 198, 152, 131, 1347.12, 152, 1346.59, 44
1, 15:28:00-000, 622, 343, 279, 304, 1347.15, 279, 1346.43, 75
1, 15:29:00-000, 309, 197, 112, 142, 1348.69, 112, 1347.82, 41
1, 15:30:00-000, 681, 389, 292, 274, 1347.97, 292, 1347.85, 104
1, 15:31:00-000, 349, 220, 129, 117, 1348.24, 128, 1347.65, 73
1, 15:32:00-000, 535, 301, 234, 248, 1347.92, 235, 1347.48, 87
1, 15:33:00-000, 310, 196, 114, 108, 1349.06, 114, 1349.12, 55
1, 15:34:00-000, 628, 329, 299, 254, 1348.30, 299, 1347.61, 95
1, 15:35:00-000, 292, 171, 121, 119, 1347.77, 121, 1346.98, 77
1, 15:36:00-000, 711, 404, 307, 314, 1347.86, 307, 1346.95, 87
1, 15:37:00-000, 279, 169, 110, 138, 1348.50, 110, 1347.09, 52
1, 15:38:00-000, 576, 317, 259, 233, 1347.63, 259, 1346.81, 53
1, 15:39:00-000, 286, 158, 128, 119, 1347.25, 128, 1347.05, 58
1, 15:40:00-000, 648, 380, 268, 210, 1348.32, 268, 1347.45, 86
1, 15:41:00-000, 296, 161, 135, 75, 1348.89, 135, 1347.13, 126
1, 15:42:00-000, 681, 432, 249, 280, 1348.19, 249, 1347.52, 141
1, 15:43:00-000, 312, 176, 136, 103, 1348.26, 136, 1347.04, 92
1, 15:44:00-000, 590, 359, 231, 225, 1348.71, 231, 1347.31, 118
1, 15:45:00-000, 360, 190, 170, 139, 1347.87, 170, 1347.15, 94
1, 15:46:00-000, 579, 358, 221, 235, 1347.30, 221, 1346.68, 58
1, 15:47:00-000, 328, 215, 113, 143, 1348.35, 113, 1347.82, 114
1, 15:48:00-000, 663, 418, 245, 317, 1348.10, 245, 1346.98, 72
1, 15:49:00-000, 302, 182, 120, 101, 1348.42, 120, 1347.57, 111
1, 15:50:00-000, 558, 355, 203, 227, 1348.09, 203, 1347.58, 88
1, 15:51:00-000, 270, 184, 86, 123, 1348.36, 86, 1348.17, 100
1, 15:52:00-000, 604, 356, 248, 253, 1347.93, 248, 1346.62, 77
1, 15:53:00-000, 373, 213, 160, 152, 1347.36, 160, 1346.70, 96
1, 15:54:00-000, 612, 352, 260, 233, 1347.62, 260, 1347.12, 104
1, 15:55:00-000, 343, 174, 169, 139, 1347.62, 169, 1346.66, 59
1, 15:56:00-000, 613, 359, 254, 248, 1348.09, 254, 1347.57, 96
1, 15:57:00-000, 305, 165, 140, 141, 1347.33, 140, 1346.90, 48
1, 15:58:00-000, 564, 321, 243, 238, 1347.82, 243, 1346.55, 71
1, 15:59:00-000, 288, 174, 114, 116, 1347.71, 114, 1347.19, 56
1, 16:00:00-000, 624, 382, 242, 267, 1348.22, 242, 1347.75, 99
1, 16:01:00-000, 329, 205, 124, 138, 1349.14, 124, 1348.25, 81
1, 16:02:00-000, 642, 370, 272, 261, 1348.34, 272, 1347.45, 63
1, 16:03:00-000, 298, 190, 108, 111, 1347.92, 108, 1346.92, 95
1, 16:04:00-000, 652, 404, 248, 270, 1348.00, 248, 1347.48, 128
1, 16:05:00-000, 355, 214, 141, 190, 1347.44, 141, 1347.31, 82
1, 16:06:00-000, 516, 247, 269, 166, 1348.71, 269, 1346.45, 61
1, 16:07:00-000, 369, 203, 166, 151, 1347.83, 166, 1347.91, 55
1, 16:08:00-000, 562, 284, 278, 202, 1347.40, 278, 1346.54, 86
1, 16:09:00-000, 308, 209, 99, 114, 1348.73, 99, 1347.78, 59
1, 16:10:00-000, 576, 357, 219, 281, 1348.15, 219, 1347.64, 90
1, 16:11:00-000, 313, 215, 98, 123, 1347.83, 98, 1347.09, 73
1, 16:12:00-000, 623, 368, 255, 247, 1348.47, 255, 1346.96, 112
1, 16:13:00-000, 362, 229, 133, 134, 1348.58, 133, 1347.81, 101
1, 16:14:00-000, 713, 441, 272, 361, 1348.46, 272, 1347.53, 78
1, 16:15:00-000, 362, 225, 137, 195, 1348.80, 137, 1346.92, 88
1, 16:16:00-000, 611, 388, 223, 220, 1348.07, 223, 1347.90, 76
1, 16:17:00-000, 226, 126, 100, 74, 1348.88, 100, 1347.57, 136
1, 16:18:00-000, 609, 344, 265, 241, 1348.12, 265, 1347.74, 43
1, 16:19:00-000, 272, 161, 111, 113, 1347.96, 111, 1347.30, 103
1, 16:20:00-000, 563, 318, 245, 245, 1348.39, 245, 1347.06, 34
1, 16:21:00-000, 371, 178, 193, 156, 1347.44, 193, 1346.90, 59
1, 16:22:00-000, 627, 348, 279, 239, 1348.08, 279, 1347.31, 65
1, 16:23:00-000, 355, 193, 162, 138, 1347.79, 162, 1347.48, 69
1, 16:24:00-000, 640, 392, 248, 243, 1347.79, 248, 1346.96, 102
1, 16:25:00-000, 355, 225, 130, 195, 1347.21, 130, 1347.01, 93
1, 16:26:00-000, 634, 351, 283, 266, 1348.46, 283, 1347.13, 78
1, 16:27:00-000, 293, 162, 131, 140, 1348.45, 125, 1347.44, 78
1, 16:28:00-000, 519, 271, 248, 214, 1348.07, 254, 1347.15, 36
1, 16:29:00-000, 285, 153, 132, 122, 1346.86, 132, 1346.39, 39
2, 09:06:00-000, 3056, 0, 3056, 0, 0.00, 1106, 1348.63, 0
2, 09:07:00-000, 0, 0, 0, 0, 0.00, 0, 0.00, 1937
2, 09:08:00-000, 0, 0, 0, 0, 0.00, 0, 0.00, 13
2, 09:13:00-000, 3123, 1106, 2017, 1106, 1352.31, 1549, 1350.57, 0
2, 09:14:00-000, 2, 0, 2, 0, 0.00, 20, 1355.00, 450
2, 09:15:00-000, 26, 18, 8, 18, 1353.94, 7, 1353.71, 0
2, 09:16:00-000, 118, 52, 66, 52, 1353.30, 66, 1352.82, 1
2, 09:17:00-000, 258, 130, 128, 130, 1353.02, 128, 1352.65, 0
2, 09:18:00-000, 564, 310, 254, 310, 1356.25, 231, 1353.07, 0
2, 09:19:00-000, 449, 236, 213, 236, 1354.11, 232, 1353.68, 1
2, 09:20:00-000, 753, 359, 394, 356, 1352.91, 387, 1352.30, 8
2, 09:21:00-000, 351, 161, 190, 161, 1352.84, 179, 1351.87, 4
2, 09:22:00-000, 597, 308, 289, 308, 1354.23, 277, 1352.62, 0
2, 09:23:00-000, 310, 129, 181, 129, 1351.78, 144, 1351.35, 8
2, 09:24:00-000, 528, 280, 248, 263, 1353.99, 287, 1352.12, 14
2, 09:25:00-000, 303, 156, 147, 173, 1356.00, 146, 1353.56, 0
2, 09:26:00-000, 619, 295, 324, 295, 1353.17, 285, 1352.66, 0
2, 09:27:00-000, 295, 166, 129, 166, 1354.35, 106, 1351.60, 40
2, 09:28:00-000, 614, 275, 339, 275, 1353.18, 254, 1351.54, 26
2, 09:29:00-000, 292, 115, 177, 115, 1353.41, 153, 1352.19, 48
2, 09:30:00-000, 651, 308, 343, 308, 1351.28, 301, 1351.18, 58
2, 09:31:00-000, 356, 195, 161, 195, 1353.95, 193, 1353.46, 2
2, 09:32:00-000, 628, 258, 370, 258, 1352.21, 283, 1351.42, 18
2, 09:33:00-000, 233, 110, 123, 110, 1351.79, 107, 1350.58, 69
2, 09:34:00-000, 686, 293, 393, 291, 1352.27, 331, 1350.86, 28
2, 09:35:00-000, 300, 146, 154, 148, 1353.71, 139, 1352.68, 43
2, 09:36:00-000, 787, 389, 398, 389, 1353.10, 354, 1351.72, 27
2, 09:37:00-000, 276, 158, 118, 158, 1354.32, 106, 1351.91, 46
2, 09:38:00-000, 600, 241, 359, 241, 1353.81, 266, 1351.28, 11
2, 09:39:00-000, 350, 171, 179, 169, 1352.90, 163, 1351.98, 53
2, 09:40:00-000, 607, 301, 306, 301, 1352.55, 317, 1351.70, 31
2, 09:41:00-000, 332, 140, 192, 142, 1353.01, 151, 1350.95, 11
2, 09:42:00-000, 659, 303, 356, 303, 1353.23, 298, 1351.57, 44
2, 09:43:00-000, 310, 156, 154, 156, 1353.36, 166, 1352.15, 34
2, 09:44:00-000, 577, 295, 282, 295, 1353.12, 237, 1351.55, 21
2, 09:45:00-000, 353, 152, 201, 152, 1353.58, 176, 1351.38, 26
2, 09:46:00-000, 617, 293, 324, 293, 1353.41, 289, 1352.34, 27
2, 09:47:00-000, 303, 147, 156, 147, 1353.72, 149, 1352.09, 33
2, 09:48:00-000, 656, 342, 314, 342, 1353.75, 276, 1352.57, 10
2, 09:49:00-000, 275, 94, 181, 94, 1351.58, 105, 1349.91, 47
2, 09:50:00-000, 693, 298, 395, 298, 1352.12, 350, 1350.66, 55
2, 09:51:00-000, 287, 117, 170, 117, 1351.55, 132, 1350.70, 53
2, 09:52:00-000, 588, 295, 293, 295, 1353.58, 255, 1352.17, 35
2, 09:53:00-000, 233, 125, 108, 125, 1353.03, 95, 1351.83, 46
2, 09:54:00-000, 644, 301, 343, 301, 1353.16, 275, 1352.25, 23
2, 09:55:00-000, 322, 131, 191, 131, 1352.91, 148, 1351.36, 61
2, 09:56:00-000, 624, 334, 290, 334, 1353.21, 250, 1351.64, 48
2, 09:57:00-000, 307, 159, 148, 159, 1353.23, 109, 1351.10, 39
2, 09:58:00-000, 655, 246, 409, 246, 1351.77, 259, 1349.85, 60
2, 09:59:00-000, 345, 134, 211, 134, 1351.20, 174, 1350.94, 83
2, 10:00:00-000, 610, 277, 333, 277, 1352.49, 309, 1351.51, 80
2, 10:01:00-000, 302, 102, 200, 102, 1351.50, 108, 1349.88, 28
2, 10:02:00-000, 608, 262, 346, 262, 1352.05, 283, 1351.36, 93
2, 10:03:00-000, 281, 125, 156, 125, 1353.00, 128, 1352.27, 37
2, 10:04:00-000, 621, 258, 363, 258, 1353.27, 271, 1351.97, 65
2, 10:05:00-000, 328, 159, 169, 159, 1352.79, 158, 1352.35, 70
2, 10:06:00-000, 658, 253, 405, 253, 1353.00, 323, 1351.36, 32
2, 10:07:00-000, 279, 110, 169, 110, 1352.71, 141, 1351.48, 59
2, 10:08:00-000, 631, 328, 303, 328, 1353.31, 285, 1352.13, 22
2, 10:09:00-000, 294, 136, 158, 136, 1352.59, 116, 1351.25, 36
2, 10:10:00-000, 684, 304, 380, 304, 1352.44, 277, 1351.12, 70
2, 10:11:00-000, 314, 134, 180, 134, 1351.97, 120, 1350.56, 60
2, 10:12:00-000, 552, 255, 297, 255, 1351.23, 274, 1350.95, 42
2, 10:13:00-000, 301, 158, 143, 158, 1354.23, 127, 1352.41, 35
2, 10:14:00-000, 644, 272, 372, 272, 1352.61, 279, 1351.56, 41
2, 10:15:00-000, 337, 142, 195, 142, 1351.75, 158, 1351.39, 58
2, 10:16:00-000, 591, 274, 317, 274, 1352.91, 286, 1351.33, 76
2, 10:17:00-000, 357, 143, 214, 143, 1351.41, 146, 1350.70, 22
2, 10:18:00-000, 510, 275, 235, 273, 1353.50, 211, 1352.42, 56
2, 10:19:00-000, 331, 149, 182, 151, 1353.58, 152, 1351.88, 29
2, 10:20:00-000, 623, 252, 371, 252, 1352.42, 274, 1351.11, 62
2, 10:21:00-000, 309, 145, 164, 145, 1352.82, 125, 1352.13, 66
2, 10:22:00-000, 608, 283, 325, 283, 1352.81, 279, 1350.89, 35
2, 10:23:00-000, 329, 152, 177, 152, 1352.92, 158, 1351.88, 36
2, 10:24:00-000, 587, 254, 333, 254, 1352.04, 251, 1351.59, 53
2, 10:25:00-000, 287, 123, 164, 122, 1352.31, 150, 1351.14, 38
2, 10:26:00-000, 597, 245, 352, 246, 1351.03, 231, 1350.86, 59
2, 10:27:00-000, 269, 115, 154, 115, 1351.47, 126, 1350.05, 87
2, 10:28:00-000, 655, 284, 371, 284, 1351.63, 285, 1350.91, 53
2, 10:29:00-000, 302, 114, 188, 114, 1353.27, 137, 1350.93, 61
2, 10:30:00-000, 654, 309, 345, 309, 1352.53, 307, 1351.89, 55
2, 10:31:00-000, 310, 140, 170, 140, 1352.43, 150, 1350.76, 47
2, 10:32:00-000, 605, 288, 317, 288, 1352.24, 235, 1351.42, 24
2, 10:33:00-000, 299, 126, 173, 126, 1352.01, 118, 1350.81, 77
2, 10:34:00-000, 685, 260, 425, 260, 1352.24, 295, 1350.91, 71
2, 10:35:00-000, 326, 145, 181, 145, 1351.54, 148, 1351.04, 85
2, 10:36:00-000, 553, 265, 288, 265, 1352.87, 252, 1351.60, 42
2, 10:37:00-000, 349, 149, 200, 149, 1353.31, 179, 1351.33, 53
2, 10:38:00-000, 593, 248, 345, 248, 1351.81, 247, 1350.91, 54
2, 10:39:00-000, 296, 107, 189, 107, 1351.56, 156, 1350.40, 68
2, 10:40:00-000, 630, 249, 381, 249, 1352.45, 256, 1351.44, 63
2, 10:41:00-000, 307, 138, 169, 138, 1352.76, 116, 1352.12, 82
2, 10:42:00-000, 730, 349, 381, 349, 1353.17, 332, 1351.73, 53
2, 10:43:00-000, 346, 152, 194, 152, 1352.28, 176, 1351.99, 57
2, 10:44:00-000, 602, 280, 322, 280, 1353.25, 259, 1351.57, 32
2, 10:45:00-000, 294, 98, 196, 98, 1351.54, 148, 1350.49, 50
2, 10:46:00-000, 565, 302, 263, 302, 1352.96, 230, 1351.75, 45
2, 10:47:00-000, 353, 170, 183, 170, 1352.51, 172, 1350.92, 37
2, 10:48:00-000, 593, 265, 328, 265, 1352.15, 257, 1351.36, 44
2, 10:49:00-000, 298, 150, 148, 150, 1352.79, 104, 1351.59, 45
2, 10:50:00-000, 584, 254, 330, 254, 1352.93, 266, 1350.83, 57
2, 10:51:00-000, 412, 205, 207, 205, 1353.68, 150, 1351.84, 53
2, 10:52:00-000, 657, 262, 395, 262, 1352.07, 295, 1350.95, 88
2, 10:53:00-000, 251, 105, 146, 105, 1351.84, 115, 1351.72, 67
2, 10:54:00-000, 522, 245, 277, 245, 1352.76, 221, 1351.11, 32
2, 10:55:00-000, 263, 109, 154, 109, 1352.00, 122, 1351.36, 44
2, 10:56:00-000, 625, 265, 360, 265, 1352.42, 270, 1350.89, 55
2, 10:57:00-000, 350, 141, 209, 141, 1353.12, 171, 1351.84, 49
2, 10:58:00-000, 704, 290, 414, 290, 1351.98, 297, 1350.93, 87
2, 10:59:00-000, 284, 130, 154, 130, 1353.17, 144, 1352.29, 58
2, 11:00:00-000, 646, 272, 374, 272, 1351.98, 260, 1351.18, 64
2, 11:01:00-000, 273, 125, 148, 125, 1351.05, 115, 1350.79, 101
2, 11:02:00-000, 648, 273, 375, 273, 1352.85, 296, 1351.16, 52
2, 11:03:00-000, 307, 105, 202, 105, 1352.57, 160, 1351.47, 51
2, 11:04:00-000, 619, 320, 299, 320, 1353.03, 267, 1352.40, 49
2, 11:05:00-000, 378, 148, 230, 148, 1351.43, 150, 1351.13, 31
2, 11:06:00-000, 642, 294, 348, 294, 1351.37, 242, 1350.88, 74
2, 11:07:00-000, 322, 136, 186, 136, 1352.65, 146, 1351.85, 90
2, 11:08:00-000, 599, 293, 306, 293, 1352.34, 280, 1350.52, 56
2, 11:09:00-000, 272, 114, 158, 114, 1352.35, 111, 1351.25, 28
2, 11:10:00-000, 682, 313, 369, 313, 1353.19, 294, 1352.04, 48
2, 11:11:00-000, 366, 145, 221, 145, 1353.07, 198, 1351.77, 58
2, 11:12:00-000, 640, 259, 381, 259, 1353.38, 316, 1352.01, 45
2, 11:13:00-000, 298, 117, 181, 117, 1352.44, 176, 1351.31, 39
2, 11:14:00-000, 579, 268, 311, 268, 1352.35, 224, 1350.75, 42
2, 11:15:00-000, 319, 134, 185, 134, 1351.79, 132, 1351.00, 61
2, 11:16:00-000, 668, 300, 368, 300, 1352.29, 292, 1351.35, 69
2, 11:17:00-000, 361, 138, 223, 138, 1351.15, 141, 1350.67, 73
2, 11:18:00-000, 648, 320, 328, 320, 1353.12, 308, 1351.47, 60
2, 11:19:00-000, 294, 130, 164, 130, 1351.85, 140, 1352.31, 35
2, 11:20:00-000, 529, 257, 272, 257, 1353.13, 242, 1352.06, 34
2, 11:21:00-000, 312, 159, 153, 159, 1353.49, 121, 1352.44, 32
2, 11:22:00-000, 596, 241, 355, 241, 1352.08, 266, 1351.11, 52
2, 11:23:00-000, 327, 123, 204, 123, 1351.45, 123, 1351.30, 67
2, 11:24:00-000, 662, 316, 346, 316, 1352.49, 277, 1351.87, 87
2, 11:25:00-000, 304, 179, 125, 179, 1354.40, 122, 1353.45, 39
2, 11:26:00-000, 584, 252, 332, 248, 1353.18, 239, 1351.53, 29
2, 11:27:00-000, 307, 145, 162, 149, 1352.23, 157, 1351.67, 50
2, 11:28:00-000, 550, 203, 347, 203, 1352.18, 270, 1350.42, 56
2, 11:29:00-000, 244, 119, 125, 119, 1353.34, 122, 1351.43, 46
2, 11:30:00-000, 670, 309, 361, 309, 1352.57, 275, 1350.73, 44
2, 11:31:00-000, 354, 148, 206, 148, 1353.00, 146, 1351.59, 64
2, 11:32:00-000, 557, 252, 305, 252, 1351.92, 236, 1351.31, 87
2, 11:33:00-000, 325, 150, 175, 150, 1352.53, 145, 1351.37, 36
2, 11:34:00-000, 569, 268, 301, 268, 1352.48, 224, 1351.74, 40
2, 11:35:00-000, 308, 114, 194, 114, 1351.96, 144, 1351.95, 57
2, 11:36:00-000, 601, 240, 361, 240, 1350.87, 229, 1350.13, 74
2, 11:37:00-000, 338, 164, 174, 164, 1352.50, 142, 1351.68, 91
2, 11:38:00-000, 596, 247, 349, 247, 1352.28, 246, 1350.97, 80
2, 11:39:00-000, 267, 113, 154, 113, 1353.07, 114, 1351.08, 73
2, 11:40:00-000, 708, 287, 421, 287, 1352.24, 315, 1351.33, 74
2, 11:41:00-000, 311, 151, 160, 151, 1353.10, 130, 1352.38, 64
2, 11:42:00-000, 615, 256, 359, 256, 1351.66, 245, 1350.62, 82
2, 11:43:00-000, 313, 124, 189, 124, 1351.96, 153, 1350.89, 72
2, 11:44:00-000, 646, 250, 396, 250, 1352.32, 318, 1351.56, 54
2, 11:45:00-000, 277, 97, 180, 97, 1351.69, 123, 1351.34, 59
2, 11:46:00-000, 575, 258, 317, 258, 1352.43, 254, 1351.37, 72
2, 11:47:00-000, 282, 119, 163, 119, 1352.44, 121, 1351.81, 60
2, 11:48:00-000, 607, 268, 339, 268, 1352.26, 259, 1351.04, 58
2, 11:49:00-000, 306, 114, 192, 114, 1351.72, 117, 1351.08, 68
2, 11:50:00-000, 630, 318, 312, 318, 1353.06, 272, 1351.41, 65
2, 11:51:00-000, 329, 155, 174, 155, 1353.47, 157, 1352.07, 24
2, 11:52:00-000, 636, 272, 364, 272, 1352.76, 282, 1351.43, 65
2, 11:53:00-000, 258, 92, 166, 92, 1351.81, 108, 1350.00, 62
2, 11:54:00-000, 607, 257, 350, 257, 1352.09, 257, 1351.03, 63
2, 11:55:00-000, 289, 140, 149, 140, 1353.12, 143, 1352.07, 48
2, 11:56:00-000, 602, 291, 311, 291, 1353.21, 215, 1352.13, 68
2, 11:57:00-000, 295, 118, 177, 118, 1351.03, 97, 1350.44, 66
2, 11:58:00-000, 614, 276, 338, 276, 1352.38, 266, 1351.07, 102
2, 11:59:00-000, 331, 131, 200, 131, 1352.51, 134, 1351.14, 58
2, 12:00:00-000, 669, 243, 426, 243, 1351.96, 309, 1351.19, 59
2, 12:01:00-000, 284, 108, 176, 108, 1351.84, 141, 1350.94, 93
2, 12:02:00-000, 689, 300, 389, 300, 1351.45, 301, 1350.83, 75
2, 12:03:00-000, 319, 146, 173, 146, 1351.94, 136, 1351.62, 65
2, 12:04:00-000, 574, 213, 361, 213, 1351.07, 208, 1350.42, 77
2, 12:05:00-000, 326, 147, 179, 147, 1352.08, 180, 1351.85, 87
2, 12:06:00-000, 621, 265, 356, 265, 1352.14, 275, 1350.49, 36
2, 12:07:00-000, 292, 162, 130, 162, 1353.46, 121, 1351.95, 58
2, 12:08:00-000, 563, 222, 341, 222, 1352.23, 233, 1350.17, 65
2, 12:09:00-000, 318, 122, 196, 122, 1352.75, 133, 1351.68, 51
2, 12:10:00-000, 703, 311, 392, 311, 1351.78, 340, 1351.14, 55
2, 12:11:00-000, 309, 131, 178, 131, 1352.51, 154, 1350.22, 83
2, 12:12:00-000, 605, 228, 377, 228, 1351.79, 279, 1351.01, 37
2, 12:13:00-000, 289, 134, 155, 134, 1352.59, 144, 1351.37, 62
2, 12:14:00-000, 593, 293, 300, 293, 1353.33, 253, 1352.33, 46
2, 12:15:00-000, 346, 151, 195, 151, 1352.98, 152, 1352.14, 39
2, 12:16:00-000, 637, 310, 327, 310, 1352.11, 289, 1351.55, 44
2, 12:17:00-000, 301, 132, 169, 132, 1352.40, 110, 1350.75, 37
2, 12:18:00-000, 656, 299, 357, 299, 1352.29, 269, 1350.28, 69
2, 12:19:00-000, 322, 135, 187, 135, 1351.46, 136, 1351.29, 58
2, 12:20:00-000, 634, 301, 333, 301, 1351.55, 193, 1350.52, 75
2, 12:21:00-000, 300, 136, 164, 136, 1352.46, 107, 1350.57, 119
2, 12:22:00-000, 555, 262, 293, 262, 1351.84, 209, 1350.49, 84
2, 12:23:00-000, 288, 126, 162, 126, 1352.89, 96, 1350.67, 68
2, 12:24:00-000, 573, 234, 339, 234, 1352.28, 234, 1350.92, 88
2, 12:25:00-000, 324, 140, 184, 140, 1353.00, 115, 1350.05, 82
2, 12:26:00-000, 700, 256, 444, 256, 1352.02, 308, 1351.39, 97
2, 12:27:00-000, 292, 128, 164, 128, 1353.21, 144, 1351.42, 88
2, 12:28:00-000, 574, 226, 348, 226, 1351.63, 228, 1350.68, 61
2, 12:29:00-000, 274, 65, 209, 65, 1350.93, 142, 1350.39, 84
2, 12:30:00-000, 652, 263, 389, 263, 1352.16, 307, 1351.08, 86
2, 12:31:00-000, 333, 136, 197, 136, 1352.37, 147, 1350.91, 77
2, 12:32:00-000, 533, 190, 343, 190, 1351.84, 275, 1351.53, 55
2, 12:33:00-000, 400, 175, 225, 175, 1352.56, 168, 1350.77, 53
2, 12:34:00-000, 669, 282, 387, 282, 1352.05, 299, 1351.44, 79
2, 12:35:00-000, 301, 134, 167, 134, 1352.06, 136, 1351.43, 78
2, 12:36:00-000, 586, 260, 326, 260, 1351.88, 252, 1350.62, 49
2, 12:37:00-000, 316, 165, 151, 165, 1351.53, 116, 1351.05, 60
2, 12:38:00-000, 661, 301, 360, 301, 1352.13, 262, 1352.12, 26
2, 12:39:00-000, 279, 136, 143, 136, 1353.46, 110, 1351.85, 90
2, 12:40:00-000, 634, 285, 349, 285, 1352.33, 278, 1350.97, 53
2, 12:41:00-000, 303, 138, 165, 138, 1352.52, 144, 1351.87, 47
2, 12:42:00-000, 659, 250, 409, 250, 1352.21, 309, 1351.50, 49
2, 12:43:00-000, 287, 96, 191, 96, 1350.80, 128, 1350.14, 78
2, 12:44:00-000, 707, 289, 418, 289, 1351.77, 280, 1351.18, 90
2, 12:45:00-000, 298, 154, 144, 154, 1352.92, 147, 1352.30, 95
2, 12:46:00-000, 598, 247, 351, 247, 1352.03, 229, 1351.48, 50
2, 12:47:00-000, 311, 119, 192, 119, 1352.20, 143, 1351.49, 73
2, 12:48:00-000, 658, 285, 373, 285, 1352.21, 290, 1351.72, 89
2, 12:49:00-000, 329, 131, 198, 131, 1352.38, 148, 1351.82, 62
2, 12:50:00-000, 601, 274, 327, 274, 1352.52, 233, 1351.31, 73
2, 12:51:00-000, 331, 133, 198, 131, 1351.60, 156, 1350.78, 62
2, 12:52:00-000, 664, 280, 384, 282, 1351.61, 319, 1350.87, 47
2, 12:53:00-000, 287, 125, 162, 125, 1352.67, 137, 1352.20, 63
2, 12:54:00-000, 617, 291, 326, 291, 1353.20, 266, 1351.90, 34
2, 12:55:00-000, 311, 125, 186, 125, 1352.34, 159, 1351.28, 29
2, 12:56:00-000, 657, 302, 355, 298, 1352.80, 284, 1351.29, 58
2, 12:57:00-000, 288, 164, 124, 168, 1353.38, 130, 1352.09, 48
2, 12:58:00-000, 788, 328, 460, 328, 1352.70, 397, 1351.26, 43
2, 12:59:00-000, 311, 137, 174, 137, 1352.64, 152, 1352.36, 39
2, 13:00:00-000, 531, 231, 300, 231, 1352.24, 220, 1351.25, 41
2, 13:01:00-000, 296, 146, 150, 146, 1352.49, 117, 1352.11, 45
2, 13:02:00-000, 625, 276, 349, 276, 1353.49, 282, 1351.22, 49
2, 13:03:00-000, 358, 182, 176, 182, 1353.37, 173, 1351.89, 52
2, 13:04:00-000, 593, 276, 317, 276, 1352.36, 262, 1351.00, 29
2, 13:05:00-000, 323, 139, 184, 139, 1351.89, 130, 1351.55, 39
2, 13:06:00-000, 537, 257, 280, 257, 1353.22, 227, 1351.60, 56
2, 13:07:00-000, 328, 155, 173, 155, 1352.25, 155, 1351.27, 39
2, 13:08:00-000, 610, 245, 365, 245, 1352.73, 279, 1351.16, 46
2, 13:09:00-000, 306, 136, 170, 136, 1352.66, 135, 1351.51, 52
2, 13:10:00-000, 676, 288, 388, 288, 1352.91, 295, 1351.97, 65
2, 13:11:00-000, 298, 149, 149, 149, 1351.36, 136, 1351.70, 62
2, 13:12:00-000, 627, 282, 345, 282, 1353.22, 284, 1351.72, 51
2, 13:13:00-000, 317, 138, 179, 138, 1351.48, 116, 1351.49, 40
2, 13:14:00-000, 603, 279, 324, 279, 1353.23, 241, 1351.88, 82
2, 13:15:00-000, 317, 160, 157, 160, 1353.91, 139, 1351.20, 57
2, 13:16:00-000, 624, 266, 358, 266, 1352.52, 295, 1351.20, 49
2, 13:17:00-000, 302, 139, 163, 139, 1352.82, 123, 1352.20, 43
2, 13:18:00-000, 615, 272, 343, 272, 1353.70, 273, 1351.34, 25
2, 13:19:00-000, 369, 161, 208, 161, 1353.36, 197, 1352.06, 45
2, 13:20:00-000, 591, 268, 323, 268, 1353.17, 258, 1351.62, 66
2, 13:21:00-000, 330, 120, 210, 120, 1353.00, 170, 1351.83, 41
2, 13:22:00-000, 650, 255, 395, 255, 1351.95, 263, 1350.81, 79
2, 13:23:00-000, 262, 122, 140, 122, 1351.78, 127, 1351.14, 73
2, 13:24:00-000, 594, 285, 309, 285, 1352.32, 281, 1352.00, 33
2, 13:25:00-000, 306, 148, 158, 148, 1352.23, 129, 1350.87, 26
2, 13:26:00-000, 659, 303, 356, 303, 1351.63, 273, 1351.53, 64
2, 13:27:00-000, 279, 115, 164, 115, 1353.13, 105, 1351.54, 58
2, 13:28:00-000, 649, 307, 342, 307, 1353.09, 281, 1351.21, 65
2, 13:29:00-000, 347, 129, 218, 129, 1352.43, 144, 1351.17, 58
2, 13:30:00-000, 652, 298, 354, 298, 1352.80, 300, 1351.79, 86
2, 13:31:00-000, 241, 105, 136, 105, 1353.26, 117, 1351.18, 47
2, 13:32:00-000, 561, 205, 356, 205, 1351.78, 257, 1350.51, 29
2, 13:33:00-000, 365, 137, 228, 137, 1352.17, 179, 1351.02, 61
2, 13:34:00-000, 660, 331, 329, 331, 1351.72, 309, 1351.31, 63
2, 13:35:00-000, 329, 130, 199, 130, 1351.90, 112, 1350.96, 27
2, 13:36:00-000, 578, 255, 323, 255, 1351.66, 262, 1351.56, 80
2, 13:37:00-000, 332, 164, 168, 164, 1352.78, 158, 1351.61, 59
2, 13:38:00-000, 572, 286, 286, 286, 1352.14, 196, 1350.56, 50
2, 13:39:00-000, 342, 144, 198, 144, 1350.96, 156, 1350.44, 57
2, 13:40:00-000, 626, 262, 364, 262, 1351.80, 268, 1350.81, 53
2, 13:41:00-000, 336, 170, 166, 170, 1351.98, 164, 1350.92, 58
2, 13:42:00-000, 698, 315, 383, 315, 1352.59, 290, 1351.43, 49
2, 13:43:00-000, 311, 119, 192, 119, 1352.22, 154, 1350.59, 71
2, 13:44:00-000, 594, 277, 317, 277, 1352.23, 242, 1350.87, 54
2, 13:45:00-000, 293, 115, 178, 115, 1351.19, 126, 1350.29, 63
2, 13:46:00-000, 630, 274, 356, 274, 1351.69, 252, 1350.92, 81
2, 13:47:00-000, 285, 121, 164, 121, 1352.03, 105, 1349.93, 57
2, 13:48:00-000, 661, 273, 388, 273, 1351.84, 295, 1350.10, 98
2, 13:49:00-000, 276, 146, 130, 146, 1353.55, 132, 1352.71, 43
2, 13:50:00-000, 650, 279, 371, 279, 1351.94, 274, 1350.82, 44
2, 13:51:00-000, 337, 150, 187, 150, 1352.16, 137, 1350.57, 71
2, 13:52:00-000, 596, 222, 374, 222, 1351.75, 247, 1350.40, 68
2, 13:53:00-000, 325, 146, 179, 146, 1352.02, 151, 1351.55, 94
2, 13:54:00-000, 603, 270, 333, 270, 1351.96, 266, 1350.97, 61
2, 13:55:00-000, 291, 134, 157, 134, 1351.42, 136, 1350.76, 52
2, 13:56:00-000, 568, 249, 319, 249, 1352.32, 249, 1351.39, 40
2, 13:57:00-000, 341, 120, 221, 120, 1351.55, 142, 1350.21, 41
2, 13:58:00-000, 572, 272, 300, 272, 1352.11, 260, 1351.19, 91
2, 13:59:00-000, 342, 138, 204, 138, 1352.01, 139, 1351.48, 40
2, 14:00:00-000, 622, 262, 360, 262, 1351.89, 274, 1351.14, 82
2, 14:01:00-000, 265, 122, 143, 122, 1352.02, 104, 1349.83, 61
2, 14:02:00-000, 568, 285, 283, 285, 1352.16, 234, 1351.23, 67
2, 14:03:00-000, 329, 102, 227, 102, 1351.14, 171, 1350.04, 34
2, 14:04:00-000, 685, 272, 413, 272, 1351.89, 299, 1351.01, 70
2, 14:05:00-000, 307, 144, 163, 144, 1352.06, 149, 1350.92, 84
2, 14:06:00-000, 606, 236, 370, 236, 1351.07, 259, 1350.77, 52
2, 14:07:00-000, 283, 137, 146, 137, 1352.59, 117, 1352.08, 65
2, 14:08:00-000, 668, 305, 363, 305, 1351.58, 280, 1350.50, 53
2, 14:09:00-000, 294, 137, 157, 137, 1351.90, 116, 1350.57, 75
2, 14:10:00-000, 700, 351, 349, 351, 1353.15, 289, 1352.25, 42
2, 14:11:00-000, 229, 99, 130, 99, 1353.12, 97, 1350.18, 59
2, 14:12:00-000, 619, 224, 395, 224, 1351.02, 265, 1350.53, 70
2, 14:13:00-000, 303, 124, 179, 124, 1351.72, 128, 1351.77, 75
2, 14:14:00-000, 567, 247, 320, 246, 1352.27, 230, 1351.56, 86
2, 14:15:00-000, 316, 153, 163, 154, 1353.52, 125, 1351.75, 67
2, 14:16:00-000, 684, 272, 412, 272, 1351.86, 280, 1350.61, 75
2, 14:17:00-000, 284, 149, 135, 149, 1351.99, 138, 1351.86, 75
2, 14:18:00-000, 557, 190, 367, 190, 1351.77, 225, 1350.78, 38
2, 14:19:00-000, 302, 135, 167, 135, 1351.41, 110, 1351.05, 133
2, 14:20:00-000, 573, 240, 333, 240, 1351.70, 219, 1350.54, 85
2, 14:21:00-000, 297, 96, 201, 96, 1351.08, 129, 1351.00, 70
2, 14:22:00-000, 629, 280, 349, 280, 1352.05, 258, 1350.11, 96
2, 14:23:00-000, 348, 156, 192, 156, 1351.95, 129, 1351.15, 77
2, 14:24:00-000, 695, 296, 399, 296, 1352.21, 323, 1351.54, 56
2, 14:25:00-000, 280, 105, 175, 105, 1351.70, 99, 1350.74, 79
2, 14:26:00-000, 585, 207, 378, 207, 1351.61, 232, 1350.90, 112
2, 14:27:00-000, 348, 146, 202, 146, 1351.41, 150, 1350.82, 111
2, 14:28:00-000, 644, 254, 390, 254, 1351.74, 244, 1350.69, 102
2, 14:29:00-000, 309, 128, 181, 128, 1351.48, 127, 1350.82, 91
2, 14:30:00-000, 613, 272, 341, 272, 1352.61, 235, 1350.99, 70
2, 14:31:00-000, 300, 134, 166, 134, 1352.09, 165, 1351.02, 59
2, 14:32:00-000, 641, 249, 392, 249, 1352.02, 241, 1350.88, 70
2, 14:33:00-000, 327, 120, 207, 120, 1351.46, 158, 1350.62, 91
2, 14:34:00-000, 594, 289, 305, 289, 1352.06, 248, 1351.29, 79
2, 14:35:00-000, 300, 124, 176, 124, 1351.88, 119, 1350.81, 64
2, 14:36:00-000, 547, 210, 337, 210, 1351.94, 260, 1351.15, 83
2, 14:37:00-000, 315, 137, 178, 137, 1351.79, 125, 1351.07, 49
2, 14:38:00-000, 640, 259, 381, 259, 1352.20, 263, 1350.86, 57
2, 14:39:00-000, 327, 135, 192, 135, 1352.18, 162, 1351.33, 94
2, 14:40:00-000, 569, 269, 300, 269, 1353.50, 236, 1351.22, 64
2, 14:41:00-000, 285, 115, 170, 115, 1351.74, 156, 1351.15, 40
2, 14:42:00-000, 530, 200, 330, 200, 1351.89, 276, 1350.62, 31
2, 14:43:00-000, 392, 165, 227, 165, 1351.98, 158, 1351.49, 52
2, 14:44:00-000, 645, 300, 345, 300, 1352.62, 270, 1351.24, 56
2, 14:45:00-000, 325, 148, 177, 148, 1352.22, 144, 1350.62, 84
2, 14:46:00-000, 586, 246, 340, 246, 1351.84, 270, 1350.39, 58
2, 14:47:00-000, 269, 136, 133, 136, 1353.19, 87, 1351.43, 53
2, 14:48:00-000, 606, 251, 355, 251, 1352.77, 277, 1351.19, 41
2, 14:49:00-000, 263, 126, 137, 126, 1352.96, 118, 1351.95, 74
2, 14:50:00-000, 732, 293, 439, 293, 1351.90, 310, 1350.90, 54
2, 14:51:00-000, 355, 168, 187, 168, 1352.17, 181, 1350.34, 69
2, 14:52:00-000, 681, 288, 393, 288, 1351.78, 277, 1351.13, 55
2, 14:53:00-000, 267, 115, 152, 115, 1351.96, 114, 1350.58, 80
2, 14:54:00-000, 578, 207, 371, 207, 1351.41, 239, 1350.04, 53
2, 14:55:00-000, 321, 143, 178, 143, 1351.27, 124, 1351.37, 96
2, 14:56:00-000, 609, 271, 338, 271, 1352.13, 227, 1350.91, 112
2, 14:57:00-000, 318, 145, 173, 145, 1351.94, 118, 1351.14, 76
2, 14:58:00-000, 667, 327, 340, 327, 1352.59, 278, 1351.98, 60
2, 14:59:00-000, 347, 165, 182, 165, 1352.56, 156, 1351.74, 65
2, 15:00:00-000, 652, 244, 408, 244, 1351.34, 296, 1350.74, 57
2, 15:01:00-000, 302, 119, 183, 119, 1351.55, 131, 1350.87, 76
2, 15:02:00-000, 619, 207, 412, 207, 1351.83, 249, 1350.45, 89
2, 15:03:00-000, 355, 173, 182, 173, 1352.14, 152, 1351.38, 110
2, 15:04:00-000, 597, 227, 370, 227, 1351.90, 272, 1350.73, 81
2, 15:05:00-000, 243, 115, 128, 115, 1352.92, 99, 1351.93, 70
2, 15:06:00-000, 715, 346, 369, 346, 1352.77, 298, 1351.00, 43
2, 15:07:00-000, 324, 157, 167, 157, 1352.66, 136, 1352.24, 53
2, 15:08:00-000, 585, 254, 331, 254, 1352.28, 241, 1351.48, 55
2, 15:09:00-000, 303, 124, 179, 122, 1352.67, 127, 1351.92, 61
2, 15:10:00-000, 619, 244, 375, 246, 1351.88, 290, 1351.24, 70
2, 15:11:00-000, 351, 143, 208, 143, 1352.60, 151, 1351.23, 74
2, 15:12:00-000, 640, 255, 385, 255, 1351.74, 267, 1350.67, 81
2, 15:13:00-000, 301, 119, 182, 119, 1352.33, 143, 1351.73, 71
2, 15:14:00-000, 668, 341, 327, 341, 1352.80, 282, 1351.05, 75
2, 15:15:00-000, 286, 120, 166, 120, 1352.60, 123, 1352.08, 35
2, 15:16:00-000, 671, 317, 354, 317, 1353.07, 296, 1351.89, 50
2, 15:17:00-000, 277, 86, 191, 86, 1352.01, 111, 1351.23, 53
2, 15:18:00-000, 671, 301, 370, 301, 1352.21, 253, 1351.46, 89
2, 15:19:00-000, 265, 117, 148, 117, 1350.29, 136, 1350.79, 93
2, 15:20:00-000, 745, 285, 460, 285, 1351.54, 307, 1349.95, 59
2, 15:21:00-000, 312, 106, 206, 106, 1351.41, 118, 1350.08, 113
2, 15:22:00-000, 630, 252, 378, 252, 1351.65, 277, 1350.55, 89
2, 15:23:00-000, 275, 108, 167, 108, 1351.13, 123, 1350.77, 84
2, 15:24:00-000, 647, 255, 392, 255, 1352.30, 343, 1351.34, 56
2, 15:25:00-000, 358, 173, 185, 173, 1352.28, 139, 1351.70, 62
2, 15:26:00-000, 666, 268, 398, 268, 1350.96, 288, 1350.88, 77
2, 15:27:00-000, 297, 139, 158, 139, 1351.67, 125, 1350.38, 68
2, 15:28:00-000, 593, 249, 344, 249, 1351.98, 266, 1350.43, 43
2, 15:29:00-000, 324, 149, 175, 149, 1353.22, 137, 1351.09, 65
2, 15:30:00-000, 576, 277, 299, 277, 1352.47, 209, 1350.75, 71
2, 15:31:00-000, 360, 184, 176, 184, 1352.97, 158, 1351.83, 55
2, 15:32:00-000, 655, 307, 348, 307, 1352.50, 292, 1351.01, 55
2, 15:33:00-000, 302, 124, 178, 124, 1353.70, 127, 1351.98, 26
2, 15:34:00-000, 560, 290, 270, 290, 1352.56, 234, 1351.35, 56
2, 15:35:00-000, 239, 95, 144, 95, 1352.50, 130, 1351.38, 35
2, 15:36:00-000, 651, 318, 333, 318, 1352.53, 272, 1351.29, 27
2, 15:37:00-000, 272, 121, 151, 121, 1351.81, 119, 1350.83, 49
2, 15:38:00-000, 605, 258, 347, 258, 1351.86, 236, 1351.06, 62
2, 15:39:00-000, 321, 135, 186, 135, 1352.22, 146, 1351.33, 60
2, 15:40:00-000, 590, 231, 359, 231, 1351.75, 195, 1350.34, 87
2, 15:41:00-000, 241, 92, 149, 92, 1352.05, 64, 1350.22, 131
2, 15:42:00-000, 597, 262, 335, 262, 1351.77, 207, 1350.43, 121
2, 15:43:00-000, 267, 116, 151, 116, 1351.25, 76, 1349.88, 101
2, 15:44:00-000, 638, 264, 374, 264, 1351.60, 252, 1350.43, 104
2, 15:45:00-000, 336, 137, 199, 137, 1351.44, 151, 1350.81, 79
2, 15:46:00-000, 584, 205, 379, 205, 1351.39, 268, 1350.21, 74
2, 15:47:00-000, 281, 88, 193, 88, 1352.09, 111, 1350.95, 77
2, 15:48:00-000, 665, 209, 456, 209, 1351.57, 321, 1350.20, 98
2, 15:49:00-000, 305, 127, 178, 127, 1351.97, 147, 1351.32, 101
2, 15:50:00-000, 576, 238, 338, 238, 1352.34, 191, 1351.09, 90
2, 15:51:00-000, 278, 102, 176, 102, 1352.67, 123, 1350.87, 98
2, 15:52:00-000, 596, 208, 388, 208, 1351.66, 244, 1350.34, 106
2, 15:53:00-000, 287, 133, 154, 133, 1352.55, 114, 1350.94, 114
2, 15:54:00-000, 685, 285, 400, 285, 1352.18, 265, 1350.97, 87
2, 15:55:00-000, 246, 97, 149, 97, 1351.37, 98, 1349.54, 89
2, 15:56:00-000, 669, 298, 371, 298, 1352.35, 319, 1350.74, 58
2, 15:57:00-000, 294, 158, 136, 158, 1352.72, 109, 1350.99, 55
2, 15:58:00-000, 558, 225, 333, 225, 1352.01, 261, 1350.01, 39
2, 15:59:00-000, 254, 123, 131, 123, 1352.39, 120, 1352.01, 52
2, 16:00:00-000, 641, 247, 394, 247, 1352.14, 312, 1350.83, 36
2, 16:01:00-000, 331, 111, 220, 111, 1353.58, 167, 1350.84, 54
2, 16:02:00-000, 559, 252, 307, 250, 1352.67, 215, 1351.38, 88
2, 16:03:00-000, 370, 172, 198, 174, 1352.67, 146, 1350.78, 71
2, 16:04:00-000, 698, 280, 418, 280, 1352.23, 292, 1351.07, 57
2, 16:05:00-000, 325, 116, 209, 116, 1351.62, 142, 1349.97, 97
2, 16:06:00-000, 614, 297, 317, 297, 1351.79, 257, 1351.15, 77
2, 16:07:00-000, 290, 130, 160, 130, 1352.19, 105, 1350.62, 59
2, 16:08:00-000, 712, 275, 437, 275, 1350.84, 298, 1350.38, 88
2, 16:09:00-000, 277, 115, 162, 115, 1351.58, 101, 1351.27, 104
2, 16:10:00-000, 680, 302, 378, 302, 1352.27, 274, 1351.04, 84
2, 16:11:00-000, 300, 132, 168, 132, 1351.93, 136, 1351.20, 71
2, 16:12:00-000, 579, 211, 368, 211, 1351.70, 275, 1351.18, 62
2, 16:13:00-000, 390, 183, 207, 183, 1353.07, 152, 1351.62, 72
2, 16:14:00-000, 600, 198, 402, 198, 1352.07, 265, 1351.00, 89
2, 16:15:00-000, 305, 140, 165, 140, 1352.28, 148, 1351.67, 97
2, 16:16:00-000, 683, 289, 394, 289, 1352.05, 252, 1350.76, 57
2, 16:17:00-000, 295, 134, 161, 134, 1351.75, 120, 1351.51, 93
2, 16:18:00-000, 663, 282, 381, 282, 1352.12, 301, 1351.01, 81
2, 16:19:00-000, 287, 96, 191, 96, 1352.36, 119, 1351.00, 66
2, 16:20:00-000, 715, 329, 386, 329, 1352.37, 299, 1351.61, 86
2, 16:21:00-000, 315, 125, 190, 125, 1351.48, 127, 1350.91, 68
2, 16:22:00-000, 651, 285, 366, 285, 1352.13, 240, 1351.27, 107
2, 16:23:00-000, 278, 115, 163, 115, 1351.91, 111, 1351.44, 74
2, 16:24:00-000, 589, 249, 340, 249, 1352.46, 242, 1351.00, 79
2, 16:25:00-000, 369, 144, 225, 144, 1351.82, 159, 1350.88, 71
2, 16:26:00-000, 728, 310, 418, 310, 1351.73, 329, 1350.78, 101
2, 16:27:00-000, 277, 127, 150, 127, 1352.24, 149, 1351.76, 38
2, 16:28:00-000, 604, 251, 353, 249, 1351.39, 202, 1350.58, 47
2, 16:29:00-000, 293, 132, 161, 134, 1352.39, 142, 1351.47, 104
3, 09:00:00-000, 167, 163, 4, 1, 1350.00, 1, 1350.00, 159
3, 09:01:00-000, 202, 202, 0, 0, 0.00, 0, 0.00, 201
3, 09:02:00-000, 216, 216, 0, 0, 0.00, 0, 0.00, 221
3, 09:03:00-000, 192, 192, 0, 0, 0.00, 0, 0.00, 185
3, 09:04:00-000, 202, 202, 0, 0, 0.00, 0, 0.00, 205
3, 09:05:00-000, 215, 215, 0, 0, 0.00, 0, 0.00, 212
3, 09:06:00-000, 209, 209, 0, 0, 0.00, 0, 0.00, 214
3, 09:07:00-000, 198, 198, 0, 0, 0.00, 0, 0.00, 184
3, 09:08:00-000, 174, 174, 0, 0, 0.00, 0, 0.00, 191
3, 09:09:00-000, 187, 187, 0, 0, 0.00, 0, 0.00, 175
3, 09:10:00-000, 186, 186, 0, 0, 0.00, 0, 0.00, 189
3, 09:11:00-000, 183, 183, 0, 0, 0.00, 0, 0.00, 184
3, 09:12:00-000, 213, 213, 0, 0, 0.00, 0, 0.00, 206
3, 09:13:00-000, 247, 240, 7, 7, 1520.86, 4, 1350.00, 247
3, 09:14:00-000, 201, 201, 0, 1, 1355.00, 0, 0.00, 191
3, 09:15:00-000, 203, 197, 6, 7, 1353.29, 3, 1352.33, 205
3, 09:16:00-000, 240, 240, 0, 7, 1352.71, 0, 0.00, 220
3, 09:17:00-000, 169, 162, 7, 6, 1355.50, 2, 1358.50, 173
3, 09:18:00-000, 180, 170, 10, 6, 1356.17, 4, 1355.50, 170
3, 09:19:00-000, 228, 220, 8, 7, 1353.28, 4, 1353.75, 214
3, 09:20:00-000, 184, 154, 30, 10, 1348.20, 0, 0.00, 180
3, 09:21:00-000, 188, 164, 24, 1, 1349.00, 1, 1350.00, 179
3, 09:22:00-000, 179, 157, 22, 10, 1349.20, 8, 1352.75, 162
3, 09:23:00-000, 191, 176, 15, 4, 1348.75, 5, 1350.40, 187
3, 09:24:00-000, 198, 190, 8, 9, 1351.67, 3, 1362.67, 185
3, 09:25:00-000, 230, 208, 22, 4, 1361.50, 9, 1364.89, 215
3, 09:26:00-000, 182, 171, 11, 7, 1351.00, 11, 1352.09, 160
3, 09:27:00-000, 184, 174, 10, 4, 1353.00, 3, 1354.67, 180
3, 09:28:00-000, 202, 188, 14, 7, 1351.57, 3, 1351.00, 196
3, 09:29:00-000, 180, 158, 22, 18, 1350.28, 3, 1354.00, 155
3, 09:30:00-000, 206, 144, 62, 10, 1346.90, 6, 1352.17, 195
3, 09:31:00-000, 211, 155, 56, 4, 1350.75, 7, 1351.28, 199
3, 09:32:00-000, 177, 119, 58, 6, 1348.33, 2, 1352.50, 165
3, 09:33:00-000, 230, 175, 55, 1, 1348.00, 6, 1352.00, 220
3, 09:34:00-000, 216, 152, 64, 8, 1348.50, 15, 1352.20, 194
3, 09:35:00-000, 208, 185, 23, 4, 1352.00, 11, 1353.91, 192
3, 09:36:00-000, 243, 214, 29, 9, 1351.89, 14, 1352.64, 216
3, 09:37:00-000, 177, 168, 9, 4, 1354.75, 2, 1355.50, 181
3, 09:38:00-000, 219, 164, 55, 14, 1350.21, 8, 1351.37, 192
3, 09:39:00-000, 196, 186, 10, 3, 1350.67, 5, 1352.40, 191
3, 09:40:00-000, 199, 183, 16, 4, 1347.25, 3, 1351.00, 195
3, 09:41:00-000, 202, 177, 25, 3, 1351.33, 2, 1352.00, 193
3, 09:42:00-000, 203, 162, 41, 3, 1348.33, 8, 1351.63, 194
3, 09:43:00-000, 189, 162, 27, 2, 1351.50, 4, 1353.50, 178
3, 09:44:00-000, 212, 174, 38, 15, 1348.06, 14, 1352.35, 189
3, 09:45:00-000, 201, 179, 22, 8, 1348.37, 7, 1350.43, 185
3, 09:46:00-000, 185, 160, 25, 8, 1351.37, 19, 1351.94, 154
3, 09:47:00-000, 219, 187, 32, 21, 1349.90, 8, 1351.75, 195
3, 09:48:00-000, 206, 188, 18, 4, 1348.75, 5, 1351.40, 199
3, 09:49:00-000, 201, 178, 23, 5, 1349.00, 1, 1350.00, 192
3, 09:50:00-000, 211, 183, 28, 3, 1348.33, 9, 1350.78, 197
3, 09:51:00-000, 224, 166, 58, 13, 1346.23, 4, 1351.00, 194
3, 09:52:00-000, 228, 151, 77, 9, 1350.11, 23, 1351.82, 202
3, 09:53:00-000, 244, 156, 88, 9, 1348.33, 9, 1352.22, 231
3, 09:54:00-000, 222, 202, 20, 11, 1347.09, 6, 1350.17, 200
3, 09:55:00-000, 188, 150, 38, 10, 1350.20, 8, 1352.12, 172
3, 09:56:00-000, 207, 178, 29, 12, 1350.58, 9, 1353.44, 191
3, 09:57:00-000, 198, 184, 14, 7, 1351.86, 4, 1352.25, 190
3, 09:58:00-000, 186, 152, 34, 10, 1349.10, 25, 1351.24, 153
3, 09:59:00-000, 156, 132, 24, 2, 1346.50, 0, 0.00, 153
3, 10:00:00-000, 193, 135, 58, 4, 1347.25, 1, 1350.00, 181
3, 10:01:00-000, 202, 151, 51, 4, 1349.00, 3, 1350.67, 199
3, 10:02:00-000, 198, 170, 28, 5, 1349.80, 3, 1352.67, 189
3, 10:03:00-000, 243, 200, 43, 6, 1348.67, 11, 1350.82, 231
3, 10:04:00-000, 194, 192, 2, 5, 1352.40, 1, 1352.00, 182
3, 10:05:00-000, 188, 164, 24, 9, 1349.33, 4, 1352.50, 180
3, 10:06:00-000, 229, 197, 32, 7, 1350.29, 8, 1351.62, 212
3, 10:07:00-000, 223, 169, 54, 20, 1347.50, 4, 1353.00, 196
3, 10:08:00-000, 180, 107, 73, 16, 1347.31, 4, 1350.50, 154
3, 10:09:00-000, 198, 108, 90, 11, 1350.27, 14, 1351.28, 177
3, 10:10:00-000, 182, 94, 88, 5, 1347.00, 9, 1350.66, 160
3, 10:11:00-000, 197, 96, 101, 0, 0.00, 7, 1350.43, 196
3, 10:12:00-000, 207, 145, 62, 3, 1347.33, 10, 1351.40, 187
3, 10:13:00-000, 231, 219, 12, 2, 1351.50, 7, 1351.43, 236
3, 10:14:00-000, 214, 195, 19, 13, 1347.54, 6, 1354.33, 194
3, 10:15:00-000, 226, 190, 36, 8, 1348.62, 5, 1350.20, 215
3, 10:16:00-000, 204, 121, 83, 17, 1345.88, 10, 1351.10, 174
3, 10:17:00-000, 204, 123, 81, 3, 1351.67, 14, 1351.85, 183
3, 10:18:00-000, 178, 143, 35, 9, 1351.56, 12, 1353.33, 151
3, 10:19:00-000, 213, 163, 50, 3, 1350.67, 5, 1351.40, 220
3, 10:20:00-000, 192, 154, 38, 13, 1351.00, 9, 1352.33, 167
3, 10:21:00-000, 225, 173, 52, 15, 1349.40, 16, 1350.37, 189
3, 10:22:00-000, 217, 169, 48, 15, 1348.27, 5, 1351.00, 200
3, 10:23:00-000, 185, 133, 52, 5, 1350.20, 8, 1350.50, 173
3, 10:24:00-000, 205, 155, 50, 7, 1348.28, 4, 1350.25, 198
3, 10:25:00-000, 184, 88, 96, 2, 1347.00, 0, 0.00, 181
3, 10:26:00-000, 189, 104, 85, 1, 1350.00, 11, 1350.45, 167
3, 10:27:00-000, 229, 157, 72, 12, 1346.42, 9, 1350.33, 211
3, 10:28:00-000, 197, 127, 70, 6, 1347.50, 12, 1351.41, 178
3, 10:29:00-000, 193, 152, 41, 2, 1348.50, 3, 1350.67, 190
3, 10:30:00-000, 187, 131, 56, 15, 1348.00, 16, 1350.81, 162
3, 10:31:00-000, 181, 157, 24, 1, 1350.00, 6, 1351.67, 167
3, 10:32:00-000, 177, 147, 30, 3, 1352.00, 3, 1350.33, 178
3, 10:33:00-000, 224, 181, 43, 5, 1348.20, 4, 1351.25, 212
3, 10:34:00-000, 194, 141, 53, 8, 1347.12, 4, 1349.00, 172
3, 10:35:00-000, 196, 117, 79, 5, 1348.20, 7, 1351.00, 197
3, 10:36:00-000, 187, 142, 45, 7, 1349.00, 10, 1350.80, 166
3, 10:37:00-000, 211, 168, 43, 9, 1350.89, 9, 1351.89, 190
3, 10:38:00-000, 205, 167, 38, 12, 1348.92, 3, 1352.00, 195
3, 10:39:00-000, 214, 182, 32, 0, 0.00, 10, 1350.50, 204
3, 10:40:00-000, 232, 167, 65, 5, 1348.60, 3, 1351.33, 220
3, 10:41:00-000, 221, 175, 46, 0, 0.00, 15, 1350.53, 212
3, 10:42:00-000, 207, 184, 23, 26, 1348.00, 8, 1352.75, 173
3, 10:43:00-000, 221, 162, 59, 7, 1349.86, 4, 1352.25, 204
3, 10:44:00-000, 174, 111, 63, 16, 1348.50, 3, 1350.00, 160
3, 10:45:00-000, 233, 139, 94, 2, 1348.00, 14, 1351.57, 215
3, 10:46:00-000, 211, 192, 19, 7, 1351.28, 13, 1351.54, 185
3, 10:47:00-000, 216, 198, 18, 6, 1348.67, 2, 1352.00, 214
3, 10:48:00-000, 176, 130, 46, 17, 1348.53, 10, 1351.10, 149
3, 10:49:00-000, 191, 150, 41, 10, 1346.90, 15, 1351.26, 170
3, 10:50:00-000, 158, 126, 32, 3, 1349.67, 5, 1351.40, 146
3, 10:51:00-000, 195, 153, 42, 8, 1347.25, 1, 1350.00, 180
3, 10:52:00-000, 211, 102, 109, 13, 1348.69, 9, 1351.44, 187
3, 10:53:00-000, 169, 120, 49, 17, 1348.17, 17, 1351.76, 147
3, 10:54:00-000, 168, 103, 65, 4, 1345.50, 12, 1350.00, 151
3, 10:55:00-000, 214, 150, 64, 1, 1347.00, 5, 1350.40, 205
3, 10:56:00-000, 214, 189, 25, 8, 1350.75, 16, 1351.31, 189
3, 10:57:00-000, 188, 171, 17, 14, 1348.43, 7, 1350.14, 172
3, 10:58:00-000, 193, 166, 27, 11, 1351.54, 16, 1351.37, 158
3, 10:59:00-000, 192, 163, 29, 3, 1350.67, 3, 1352.67, 194
3, 11:00:00-000, 222, 214, 8, 9, 1348.00, 4, 1350.50, 202
3, 11:01:00-000, 193, 163, 30, 2, 1345.50, 5, 1350.00, 189
3, 11:02:00-000, 188, 148, 40, 10, 1346.90, 9, 1351.11, 169
3, 11:03:00-000, 191, 154, 37, 10, 1354.70, 10, 1354.30, 168
3, 11:04:00-000, 184, 99, 85, 24, 1349.96, 0, 0.00, 166
3, 11:05:00-000, 188, 95, 93, 2, 1350.50, 4, 1349.00, 182
3, 11:06:00-000, 214, 87, 127, 9, 1348.11, 17, 1351.17, 187
3, 11:07:00-000, 168, 83, 85, 11, 1347.36, 14, 1350.64, 140
3, 11:08:00-000, 196, 138, 58, 8, 1349.12, 21, 1351.47, 165
3, 11:09:00-000, 196, 153, 43, 15, 1349.00, 9, 1351.33, 178
3, 11:10:00-000, 209, 141, 68, 9, 1348.33, 13, 1350.54, 181
3, 11:11:00-000, 203, 174, 29, 1, 1351.00, 15, 1351.20, 192
3, 11:12:00-000, 220, 195, 25, 5, 1348.20, 4, 1351.25, 211
3, 11:13:00-000, 204, 192, 12, 1, 1348.00, 2, 1352.50, 194
3, 11:14:00-000, 200, 176, 24, 16, 1350.00, 2, 1351.50, 186
3, 11:15:00-000, 186, 146, 40, 2, 1345.00, 3, 1350.33, 182
3, 11:16:00-000, 196, 167, 29, 12, 1350.08, 6, 1352.83, 173
3, 11:17:00-000, 153, 112, 41, 4, 1349.00, 7, 1350.86, 144
3, 11:18:00-000, 216, 181, 35, 13, 1349.15, 19, 1351.79, 185
3, 11:19:00-000, 199, 158, 41, 4, 1348.75, 4, 1350.25, 193
3, 11:20:00-000, 172, 150, 22, 3, 1349.33, 4, 1351.25, 165
3, 11:21:00-000, 201, 183, 18, 5, 1347.60, 12, 1352.92, 184
3, 11:22:00-000, 215, 196, 19, 16, 1347.31, 6, 1351.50, 194
3, 11:23:00-000, 219, 171, 48, 9, 1347.55, 1, 1350.00, 208
3, 11:24:00-000, 164, 101, 63, 14, 1348.71, 9, 1351.55, 145
3, 11:25:00-000, 183, 131, 52, 4, 1351.00, 13, 1351.08, 164
3, 11:26:00-000, 220, 178, 42, 10, 1349.80, 12, 1351.00, 199
3, 11:27:00-000, 209, 136, 73, 12, 1348.17, 1, 1353.00, 191
3, 11:28:00-000, 216, 123, 93, 13, 1347.61, 14, 1351.50, 185
3, 11:29:00-000, 220, 179, 41, 1, 1350.00, 21, 1351.90, 208
3, 11:30:00-000, 222, 206, 16, 18, 1350.39, 1, 1351.00, 202
3, 11:31:00-000, 223, 167, 56, 14, 1351.00, 3, 1351.33, 204
3, 11:32:00-000, 210, 118, 92, 14, 1348.00, 12, 1350.83, 184
3, 11:33:00-000, 201, 127, 74, 3, 1349.00, 12, 1350.17, 173
3, 11:34:00-000, 212, 142, 70, 10, 1347.20, 4, 1351.00, 206
3, 11:35:00-000, 204, 132, 72, 15, 1349.13, 18, 1350.55, 174
3, 11:36:00-000, 187, 120, 67, 8, 1348.37, 20, 1350.70, 156
3, 11:37:00-000, 176, 115, 61, 7, 1346.57, 13, 1351.46, 157
3, 11:38:00-000, 189, 148, 41, 18, 1348.33, 13, 1352.15, 161
3, 11:39:00-000, 181, 117, 64, 8, 1347.13, 2, 1350.00, 173
3, 11:40:00-000, 230, 135, 95, 10, 1348.60, 15, 1351.33, 198
3, 11:41:00-000, 178, 127, 51, 7, 1349.00, 5, 1351.20, 171
3, 11:42:00-000, 185, 100, 85, 13, 1345.38, 13, 1350.77, 162
3, 11:43:00-000, 190, 137, 53, 6, 1349.50, 6, 1351.33, 179
3, 11:44:00-000, 256, 215, 41, 4, 1348.50, 7, 1351.86, 239
3, 11:45:00-000, 191, 166, 25, 9, 1348.89, 8, 1350.50, 172
3, 11:46:00-000, 188, 132, 56, 27, 1348.74, 14, 1352.64, 147
3, 11:47:00-000, 206, 133, 73, 2, 1347.00, 13, 1350.46, 198
3, 11:48:00-000, 202, 139, 63, 16, 1348.19, 23, 1351.17, 153
3, 11:49:00-000, 189, 168, 21, 13, 1349.23, 14, 1351.71, 166
3, 11:50:00-000, 186, 149, 37, 13, 1349.38, 13, 1352.23, 159
3, 11:51:00-000, 184, 148, 36, 3, 1351.33, 11, 1350.82, 178
3, 11:52:00-000, 218, 155, 63, 12, 1347.50, 10, 1353.10, 187
3, 11:53:00-000, 212, 164, 48, 12, 1348.00, 11, 1351.27, 190
3, 11:54:00-000, 213, 177, 36, 15, 1348.93, 3, 1353.33, 193
3, 11:55:00-000, 210, 142, 68, 13, 1347.69, 8, 1351.25, 187
3, 11:56:00-000, 194, 122, 72, 11, 1348.91, 7, 1350.43, 182
3, 11:57:00-000, 172, 124, 48, 8, 1348.25, 5, 1350.40, 156
3, 11:58:00-000, 202, 141, 61, 17, 1348.00, 20, 1351.65, 169
3, 11:59:00-000, 214, 147, 67, 0, 0.00, 7, 1351.28, 203
3, 12:00:00-000, 201, 159, 42, 9, 1349.00, 2, 1350.00, 192
3, 12:01:00-000, 173, 111, 62, 4, 1348.00, 8, 1350.87, 164
3, 12:02:00-000, 221, 144, 77, 18, 1347.16, 9, 1350.33, 188
3, 12:03:00-000, 207, 155, 52, 7, 1350.57, 20, 1351.10, 178
3, 12:04:00-000, 186, 105, 81, 14, 1346.28, 6, 1350.17, 176
3, 12:05:00-000, 183, 127, 56, 0, 0.00, 7, 1352.57, 169
3, 12:06:00-000, 198, 163, 35, 7, 1349.57, 7, 1350.71, 192
3, 12:07:00-000, 189, 143, 46, 6, 1348.83, 10, 1352.20, 173
3, 12:08:00-000, 193, 157, 36, 9, 1348.00, 8, 1352.25, 177
3, 12:09:00-000, 222, 169, 53, 11, 1350.36, 10, 1350.90, 192
3, 12:10:00-000, 189, 133, 56, 9, 1346.78, 6, 1351.00, 182
3, 12:11:00-000, 166, 120, 46, 5, 1348.40, 6, 1351.17, 155
3, 12:12:00-000, 206, 157, 49, 10, 1349.90, 8, 1352.50, 180
3, 12:13:00-000, 208, 158, 50, 2, 1347.00, 3, 1352.33, 206
3, 12:14:00-000, 214, 167, 47, 4, 1350.50, 8, 1353.38, 201
3, 12:15:00-000, 192, 171, 21, 5, 1349.80, 0, 0.00, 188
3, 12:16:00-000, 147, 107, 40, 12, 1348.17, 4, 1352.00, 132
3, 12:17:00-000, 185, 148, 37, 5, 1348.60, 14, 1352.07, 163
3, 12:18:00-000, 198, 164, 34, 7, 1349.71, 2, 1352.00, 195
3, 12:19:00-000, 216, 141, 75, 6, 1349.33, 0, 0.00, 205
3, 12:20:00-000, 203, 124, 79, 5, 1349.20, 17, 1350.82, 179
3, 12:21:00-000, 209, 166, 43, 2, 1350.00, 14, 1351.64, 200
3, 12:22:00-000, 185, 160, 25, 23, 1348.65, 13, 1352.61, 150
3, 12:23:00-000, 219, 191, 28, 2, 1350.00, 9, 1351.67, 207
3, 12:24:00-000, 215, 179, 36, 9, 1350.00, 4, 1352.25, 202
3, 12:25:00-000, 203, 161, 42, 7, 1347.14, 7, 1351.00, 184
3, 12:26:00-000, 197, 155, 42, 19, 1349.00, 19, 1351.84, 165
3, 12:27:00-000, 216, 193, 23, 8, 1348.38, 4, 1351.00, 197
3, 12:28:00-000, 226, 193, 33, 10, 1347.80, 6, 1351.33, 209
3, 12:29:00-000, 169, 139, 30, 3, 1350.67, 6, 1351.67, 168
3, 12:30:00-000, 224, 159, 65, 17, 1348.65, 24, 1349.62, 178
3, 12:31:00-000, 211, 180, 31, 11, 1347.73, 0, 0.00, 204
3, 12:32:00-000, 196, 133, 63, 5, 1348.20, 6, 1350.33, 185
3, 12:33:00-000, 216, 175, 41, 4, 1347.00, 7, 1351.00, 201
3, 12:34:00-000, 192, 158, 34, 19, 1348.74, 10, 1350.30, 167
3, 12:35:00-000, 233, 183, 50, 10, 1348.70, 14, 1351.21, 210
3, 12:36:00-000, 209, 157, 52, 24, 1347.16, 13, 1352.00, 172
3, 12:37:00-000, 216, 158, 58, 6, 1348.33, 13, 1350.92, 194
3, 12:38:00-000, 231, 159, 72, 23, 1347.48, 22, 1351.63, 176
3, 12:39:00-000, 192, 120, 72, 6, 1345.83, 10, 1350.70, 178
3, 12:40:00-000, 228, 168, 60, 5, 1348.80, 15, 1352.20, 209
3, 12:41:00-000, 176, 141, 35, 11, 1350.91, 15, 1352.93, 153
3, 12:42:00-000, 191, 143, 48, 11, 1348.09, 8, 1351.38, 176
3, 12:43:00-000, 220, 143, 77, 12, 1348.08, 8, 1350.25, 195
3, 12:44:00-000, 201, 152, 49, 4, 1351.25, 8, 1350.12, 186
3, 12:45:00-000, 185, 147, 38, 9, 1345.55, 5, 1351.20, 176
3, 12:46:00-000, 218, 160, 58, 17, 1348.76, 17, 1351.12, 191
3, 12:47:00-000, 190, 121, 69, 10, 1350.00, 11, 1351.00, 160
3, 12:48:00-000, 188, 150, 38, 12, 1349.58, 8, 1352.88, 172
3, 12:49:00-000, 177, 111, 66, 2, 1347.00, 22, 1351.86, 157
3, 12:50:00-000, 216, 172, 44, 28, 1348.75, 7, 1353.00, 173
3, 12:51:00-000, 212, 162, 50, 2, 1346.00, 15, 1352.27, 203
3, 12:52:00-000, 217, 171, 46, 14, 1350.14, 10, 1350.90, 190
3, 12:53:00-000, 179, 159, 20, 7, 1349.28, 5, 1350.80, 165
3, 12:54:00-000, 182, 135, 47, 20, 1348.00, 4, 1350.25, 159
3, 12:55:00-000, 209, 134, 75, 1, 1348.00, 7, 1350.57, 198
3, 12:56:00-000, 200, 134, 66, 10, 1349.10, 17, 1351.64, 175
3, 12:57:00-000, 225, 189, 36, 13, 1349.00, 6, 1350.33, 209
3, 12:58:00-000, 184, 156, 28, 16, 1349.50, 6, 1351.67, 164
3, 12:59:00-000, 215, 152, 63, 5, 1352.40, 20, 1353.10, 190
3, 13:00:00-000, 206, 152, 54, 10, 1348.30, 10, 1351.50, 184
3, 13:01:00-000, 192, 154, 38, 3, 1347.00, 9, 1352.00, 178
3, 13:02:00-000, 196, 131, 65, 22, 1350.22, 7, 1353.00, 171
3, 13:03:00-000, 178, 114, 64, 5, 1346.00, 12, 1351.33, 157
3, 13:04:00-000, 203, 129, 74, 17, 1348.06, 19, 1350.36, 160
3, 13:05:00-000, 169, 115, 54, 6, 1348.33, 2, 1351.50, 167
3, 13:06:00-000, 224, 162, 62, 7, 1349.00, 17, 1351.94, 187
3, 13:07:00-000, 226, 189, 37, 7, 1349.43, 10, 1350.60, 215
3, 13:08:00-000, 194, 183, 11, 10, 1351.00, 2, 1353.50, 195
3, 13:09:00-000, 185, 136, 49, 6, 1347.83, 2, 1351.00, 172
3, 13:10:00-000, 203, 158, 45, 3, 1348.00, 6, 1350.33, 193
3, 13:11:00-000, 201, 177, 24, 4, 1351.25, 9, 1352.11, 192
3, 13:12:00-000, 211, 147, 64, 24, 1349.50, 12, 1351.92, 172
3, 13:13:00-000, 199, 124, 75, 13, 1349.69, 14, 1350.28, 173
3, 13:14:00-000, 206, 106, 100, 12, 1348.17, 16, 1351.19, 178
3, 13:15:00-000, 174, 102, 72, 18, 1349.22, 12, 1351.66, 141
3, 13:16:00-000, 215, 106, 109, 10, 1347.50, 25, 1350.76, 185
3, 13:17:00-000, 221, 152, 69, 5, 1347.00, 13, 1350.92, 198
3, 13:18:00-000, 189, 177, 12, 7, 1349.28, 1, 1351.00, 187
3, 13:19:00-000, 179, 145, 34, 5, 1349.00, 11, 1350.64, 163
3, 13:20:00-000, 191, 142, 49, 34, 1348.94, 19, 1351.73, 138
3, 13:21:00-000, 223, 151, 72, 17, 1348.82, 21, 1350.95, 186
3, 13:22:00-000, 220, 152, 68, 15, 1348.53, 9, 1351.33, 184
3, 13:23:00-000, 200, 119, 81, 11, 1347.64, 17, 1351.00, 183
3, 13:24:00-000, 218, 159, 59, 11, 1348.18, 16, 1351.75, 183
3, 13:25:00-000, 204, 165, 39, 5, 1347.80, 15, 1351.46, 191
3, 13:26:00-000, 218, 163, 55, 20, 1349.30, 11, 1351.54, 181
3, 13:27:00-000, 221, 188, 33, 18, 1348.33, 2, 1350.50, 201
3, 13:28:00-000, 178, 97, 81, 14, 1348.43, 16, 1350.31, 156
3, 13:29:00-000, 200, 118, 82, 5, 1348.40, 13, 1351.61, 180
3, 13:30:00-000, 209, 183, 26, 26, 1350.84, 11, 1352.63, 167
3, 13:31:00-000, 215, 176, 39, 1, 1352.00, 12, 1351.17, 205
3, 13:32:00-000, 213, 110, 103, 28, 1348.10, 10, 1350.80, 174
3, 13:33:00-000, 196, 123, 73, 3, 1347.67, 8, 1351.62, 189
3, 13:34:00-000, 224, 131, 93, 19, 1347.47, 17, 1350.94, 185
3, 13:35:00-000, 208, 129, 79, 5, 1347.00, 4, 1348.50, 198
3, 13:36:00-000, 213, 94, 119, 12, 1348.25, 18, 1349.11, 185
3, 13:37:00-000, 171, 91, 80, 7, 1349.14, 13, 1351.84, 153
3, 13:38:00-000, 192, 134, 58, 10, 1347.90, 9, 1351.22, 169
3, 13:39:00-000, 217, 162, 55, 5, 1348.60, 13, 1352.15, 202
3, 13:40:00-000, 179, 140, 39, 10, 1348.30, 12, 1351.25, 154
3, 13:41:00-000, 222, 173, 49, 14, 1348.00, 20, 1351.65, 187
3, 13:42:00-000, 210, 154, 56, 16, 1348.37, 13, 1351.61, 177
3, 13:43:00-000, 180, 142, 38, 10, 1347.50, 4, 1350.00, 174
3, 13:44:00-000, 200, 130, 70, 34, 1348.50, 15, 1352.00, 151
3, 13:45:00-000, 214, 115, 99, 7, 1347.00, 14, 1351.14, 193
3, 13:46:00-000, 191, 123, 68, 19, 1348.00, 23, 1351.52, 144
3, 13:47:00-000, 201, 107, 94, 10, 1345.60, 2, 1349.00, 195
3, 13:48:00-000, 191, 123, 68, 1, 1347.00, 15, 1350.46, 168
3, 13:49:00-000, 210, 161, 49, 6, 1349.17, 19, 1351.58, 186
3, 13:50:00-000, 211, 180, 31, 14, 1349.57, 19, 1353.36, 177
3, 13:51:00-000, 160, 137, 23, 6, 1351.17, 9, 1352.11, 151
3, 13:52:00-000, 206, 180, 26, 17, 1347.35, 5, 1351.40, 185
3, 13:53:00-000, 201, 153, 48, 1, 1352.00, 5, 1352.80, 192
3, 13:54:00-000, 221, 210, 11, 9, 1349.89, 3, 1351.67, 207
3, 13:55:00-000, 188, 161, 27, 6, 1348.17, 2, 1350.00, 186
3, 13:56:00-000, 185, 115, 70, 27, 1347.33, 14, 1350.64, 141
3, 13:57:00-000, 205, 121, 84, 5, 1348.20, 12, 1351.17, 184
3, 13:58:00-000, 159, 103, 56, 10, 1347.90, 12, 1351.75, 140
3, 13:59:00-000, 180, 142, 38, 12, 1349.58, 12, 1351.83, 150
3, 14:00:00-000, 189, 137, 52, 6, 1347.83, 7, 1350.43, 181
3, 14:01:00-000, 209, 133, 76, 24, 1349.00, 25, 1351.52, 163
3, 14:02:00-000, 198, 158, 40, 3, 1347.33, 16, 1351.50, 180
3, 14:03:00-000, 151, 135, 16, 7, 1351.43, 7, 1351.43, 138
3, 14:04:00-000, 208, 153, 55, 21, 1349.00, 8, 1352.00, 175
3, 14:05:00-000, 195, 154, 41, 5, 1348.40, 5, 1351.40, 181
3, 14:06:00-000, 201, 150, 51, 13, 1347.69, 7, 1351.14, 181
3, 14:07:00-000, 218, 146, 72, 6, 1348.00, 13, 1350.00, 192
3, 14:08:00-000, 187, 100, 87, 14, 1348.14, 7, 1350.86, 178
3, 14:09:00-000, 217, 142, 75, 19, 1347.05, 9, 1351.78, 185
3, 14:10:00-000, 193, 96, 97, 6, 1348.33, 20, 1351.10, 169
3, 14:11:00-000, 201, 138, 63, 5, 1349.00, 9, 1352.67, 184
3, 14:12:00-000, 212, 147, 65, 10, 1346.20, 11, 1351.64, 196
3, 14:13:00-000, 194, 117, 77, 12, 1347.83, 8, 1351.25, 171
3, 14:14:00-000, 206, 157, 49, 8, 1350.37, 20, 1351.80, 180
3, 14:15:00-000, 199, 196, 3, 4, 1351.00, 2, 1354.00, 195
3, 14:16:00-000, 230, 168, 62, 21, 1349.81, 7, 1350.71, 196
3, 14:17:00-000, 179, 128, 51, 3, 1348.67, 9, 1350.89, 169
3, 14:18:00-000, 209, 164, 45, 21, 1347.14, 3, 1350.00, 182
3, 14:19:00-000, 206, 98, 108, 4, 1346.00, 8, 1350.87, 198
3, 14:20:00-000, 212, 92, 120, 23, 1347.43, 12, 1350.42, 181
3, 14:21:00-000, 182, 64, 118, 5, 1347.00, 9, 1351.22, 168
3, 14:22:00-000, 185, 108, 77, 17, 1348.53, 18, 1350.55, 149
3, 14:23:00-000, 185, 89, 96, 3, 1351.00, 20, 1350.80, 161
3, 14:24:00-000, 174, 126, 48, 18, 1348.55, 14, 1352.14, 143
3, 14:25:00-000, 237, 157, 80, 2, 1348.00, 24, 1351.16, 206
3, 14:26:00-000, 206, 158, 48, 14, 1347.21, 5, 1352.60, 190
3, 14:27:00-000, 176, 149, 27, 10, 1349.40, 3, 1351.00, 167
3, 14:28:00-000, 219, 193, 26, 24, 1347.58, 6, 1350.67, 186
3, 14:29:00-000, 209, 155, 54, 5, 1347.00, 15, 1350.13, 189
3, 14:30:00-000, 217, 169, 48, 9, 1348.22, 1, 1352.00, 210
3, 14:31:00-000, 213, 159, 54, 6, 1349.50, 3, 1351.00, 196
3, 14:32:00-000, 178, 104, 74, 16, 1347.62, 11, 1351.00, 153
3, 14:33:00-000, 178, 83, 95, 1, 1347.00, 7, 1350.00, 170
3, 14:34:00-000, 200, 83, 117, 15, 1347.13, 23, 1351.52, 168
3, 14:35:00-000, 205, 124, 81, 6, 1349.33, 19, 1352.21, 174
3, 14:36:00-000, 210, 147, 63, 32, 1348.56, 15, 1351.80, 167
3, 14:37:00-000, 200, 134, 66, 9, 1348.67, 19, 1350.52, 171
3, 14:38:00-000, 219, 174, 45, 21, 1348.04, 17, 1350.82, 184
3, 14:39:00-000, 212, 117, 95, 20, 1350.75, 25, 1351.88, 153
3, 14:40:00-000, 205, 146, 59, 9, 1348.78, 11, 1352.18, 199
3, 14:41:00-000, 173, 130, 43, 4, 1346.50, 5, 1351.20, 159
3, 14:42:00-000, 180, 140, 40, 7, 1349.71, 2, 1353.00, 165
3, 14:43:00-000, 210, 145, 65, 9, 1348.55, 7, 1351.57, 202
3, 14:44:00-000, 196, 131, 65, 13, 1348.15, 13, 1350.54, 165
3, 14:45:00-000, 194, 135, 59, 17, 1347.88, 20, 1351.65, 160
3, 14:46:00-000, 201, 120, 81, 30, 1347.63, 14, 1350.50, 160
3, 14:47:00-000, 184, 82, 102, 5, 1349.60, 27, 1350.89, 153
3, 14:48:00-000, 188, 111, 77, 14, 1349.78, 18, 1350.22, 152
3, 14:49:00-000, 176, 121, 55, 3, 1345.67, 10, 1350.90, 160
3, 14:50:00-000, 176, 137, 39, 6, 1347.50, 3, 1350.33, 173
3, 14:51:00-000, 187, 111, 76, 8, 1348.75, 12, 1351.00, 161
3, 14:52:00-000, 207, 161, 46, 10, 1347.90, 20, 1351.95, 184
3, 14:53:00-000, 208, 186, 22, 24, 1348.54, 9, 1352.11, 166
3, 14:54:00-000, 211, 140, 71, 27, 1346.74, 3, 1351.67, 190
3, 14:55:00-000, 190, 119, 71, 1, 1348.00, 15, 1348.26, 164
3, 14:56:00-000, 192, 145, 47, 19, 1346.79, 12, 1351.25, 170
3, 14:57:00-000, 216, 178, 38, 2, 1348.50, 8, 1350.75, 195
3, 14:58:00-000, 181, 148, 33, 10, 1348.40, 13, 1351.38, 171
3, 14:59:00-000, 197, 141, 56, 14, 1347.57, 7, 1353.86, 167
3, 15:00:00-000, 198, 122, 76, 24, 1351.33, 10, 1352.20, 172
3, 15:01:00-000, 199, 129, 70, 2, 1350.00, 13, 1350.69, 183
3, 15:02:00-000, 247, 139, 108, 19, 1347.26, 20, 1351.15, 208
3, 15:03:00-000, 192, 123, 69, 2, 1345.50, 13, 1351.61, 166
3, 15:04:00-000, 196, 142, 54, 26, 1348.61, 10, 1350.70, 154
3, 15:05:00-000, 215, 121, 94, 1, 1347.00, 12, 1351.25, 221
3, 15:06:00-000, 227, 156, 71, 22, 1349.63, 23, 1353.00, 172
3, 15:07:00-000, 197, 153, 44, 8, 1348.88, 11, 1351.54, 182
3, 15:08:00-000, 198, 148, 50, 10, 1349.10, 7, 1351.14, 185
3, 15:09:00-000, 195, 157, 38, 7, 1348.29, 2, 1352.00, 173
3, 15:10:00-000, 196, 129, 67, 14, 1349.28, 25, 1351.68, 159
3, 15:11:00-000, 193, 126, 67, 15, 1347.20, 0, 0.00, 190
3, 15:12:00-000, 208, 132, 76, 14, 1346.93, 13, 1351.69, 177
3, 15:13:00-000, 208, 138, 70, 5, 1349.60, 4, 1351.75, 202
3, 15:14:00-000, 228, 152, 76, 5, 1348.20, 14, 1351.43, 204
3, 15:15:00-000, 153, 117, 36, 14, 1350.36, 8, 1353.13, 136
3, 15:16:00-000, 213, 149, 64, 13, 1351.69, 10, 1351.50, 189
3, 15:17:00-000, 176, 134, 42, 6, 1347.83, 10, 1351.20, 152
3, 15:18:00-000, 171, 124, 47, 9, 1347.66, 16, 1351.00, 152
3, 15:19:00-000, 198, 175, 23, 5, 1347.20, 13, 1350.00, 185
3, 15:20:00-000, 174, 119, 55, 11, 1347.36, 9, 1351.22, 151
3, 15:21:00-000, 173, 133, 40, 7, 1347.00, 1, 1352.00, 165
3, 15:22:00-000, 191, 115, 76, 12, 1346.08, 12, 1350.42, 168
3, 15:23:00-000, 194, 130, 64, 4, 1345.50, 9, 1350.33, 180
3, 15:24:00-000, 252, 178, 74, 20, 1348.75, 22, 1351.31, 205
3, 15:25:00-000, 196, 122, 74, 24, 1349.46, 14, 1350.28, 165
3, 15:26:00-000, 166, 108, 58, 10, 1348.40, 24, 1351.16, 129
3, 15:27:00-000, 203, 149, 54, 8, 1347.50, 5, 1352.00, 186
3, 15:28:00-000, 189, 120, 69, 19, 1347.37, 15, 1351.27, 160
3, 15:29:00-000, 224, 171, 53, 10, 1347.70, 6, 1352.33, 209
3, 15:30:00-000, 219, 148, 71, 17, 1347.35, 11, 1350.82, 193
3, 15:31:00-000, 189, 137, 52, 5, 1350.20, 6, 1350.83, 175
3, 15:32:00-000, 189, 135, 54, 16, 1348.56, 24, 1351.54, 148
3, 15:33:00-000, 182, 165, 17, 9, 1350.11, 3, 1352.67, 172
3, 15:34:00-000, 177, 140, 37, 23, 1349.21, 20, 1354.30, 132
3, 15:35:00-000, 262, 172, 90, 15, 1349.27, 13, 1351.61, 226
3, 15:36:00-000, 192, 157, 35, 11, 1349.36, 27, 1352.00, 162
3, 15:37:00-000, 184, 143, 41, 4, 1346.50, 4, 1350.75, 179
3, 15:38:00-000, 221, 156, 65, 19, 1348.05, 25, 1351.36, 174
3, 15:39:00-000, 213, 155, 58, 8, 1346.12, 1, 1350.00, 200
3, 15:40:00-000, 205, 168, 37, 20, 1348.85, 24, 1351.41, 167
3, 15:41:00-000, 212, 165, 47, 8, 1346.00, 15, 1350.73, 183
3, 15:42:00-000, 203, 194, 9, 20, 1346.85, 3, 1351.33, 179
3, 15:43:00-000, 184, 135, 49, 4, 1349.00, 9, 1350.78, 176
3, 15:44:00-000, 193, 150, 43, 11, 1347.73, 8, 1351.13, 176
3, 15:45:00-000, 206, 171, 35, 4, 1348.25, 8, 1350.00, 194
3, 15:46:00-000, 198, 141, 57, 21, 1348.19, 12, 1350.42, 160
3, 15:47:00-000, 160, 106, 54, 9, 1347.89, 3, 1351.00, 150
3, 15:48:00-000, 212, 107, 105, 21, 1347.81, 21, 1351.43, 172
3, 15:49:00-000, 200, 104, 96, 11, 1348.45, 11, 1350.63, 180
3, 15:50:00-000, 193, 126, 67, 7, 1347.43, 13, 1350.15, 174
3, 15:51:00-000, 182, 123, 59, 3, 1350.67, 19, 1350.73, 159
3, 15:52:00-000, 205, 147, 58, 15, 1348.13, 12, 1349.42, 170
3, 15:53:00-000, 181, 126, 55, 7, 1347.43, 3, 1351.33, 174
3, 15:54:00-000, 199, 145, 54, 9, 1347.33, 13, 1351.08, 178
3, 15:55:00-000, 192, 150, 42, 16, 1352.31, 8, 1354.00, 164
3, 15:56:00-000, 195, 125, 70, 10, 1347.60, 6, 1351.17, 185
3, 15:57:00-000, 202, 144, 58, 4, 1347.25, 17, 1350.29, 182
3, 15:58:00-000, 173, 126, 47, 21, 1347.62, 16, 1350.12, 135
3, 15:59:00-000, 196, 162, 34, 14, 1348.57, 5, 1350.40, 175
3, 16:00:00-000, 187, 147, 40, 6, 1348.00, 6, 1351.00, 175
3, 16:01:00-000, 164, 117, 47, 3, 1347.67, 4, 1350.75, 162
3, 16:02:00-000, 196, 159, 37, 20, 1348.25, 19, 1353.10, 155
3, 16:03:00-000, 213, 185, 28, 10, 1351.90, 14, 1353.07, 178
3, 16:04:00-000, 213, 167, 46, 14, 1347.93, 5, 1351.60, 204
3, 16:05:00-000, 170, 104, 66, 10, 1348.50, 7, 1348.86, 151
3, 16:06:00-000, 218, 138, 80, 11, 1347.36, 20, 1351.30, 185
3, 16:07:00-000, 199, 132, 67, 3, 1349.67, 7, 1350.43, 191
3, 16:08:00-000, 183, 135, 48, 9, 1348.00, 13, 1350.69, 163
3, 16:09:00-000, 200, 140, 60, 3, 1348.67, 13, 1350.85, 185
3, 16:10:00-000, 198, 169, 29, 20, 1351.10, 4, 1353.25, 170
3, 16:11:00-000, 183, 158, 25, 1, 1351.00, 6, 1351.00, 168
3, 16:12:00-000, 247, 186, 61, 28, 1350.00, 10, 1351.80, 213
3, 16:13:00-000, 229, 157, 72, 11, 1348.00, 16, 1351.75, 190
3, 16:14:00-000, 195, 131, 64, 13, 1348.15, 5, 1350.00, 196
3, 16:15:00-000, 215, 95, 120, 17, 1346.76, 4, 1350.00, 186
3, 16:16:00-000, 191, 102, 89, 0, 0.00, 12, 1351.00, 186
3, 16:17:00-000, 204, 108, 96, 6, 1349.17, 23, 1351.52, 173
3, 16:18:00-000, 223, 161, 62, 26, 1348.15, 13, 1350.31, 184
3, 16:19:00-000, 183, 91, 92, 5, 1351.00, 10, 1351.60, 174
3, 16:20:00-000, 163, 100, 63, 11, 1347.82, 23, 1352.00, 128
3, 16:21:00-000, 196, 144, 52, 20, 1348.60, 12, 1351.41, 163
3, 16:22:00-000, 215, 139, 76, 13, 1349.38, 19, 1352.10, 177
3, 16:23:00-000, 196, 153, 43, 1, 1346.00, 6, 1350.67, 197
3, 16:24:00-000, 184, 154, 30, 14, 1348.71, 12, 1352.58, 151
3, 16:25:00-000, 171, 147, 24, 13, 1350.31, 5, 1351.80, 152
3, 16:26:00-000, 201, 143, 58, 10, 1347.90, 19, 1351.26, 176
3, 16:27:00-000, 191, 165, 26, 8, 1347.37, 15, 1351.07, 170
3, 16:28:00-000, 193, 136, 57, 17, 1347.17, 11, 1351.09, 160
3, 16:29:00-000, 210, 133, 77, 15, 1346.40, 10, 1350.20, 191
4, 09:03:00-000, 285, 285, 0, 0, 0.00, 0, 0.00, 282
4, 09:04:00-000, 0, 0, 0, 0, 0.00, 0, 0.00, 3
4, 09:06:00-000, 286, 286, 0, 284, 1351.00, 0, 0.00, 0
4, 09:07:00-000, 2, 1, 1, 0, 0.00, 0, 0.00, 3
4, 09:08:00-000, 48, 36, 12, 13, 1350.69, 13, 1350.69, 21
4, 09:09:00-000, 79, 64, 15, 15, 1375.20, 15, 1375.20, 38
4, 09:10:00-000, 95, 77, 18, 17, 1364.76, 17, 1364.76, 58
4, 09:11:00-000, 83, 74, 9, 10, 1421.80, 10, 1421.80, 56
4, 09:12:00-000, 92, 78, 14, 14, 1497.57, 14, 1497.57, 59
4, 09:13:00-000, 72, 61, 11, 56, 1416.15, 11, 1396.64, 28
4, 09:14:00-000, 95, 84, 11, 69, 1355.35, 9, 1353.89, 14
4, 09:15:00-000, 76, 64, 12, 61, 1356.43, 10, 1355.30, 11
4, 09:16:00-000, 82, 57, 25, 43, 1353.74, 26, 1353.88, 7
4, 09:17:00-000, 85, 62, 23, 36, 1355.80, 23, 1355.43, 22
4, 09:18:00-000, 88, 49, 39, 57, 1357.30, 39, 1357.63, 0
4, 09:19:00-000, 81, 40, 41, 31, 1355.51, 26, 1355.96, 12
4, 09:20:00-000, 108, 28, 80, 29, 1351.37, 59, 1351.57, 17
4, 09:21:00-000, 78, 31, 47, 30, 1349.63, 39, 1349.48, 21
4, 09:22:00-000, 87, 39, 48, 37, 1350.91, 46, 1351.06, 4
4, 09:23:00-000, 73, 35, 38, 35, 1350.13, 32, 1349.84, 8
4, 09:24:00-000, 93, 37, 56, 37, 1359.91, 48, 1358.91, 9
4, 09:25:00-000, 73, 23, 50, 22, 1356.13, 37, 1356.48, 14
4, 09:26:00-000, 80, 43, 37, 43, 1353.25, 37, 1352.59, 2
4, 09:27:00-000, 96, 52, 44, 40, 1355.47, 26, 1354.46, 29
4, 09:28:00-000, 97, 44, 53, 38, 1351.89, 35, 1352.02, 6
4, 09:29:00-000, 63, 26, 37, 22, 1350.50, 28, 1349.42, 20
4, 09:30:00-000, 75, 38, 37, 43, 1349.95, 39, 1350.71, 0
4, 09:31:00-000, 83, 41, 42, 40, 1350.77, 40, 1350.42, 9
4, 09:32:00-000, 79, 36, 43, 36, 1349.38, 41, 1349.46, 3
4, 09:33:00-000, 90, 37, 53, 37, 1350.64, 41, 1350.36, 0
4, 09:34:00-000, 91, 59, 32, 49, 1352.40, 43, 1352.13, 3
4, 09:35:00-000, 85, 41, 44, 42, 1352.56, 38, 1351.49, 10
4, 09:36:00-000, 64, 30, 34, 29, 1351.41, 32, 1350.90, 5
4, 09:37:00-000, 71, 38, 33, 37, 1354.37, 25, 1355.20, 4
4, 09:38:00-000, 97, 46, 51, 42, 1350.75, 50, 1351.35, 2
4, 09:39:00-000, 74, 45, 29, 42, 1352.18, 31, 1351.93, 8
4, 09:40:00-000, 88, 44, 44, 41, 1351.68, 38, 1351.68, 6
4, 09:41:00-000, 86, 46, 40, 46, 1351.79, 39, 1351.33, 3
4, 09:42:00-000, 70, 26, 44, 25, 1348.47, 40, 1348.22, 2
4, 09:43:00-000, 80, 29, 51, 30, 1352.03, 31, 1351.96, 9
4, 09:44:00-000, 90, 49, 41, 46, 1351.95, 54, 1351.90, 5
4, 09:45:00-000, 64, 35, 29, 33, 1350.60, 22, 1350.91, 2
4, 09:46:00-000, 89, 42, 47, 41, 1351.65, 42, 1351.66, 7
4, 09:47:00-000, 54, 20, 34, 21, 1351.14, 20, 1351.15, 15
4, 09:48:00-000, 94, 53, 41, 45, 1351.59, 43, 1351.90, 6
4, 09:49:00-000, 98, 39, 59, 36, 1349.85, 39, 1350.17, 17
4, 09:50:00-000, 94, 30, 64, 33, 1350.60, 47, 1351.01, 3
4, 09:51:00-000, 74, 43, 31, 35, 1349.85, 34, 1350.26, 26
4, 09:52:00-000, 83, 44, 39, 43, 1352.25, 35, 1352.11, 0
4, 09:53:00-000, 109, 63, 46, 58, 1352.44, 45, 1351.95, 7
4, 09:54:00-000, 72, 38, 34, 36, 1350.08, 36, 1350.69, 3
4, 09:55:00-000, 73, 33, 40, 33, 1352.09, 28, 1352.24, 3
4, 09:56:00-000, 97, 42, 55, 38, 1349.86, 57, 1350.76, 3
4, 09:57:00-000, 67, 27, 40, 27, 1352.74, 28, 1353.17, 16
4, 09:58:00-000, 88, 44, 44, 46, 1350.93, 47, 1350.76, 0
4, 09:59:00-000, 87, 47, 40, 43, 1348.83, 32, 1348.49, 6
4, 10:00:00-000, 68, 30, 38, 28, 1349.03, 31, 1350.22, 4
4, 10:01:00-000, 83, 44, 39, 39, 1350.20, 34, 1350.35, 12
4, 10:02:00-000, 73, 37, 36, 37, 1348.99, 41, 1349.85, 0
4, 10:03:00-000, 71, 38, 33, 35, 1350.39, 27, 1350.55, 9
4, 10:04:00-000, 97, 52, 45, 47, 1351.50, 43, 1351.64, 4
4, 10:05:00-000, 88, 51, 37, 49, 1350.54, 38, 1350.44, 4
4, 10:06:00-000, 64, 36, 28, 31, 1351.35, 24, 1351.20, 4
4, 10:07:00-000, 73, 29, 44, 29, 1349.30, 37, 1349.64, 10
4, 10:08:00-000, 79, 36, 43, 39, 1352.48, 41, 1351.72, 6
4, 10:09:00-000, 100, 43, 57, 43, 1350.76, 33, 1351.09, 10
4, 10:10:00-000, 76, 35, 41, 34, 1349.11, 38, 1351.10, 4
4, 10:11:00-000, 71, 27, 44, 27, 1346.77, 43, 1347.74, 14
4, 10:12:00-000, 102, 44, 58, 41, 1350.53, 59, 1350.63, 0
4, 10:13:00-000, 89, 45, 44, 46, 1351.56, 39, 1350.99, 2
4, 10:14:00-000, 55, 26, 29, 24, 1350.70, 25, 1350.83, 7
4, 10:15:00-000, 96, 36, 60, 34, 1349.52, 47, 1349.78, 8
4, 10:16:00-000, 84, 45, 39, 41, 1350.51, 48, 1350.93, 1
4, 10:17:00-000, 68, 30, 38, 32, 1351.59, 27, 1352.11, 6
4, 10:18:00-000, 66, 35, 31, 32, 1354.15, 28, 1353.42, 9
4, 10:19:00-000, 87, 30, 57, 30, 1349.93, 24, 1349.50, 9
4, 10:20:00-000, 103, 69, 34, 50, 1352.65, 51, 1351.38, 17
4, 10:21:00-000, 79, 36, 43, 42, 1349.90, 35, 1350.31, 8
4, 10:22:00-000, 77, 38, 39, 38, 1351.46, 34, 1351.76, 8
4, 10:23:00-000, 59, 28, 31, 23, 1351.25, 22, 1351.86, 14
4, 10:24:00-000, 81, 47, 34, 48, 1350.30, 24, 1350.16, 11
4, 10:25:00-000, 107, 37, 70, 37, 1348.96, 49, 1349.48, 10
4, 10:26:00-000, 82, 41, 41, 38, 1350.23, 53, 1350.14, 0
4, 10:27:00-000, 81, 38, 43, 36, 1350.35, 42, 1350.23, 5
4, 10:28:00-000, 69, 33, 36, 34, 1350.93, 36, 1350.83, 0
4, 10:29:00-000, 81, 41, 40, 38, 1350.57, 29, 1350.82, 13
4, 10:30:00-000, 82, 52, 30, 51, 1350.09, 28, 1350.82, 2
4, 10:31:00-000, 87, 37, 50, 35, 1351.02, 43, 1349.81, 9
4, 10:32:00-000, 97, 47, 50, 47, 1349.50, 46, 1349.23, 3
4, 10:33:00-000, 83, 38, 45, 40, 1351.04, 33, 1350.42, 3
4, 10:34:00-000, 91, 38, 53, 38, 1348.52, 48, 1349.64, 5
4, 10:35:00-000, 85, 40, 45, 36, 1349.44, 34, 1350.23, 11
4, 10:36:00-000, 69, 28, 41, 31, 1350.64, 48, 1351.74, 0
4, 10:37:00-000, 82, 48, 34, 48, 1352.07, 29, 1351.41, 1
4, 10:38:00-000, 98, 41, 57, 30, 1350.43, 56, 1351.05, 7
4, 10:39:00-000, 99, 45, 54, 44, 1350.24, 39, 1350.38, 16
4, 10:40:00-000, 68, 24, 44, 24, 1350.25, 38, 1350.54, 13
4, 10:41:00-000, 78, 37, 41, 33, 1348.90, 37, 1349.40, 11
4, 10:42:00-000, 95, 63, 32, 60, 1353.97, 31, 1354.12, 7
4, 10:43:00-000, 97, 44, 53, 39, 1351.20, 41, 1351.02, 4
4, 10:44:00-000, 58, 26, 32, 31, 1349.86, 37, 1350.26, 3
4, 10:45:00-000, 113, 47, 66, 47, 1351.46, 43, 1350.29, 5
4, 10:46:00-000, 76, 48, 28, 47, 1352.14, 47, 1351.80, 0
4, 10:47:00-000, 63, 27, 36, 22, 1350.99, 28, 1351.67, 10
4, 10:48:00-000, 88, 45, 43, 45, 1351.52, 44, 1351.99, 2
4, 10:49:00-000, 96, 43, 53, 38, 1350.44, 51, 1350.60, 4
4, 10:50:00-000, 93, 44, 49, 46, 1351.01, 35, 1350.59, 8
4, 10:51:00-000, 89, 41, 48, 39, 1351.05, 38, 1350.99, 13
4, 10:52:00-000, 74, 36, 38, 34, 1350.44, 41, 1350.14, 5
4, 10:53:00-000, 80, 42, 38, 43, 1350.99, 26, 1350.00, 0
4, 10:54:00-000, 91, 43, 48, 44, 1349.33, 44, 1350.65, 7
4, 10:55:00-000, 76, 34, 42, 30, 1350.63, 37, 1350.45, 4
4, 10:56:00-000, 83, 52, 31, 48, 1351.16, 39, 1350.38, 4
4, 10:57:00-000, 71, 37, 34, 34, 1350.11, 25, 1350.03, 8
4, 10:58:00-000, 89, 40, 49, 36, 1352.10, 42, 1351.97, 13
4, 10:59:00-000, 81, 30, 51, 31, 1351.57, 37, 1350.67, 10
4, 11:00:00-000, 67, 27, 40, 23, 1348.82, 40, 1349.47, 8
4, 11:01:00-000, 77, 43, 34, 40, 1349.84, 31, 1349.77, 9
4, 11:02:00-000, 102, 52, 50, 52, 1350.60, 52, 1350.43, 2
4, 11:03:00-000, 75, 49, 26, 42, 1353.06, 23, 1353.13, 7
4, 11:04:00-000, 83, 35, 48, 37, 1349.40, 35, 1349.71, 6
4, 11:05:00-000, 91, 35, 56, 34, 1350.67, 36, 1349.55, 10
4, 11:06:00-000, 75, 41, 34, 40, 1349.74, 51, 1351.01, 2
4, 11:07:00-000, 85, 36, 49, 36, 1349.72, 32, 1349.02, 1
4, 11:08:00-000, 66, 30, 36, 26, 1351.49, 43, 1350.55, 5
4, 11:09:00-000, 81, 42, 39, 41, 1350.89, 32, 1351.53, 9
4, 11:10:00-000, 89, 48, 41, 43, 1350.36, 47, 1349.99, 4
4, 11:11:00-000, 80, 44, 36, 43, 1351.18, 28, 1350.82, 7
4, 11:12:00-000, 89, 51, 38, 49, 1351.28, 35, 1351.36, 0
4, 11:13:00-000, 115, 51, 64, 47, 1352.23, 62, 1351.44, 10
4, 11:14:00-000, 73, 30, 43, 29, 1351.13, 28, 1349.60, 8
4, 11:15:00-000, 75, 34, 41, 34, 1349.73, 37, 1349.75, 7
4, 11:16:00-000, 89, 59, 30, 52, 1351.53, 36, 1350.80, 4
4, 11:17:00-000, 94, 43, 51, 44, 1350.58, 42, 1351.35, 7
4, 11:18:00-000, 91, 46, 45, 46, 1351.10, 51, 1351.42, 1
4, 11:19:00-000, 81, 33, 48, 32, 1351.56, 38, 1350.81, 7
4, 11:20:00-000, 82, 40, 42, 37, 1349.26, 37, 1349.61, 3
4, 11:21:00-000, 103, 58, 45, 45, 1352.93, 38, 1351.28, 11
4, 11:22:00-000, 89, 33, 56, 50, 1350.31, 54, 1349.27, 5
4, 11:23:00-000, 78, 20, 58, 19, 1348.21, 28, 1349.03, 5
4, 11:24:00-000, 78, 33, 45, 34, 1351.88, 64, 1350.64, 4
4, 11:25:00-000, 102, 52, 50, 47, 1351.18, 34, 1351.61, 9
4, 11:26:00-000, 66, 24, 42, 27, 1350.70, 28, 1351.21, 11
4, 11:27:00-000, 99, 40, 59, 41, 1351.09, 52, 1351.39, 11
4, 11:28:00-000, 80, 36, 44, 36, 1350.10, 48, 1350.68, 1
4, 11:29:00-000, 100, 51, 49, 46, 1351.69, 36, 1351.88, 4
4, 11:30:00-000, 90, 42, 48, 45, 1350.77, 45, 1351.08, 12
4, 11:31:00-000, 76, 38, 38, 35, 1349.76, 26, 1350.11, 12
4, 11:32:00-000, 64, 31, 33, 26, 1350.76, 36, 1351.49, 4
4, 11:33:00-000, 83, 45, 38, 43, 1350.62, 37, 1351.05, 6
4, 11:34:00-000, 91, 51, 40, 50, 1350.27, 39, 1350.55, 3
4, 11:35:00-000, 76, 43, 33, 43, 1350.46, 23, 1349.56, 4
4, 11:36:00-000, 121, 64, 57, 51, 1350.91, 53, 1350.18, 13
4, 11:37:00-000, 65, 31, 34, 29, 1349.37, 34, 1350.35, 13
4, 11:38:00-000, 83, 37, 46, 37, 1351.02, 36, 1350.41, 8
4, 11:39:00-000, 73, 32, 41, 30, 1349.43, 38, 1349.57, 5
4, 11:40:00-000, 99, 46, 53, 42, 1351.68, 49, 1351.36, 5
4, 11:41:00-000, 125, 50, 75, 51, 1350.33, 54, 1350.44, 10
4, 11:42:00-000, 87, 37, 50, 27, 1349.29, 52, 1350.34, 12
4, 11:43:00-000, 84, 42, 42, 37, 1350.32, 40, 1350.04, 13
4, 11:44:00-000, 86, 40, 46, 38, 1349.86, 41, 1350.46, 1
4, 11:45:00-000, 73, 40, 33, 43, 1350.69, 33, 1350.72, 4
4, 11:46:00-000, 83, 51, 32, 51, 1352.81, 35, 1352.71, 1
4, 11:47:00-000, 82, 35, 47, 35, 1348.71, 39, 1348.25, 3
4, 11:48:00-000, 78, 49, 29, 48, 1351.39, 35, 1351.31, 0
4, 11:49:00-000, 96, 48, 48, 43, 1350.94, 47, 1350.14, 1
4, 11:50:00-000, 75, 29, 46, 35, 1352.33, 42, 1351.33, 0
4, 11:51:00-000, 63, 41, 22, 39, 1351.22, 19, 1352.26, 3
4, 11:52:00-000, 87, 43, 44, 40, 1353.69, 17, 1352.00, 9
4, 11:53:00-000, 111, 42, 69, 41, 1348.63, 62, 1348.54, 24
4, 11:54:00-000, 112, 49, 63, 51, 1351.48, 55, 1349.66, 12
4, 11:55:00-000, 94, 37, 57, 33, 1350.42, 33, 1350.69, 11
4, 11:56:00-000, 86, 39, 47, 35, 1348.08, 52, 1349.07, 12
4, 11:57:00-000, 79, 38, 41, 40, 1349.62, 29, 1350.10, 7
4, 11:58:00-000, 66, 36, 30, 34, 1350.37, 40, 1350.42, 3
4, 11:59:00-000, 73, 37, 36, 33, 1351.33, 24, 1351.25, 9
4, 12:00:00-000, 90, 44, 46, 37, 1349.59, 36, 1350.22, 1
4, 12:01:00-000, 79, 44, 35, 46, 1350.01, 36, 1350.41, 17
4, 12:02:00-000, 84, 42, 42, 40, 1350.64, 47, 1350.33, 0
4, 12:03:00-000, 83, 43, 40, 45, 1351.21, 35, 1351.25, 1
4, 12:04:00-000, 95, 38, 57, 33, 1350.33, 44, 1350.08, 15
4, 12:05:00-000, 86, 59, 27, 46, 1351.93, 28, 1351.39, 15
4, 12:06:00-000, 68, 33, 35, 34, 1349.70, 34, 1349.67, 3
4, 12:07:00-000, 101, 44, 57, 42, 1352.13, 50, 1351.29, 1
4, 12:08:00-000, 73, 35, 38, 34, 1351.88, 32, 1351.49, 9
4, 12:09:00-000, 81, 32, 49, 35, 1350.39, 35, 1350.65, 6
4, 12:10:00-000, 66, 28, 38, 27, 1348.70, 45, 1349.15, 3
4, 12:11:00-000, 76, 42, 34, 33, 1349.60, 31, 1349.77, 13
4, 12:12:00-000, 96, 65, 31, 59, 1352.21, 25, 1351.28, 7
4, 12:13:00-000, 78, 27, 51, 27, 1351.22, 39, 1350.61, 7
4, 12:14:00-000, 88, 33, 55, 31, 1351.45, 46, 1350.62, 16
4, 12:15:00-000, 72, 29, 43, 28, 1350.67, 35, 1350.56, 8
4, 12:16:00-000, 110, 57, 53, 49, 1350.44, 55, 1351.05, 5
4, 12:17:00-000, 69, 30, 39, 37, 1351.48, 25, 1351.04, 11
4, 12:18:00-000, 85, 44, 41, 29, 1350.27, 43, 1350.83, 4
4, 12:19:00-000, 96, 35, 61, 31, 1348.38, 49, 1348.87, 14
4, 12:20:00-000, 93, 45, 48, 46, 1349.17, 45, 1349.97, 9
4, 12:21:00-000, 79, 39, 40, 36, 1351.74, 36, 1351.66, 7
4, 12:22:00-000, 80, 52, 28, 47, 1352.86, 17, 1352.17, 16
4, 12:23:00-000, 77, 33, 44, 32, 1352.71, 34, 1352.40, 10
4, 12:24:00-000, 71, 35, 36, 34, 1351.14, 29, 1350.58, 9
4, 12:25:00-000, 78, 46, 32, 40, 1350.12, 34, 1350.08, 10
4, 12:26:00-000, 103, 60, 43, 60, 1352.14, 38, 1351.97, 3
4, 12:27:00-000, 72, 28, 44, 26, 1349.80, 28, 1350.35, 6
4, 12:28:00-000, 95, 35, 60, 32, 1348.80, 61, 1349.25, 13
4, 12:29:00-000, 84, 58, 26, 54, 1352.53, 27, 1352.29, 3
4, 12:30:00-000, 92, 47, 45, 51, 1349.11, 39, 1349.53, 2
4, 12:31:00-000, 95, 34, 61, 35, 1349.34, 47, 1349.42, 5
4, 12:32:00-000, 41, 24, 17, 21, 1349.38, 28, 1349.89, 2
4, 12:33:00-000, 102, 36, 66, 36, 1349.41, 48, 1349.37, 9
4, 12:34:00-000, 71, 32, 39, 29, 1349.44, 37, 1350.48, 5
4, 12:35:00-000, 97, 58, 39, 56, 1351.12, 42, 1351.47, 4
4, 12:36:00-000, 65, 29, 36, 35, 1351.57, 36, 1351.19, 1
4, 12:37:00-000, 84, 29, 55, 27, 1350.29, 35, 1350.08, 3
4, 12:38:00-000, 97, 51, 46, 52, 1351.03, 57, 1350.64, 2
4, 12:39:00-000, 85, 44, 41, 41, 1349.97, 39, 1349.79, 1
4, 12:40:00-000, 81, 42, 39, 38, 1350.96, 41, 1351.24, 3
4, 12:41:00-000, 73, 41, 32, 39, 1352.27, 22, 1352.81, 10
4, 12:42:00-000, 70, 24, 46, 23, 1347.69, 33, 1348.90, 8
4, 12:43:00-000, 76, 28, 48, 28, 1348.10, 36, 1348.55, 18
4, 12:44:00-000, 83, 32, 51, 33, 1350.02, 39, 1349.33, 6
4, 12:45:00-000, 68, 29, 39, 28, 1350.06, 27, 1349.77, 14
4, 12:46:00-000, 105, 32, 73, 33, 1350.39, 70, 1350.50, 1
4, 12:47:00-000, 62, 30, 32, 27, 1351.85, 27, 1351.51, 20
4, 12:48:00-000, 76, 39, 37, 42, 1352.16, 35, 1352.62, 3
4, 12:49:00-000, 101, 47, 54, 45, 1351.81, 46, 1351.10, 1
4, 12:50:00-000, 79, 36, 43, 35, 1351.16, 43, 1352.34, 6
4, 12:51:00-000, 78, 45, 33, 44, 1351.81, 31, 1350.19, 3
4, 12:52:00-000, 83, 44, 39, 40, 1350.79, 33, 1350.72, 6
4, 12:53:00-000, 122, 60, 62, 60, 1350.52, 55, 1350.28, 0
4, 12:54:00-000, 64, 35, 29, 32, 1349.99, 38, 1350.34, 6
4, 12:55:00-000, 77, 36, 41, 36, 1350.50, 33, 1350.51, 9
4, 12:56:00-000, 78, 37, 41, 37, 1350.75, 36, 1350.72, 4
4, 12:57:00-000, 84, 37, 47, 33, 1349.84, 38, 1349.73, 5
4, 12:58:00-000, 106, 55, 51, 54, 1350.36, 39, 1350.71, 11
4, 12:59:00-000, 87, 60, 27, 54, 1352.77, 26, 1352.07, 8
4, 13:00:00-000, 81, 38, 43, 44, 1350.65, 28, 1350.92, 5
4, 13:01:00-000, 85, 34, 51, 29, 1350.17, 49, 1350.26, 11
4, 13:02:00-000, 69, 43, 26, 46, 1352.49, 30, 1352.09, 0
4, 13:03:00-000, 92, 45, 47, 46, 1350.95, 32, 1350.74, 8
4, 13:04:00-000, 85, 39, 46, 39, 1350.30, 54, 1350.79, 0
4, 13:05:00-000, 86, 39, 47, 30, 1348.56, 39, 1348.94, 7
4, 13:06:00-000, 79, 38, 41, 43, 1351.25, 33, 1351.75, 1
4, 13:07:00-000, 94, 33, 61, 35, 1350.02, 30, 1350.23, 19
4, 13:08:00-000, 91, 47, 44, 43, 1351.20, 62, 1351.26, 0
4, 13:09:00-000, 51, 23, 28, 24, 1350.04, 25, 1350.20, 4
4, 13:10:00-000, 86, 37, 49, 37, 1350.80, 45, 1351.17, 0
4, 13:11:00-000, 106, 49, 57, 46, 1350.64, 60, 1349.84, 8
4, 13:12:00-000, 95, 46, 49, 46, 1350.99, 47, 1351.20, 0
4, 13:13:00-000, 80, 36, 44, 35, 1350.02, 37, 1349.51, 6
4, 13:14:00-000, 74, 41, 33, 44, 1350.49, 35, 1351.16, 1
4, 13:15:00-000, 85, 43, 42, 40, 1350.64, 28, 1350.71, 13
4, 13:16:00-000, 89, 42, 47, 45, 1349.66, 34, 1349.99, 8
4, 13:17:00-000, 88, 56, 32, 48, 1350.97, 39, 1350.81, 3
4, 13:18:00-000, 76, 31, 45, 38, 1351.18, 32, 1351.68, 1
4, 13:19:00-000, 86, 40, 46, 38, 1351.92, 26, 1351.92, 17
4, 13:20:00-000, 88, 44, 44, 39, 1351.74, 55, 1351.72, 3
4, 13:21:00-000, 86, 47, 39, 40, 1350.64, 42, 1350.68, 7
4, 13:22:00-000, 90, 25, 65, 24, 1350.74, 49, 1350.68, 2
4, 13:23:00-000, 99, 59, 40, 60, 1350.84, 46, 1350.34, 8
4, 13:24:00-000, 101, 52, 49, 49, 1350.40, 49, 1350.40, 3
4, 13:25:00-000, 77, 34, 43, 31, 1351.74, 32, 1352.53, 10
4, 13:26:00-000, 100, 56, 44, 53, 1351.76, 50, 1351.47, 3
4, 13:27:00-000, 94, 30, 64, 33, 1349.84, 46, 1349.90, 3
4, 13:28:00-000, 116, 58, 58, 58, 1349.92, 70, 1349.94, 1
4, 13:29:00-000, 68, 32, 36, 27, 1351.14, 33, 1351.05, 1
4, 13:30:00-000, 89, 45, 44, 46, 1351.95, 41, 1353.41, 0
4, 13:31:00-000, 95, 55, 40, 45, 1352.12, 43, 1352.97, 3
4, 13:32:00-000, 91, 46, 45, 53, 1349.65, 39, 1349.33, 6
4, 13:33:00-000, 93, 43, 50, 40, 1349.77, 41, 1350.60, 5
4, 13:34:00-000, 85, 35, 50, 36, 1349.66, 43, 1349.97, 0
4, 13:35:00-000, 96, 42, 54, 37, 1348.29, 43, 1348.04, 16
4, 13:36:00-000, 83, 23, 60, 31, 1349.22, 56, 1349.21, 6
4, 13:37:00-000, 78, 49, 29, 46, 1350.86, 25, 1351.23, 8
4, 13:38:00-000, 81, 42, 39, 43, 1350.36, 33, 1350.17, 4
4, 13:39:00-000, 83, 45, 38, 34, 1351.14, 37, 1351.86, 12
4, 13:40:00-000, 114, 49, 65, 43, 1350.22, 65, 1350.25, 7
4, 13:41:00-000, 44, 18, 26, 20, 1351.10, 23, 1351.21, 5
4, 13:42:00-000, 81, 43, 38, 43, 1350.67, 34, 1351.02, 4
4, 13:43:00-000, 84, 46, 38, 42, 1349.49, 32, 1350.06, 8
4, 13:44:00-000, 72, 33, 39, 35, 1352.31, 38, 1351.26, 3
4, 13:45:00-000, 93, 45, 48, 43, 1350.13, 46, 1350.36, 4
4, 13:46:00-000, 79, 42, 37, 42, 1350.83, 36, 1350.66, 3
4, 13:47:00-000, 59, 21, 38, 18, 1347.66, 25, 1349.00, 3
4, 13:48:00-000, 95, 45, 50, 42, 1349.82, 51, 1349.77, 7
4, 13:49:00-000, 75, 37, 38, 38, 1351.49, 35, 1351.70, 3
4, 13:50:00-000, 70, 39, 31, 40, 1353.37, 25, 1352.88, 5
4, 13:51:00-000, 76, 39, 37, 38, 1350.78, 42, 1351.06, 1
4, 13:52:00-000, 97, 49, 48, 50, 1350.81, 38, 1351.15, 2
4, 13:53:00-000, 60, 28, 32, 25, 1351.16, 36, 1351.13, 7
4, 13:54:00-000, 86, 33, 53, 34, 1347.61, 49, 1347.09, 3
4, 13:55:00-000, 81, 35, 46, 34, 1347.88, 39, 1348.07, 8
4, 13:56:00-000, 73, 34, 39, 34, 1350.38, 35, 1350.37, 0
4, 13:57:00-000, 106, 46, 60, 44, 1349.54, 57, 1349.46, 3
4, 13:58:00-000, 103, 67, 36, 69, 1351.67, 34, 1351.20, 2
4, 13:59:00-000, 47, 26, 21, 27, 1351.51, 19, 1351.94, 2
4, 14:00:00-000, 93, 45, 48, 44, 1349.77, 46, 1350.21, 8
4, 14:01:00-000, 63, 35, 28, 30, 1350.00, 28, 1350.39, 1
4, 14:02:00-000, 67, 41, 26, 43, 1350.78, 25, 1351.68, 3
4, 14:03:00-000, 117, 65, 52, 63, 1352.13, 40, 1352.27, 5
4, 14:04:00-000, 79, 35, 44, 38, 1349.36, 47, 1349.69, 1
4, 14:05:00-000, 68, 31, 37, 27, 1349.73, 24, 1350.29, 4
4, 14:06:00-000, 99, 41, 58, 44, 1350.67, 68, 1350.63, 0
4, 14:07:00-000, 91, 36, 55, 35, 1349.68, 35, 1349.17, 6
4, 14:08:00-000, 56, 21, 35, 21, 1349.99, 43, 1350.88, 5
4, 14:09:00-000, 106, 49, 57, 46, 1350.15, 53, 1350.20, 3
4, 14:10:00-000, 73, 46, 27, 44, 1350.51, 34, 1350.76, 0
4, 14:11:00-000, 75, 38, 37, 37, 1351.51, 28, 1351.60, 5
4, 14:12:00-000, 89, 40, 49, 42, 1348.49, 53, 1349.22, 3
4, 14:13:00-000, 98, 42, 56, 41, 1349.38, 47, 1349.50, 0
4, 14:14:00-000, 84, 47, 37, 48, 1352.68, 41, 1351.82, 0
4, 14:15:00-000, 84, 48, 36, 35, 1353.34, 29, 1353.51, 4
4, 14:16:00-000, 60, 36, 24, 48, 1351.05, 21, 1350.95, 8
4, 14:17:00-000, 72, 45, 27, 35, 1351.08, 28, 1350.64, 1
4, 14:18:00-000, 101, 36, 65, 42, 1348.83, 53, 1349.48, 9
4, 14:19:00-000, 95, 38, 57, 35, 1349.48, 61, 1349.92, 5
4, 14:20:00-000, 87, 37, 50, 38, 1349.39, 42, 1349.87, 1
4, 14:21:00-000, 76, 33, 43, 33, 1350.63, 38, 1350.10, 4
4, 14:22:00-000, 85, 39, 46, 39, 1349.97, 54, 1350.01, 0
4, 14:23:00-000, 117, 65, 52, 65, 1350.33, 53, 1350.76, 1
4, 14:24:00-000, 71, 41, 30, 39, 1351.40, 21, 1352.04, 0
4, 14:25:00-000, 59, 44, 15, 39, 1350.71, 20, 1350.70, 1
4, 14:26:00-000, 105, 55, 50, 55, 1350.90, 48, 1350.86, 9
4, 14:27:00-000, 80, 30, 50, 29, 1350.00, 41, 1349.87, 2
4, 14:28:00-000, 69, 33, 36, 31, 1350.67, 43, 1351.04, 0
4, 14:29:00-000, 100, 55, 45, 52, 1350.64, 38, 1350.99, 6
4, 14:30:00-000, 101, 41, 60, 35, 1347.74, 62, 1349.52, 8
4, 14:31:00-000, 91, 55, 36, 44, 1350.51, 36, 1350.47, 7
4, 14:32:00-000, 66, 27, 39, 35, 1349.45, 36, 1351.33, 1
4, 14:33:00-000, 106, 56, 50, 54, 1349.01, 45, 1349.17, 1
4, 14:34:00-000, 102, 46, 56, 44, 1349.85, 50, 1350.43, 10
4, 14:35:00-000, 73, 44, 29, 43, 1352.85, 34, 1352.05, 0
4, 14:36:00-000, 80, 48, 32, 48, 1351.80, 33, 1351.54, 2
4, 14:37:00-000, 95, 35, 60, 33, 1349.93, 59, 1349.83, 0
4, 14:38:00-000, 87, 46, 41, 46, 1350.45, 40, 1350.94, 1
4, 14:39:00-000, 74, 48, 26, 39, 1351.81, 25, 1351.84, 4
4, 14:40:00-000, 109, 45, 64, 46, 1350.82, 52, 1350.16, 8
4, 14:41:00-000, 58, 30, 28, 20, 1350.75, 31, 1349.80, 8
4, 14:42:00-000, 75, 35, 40, 40, 1350.87, 28, 1351.17, 7
4, 14:43:00-000, 84, 42, 42, 40, 1350.59, 45, 1350.79, 7
4, 14:44:00-000, 98, 39, 59, 40, 1349.99, 54, 1350.64, 0
4, 14:45:00-000, 79, 49, 30, 47, 1349.48, 37, 1349.99, 0
4, 14:46:00-000, 91, 43, 48, 40, 1350.31, 41, 1350.84, 7
4, 14:47:00-000, 113, 55, 58, 55, 1350.92, 53, 1351.41, 4
4, 14:48:00-000, 63, 32, 31, 31, 1350.28, 34, 1350.55, 0
4, 14:49:00-000, 99, 39, 60, 40, 1350.34, 56, 1349.72, 2
4, 14:50:00-000, 83, 26, 57, 22, 1347.91, 41, 1348.16, 8
4, 14:51:00-000, 86, 49, 37, 45, 1349.59, 45, 1349.97, 6
4, 14:52:00-000, 87, 49, 38, 54, 1351.06, 39, 1351.30, 1
4, 14:53:00-000, 88, 51, 37, 51, 1352.18, 28, 1352.03, 0
4, 14:54:00-000, 64, 26, 38, 24, 1347.49, 37, 1350.51, 3
4, 14:55:00-000, 94, 37, 57, 37, 1349.21, 60, 1349.17, 7
4, 14:56:00-000, 81, 40, 41, 39, 1351.28, 37, 1351.37, 0
4, 14:57:00-000, 91, 38, 53, 36, 1349.02, 42, 1349.01, 3
4, 14:58:00-000, 66, 38, 28, 36, 1351.35, 39, 1351.02, 2
4, 14:59:00-000, 86, 57, 29, 51, 1351.26, 29, 1351.82, 3
4, 15:00:00-000, 84, 29, 55, 35, 1350.34, 48, 1349.70, 5
4, 15:01:00-000, 78, 41, 37, 41, 1351.29, 36, 1350.80, 1
4, 15:02:00-000, 78, 35, 43, 35, 1348.91, 45, 1349.72, 1
4, 15:03:00-000, 105, 66, 39, 63, 1352.02, 38, 1351.84, 0
4, 15:04:00-000, 79, 35, 44, 36, 1349.99, 36, 1350.47, 3
4, 15:05:00-000, 76, 23, 53, 18, 1348.39, 45, 1348.81, 12
4, 15:06:00-000, 71, 43, 28, 48, 1351.41, 26, 1351.07, 0
4, 15:07:00-000, 104, 46, 58, 44, 1351.20, 53, 1351.50, 2
4, 15:08:00-000, 91, 49, 42, 44, 1348.99, 40, 1349.19, 2
4, 15:09:00-000, 72, 38, 34, 42, 1348.71, 33, 1348.75, 9
4, 15:10:00-000, 96, 56, 40, 57, 1350.60, 39, 1351.20, 2
4, 15:11:00-000, 79, 31, 48, 32, 1349.12, 32, 1349.49, 0
4, 15:12:00-000, 61, 35, 26, 35, 1351.25, 35, 1350.48, 5
4, 15:13:00-000, 110, 56, 54, 52, 1349.16, 52, 1349.53, 8
4, 15:14:00-000, 55, 26, 29, 19, 1349.63, 25, 1350.56, 3
4, 15:15:00-000, 64, 30, 34, 30, 1351.90, 27, 1352.73, 5
4, 15:16:00-000, 92, 41, 51, 41, 1350.41, 52, 1350.82, 0
4, 15:17:00-000, 80, 42, 38, 37, 1350.37, 36, 1350.19, 3
4, 15:18:00-000, 69, 28, 41, 30, 1351.16, 40, 1351.94, 8
4, 15:19:00-000, 97, 48, 49, 40, 1348.82, 40, 1346.34, 12
4, 15:20:00-000, 80, 38, 42, 41, 1348.43, 34, 1349.26, 9
4, 15:21:00-000, 78, 31, 47, 27, 1349.81, 25, 1349.88, 16
4, 15:22:00-000, 99, 31, 68, 30, 1347.13, 62, 1348.08, 7
4, 15:23:00-000, 82, 46, 36, 43, 1349.02, 44, 1349.17, 3
4, 15:24:00-000, 97, 44, 53, 46, 1351.49, 35, 1350.71, 9
4, 15:25:00-000, 110, 59, 51, 46, 1350.25, 44, 1350.52, 12
4, 15:26:00-000, 80, 51, 29, 64, 1350.75, 39, 1351.40, 0
4, 15:27:00-000, 93, 45, 48, 37, 1348.72, 35, 1348.71, 1
4, 15:28:00-000, 78, 39, 39, 42, 1349.99, 39, 1350.94, 2
4, 15:29:00-000, 71, 23, 48, 23, 1348.30, 41, 1348.55, 13
4, 15:30:00-000, 87, 38, 49, 33, 1349.63, 39, 1349.94, 13
4, 15:31:00-000, 83, 36, 47, 36, 1350.38, 47, 1351.05, 1
4, 15:32:00-000, 62, 32, 30, 35, 1350.53, 33, 1351.54, 0
4, 15:33:00-000, 85, 39, 46, 37, 1350.40, 34, 1350.64, 2
4, 15:34:00-000, 81, 44, 37, 43, 1353.78, 43, 1352.36, 5
4, 15:35:00-000, 84, 51, 33, 51, 1351.07, 32, 1350.62, 1
4, 15:36:00-000, 103, 50, 53, 54, 1350.88, 51, 1351.03, 0
4, 15:37:00-000, 64, 31, 33, 25, 1349.19, 24, 1350.33, 4
4, 15:38:00-000, 96, 36, 60, 41, 1350.90, 56, 1351.31, 7
4, 15:39:00-000, 67, 36, 31, 29, 1349.03, 29, 1349.55, 11
4, 15:40:00-000, 78, 50, 28, 48, 1350.93, 19, 1350.26, 11
4, 15:41:00-000, 86, 49, 37, 47, 1350.74, 21, 1350.62, 14
4, 15:42:00-000, 74, 40, 34, 41, 1351.04, 33, 1351.11, 6
4, 15:43:00-000, 85, 41, 44, 40, 1351.52, 38, 1350.91, 0
4, 15:44:00-000, 91, 38, 53, 33, 1349.81, 48, 1349.70, 5
4, 15:45:00-000, 64, 20, 44, 26, 1350.23, 44, 1349.77, 4
4, 15:46:00-000, 102, 45, 57, 40, 1349.22, 50, 1350.23, 13
4, 15:47:00-000, 66, 28, 38, 26, 1349.50, 31, 1349.99, 1
4, 15:48:00-000, 90, 34, 56, 37, 1349.21, 52, 1349.49, 0
4, 15:49:00-000, 89, 32, 57, 31, 1348.99, 44, 1349.76, 7
4, 15:50:00-000, 77, 41, 36, 38, 1349.55, 48, 1349.85, 5
4, 15:51:00-000, 91, 60, 31, 57, 1351.21, 30, 1351.33, 2
4, 15:52:00-000, 75, 33, 42, 38, 1349.54, 42, 1349.78, 1
4, 15:53:00-000, 61, 34, 27, 27, 1350.74, 23, 1351.47, 5
4, 15:54:00-000, 78, 39, 39, 32, 1349.24, 41, 1350.33, 2
4, 15:55:00-000, 59, 26, 33, 32, 1351.18, 27, 1351.25, 8
4, 15:56:00-000, 96, 42, 54, 42, 1349.49, 51, 1349.72, 6
4, 15:57:00-000, 82, 52, 30, 45, 1350.57, 29, 1350.30, 0
4, 15:58:00-000, 88, 46, 42, 43, 1348.55, 37, 1349.43, 2
4, 15:59:00-000, 117, 53, 64, 51, 1349.42, 55, 1349.11, 4
4, 16:00:00-000, 78, 35, 43, 33, 1349.81, 42, 1350.40, 8
4, 16:01:00-000, 80, 34, 46, 36, 1349.58, 36, 1349.83, 7
4, 16:02:00-000, 87, 50, 37, 51, 1351.81, 36, 1351.10, 4
4, 16:03:00-000, 90, 37, 53, 34, 1352.02, 37, 1351.42, 18
4, 16:04:00-000, 87, 46, 41, 45, 1350.72, 43, 1351.39, 5
4, 16:05:00-000, 64, 33, 31, 35, 1347.68, 29, 1346.82, 3
4, 16:06:00-000, 97, 47, 50, 44, 1350.29, 47, 1350.67, 7
4, 16:07:00-000, 77, 36, 41, 32, 1350.21, 37, 1350.24, 8
4, 16:08:00-000, 83, 39, 44, 32, 1349.15, 35, 1349.56, 8
4, 16:09:00-000, 90, 54, 36, 57, 1350.34, 32, 1350.28, 4
4, 16:10:00-000, 87, 42, 45, 36, 1352.21, 39, 1351.58, 7
4, 16:11:00-000, 82, 31, 51, 31, 1350.22, 43, 1350.22, 16
4, 16:12:00-000, 76, 34, 42, 33, 1351.42, 32, 1351.06, 4
4, 16:13:00-000, 71, 35, 36, 35, 1349.99, 36, 1350.35, 5
4, 16:14:00-000, 121, 51, 70, 42, 1349.85, 73, 1350.09, 1
4, 16:15:00-000, 57, 14, 43, 23, 1347.99, 38, 1348.07, 3
4, 16:16:00-000, 95, 42, 53, 36, 1349.55, 50, 1349.67, 3
4, 16:17:00-000, 81, 51, 30, 46, 1351.12, 30, 1351.23, 3
4, 16:18:00-000, 109, 63, 46, 62, 1350.20, 49, 1350.73, 10
4, 16:19:00-000, 77, 45, 32, 44, 1350.58, 23, 1351.13, 3
4, 16:20:00-000, 72, 30, 42, 31, 1350.93, 38, 1351.81, 2
4, 16:21:00-000, 88, 50, 38, 45, 1351.35, 30, 1351.16, 7
4, 16:22:00-000, 73, 42, 31, 47, 1351.73, 37, 1352.37, 1
4, 16:23:00-000, 58, 28, 30, 26, 1349.49, 24, 1350.79, 2
4, 16:24:00-000, 103, 59, 44, 51, 1351.68, 45, 1351.48, 13
4, 16:25:00-000, 66, 25, 41, 21, 1350.57, 31, 1351.19, 2
4, 16:26:00-000, 96, 44, 52, 49, 1349.42, 59, 1350.11, 2
4, 16:27:00-000, 99, 57, 42, 52, 1350.76, 37, 1350.86, 0
4, 16:28:00-000, 56, 27, 29, 31, 1348.54, 33, 1350.33, 1
4, 16:29:00-000, 96, 38, 58, 39, 1350.79, 56, 1351.67, 0
5, 09:13:00-000, 10170, 5423, 4747, 3762, 1348.04, 3747, 1349.57, 0
5, 09:14:00-000, 0, 0, 0, 0, 0.00, 38, 1356.00, 610
5, 09:15:00-000, 0, 0, 0, 1, 1347.00, 63, 1356.45, 1938
5, 09:16:00-000, 0, 0, 0, 0, 0.00, 0, 0.00, 11
5, 09:26:00-000, 10271, 5789, 4482, 3758, 1348.59, 3715, 1348.61, 0
5, 09:27:00-000, 0, 0, 0, 7, 1349.00, 92, 1357.00, 0
5, 09:28:00-000, 2, 2, 0, 123, 1348.00, 64, 1357.34, 1886
5, 09:29:00-000, 31, 14, 17, 12, 1352.00, 16, 1352.75, 626
5, 09:30:00-000, 99, 46, 53, 17, 1346.88, 41, 1349.80, 0
5, 09:31:00-000, 0, 0, 0, 0, 0.00, 8, 1358.12, 1
5, 09:32:00-000, 248, 121, 127, 68, 1348.43, 108, 1350.68, 32
5, 09:33:00-000, 408, 173, 235, 125, 1348.11, 161, 1348.84, 44
5, 09:34:00-000, 599, 333, 266, 260, 1348.25, 255, 1349.65, 53
5, 09:35:00-000, 0, 0, 0, 1, 1346.00, 22, 1356.00, 52
5, 09:36:00-000, 973, 515, 458, 341, 1349.63, 401, 1350.90, 67
5, 09:37:00-000, 1161, 647, 514, 449, 1348.63, 473, 1349.91, 121
5, 09:38:00-000, 1294, 718, 576, 539, 1348.83, 524, 1349.83, 154
5, 09:39:00-000, 0, 0, 0, 43, 1346.98, 38, 1355.41, 143
5, 09:40:00-000, 1298, 704, 594, 514, 1348.62, 486, 1349.48, 173
5, 09:41:00-000, 1296, 701, 595, 470, 1349.14, 488, 1349.54, 216
5, 09:42:00-000, 1168, 653, 515, 483, 1348.67, 472, 1349.63, 210
5, 09:43:00-000, 0, 0, 0, 16, 1347.00, 17, 1357.59, 197
5, 09:44:00-000, 1053, 570, 483, 458, 1348.75, 439, 1349.91, 178
5, 09:45:00-000, 930, 537, 393, 365, 1349.42, 344, 1350.34, 168
5, 09:46:00-000, 831, 482, 349, 328, 1348.86, 315, 1349.86, 127
5, 09:47:00-000, 0, 0, 0, 11, 1347.00, 29, 1357.72, 136
5, 09:48:00-000, 892, 449, 443, 292, 1348.87, 401, 1350.59, 118
5, 09:49:00-000, 1011, 506, 505, 382, 1348.53, 392, 1348.71, 130
5, 09:50:00-000, 956, 515, 441, 422, 1348.50, 362, 1349.37, 134
5, 09:51:00-000, 0, 0, 0, 24, 1345.16, 0, 0.00, 154
5, 09:52:00-000, 1015, 570, 445, 387, 1349.06, 423, 1350.47, 157
5, 09:53:00-000, 1101, 568, 533, 397, 1348.56, 438, 1349.26, 171
5, 09:54:00-000, 1011, 494, 517, 417, 1348.57, 412, 1349.78, 130
5, 09:55:00-000, 0, 0, 0, 15, 1346.00, 10, 1357.00, 162
5, 09:56:00-000, 1171, 576, 595, 462, 1348.31, 528, 1349.78, 150
5, 09:57:00-000, 1020, 499, 521, 341, 1348.58, 405, 1349.59, 146
5, 09:58:00-000, 1058, 552, 506, 452, 1348.15, 395, 1349.11, 209
5, 09:59:00-000, 0, 0, 0, 4, 1345.00, 5, 1355.00, 155
5, 10:00:00-000, 957, 520, 437, 406, 1348.86, 388, 1349.79, 177
5, 10:01:00-000, 913, 466, 447, 371, 1348.58, 351, 1349.29, 101
5, 10:02:00-000, 984, 532, 452, 412, 1348.23, 374, 1348.70, 151
5, 10:03:00-000, 0, 0, 0, 7, 1345.00, 29, 1356.00, 137
5, 10:04:00-000, 1021, 552, 469, 426, 1348.93, 427, 1350.13, 140
5, 10:05:00-000, 1057, 571, 486, 388, 1349.33, 394, 1349.66, 121
5, 10:06:00-000, 1124, 612, 512, 415, 1349.63, 441, 1350.51, 147
5, 10:07:00-000, 0, 0, 0, 50, 1346.64, 0, 0.00, 168
5, 10:08:00-000, 1046, 496, 550, 399, 1348.78, 474, 1349.90, 197
5, 10:09:00-000, 1031, 534, 497, 381, 1348.95, 402, 1349.33, 154
5, 10:10:00-000, 987, 489, 498, 353, 1348.19, 403, 1348.94, 136
5, 10:11:00-000, 0, 0, 0, 35, 1345.00, 4, 1356.00, 175
5, 10:12:00-000, 1052, 528, 524, 415, 1348.39, 417, 1348.78, 142
5, 10:13:00-000, 1046, 521, 525, 377, 1349.15, 430, 1349.96, 148
5, 10:14:00-000, 1121, 623, 498, 511, 1349.62, 449, 1350.49, 145
5, 10:15:00-000, 0, 0, 0, 13, 1346.00, 0, 0.00, 199
5, 10:16:00-000, 989, 512, 477, 429, 1348.41, 402, 1349.52, 112
5, 10:17:00-000, 975, 493, 482, 400, 1348.28, 380, 1348.56, 123
5, 10:18:00-000, 1033, 582, 451, 356, 1349.28, 404, 1350.43, 144
5, 10:19:00-000, 0, 0, 0, 23, 1346.65, 29, 1357.00, 122
5, 10:20:00-000, 1099, 549, 550, 476, 1348.59, 444, 1349.50, 152
5, 10:21:00-000, 1036, 540, 496, 387, 1349.97, 393, 1350.52, 189
5, 10:22:00-000, 1050, 538, 512, 418, 1348.74, 440, 1349.97, 137
5, 10:23:00-000, 4, 4, 0, 17, 1346.88, 27, 1356.00, 139
5, 10:24:00-000, 944, 466, 478, 348, 1348.47, 350, 1349.46, 164
5, 10:25:00-000, 1023, 526, 497, 418, 1348.55, 385, 1348.91, 206
5, 10:26:00-000, 1019, 468, 551, 371, 1348.28, 396, 1348.92, 127
5, 10:27:00-000, 0, 0, 0, 26, 1345.34, 18, 1354.00, 172
5, 10:28:00-000, 1032, 494, 538, 416, 1349.06, 443, 1349.48, 145
5, 10:29:00-000, 950, 526, 424, 383, 1348.64, 353, 1349.23, 145
5, 10:30:00-000, 1040, 528, 512, 392, 1348.65, 411, 1349.37, 153
5, 10:31:00-000, 3, 3, 0, 8, 1348.62, 29, 1356.00, 155
5, 10:32:00-000, 1074, 513, 561, 438, 1348.38, 459, 1349.55, 159
5, 10:33:00-000, 1003, 487, 516, 397, 1348.42, 403, 1349.32, 147
5, 10:34:00-000, 935, 480, 455, 394, 1348.15, 365, 1349.26, 135
5, 10:35:00-000, 0, 0, 0, 0, 0.00, 16, 1355.00, 122
5, 10:36:00-000, 1031, 536, 495, 416, 1349.48, 408, 1350.37, 134
5, 10:37:00-000, 1066, 589, 477, 416, 1348.78, 418, 1349.69, 144
5, 10:38:00-000, 989, 500, 489, 441, 1348.11, 384, 1349.58, 166
5, 10:39:00-000, 0, 0, 0, 25, 1344.68, 0, 0.00, 137
5, 10:40:00-000, 981, 511, 470, 400, 1348.75, 361, 1349.48, 167
5, 10:41:00-000, 1062, 567, 495, 421, 1349.09, 397, 1349.53, 116
5, 10:42:00-000, 1035, 531, 504, 406, 1348.53, 453, 1350.47, 175
5, 10:43:00-000, 0, 0, 0, 0, 0.00, 0, 0.00, 146
5, 10:44:00-000, 1035, 577, 458, 387, 1350.07, 444, 1351.18, 149
5, 10:45:00-000, 1013, 518, 495, 391, 1348.41, 318, 1348.77, 149
5, 10:46:00-000, 1047, 546, 501, 387, 1349.47, 484, 1350.88, 169
5, 10:47:00-000, 0, 0, 0, 60, 1345.51, 28, 1356.00, 179
5, 10:48:00-000, 991, 496, 495, 414, 1348.61, 388, 1349.63, 131
5, 10:49:00-000, 997, 488, 509, 355, 1349.20, 404, 1349.75, 142
5, 10:50:00-000, 992, 540, 452, 438, 1349.70, 412, 1350.86, 121
5, 10:51:00-000, 0, 0, 0, 14, 1347.07, 58, 1356.65, 129
5, 10:52:00-000, 1046, 525, 521, 446, 1348.39, 446, 1349.42, 96
5, 10:53:00-000, 923, 498, 425, 355, 1349.10, 334, 1349.46, 143
5, 10:54:00-000, 985, 451, 534, 385, 1348.49, 416, 1349.23, 115
5, 10:55:00-000, 1, 1, 0, 12, 1345.41, 10, 1356.00, 133
5, 10:56:00-000, 999, 503, 496, 439, 1348.08, 399, 1349.47, 141
5, 10:57:00-000, 997, 541, 456, 405, 1348.55, 359, 1348.92, 151
5, 10:58:00-000, 1165, 583, 582, 459, 1348.61, 479, 1349.46, 151
5, 10:59:00-000, 1, 0, 1, 3, 1345.00, 20, 1356.00, 135
5, 11:00:00-000, 1142, 565, 577, 436, 1348.15, 459, 1348.70, 173
5, 11:01:00-000, 1017, 511, 506, 414, 1348.30, 397, 1348.77, 195
5, 11:02:00-000, 1061, 551, 510, 432, 1349.30, 441, 1349.95, 158
5, 11:03:00-000, 2, 2, 0, 36, 1346.02, 0, 0.00, 127
5, 11:04:00-000, 1049, 529, 520, 406, 1348.76, 468, 1350.08, 151
5, 11:05:00-000, 945, 468, 477, 390, 1347.88, 356, 1348.74, 120
5, 11:06:00-000, 975, 485, 490, 376, 1348.23, 378, 1349.22, 130
5, 11:07:00-000, 3, 3, 0, 21, 1346.24, 18, 1355.11, 136
5, 11:08:00-000, 1046, 562, 484, 459, 1348.48, 436, 1349.55, 143
5, 11:09:00-000, 1051, 560, 491, 368, 1348.78, 399, 1349.43, 118
5, 11:10:00-000, 951, 531, 420, 432, 1349.24, 388, 1350.24, 179
5, 11:11:00-000, 0, 0, 0, 17, 1346.00, 11, 1357.00, 165
5, 11:12:00-000, 1006, 528, 478, 383, 1349.01, 426, 1349.70, 103
5, 11:13:00-000, 946, 555, 391, 390, 1349.50, 299, 1349.84, 146
5, 11:14:00-000, 1086, 449, 637, 377, 1348.07, 471, 1349.55, 151
5, 11:15:00-000, 0, 0, 0, 16, 1344.37, 22, 1354.18, 131
5, 11:16:00-000, 1053, 532, 521, 421, 1348.94, 437, 1349.95, 182
5, 11:17:00-000, 1063, 561, 502, 374, 1349.34, 359, 1349.60, 178
5, 11:18:00-000, 1011, 523, 488, 433, 1349.07, 411, 1350.54, 158
5, 11:19:00-000, 1, 0, 1, 21, 1345.00, 39, 1355.85, 167
5, 11:20:00-000, 982, 498, 484, 403, 1349.03, 401, 1349.86, 167
5, 11:21:00-000, 1008, 505, 503, 350, 1348.66, 416, 1349.63, 140
5, 11:22:00-000, 982, 522, 460, 471, 1348.27, 386, 1349.22, 132
5, 11:23:00-000, 3, 3, 0, 74, 1343.35, 8, 1356.00, 119
5, 11:24:00-000, 928, 488, 440, 392, 1348.43, 384, 1349.72, 91
5, 11:25:00-000, 1054, 591, 463, 360, 1349.40, 413, 1350.29, 90
5, 11:26:00-000, 934, 495, 439, 384, 1348.94, 370, 1350.10, 139
5, 11:27:00-000, 1, 0, 1, 8, 1346.00, 9, 1354.33, 161
5, 11:28:00-000, 1109, 562, 547, 456, 1348.69, 403, 1349.76, 181
5, 11:29:00-000, 982, 528, 454, 365, 1348.92, 376, 1349.56, 158
5, 11:30:00-000, 1155, 556, 599, 465, 1348.17, 511, 1349.71, 179
5, 11:31:00-000, 0, 0, 0, 3, 1346.00, 34, 1356.00, 149
5, 11:32:00-000, 1067, 537, 530, 395, 1348.34, 421, 1349.13, 161
5, 11:33:00-000, 999, 531, 468, 375, 1348.52, 391, 1349.22, 159
5, 11:34:00-000, 1110, 581, 529, 422, 1349.06, 471, 1349.85, 182
5, 11:35:00-000, 5, 0, 5, 12, 1346.00, 0, 0.00, 176
5, 11:36:00-000, 911, 385, 526, 352, 1347.23, 377, 1348.33, 148
5, 11:37:00-000, 920, 461, 459, 378, 1348.77, 398, 1349.18, 122
5, 11:38:00-000, 1114, 611, 503, 461, 1348.89, 433, 1350.11, 127
5, 11:39:00-000, 0, 0, 0, 31, 1344.94, 27, 1356.00, 112
5, 11:40:00-000, 1044, 601, 443, 429, 1349.23, 349, 1350.15, 160
5, 11:41:00-000, 1040, 524, 516, 402, 1348.78, 397, 1349.24, 195
5, 11:42:00-000, 975, 505, 470, 423, 1348.07, 350, 1349.12, 160
5, 11:43:00-000, 3, 0, 3, 30, 1345.00, 9, 1353.00, 157
5, 11:44:00-000, 1108, 586, 522, 450, 1349.09, 428, 1349.76, 149
5, 11:45:00-000, 994, 471, 523, 326, 1349.64, 383, 1349.66, 196
5, 11:46:00-000, 950, 489, 461, 365, 1349.09, 412, 1350.03, 154
5, 11:47:00-000, 0, 0, 0, 16, 1345.00, 13, 1356.00, 160
5, 11:48:00-000, 1076, 533, 543, 394, 1348.43, 476, 1349.39, 176
5, 11:49:00-000, 1018, 524, 494, 393, 1349.05, 373, 1349.53, 131
5, 11:50:00-000, 1042, 539, 503, 429, 1348.67, 451, 1350.32, 126
5, 11:51:00-000, 2, 0, 2, 14, 1345.21, 30, 1356.89, 150
5, 11:52:00-000, 1024, 518, 506, 428, 1348.93, 421, 1350.17, 142
5, 11:53:00-000, 990, 509, 481, 336, 1348.23, 324, 1348.79, 154
5, 11:54:00-000, 963, 466, 497, 396, 1347.90, 414, 1349.31, 181
5, 11:55:00-000, 0, 0, 0, 6, 1345.00, 16, 1355.37, 167
5, 11:56:00-000, 982, 504, 478, 409, 1348.66, 408, 1350.26, 142
5, 11:57:00-000, 1082, 500, 582, 378, 1347.96, 421, 1348.30, 137
5, 11:58:00-000, 1033, 536, 497, 416, 1348.48, 427, 1349.64, 147
5, 11:59:00-000, 0, 0, 0, 21, 1345.38, 28, 1356.00, 137
5, 12:00:00-000, 1022, 546, 476, 446, 1349.53, 371, 1350.58, 139
5, 12:01:00-000, 1090, 567, 523, 401, 1348.54, 401, 1348.54, 180
5, 12:02:00-000, 1035, 532, 503, 436, 1348.08, 407, 1348.62, 177
5, 12:03:00-000, 1, 0, 1, 0, 0.00, 19, 1355.05, 172
5, 12:04:00-000, 965, 484, 481, 386, 1348.06, 365, 1348.58, 168
5, 12:05:00-000, 957, 539, 418, 390, 1349.63, 343, 1349.77, 151
5, 12:06:00-000, 956, 472, 484, 412, 1348.65, 395, 1349.87, 138
5, 12:07:00-000, 1, 1, 0, 34, 1344.94, 48, 1355.83, 136
5, 12:08:00-000, 1066, 488, 578, 390, 1348.16, 450, 1349.26, 114
5, 12:09:00-000, 1050, 551, 499, 415, 1348.85, 391, 1349.25, 153
5, 12:10:00-000, 1025, 541, 484, 416, 1349.08, 363, 1349.34, 138
5, 12:11:00-000, 0, 0, 0, 45, 1345.15, 20, 1356.00, 184
5, 12:12:00-000, 999, 514, 485, 418, 1348.94, 398, 1349.65, 140
5, 12:13:00-000, 1085, 573, 512, 382, 1348.77, 394, 1349.09, 179
5, 12:14:00-000, 1040, 570, 470, 409, 1348.91, 418, 1350.08, 117
5, 12:15:00-000, 1, 1, 0, 26, 1347.15, 15, 1357.00, 211
5, 12:16:00-000, 1084, 565, 519, 442, 1348.77, 456, 1349.72, 137
5, 12:17:00-000, 934, 476, 458, 337, 1349.42, 373, 1350.21, 151
5, 12:18:00-000, 1005, 461, 544, 386, 1347.81, 442, 1349.18, 155
5, 12:19:00-000, 1, 0, 1, 2, 1344.00, 4, 1355.00, 135
5, 12:20:00-000, 1016, 512, 504, 333, 1349.27, 360, 1348.66, 148
5, 12:21:00-000, 1104, 562, 542, 392, 1349.07, 380, 1348.71, 241
5, 12:22:00-000, 1030, 554, 476, 411, 1348.95, 356, 1347.99, 257
5, 12:23:00-000, 2, 1, 1, 0, 0.00, 27, 1354.00, 217
5, 12:24:00-000, 951, 521, 430, 379, 1348.87, 344, 1349.34, 173
5, 12:25:00-000, 996, 556, 440, 402, 1349.70, 308, 1348.22, 208
5, 12:26:00-000, 1020, 539, 481, 390, 1349.18, 389, 1349.30, 168
5, 12:27:00-000, 0, 0, 0, 0, 0.00, 0, 0.00, 197
5, 12:28:00-000, 1006, 502, 504, 374, 1348.68, 377, 1348.99, 194
5, 12:29:00-000, 1120, 548, 572, 411, 1349.09, 417, 1349.33, 192
5, 12:30:00-000, 1113, 567, 546, 431, 1348.63, 444, 1349.32, 162
5, 12:31:00-000, 1, 1, 0, 5, 1347.40, 29, 1355.00, 219
5, 12:32:00-000, 1014, 565, 449, 393, 1349.38, 320, 1349.18, 213
5, 12:33:00-000, 1077, 559, 518, 413, 1348.31, 408, 1348.92, 190
5, 12:34:00-000, 1028, 528, 500, 406, 1349.33, 356, 1349.66, 191
5, 12:35:00-000, 0, 0, 0, 0, 0.00, 8, 1355.00, 198
5, 12:36:00-000, 1080, 538, 542, 412, 1348.78, 405, 1349.33, 206
5, 12:37:00-000, 925, 448, 477, 334, 1349.21, 365, 1349.39, 215
5, 12:38:00-000, 956, 493, 463, 388, 1349.08, 359, 1349.04, 153
5, 12:39:00-000, 0, 0, 0, 19, 1346.00, 0, 0.00, 168
5, 12:40:00-000, 1038, 538, 500, 422, 1349.32, 427, 1349.96, 162
5, 12:41:00-000, 1148, 586, 562, 393, 1349.45, 396, 1349.80, 114
5, 12:42:00-000, 990, 553, 437, 480, 1349.11, 341, 1349.76, 180
5, 12:43:00-000, 1, 0, 1, 27, 1345.00, 1, 1351.00, 221
5, 12:44:00-000, 1059, 570, 489, 390, 1348.75, 383, 1349.54, 175
5, 12:45:00-000, 1005, 515, 490, 396, 1348.81, 405, 1349.57, 165
5, 12:46:00-000, 1033, 537, 496, 392, 1348.80, 409, 1349.12, 159
5, 12:47:00-000, 1, 1, 0, 0, 0.00, 4, 1355.00, 206
5, 12:48:00-000, 1023, 470, 553, 378, 1348.55, 443, 1349.22, 129
5, 12:49:00-000, 1053, 581, 472, 418, 1349.34, 374, 1349.70, 196
5, 12:50:00-000, 1105, 550, 555, 439, 1348.65, 433, 1349.59, 128
5, 12:51:00-000, 0, 0, 0, 28, 1345.00, 11, 1355.00, 174
5, 12:52:00-000, 1076, 532, 544, 431, 1348.61, 426, 1349.33, 196
5, 12:53:00-000, 993, 510, 483, 350, 1349.11, 363, 1349.46, 181
5, 12:54:00-000, 983, 480, 503, 394, 1348.72, 445, 1350.04, 152
5, 12:55:00-000, 0, 0, 0, 43, 1345.27, 6, 1356.00, 145
5, 12:56:00-000, 1088, 527, 561, 418, 1348.42, 473, 1349.64, 155
5, 12:57:00-000, 1004, 546, 458, 378, 1349.24, 387, 1349.52, 142
5, 12:58:00-000, 1014, 557, 457, 368, 1349.72, 378, 1350.55, 141
5, 12:59:00-000, 0, 0, 0, 42, 1346.40, 11, 1357.00, 158
5, 13:00:00-000, 987, 516, 471, 392, 1348.99, 408, 1350.03, 172
5, 13:01:00-000, 1061, 534, 527, 413, 1348.81, 413, 1349.21, 137
5, 13:02:00-000, 962, 513, 449, 393, 1349.08, 415, 1350.89, 116
5, 13:03:00-000, 0, 0, 0, 38, 1345.34, 26, 1357.00, 152
5, 13:04:00-000, 1118, 601, 517, 443, 1348.61, 424, 1350.02, 147
5, 13:05:00-000, 1040, 544, 496, 449, 1348.69, 379, 1349.20, 170
5, 13:06:00-000, 892, 463, 429, 315, 1349.17, 368, 1350.61, 132
5, 13:07:00-000, 1, 0, 1, 13, 1347.00, 19, 1356.42, 146
5, 13:08:00-000, 1052, 533, 519, 439, 1348.46, 428, 1349.30, 130
5, 13:09:00-000, 1032, 547, 485, 392, 1349.29, 386, 1350.12, 179
5, 13:10:00-000, 1023, 544, 479, 409, 1349.30, 404, 1350.25, 152
5, 13:11:00-000, 0, 0, 0, 22, 1345.36, 0, 0.00, 155
5, 13:12:00-000, 1038, 551, 487, 404, 1349.77, 447, 1350.56, 155
5, 13:13:00-000, 1092, 593, 499, 434, 1349.69, 380, 1350.26, 149
5, 13:14:00-000, 1100, 538, 562, 435, 1349.01, 447, 1350.20, 141
5, 13:15:00-000, 0, 0, 0, 30, 1346.50, 59, 1356.60, 187
5, 13:16:00-000, 1042, 556, 486, 431, 1348.95, 395, 1350.08, 148
5, 13:17:00-000, 997, 526, 471, 411, 1349.33, 425, 1350.10, 179
5, 13:18:00-000, 1010, 487, 523, 340, 1348.70, 465, 1350.41, 91
5, 13:19:00-000, 0, 0, 0, 20, 1346.00, 28, 1355.53, 96
5, 13:20:00-000, 1000, 465, 535, 384, 1348.34, 457, 1349.65, 161
5, 13:21:00-000, 1070, 565, 505, 427, 1349.01, 394, 1349.14, 123
5, 13:22:00-000, 1027, 526, 501, 437, 1348.33, 395, 1349.28, 118
5, 13:23:00-000, 1, 1, 0, 37, 1345.00, 40, 1354.54, 170
5, 13:24:00-000, 948, 518, 430, 418, 1349.05, 354, 1349.89, 102
5, 13:25:00-000, 1025, 517, 508, 393, 1348.39, 412, 1348.96, 132
5, 13:26:00-000, 1044, 543, 501, 400, 1348.77, 409, 1349.57, 134
5, 13:27:00-000, 1, 1, 0, 22, 1345.00, 35, 1355.00, 139
5, 13:28:00-000, 1024, 531, 493, 407, 1349.52, 446, 1350.87, 177
5, 13:29:00-000, 991, 503, 488, 357, 1348.93, 375, 1349.49, 136
5, 13:30:00-000, 1055, 563, 492, 420, 1349.28, 397, 1350.38, 141
5, 13:31:00-000, 0, 0, 0, 53, 1345.52, 18, 1357.00, 161
5, 13:32:00-000, 962, 473, 489, 408, 1348.06, 408, 1349.20, 165
5, 13:33:00-000, 1063, 556, 507, 432, 1348.42, 385, 1348.61, 123
5, 13:34:00-000, 1043, 539, 504, 410, 1349.08, 400, 1349.90, 118
5, 13:35:00-000, 0, 0, 0, 20, 1346.00, 16, 1356.00, 167
5, 13:36:00-000, 1056, 535, 521, 408, 1348.27, 391, 1348.72, 170
5, 13:37:00-000, 1109, 570, 539, 441, 1348.85, 452, 1349.59, 194
5, 13:38:00-000, 1096, 498, 598, 419, 1347.19, 482, 1349.33, 133
5, 13:39:00-000, 2, 0, 2, 41, 1344.00, 3, 1351.67, 144
5, 13:40:00-000, 1042, 522, 520, 411, 1348.72, 411, 1349.70, 170
5, 13:41:00-000, 1072, 550, 522, 424, 1349.25, 398, 1349.92, 142
5, 13:42:00-000, 1030, 531, 499, 386, 1348.76, 440, 1349.67, 154
5, 13:43:00-000, 2, 0, 2, 12, 1345.58, 5, 1354.00, 181
5, 13:44:00-000, 1046, 525, 521, 416, 1348.56, 419, 1350.12, 153
5, 13:45:00-000, 1136, 569, 567, 446, 1348.80, 429, 1349.13, 164
5, 13:46:00-000, 960, 434, 526, 323, 1348.47, 381, 1349.13, 175
5, 13:47:00-000, 0, 0, 0, 7, 1345.00, 36, 1354.00, 193
5, 13:48:00-000, 981, 474, 507, 414, 1348.27, 411, 1349.53, 152
5, 13:49:00-000, 1066, 611, 455, 394, 1349.86, 405, 1350.15, 146
5, 13:50:00-000, 1083, 534, 549, 401, 1348.60, 399, 1349.63, 93
5, 13:51:00-000, 0, 0, 0, 31, 1346.00, 47, 1354.15, 181
5, 13:52:00-000, 942, 463, 479, 432, 1347.66, 383, 1348.80, 188
5, 13:53:00-000, 1024, 534, 490, 407, 1348.94, 360, 1349.48, 142
5, 13:54:00-000, 1047, 561, 486, 443, 1348.27, 402, 1349.21, 110
5, 13:55:00-000, 1, 0, 1, 9, 1345.00, 17, 1353.88, 169
5, 13:56:00-000, 999, 505, 494, 416, 1349.14, 418, 1349.81, 146
5, 13:57:00-000, 989, 529, 460, 380, 1349.10, 315, 1349.50, 155
5, 13:58:00-000, 1161, 604, 557, 459, 1349.23, 481, 1349.97, 172
5, 13:59:00-000, 0, 0, 0, 4, 1346.00, 20, 1356.00, 162
5, 14:00:00-000, 975, 469, 506, 374, 1348.30, 412, 1348.91, 177
5, 14:01:00-000, 1088, 474, 614, 371, 1348.15, 433, 1348.50, 166
5, 14:02:00-000, 1034, 524, 510, 383, 1348.94, 430, 1349.78, 179
5, 14:03:00-000, 3, 1, 2, 19, 1346.73, 14, 1355.14, 164
5, 14:04:00-000, 1077, 521, 556, 422, 1348.67, 460, 1349.51, 168
5, 14:05:00-000, 1054, 505, 549, 412, 1348.63, 446, 1349.07, 171
5, 14:06:00-000, 1036, 546, 490, 439, 1349.11, 369, 1349.29, 106
5, 14:07:00-000, 0, 0, 0, 16, 1345.06, 30, 1355.00, 178
5, 14:08:00-000, 990, 523, 467, 468, 1348.41, 402, 1349.78, 107
5, 14:09:00-000, 965, 487, 478, 388, 1348.90, 384, 1349.30, 126
5, 14:10:00-000, 1032, 527, 505, 413, 1348.71, 421, 1350.37, 110
5, 14:11:00-000, 3, 1, 2, 26, 1345.11, 27, 1355.67, 94
5, 14:12:00-000, 960, 513, 447, 429, 1348.39, 356, 1349.45, 145
5, 14:13:00-000, 1145, 568, 577, 441, 1348.58, 426, 1348.74, 146
5, 14:14:00-000, 1021, 502, 519, 361, 1349.17, 434, 1350.14, 150
5, 14:15:00-000, 1, 0, 1, 0, 0.00, 59, 1355.72, 157
5, 14:16:00-000, 994, 450, 544, 363, 1348.54, 394, 1349.77, 143
5, 14:17:00-000, 1027, 526, 501, 393, 1348.93, 385, 1349.24, 196
5, 14:18:00-000, 992, 481, 511, 420, 1347.77, 356, 1348.62, 157
5, 14:19:00-000, 2, 2, 0, 1, 1349.00, 15, 1354.00, 169
5, 14:20:00-000, 988, 471, 517, 401, 1347.99, 426, 1348.76, 179
5, 14:21:00-000, 1100, 552, 548, 381, 1348.83, 361, 1348.66, 150
5, 14:22:00-000, 1048, 496, 552, 382, 1348.64, 451, 1349.95, 165
5, 14:23:00-000, 0, 0, 0, 32, 1344.97, 24, 1355.00, 183
5, 14:24:00-000, 1002, 540, 462, 389, 1348.88, 387, 1349.50, 190
5, 14:25:00-000, 1028, 538, 490, 386, 1349.50, 405, 1349.46, 180
5, 14:26:00-000, 937, 440, 497, 354, 1348.43, 347, 1348.81, 163
5, 14:27:00-000, 0, 0, 0, 0, 0.00, 17, 1354.00, 137
5, 14:28:00-000, 976, 481, 495, 437, 1348.08, 403, 1349.04, 170
5, 14:29:00-000, 1044, 473, 571, 392, 1348.09, 390, 1348.48, 162
5, 14:30:00-000, 1053, 601, 452, 406, 1349.56, 425, 1350.68, 117
5, 14:31:00-000, 2, 2, 0, 46, 1345.50, 20, 1355.00, 153
5, 14:32:00-000, 1026, 531, 495, 421, 1348.90, 362, 1349.89, 158
5, 14:33:00-000, 1091, 535, 556, 418, 1348.77, 400, 1349.12, 187
5, 14:34:00-000, 973, 470, 503, 397, 1348.63, 415, 1349.23, 167
5, 14:35:00-000, 0, 0, 0, 0, 0.00, 25, 1356.00, 157
5, 14:36:00-000, 1047, 562, 485, 431, 1348.75, 402, 1349.42, 161
5, 14:37:00-000, 1033, 524, 509, 378, 1348.60, 394, 1349.20, 166
5, 14:38:00-000, 1075, 536, 539, 432, 1348.75, 437, 1349.65, 114
5, 14:39:00-000, 0, 0, 0, 39, 1344.69, 2, 1355.00, 157
5, 14:40:00-000, 1087, 536, 551, 427, 1349.75, 500, 1350.84, 175
5, 14:41:00-000, 988, 488, 500, 409, 1348.77, 377, 1349.07, 116
5, 14:42:00-000, 973, 552, 421, 411, 1349.19, 336, 1349.76, 140
5, 14:43:00-000, 0, 0, 0, 1, 1346.00, 12, 1356.00, 124
5, 14:44:00-000, 1012, 489, 523, 411, 1348.41, 439, 1349.99, 202
5, 14:45:00-000, 951, 461, 490, 344, 1348.21, 329, 1348.87, 135
5, 14:46:00-000, 1035, 521, 514, 421, 1348.27, 418, 1349.00, 123
5, 14:47:00-000, 0, 0, 0, 9, 1345.00, 44, 1356.00, 172
5, 14:48:00-000, 1053, 574, 479, 414, 1349.32, 396, 1350.05, 161
5, 14:49:00-000, 1093, 534, 559, 434, 1347.99, 410, 1348.62, 160
5, 14:50:00-000, 1070, 499, 571, 410, 1348.29, 411, 1349.56, 166
5, 14:51:00-000, 0, 0, 0, 37, 1344.81, 23, 1354.78, 167
5, 14:52:00-000, 1043, 537, 506, 414, 1348.61, 399, 1349.51, 185
5, 14:53:00-000, 983, 476, 507, 338, 1348.31, 388, 1348.92, 178
5, 14:54:00-000, 1055, 510, 545, 399, 1348.41, 408, 1348.71, 172
5, 14:55:00-000, 2, 0, 2, 4, 1344.00, 5, 1352.00, 176
5, 14:56:00-000, 1014, 464, 550, 420, 1347.62, 456, 1349.41, 173
5, 14:57:00-000, 1002, 506, 496, 354, 1348.49, 369, 1349.21, 136
5, 14:58:00-000, 1048, 521, 527, 452, 1347.48, 457, 1349.15, 136
5, 14:59:00-000, 1, 1, 0, 32, 1344.00, 32, 1356.37, 143
5, 15:00:00-000, 1104, 582, 522, 482, 1348.30, 415, 1349.16, 119
5, 15:01:00-000, 1054, 465, 589, 361, 1348.26, 393, 1348.52, 159
5, 15:02:00-000, 1082, 618, 464, 449, 1349.21, 378, 1349.87, 163
5, 15:03:00-000, 3, 1, 2, 28, 1345.68, 45, 1354.61, 166
5, 15:04:00-000, 1022, 525, 497, 366, 1348.57, 388, 1349.19, 195
5, 15:05:00-000, 945, 497, 448, 371, 1348.94, 379, 1349.61, 177
5, 15:06:00-000, 1029, 524, 505, 383, 1349.40, 436, 1350.81, 162
5, 15:07:00-000, 1, 1, 0, 1, 1351.00, 11, 1357.00, 149
5, 15:08:00-000, 1010, 503, 507, 385, 1348.57, 416, 1349.59, 151
5, 15:09:00-000, 946, 494, 452, 383, 1349.54, 376, 1350.27, 170
5, 15:10:00-000, 1083, 541, 542, 447, 1348.98, 422, 1349.33, 159
5, 15:11:00-000, 1, 0, 1, 0, 0.00, 31, 1355.71, 142
5, 15:12:00-000, 1033, 478, 555, 383, 1348.44, 400, 1349.33, 119
5, 15:13:00-000, 946, 485, 461, 362, 1349.30, 362, 1349.37, 176
5, 15:14:00-000, 1008, 520, 488, 434, 1348.93, 435, 1350.68, 150
5, 15:15:00-000, 5, 4, 1, 10, 1346.20, 30, 1355.96, 145
5, 15:16:00-000, 1139, 640, 499, 521, 1349.14, 464, 1350.14, 110
5, 15:17:00-000, 1038, 489, 549, 401, 1347.80, 440, 1348.08, 125
5, 15:18:00-000, 1051, 493, 558, 426, 1348.23, 464, 1349.03, 117
5, 15:19:00-000, 0, 0, 0, 26, 1343.92, 7, 1355.00, 141
5, 15:20:00-000, 1057, 492, 565, 427, 1348.11, 436, 1349.20, 110
5, 15:21:00-000, 1004, 477, 527, 374, 1348.44, 364, 1349.20, 127
5, 15:22:00-000, 1012, 502, 510, 429, 1348.23, 416, 1349.39, 163
5, 15:23:00-000, 0, 0, 0, 15, 1343.60, 0, 0.00, 170
5, 15:24:00-000, 1030, 544, 486, 440, 1348.70, 402, 1349.48, 106
5, 15:25:00-000, 1101, 576, 525, 456, 1348.47, 440, 1349.13, 182
5, 15:26:00-000, 998, 522, 476, 461, 1348.38, 386, 1348.93, 158
5, 15:27:00-000, 0, 0, 0, 25, 1343.28, 20, 1355.80, 101
5, 15:28:00-000, 1052, 506, 546, 367, 1348.00, 382, 1348.95, 119
5, 15:29:00-000, 964, 467, 497, 364, 1348.67, 392, 1349.74, 138
5, 15:30:00-000, 973, 490, 483, 363, 1348.41, 407, 1349.77, 215
5, 15:31:00-000, 3, 3, 0, 28, 1345.00, 37, 1355.26, 148
5, 15:32:00-000, 1063, 516, 547, 405, 1349.18, 427, 1350.23, 127
5, 15:33:00-000, 1066, 609, 457, 383, 1349.93, 383, 1350.43, 164
5, 15:34:00-000, 1014, 488, 526, 429, 1348.66, 442, 1350.20, 154
5, 15:35:00-000, 0, 0, 0, 23, 1345.00, 8, 1356.00, 186
5, 15:36:00-000, 987, 481, 506, 385, 1347.92, 418, 1349.57, 144
5, 15:37:00-000, 1044, 494, 550, 375, 1348.74, 410, 1349.42, 151
5, 15:38:00-000, 1027, 530, 497, 426, 1348.95, 405, 1349.85, 134
5, 15:39:00-000, 0, 0, 0, 21, 1345.76, 7, 1355.00, 158
5, 15:40:00-000, 1080, 518, 562, 346, 1348.87, 329, 1348.53, 158
5, 15:41:00-000, 1033, 525, 508, 337, 1349.04, 353, 1349.10, 229
5, 15:42:00-000, 986, 453, 533, 357, 1348.54, 401, 1348.84, 280
5, 15:43:00-000, 7, 0, 7, 0, 0.00, 7, 1351.00, 248
5, 15:44:00-000, 1002, 517, 485, 372, 1349.62, 374, 1348.57, 207
5, 15:45:00-000, 993, 517, 476, 405, 1349.01, 391, 1349.10, 178
5, 15:46:00-000, 1005, 506, 499, 361, 1349.31, 332, 1349.27, 175
5, 15:47:00-000, 1, 1, 0, 1, 1349.00, 18, 1354.00, 173
5, 15:48:00-000, 984, 502, 482, 368, 1348.90, 353, 1349.27, 210
5, 15:49:00-000, 1085, 585, 500, 412, 1348.94, 360, 1349.30, 257
5, 15:50:00-000, 1008, 478, 530, 348, 1348.20, 362, 1348.80, 168
5, 15:51:00-000, 0, 0, 0, 4, 1347.00, 40, 1353.60, 190
5, 15:52:00-000, 1033, 508, 525, 404, 1348.53, 383, 1349.03, 209
5, 15:53:00-000, 1003, 508, 495, 393, 1349.73, 363, 1349.21, 201
5, 15:54:00-000, 1181, 592, 589, 439, 1349.03, 427, 1348.89, 211
5, 15:55:00-000, 0, 0, 0, 0, 0.00, 0, 0.00, 172
5, 15:56:00-000, 1039, 547, 492, 446, 1349.17, 380, 1349.74, 233
5, 15:57:00-000, 1046, 537, 509, 371, 1348.74, 396, 1349.36, 186
5, 15:58:00-000, 947, 474, 473, 383, 1348.17, 371, 1349.11, 160
5, 15:59:00-000, 6, 2, 4, 2, 1348.00, 0, 0.00, 195
5, 16:00:00-000, 996, 556, 440, 420, 1349.39, 338, 1349.53, 173
5, 16:01:00-000, 975, 526, 449, 416, 1349.84, 318, 1349.85, 186
5, 16:02:00-000, 1056, 486, 570, 406, 1348.95, 401, 1349.76, 158
5, 16:03:00-000, 1, 0, 1, 28, 1345.00, 35, 1355.86, 153
5, 16:04:00-000, 1147, 605, 542, 448, 1348.84, 469, 1349.61, 150
5, 16:05:00-000, 966, 447, 519, 335, 1348.39, 380, 1348.61, 190
5, 16:06:00-000, 1002, 549, 453, 376, 1348.87, 377, 1350.15, 164
5, 16:07:00-000, 1, 1, 0, 22, 1346.14, 25, 1356.00, 172
5, 16:08:00-000, 970, 540, 430, 421, 1348.53, 328, 1349.48, 206
5, 16:09:00-000, 992, 443, 549, 324, 1347.73, 369, 1348.33, 128
5, 16:10:00-000, 999, 488, 511, 367, 1348.44, 470, 1349.62, 183
5, 16:11:00-000, 3, 0, 3, 8, 1345.75, 12, 1354.92, 160
5, 16:12:00-000, 919, 475, 444, 390, 1348.87, 337, 1349.86, 155
5, 16:13:00-000, 1030, 529, 501, 384, 1348.48, 410, 1349.43, 166
5, 16:14:00-000, 1074, 506, 568, 360, 1348.97, 398, 1349.17, 134
5, 16:15:00-000, 4, 4, 0, 32, 1345.50, 41, 1354.73, 163
5, 16:16:00-000, 994, 518, 476, 375, 1348.96, 383, 1350.12, 199
5, 16:17:00-000, 1074, 520, 554, 396, 1348.88, 383, 1349.33, 184
5, 16:18:00-000, 1031, 560, 471, 387, 1349.17, 370, 1350.38, 164
5, 16:19:00-000, 0, 0, 0, 21, 1346.00, 16, 1355.00, 239
5, 16:20:00-000, 980, 482, 498, 406, 1348.41, 415, 1349.66, 165
5, 16:21:00-000, 967, 447, 520, 373, 1348.65, 357, 1349.35, 172
5, 16:22:00-000, 945, 504, 441, 353, 1349.79, 367, 1351.16, 126
5, 16:23:00-000, 1, 1, 0, 28, 1346.18, 3, 1356.00, 147
5, 16:24:00-000, 1083, 516, 567, 458, 1348.02, 467, 1349.28, 151
5, 16:25:00-000, 1048, 486, 562, 376, 1348.97, 423, 1348.91, 143
5, 16:26:00-000, 1071, 595, 476, 492, 1348.86, 431, 1349.96, 161
5, 16:27:00-000, 3, 0, 3, 0, 0.00, 8, 1356.00, 136
5, 16:28:00-000, 1045, 510, 535, 426, 1348.01, 436, 1349.53, 143
5, 16:29:00-000, 1017, 525, 492, 402, 1348.67, 367, 1349.01, 124
6, 12:20:00-000, 6950, 3478, 3472, 1653, 1347.62, 1632, 1348.45, 0
6, 12:21:00-000, 0, 0, 0, 24, 1347.00, 75, 1354.00, 0
6, 12:22:00-000, 0, 0, 0, 151, 1346.00, 157, 1354.00, 0
6, 12:23:00-000, 0, 0, 0, 54, 1346.00, 33, 1354.90, 0
6, 12:24:00-000, 0, 0, 0, 18, 1346.00, 65, 1355.00, 0
6, 12:25:00-000, 0, 0, 0, 12, 1345.00, 157, 1355.00, 0
6, 12:26:00-000, 0, 0, 0, 46, 1345.00, 18, 1355.00, 0
6, 12:27:00-000, 0, 0, 0, 5, 1345.00, 26, 1356.00, 0
6, 12:28:00-000, 0, 0, 0, 51, 1345.00, 0, 0.00, 0
6, 12:29:00-000, 0, 0, 0, 7, 1345.00, 0, 0.00, 0
6, 12:30:00-000, 0, 0, 0, 2, 1345.00, 0, 0.00, 0
6, 12:32:00-000, 0, 0, 0, 0, 0.00, 12, 1356.00, 0
6, 12:33:00-000, 0, 0, 0, 0, 0.00, 14, 1356.00, 0
6, 12:34:00-000, 0, 0, 0, 76, 1345.00, 15, 1356.00, 0
6, 12:35:00-000, 0, 0, 0, 0, 0.00, 1, 1356.00, 0
6, 12:36:00-000, 0, 0, 0, 22, 1345.00, 28, 1356.00, 0
6, 12:37:00-000, 0, 0, 0, 0, 0.00, 10, 1356.00, 0
6, 12:38:00-000, 0, 0, 0, 0, 0.00, 33, 1356.00, 0
6, 12:39:00-000, 0, 0, 0, 0, 0.00, 45, 1356.00, 0
6, 12:40:00-000, 0, 0, 0, 0, 0.00, 20, 1356.00, 125
6, 12:41:00-000, 0, 0, 0, 0, 0.00, 0, 0.00, 133
6, 12:42:00-000, 0, 0, 0, 0, 0.00, 0, 0.00, 115
6, 12:43:00-000, 0, 0, 0, 4, 1344.00, 0, 0.00, 137
6, 12:44:00-000, 0, 0, 0, 0, 0.00, 0, 0.00, 132
6, 12:45:00-000, 0, 0, 0, 0, 0.00, 0, 0.00, 141
6, 12:46:00-000, 0, 0, 0, 0, 0.00, 0, 0.00, 128
6, 12:47:00-000, 0, 0, 0, 0, 0.00, 0, 0.00, 123
6, 12:48:00-000, 0, 0, 0, 0, 0.00, 0, 0.00, 124
6, 12:49:00-000, 0, 0, 0, 0, 0.00, 0, 0.00, 126
6, 12:50:00-000, 0, 0, 0, 0, 0.00, 8, 1357.00, 119
6, 12:51:00-000, 0, 0, 0, 19, 1344.00, 0, 0.00, 122
6, 12:52:00-000, 0, 0, 0, 17, 1344.00, 0, 0.00, 127
6, 12:53:00-000, 0, 0, 0, 0, 0.00, 0, 0.00, 106
6, 12:54:00-000, 0, 0, 0, 0, 0.00, 0, 0.00, 121
6, 12:55:00-000, 0, 0, 0, 0, 0.00, 0, 0.00, 124
6, 12:56:00-000, 0, 0, 0, 1, 1344.00, 0, 0.00, 100
6, 12:57:00-000, 0, 0, 0, 0, 0.00, 21, 1357.00, 108
6, 12:58:00-000, 0, 0, 0, 0, 0.00, 0, 0.00, 112
6, 12:59:00-000, 0, 0, 0, 0, 0.00, 0, 0.00, 95
6, 15:40:00-000, 6951, 3515, 3436, 1570, 1347.80, 1603, 1348.29, 0
6, 15:41:00-000, 0, 0, 0, 105, 1347.00, 60, 1353.00, 0
6, 15:42:00-000, 0, 0, 0, 12, 1346.00, 82, 1354.00, 0
6, 15:43:00-000, 0, 0, 0, 49, 1346.00, 46, 1354.00, 0
6, 15:44:00-000, 0, 0, 0, 131, 1346.00, 123, 1354.00, 0
6, 15:45:00-000, 0, 0, 0, 53, 1345.83, 0, 0.00, 0
6, 15:46:00-000, 0, 0, 0, 41, 1345.00, 0, 0.00, 0
6, 15:47:00-000, 0, 0, 0, 0, 0.00, 11, 1355.00, 0
6, 15:48:00-000, 0, 0, 0, 40, 1345.00, 0, 0.00, 0
6, 15:50:00-000, 0, 0, 0, 0, 0.00, 32, 1355.00, 0
6, 15:52:00-000, 0, 0, 0, 30, 1345.00, 24, 1355.00, 0
6, 15:53:00-000, 0, 0, 0, 29, 1345.00, 73, 1355.00, 0
6, 15:54:00-000, 0, 0, 0, 59, 1345.00, 39, 1355.00, 0
6, 15:55:00-000, 0, 0, 0, 46, 1345.00, 40, 1355.00, 0
6, 15:56:00-000, 0, 0, 0, 10, 1345.00, 44, 1355.70, 0
6, 15:57:00-000, 0, 0, 0, 0, 0.00, 28, 1356.00, 0
6, 15:58:00-000, 0, 0, 0, 35, 1344.00, 15, 1356.00, 0
6, 15:59:00-000, 0, 0, 0, 3, 1344.00, 17, 1356.00, 0
6, 16:00:00-000, 7, 5, 2, 3, 1349.33, 36, 1355.80, 124
6, 16:01:00-000, 1, 0, 1, 0, 0.00, 55, 1356.00, 107
6, 16:02:00-000, 0, 0, 0, 0, 0.00, 45, 1355.92, 135
6, 16:03:00-000, 0, 0, 0, 0, 0.00, 17, 1356.00, 112
6, 16:04:00-000, 0, 0, 0, 0, 0.00, 0, 0.00, 111
6, 16:05:00-000, 0, 0, 0, 13, 1344.00, 0, 0.00, 131
6, 16:06:00-000, 1, 1, 0, 78, 1344.02, 0, 0.00, 111
6, 16:07:00-000, 0, 0, 0, 0, 0.00, 0, 0.00, 117
6, 16:08:00-000, 0, 0, 0, 14, 1344.00, 0, 0.00, 92
6, 16:09:00-000, 0, 0, 0, 0, 0.00, 0, 0.00, 108
6, 16:10:00-000, 0, 0, 0, 0, 0.00, 0, 0.00, 112
6, 16:11:00-000, 0, 0, 0, 0, 0.00, 0, 0.00, 104
6, 16:12:00-000, 0, 0, 0, 0, 0.00, 0, 0.00, 117
6, 16:13:00-000, 0, 0, 0, 0, 0.00, 0, 0.00, 104
6, 16:14:00-000, 0, 0, 0, 0, 0.00, 0, 0.00, 100
6, 16:15:00-000, 0, 0, 0, 0, 0.00, 0, 0.00, 122
6, 16:16:00-000, 0, 0, 0, 0, 0.00, 0, 0.00, 118
6, 16:17:00-000, 0, 0, 0, 0, 0.00, 0, 0.00, 107
6, 16:18:00-000, 0, 0, 0, 0, 0.00, 0, 0.00, 118
6, 16:19:00-000, 0, 0, 0, 0, 0.00, 0, 0.00, 95
6, 16:20:00-000, 16, 8, 8, 3, 1349.00, 5, 1348.20, 2
6, 16:22:00-000, 0, 0, 0, 2, 1344.00, 0, 0.00, 0
6, 16:26:00-000, 0, 0, 0, 0, 0.00, 0, 0.00, 1
7, 09:07:00-000, 8293, 7000, 1293, 0, 0.00, 0, 0.00, 8293
7, 09:16:00-000, 1474, 1472, 2, 2, 1352.00, 2, 1350.00, 1470
7, 09:23:00-000, 16422, 10212, 6210, 0, 0.00, 0, 0.00, 16422
7, 09:29:00-000, 9053, 6919, 2134, 0, 0.00, 0, 0.00, 9041
7, 09:30:00-000, 7902, 4976, 2926, 90, 1348.78, 90, 1349.87, 7734
7, 09:32:00-000, 2888, 1528, 1360, 0, 0.00, 0, 0.00, 2888
7, 09:34:00-000, 1594, 682, 912, 3, 1348.00, 3, 1354.00, 1588
7, 09:49:00-000, 2541, 958, 1583, 1, 1349.00, 1, 1349.00, 2539
7, 09:50:00-000, 72, 12, 60, 0, 0.00, 0, 0.00, 72
7, 09:51:00-000, 7731, 3226, 4505, 0, 0.00, 0, 0.00, 7731
7, 09:54:00-000, 3305, 2144, 1161, 2, 1352.50, 7, 1351.29, 3296
7, 09:55:00-000, 6, 6, 0, 5, 1354.40, 0, 0.00, 1
7, 09:56:00-000, 7541, 1265, 6276, 0, 0.00, 0, 0.00, 7541
7, 09:58:00-000, 6145, 3584, 2561, 17, 1346.76, 34, 1352.00, 6094
7, 09:59:00-000, 9857, 5634, 4223, 17, 1351.76, 0, 0.00, 9840
7, 10:00:00-000, 8511, 5290, 3221, 0, 0.00, 0, 0.00, 7455
7, 10:01:00-000, 11129, 3408, 7721, 15, 1350.67, 15, 1350.20, 12148
7, 10:02:00-000, 3860, 1294, 2566, 0, 0.00, 0, 0.00, 3867
7, 10:03:00-000, 8238, 2999, 5239, 2, 1348.00, 2, 1350.00, 8234
7, 10:05:00-000, 1249, 9, 1240, 0, 0.00, 0, 0.00, 1249
7, 10:08:00-000, 8081, 3274, 4807, 10, 1348.60, 10, 1348.60, 8061
7, 10:09:00-000, 1658, 760, 898, 0, 0.00, 0, 0.00, 1658
7, 10:10:00-000, 5979, 2546, 3433, 18, 1348.33, 18, 1349.78, 5943
7, 10:11:00-000, 6454, 4284, 2170, 34, 1349.03, 45, 1351.78, 6375
7, 10:12:00-000, 11069, 5243, 5826, 72, 1351.38, 61, 1351.55, 10936
7, 10:13:00-000, 8155, 2295, 5860, 0, 0.00, 0, 0.00, 8155
7, 10:14:00-000, 1023, 13, 1010, 0, 0.00, 0, 0.00, 1023
7, 10:15:00-000, 10874, 7450, 3424, 0, 0.00, 0, 0.00, 10874
7, 10:16:00-000, 3868, 1968, 1900, 1, 1352.00, 1, 1350.00, 3866
7, 10:17:00-000, 5105, 1358, 3747, 0, 0.00, 0, 0.00, 5105
7, 10:20:00-000, 1384, 24, 1360, 9, 1353.56, 9, 1352.00, 1366
7, 10:21:00-000, 2977, 595, 2382, 112, 1349.56, 112, 1349.26, 2753
7, 10:22:00-000, 4984, 2478, 2506, 0, 0.00, 0, 0.00, 4984
7, 10:23:00-000, 16099, 11082, 5017, 0, 0.00, 0, 0.00, 16099
7, 10:24:00-000, 3854, 2441, 1413, 66, 1349.46, 28, 1351.11, 3760
7, 10:25:00-000, 18464, 9905, 8559, 0, 0.00, 38, 1345.42, 17697
7, 10:26:00-000, 9862, 5583, 4279, 29, 1354.58, 29, 1351.86, 10533
7, 10:27:00-000, 10218, 6038, 4180, 0, 0.00, 0, 0.00, 10218
7, 10:28:00-000, 4005, 1540, 2465, 0, 0.00, 0, 0.00, 4005
7, 10:29:00-000, 10202, 3431, 6771, 0, 0.00, 0, 0.00, 10202
7, 10:30:00-000, 8734, 3720, 5014, 11, 1348.73, 14, 1349.64, 8709
7, 10:31:00-000, 1187, 1183, 4, 3, 1347.00, 0, 0.00, 1184
7, 10:32:00-000, 13597, 8071, 5526, 36, 1346.30, 36, 1348.58, 13525
7, 10:33:00-000, 9571, 2263, 7308, 1, 1349.00, 1, 1350.00, 9569
7, 10:34:00-000, 16514, 10975, 5539, 4, 1348.00, 4, 1347.00, 16506
7, 10:35:00-000, 12095, 7641, 4454, 25, 1350.88, 25, 1350.00, 12045
7, 10:36:00-000, 6313, 2916, 3397, 15, 1351.60, 15, 1351.47, 6283
7, 10:37:00-000, 3481, 2195, 1286, 4, 1349.00, 4, 1354.00, 3473
7, 10:38:00-000, 14335, 6787, 7548, 8, 1350.88, 8, 1350.62, 14319
7, 10:39:00-000, 2740, 1858, 882, 0, 0.00, 0, 0.00, 2740
7, 10:40:00-000, 5940, 5200, 740, 73, 1347.87, 73, 1348.91, 5794
7, 10:41:00-000, 5904, 5023, 881, 0, 0.00, 0, 0.00, 5904
7, 10:42:00-000, 975, 970, 5, 0, 0.00, 0, 0.00, 975
7, 10:45:00-000, 1234, 1230, 4, 0, 0.00, 0, 0.00, 1234
7, 10:46:00-000, 7472, 3648, 3824, 6, 1353.33, 6, 1351.33, 7460
7, 10:47:00-000, 6096, 5019, 1077, 3, 1349.00, 3, 1350.00, 4527
7, 10:48:00-000, 4689, 2548, 2141, 5, 1352.00, 5, 1351.00, 4937
7, 10:49:00-000, 8243, 4963, 3280, 7, 1350.86, 7, 1350.14, 9534
7, 10:50:00-000, 5320, 3327, 1993, 0, 0.00, 0, 0.00, 5320
7, 10:52:00-000, 11616, 7396, 4220, 6, 1353.17, 6, 1352.00, 11604
7, 10:53:00-000, 9625, 6965, 2660, 3, 1350.00, 3, 1351.00, 9551
7, 10:54:00-000, 8008, 5730, 2278, 36, 1348.06, 36, 1348.47, 8004
7, 10:55:00-000, 9923, 3981, 5942, 0, 0.00, 0, 0.00, 9923
7, 10:56:00-000, 13021, 6246, 6775, 20, 1348.15, 20, 1353.05, 12981
7, 10:57:00-000, 6673, 1148, 5525, 13, 1350.54, 13, 1352.00, 5358
7, 10:58:00-000, 3352, 1184, 2168, 28, 1349.25, 28, 1352.10, 4585
7, 11:00:00-000, 4164, 4080, 84, 69, 1347.66, 45, 1350.46, 4050
7, 11:01:00-000, 8716, 5363, 3353, 2, 1350.50, 26, 1347.96, 8688
7, 11:02:00-000, 7276, 5557, 1719, 8, 1351.25, 8, 1351.00, 7260
7, 11:04:00-000, 3435, 2549, 886, 49, 1353.04, 45, 1346.89, 3341
7, 11:05:00-000, 5861, 4463, 1398, 4, 1351.00, 8, 1347.62, 5849
7, 11:06:00-000, 20550, 10411, 10139, 24, 1346.42, 24, 1347.16, 20502
7, 11:07:00-000, 10416, 2559, 7857, 6, 1348.00, 6, 1346.67, 10404
7, 11:08:00-000, 5937, 3297, 2640, 7, 1349.86, 7, 1351.00, 5923
7, 11:09:00-000, 743, 740, 3, 0, 0.00, 0, 0.00, 743
7, 11:10:00-000, 2652, 1549, 1103, 0, 0.00, 0, 0.00, 2652
7, 11:15:00-000, 21701, 11024, 10677, 0, 0.00, 0, 0.00, 20602
7, 11:16:00-000, 5316, 1913, 3403, 7, 1348.28, 7, 1349.71, 6401
7, 11:17:00-000, 12314, 5830, 6484, 5, 1348.00, 5, 1349.80, 12297
7, 11:18:00-000, 3675, 35, 3640, 0, 0.00, 0, 0.00, 3682
7, 11:19:00-000, 8454, 5512, 2942, 1, 1351.00, 1, 1350.00, 8452
7, 11:20:00-000, 3215, 2971, 244, 7, 1351.14, 7, 1348.86, 3201
7, 11:21:00-000, 5821, 2911, 2910, 3, 1348.00, 3, 1347.33, 5815
7, 11:22:00-000, 6316, 3725, 2591, 75, 1353.55, 75, 1352.00, 6166
7, 11:23:00-000, 5090, 3731, 1359, 0, 0.00, 0, 0.00, 5090
7, 11:24:00-000, 11529, 6061, 5468, 23, 1347.82, 30, 1350.03, 11476
7, 11:25:00-000, 8, 8, 0, 7, 1350.57, 0, 0.00, 1
7, 11:27:00-000, 12024, 7861, 4163, 26, 1348.07, 26, 1351.31, 11972
7, 11:28:00-000, 8901, 7377, 1524, 4, 1349.75, 4, 1349.75, 8893
7, 11:29:00-000, 4845, 1726, 3119, 24, 1349.58, 24, 1352.25, 4797
7, 11:30:00-000, 5063, 1768, 3295, 0, 0.00, 0, 0.00, 5063
7, 11:31:00-000, 13137, 10749, 2388, 0, 0.00, 0, 0.00, 13137
7, 11:32:00-000, 14039, 3818, 10221, 0, 0.00, 0, 0.00, 14039
7, 11:33:00-000, 9586, 7305, 2281, 21, 1350.10, 21, 1349.52, 9544
7, 11:34:00-000, 6953, 3412, 3541, 6, 1350.67, 6, 1349.00, 6941
7, 11:35:00-000, 3661, 2172, 1489, 3, 1349.00, 3, 1349.00, 3655
7, 11:36:00-000, 6796, 2936, 3860, 0, 0.00, 0, 0.00, 6796
7, 11:37:00-000, 1419, 39, 1380, 13, 1352.85, 13, 1351.00, 1393
7, 11:38:00-000, 20064, 12211, 7853, 9, 1351.00, 8, 1351.00, 20047
7, 11:39:00-000, 21453, 11833, 9620, 1, 1349.00, 2, 1349.50, 20676
7, 11:40:00-000, 130, 0, 130, 0, 0.00, 0, 0.00, 904
7, 11:41:00-000, 4541, 1081, 3460, 0, 0.00, 0, 0.00, 4541
7, 11:42:00-000, 10633, 5567, 5066, 7, 1348.57, 7, 1349.86, 10619
7, 11:43:00-000, 8429, 2196, 6233, 0, 0.00, 0, 0.00, 6966
7, 11:44:00-000, 5529, 3263, 2266, 41, 1349.32, 42, 1348.52, 6909
7, 11:45:00-000, 8448, 3416, 5032, 20, 1350.30, 19, 1348.79, 8409
7, 11:46:00-000, 3849, 2486, 1363, 0, 0.00, 0, 0.00, 3849
7, 11:47:00-000, 4272, 1142, 3130, 0, 0.00, 0, 0.00, 4272
7, 11:48:00-000, 9575, 4628, 4947, 7, 1356.00, 7, 1352.00, 9561
7, 11:49:00-000, 3731, 1583, 2148, 20, 1350.75, 20, 1352.00, 3691
7, 11:50:00-000, 15065, 7439, 7626, 13, 1354.69, 13, 1351.15, 15039
7, 11:51:00-000, 7616, 2640, 4976, 0, 0.00, 0, 0.00, 7616
7, 11:52:00-000, 11427, 7490, 3937, 0, 0.00, 0, 0.00, 10575
7, 11:53:00-000, 8368, 3872, 4496, 2, 1349.00, 2, 1347.00, 9216
7, 11:54:00-000, 11455, 7791, 3664, 8, 1345.00, 8, 1350.75, 11439
7, 11:55:00-000, 7120, 5308, 1812, 25, 1348.00, 25, 1348.36, 7070
7, 11:56:00-000, 6941, 4662, 2279, 9, 1345.89, 9, 1346.55, 6050
7, 11:57:00-000, 4031, 1070, 2961, 3, 1351.00, 3, 1349.00, 3970
7, 11:58:00-000, 13633, 9246, 4387, 4, 1350.50, 4, 1352.00, 14553
7, 12:00:00-000, 9741, 4954, 4787, 1, 1348.00, 1, 1349.00, 9723
7, 12:01:00-000, 14936, 9114, 5822, 26, 1349.19, 26, 1348.04, 14900
7, 12:02:00-000, 10967, 5542, 5425, 29, 1350.89, 48, 1352.10, 10890
7, 12:03:00-000, 8263, 1809, 6454, 21, 1352.81, 2, 1350.00, 8240
7, 12:04:00-000, 10721, 5686, 5035, 10, 1350.20, 7, 1351.57, 10704
7, 12:05:00-000, 3797, 2597, 1200, 17, 1349.47, 20, 1351.50, 3760
7, 12:06:00-000, 6791, 4669, 2122, 29, 1349.17, 29, 1350.03, 6733
7, 12:08:00-000, 249, 9, 240, 0, 0.00, 0, 0.00, 249
7, 12:09:00-000, 7153, 5066, 2087, 3, 1349.00, 3, 1349.00, 7147
7, 12:10:00-000, 12469, 6546, 5923, 1, 1348.00, 1, 1350.00, 12467
7, 12:11:00-000, 12110, 5505, 6605, 1, 1353.00, 3, 1350.00, 12106
7, 12:12:00-000, 11092, 6079, 5013, 23, 1346.87, 1, 1350.00, 11068
7, 12:13:00-000, 10760, 5221, 5539, 0, 0.00, 20, 1348.80, 10740
7, 12:14:00-000, 839, 820, 19, 16, 1345.81, 16, 1348.75, 807
7, 12:16:00-000, 9666, 3548, 6118, 0, 0.00, 0, 0.00, 9666
7, 12:18:00-000, 8271, 6855, 1416, 7, 1348.14, 7, 1350.57, 8257
7, 12:19:00-000, 10275, 5177, 5098, 0, 0.00, 0, 0.00, 10275
7, 12:21:00-000, 4322, 3356, 966, 0, 0.00, 0, 0.00, 4322
7, 12:24:00-000, 1494, 1492, 2, 2, 1354.00, 2, 1353.00, 1490
7, 12:25:00-000, 1160, 1160, 0, 0, 0.00, 0, 0.00, 1160
7, 12:28:00-000, 4867, 2424, 2443, 0, 0.00, 0, 0.00, 3478
7, 12:29:00-000, 10602, 2597, 8005, 0, 0.00, 0, 0.00, 11991
7, 12:30:00-000, 5647, 32, 5615, 5, 1346.80, 5, 1347.00, 5637
7, 12:32:00-000, 4773, 1385, 3388, 0, 0.00, 0, 0.00, 4773
7, 12:33:00-000, 2239, 8, 2231, 1, 1349.00, 1, 1349.00, 2237
7, 12:36:00-000, 874, 14, 860, 14, 1351.86, 14, 1352.00, 846
7, 12:37:00-000, 4106, 1256, 2850, 16, 1348.88, 16, 1352.25, 4074
7, 12:38:00-000, 4120, 1332, 2788, 0, 0.00, 0, 0.00, 4120
7, 12:39:00-000, 1553, 1550, 3, 0, 0.00, 0, 0.00, 1553
7, 12:40:00-000, 2048, 1183, 865, 0, 0.00, 0, 0.00, 2048
7, 12:42:00-000, 3849, 59, 3790, 0, 0.00, 0, 0.00, 2980
7, 12:43:00-000, 2157, 1268, 889, 0, 0.00, 0, 0.00, 3026
7, 12:44:00-000, 3432, 1701, 1731, 10, 1350.00, 10, 1352.00, 3412
7, 12:47:00-000, 5189, 4689, 500, 10, 1348.50, 10, 1352.50, 5169
7, 12:48:00-000, 1331, 115, 1216, 13, 1350.77, 12, 1349.50, 1306
7, 12:49:00-000, 1, 0, 1, 0, 0.00, 1, 1345.00, 0
7, 12:50:00-000, 901, 7, 894, 4, 1350.00, 4, 1346.75, 893
7, 12:52:00-000, 18368, 4318, 14050, 4, 1353.25, 4, 1352.00, 17240
7, 12:53:00-000, 0, 0, 0, 0, 0.00, 0, 0.00, 1120
7, 12:54:00-000, 1353, 1340, 13, 0, 0.00, 0, 0.00, 1353
7, 12:55:00-000, 9520, 4972, 4548, 2, 1349.00, 2, 1348.00, 9516
7, 12:56:00-000, 2126, 2120, 6, 0, 0.00, 0, 0.00, 2126
7, 12:57:00-000, 1427, 7, 1420, 0, 0.00, 0, 0.00, 1427
7, 13:01:00-000, 7505, 1644, 5861, 16, 1350.81, 16, 1350.37, 7473
7, 13:02:00-000, 915, 5, 910, 0, 0.00, 0, 0.00, 915
7, 13:03:00-000, 5227, 1800, 3427, 4, 1349.50, 4, 1348.75, 5219
7, 13:04:00-000, 13323, 7182, 6141, 14, 1348.86, 14, 1349.57, 13295
7, 13:05:00-000, 5652, 5610, 42, 0, 0.00, 0, 0.00, 5652
7, 13:06:00-000, 798, 793, 5, 3, 1357.00, 3, 1351.00, 792
7, 13:07:00-000, 995, 14, 981, 1, 1350.00, 1, 1347.00, 993
7, 13:08:00-000, 2668, 2651, 17, 1, 1349.00, 1, 1352.00, 2666
7, 13:09:00-000, 14956, 5504, 9452, 84, 1352.38, 79, 1352.33, 14793
7, 13:10:00-000, 4430, 2181, 2249, 3, 1349.00, 8, 1349.00, 4419
7, 13:11:00-000, 846, 16, 830, 3, 1356.00, 3, 1352.00, 840
7, 13:12:00-000, 1859, 19, 1840, 3, 1352.00, 3, 1353.00, 1853
7, 13:13:00-000, 2668, 8, 2660, 0, 0.00, 0, 0.00, 1350
7, 13:14:00-000, 5158, 3677, 1481, 2, 1349.00, 2, 1346.00, 6472
7, 13:15:00-000, 12431, 6036, 6395, 1, 1350.00, 1, 1349.00, 12429
7, 13:16:00-000, 4028, 2724, 1304, 1, 1352.00, 1, 1351.00, 4026
7, 13:17:00-000, 8084, 3834, 4250, 0, 0.00, 0, 0.00, 8084
7, 13:18:00-000, 4639, 2393, 2246, 0, 0.00, 0, 0.00, 3709
7, 13:19:00-000, 19198, 7447, 11751, 7, 1349.71, 7, 1352.14, 20113
7, 13:20:00-000, 4216, 3396, 820, 8, 1354.00, 8, 1351.00, 4201
7, 13:21:00-000, 6884, 6327, 557, 0, 0.00, 0, 0.00, 6884
7, 13:22:00-000, 2547, 314, 2233, 4, 1350.00, 4, 1351.25, 2539
7, 13:23:00-000, 6017, 3795, 2222, 2, 1353.00, 2, 1351.00, 6013
7, 13:24:00-000, 12360, 8195, 4165, 10, 1353.50, 10, 1351.80, 12340
7, 13:25:00-000, 3787, 2444, 1343, 3, 1350.00, 3, 1351.00, 3781
7, 13:26:00-000, 2676, 2307, 369, 8, 1352.50, 8, 1350.50, 2660
7, 13:27:00-000, 23183, 12352, 10831, 5, 1351.80, 5, 1350.00, 22379
7, 13:28:00-000, 1777, 729, 1048, 16, 1350.31, 18, 1349.83, 2537
7, 13:29:00-000, 8388, 5169, 3219, 2, 1352.00, 0, 0.00, 8386
7, 13:32:00-000, 3654, 2961, 693, 18, 1348.89, 18, 1349.33, 3618
7, 13:33:00-000, 13404, 4047, 9357, 18, 1346.78, 18, 1346.72, 13368
7, 13:34:00-000, 6255, 431, 5824, 10, 1352.20, 10, 1350.40, 6235
7, 13:36:00-000, 6257, 3283, 2974, 39, 1347.72, 35, 1347.54, 6183
7, 13:37:00-000, 1500, 663, 837, 10, 1351.50, 14, 1349.86, 1476
7, 13:38:00-000, 1084, 1070, 14, 0, 0.00, 0, 0.00, 1084
7, 13:39:00-000, 4110, 3107, 1003, 20, 1352.20, 20, 1352.20, 3086
7, 13:40:00-000, 11032, 6107, 4925, 10, 1348.80, 10, 1349.80, 11996
7, 13:41:00-000, 6037, 3551, 2486, 9, 1352.78, 9, 1351.22, 6019
7, 13:42:00-000, 16513, 7184, 9329, 11, 1349.00, 13, 1349.00, 16489
7, 13:43:00-000, 11428, 6145, 5283, 5, 1350.20, 3, 1348.00, 11416
7, 13:44:00-000, 5246, 380, 4866, 10, 1348.10, 10, 1349.40, 5230
7, 13:45:00-000, 15901, 12025, 3876, 0, 0.00, 2, 1350.00, 15899
7, 13:46:00-000, 9611, 4329, 5282, 10, 1350.80, 8, 1351.25, 9593
7, 13:47:00-000, 2846, 1550, 1296, 0, 0.00, 0, 0.00, 2846
7, 13:48:00-000, 3640, 2134, 1506, 0, 0.00, 0, 0.00, 3640
7, 13:49:00-000, 1304, 1297, 7, 7, 1352.00, 7, 1352.00, 1290
7, 13:50:00-000, 2566, 1473, 1093, 0, 0.00, 0, 0.00, 2566
7, 13:51:00-000, 16550, 8068, 8482, 1, 1352.00, 2, 1350.50, 15815
7, 13:52:00-000, 3921, 975, 2946, 1, 1348.00, 0, 0.00, 4652
7, 13:53:00-000, 11884, 6359, 5525, 14, 1354.86, 14, 1350.43, 11856
7, 13:54:00-000, 3923, 1181, 2742, 21, 1347.86, 23, 1350.65, 3879
7, 13:55:00-000, 5338, 3805, 1533, 2, 1353.00, 0, 0.00, 5336
7, 13:56:00-000, 23229, 11126, 12103, 3, 1351.33, 3, 1352.00, 21652
7, 13:57:00-000, 13279, 7607, 5672, 5, 1350.00, 5, 1346.60, 14123
7, 13:58:00-000, 6964, 4063, 2901, 2, 1350.00, 2, 1349.00, 7677
7, 13:59:00-000, 4679, 3950, 729, 0, 0.00, 0, 0.00, 4679
7, 14:00:00-000, 14289, 6295, 7994, 6, 1347.67, 3, 1352.00, 14280
7, 14:01:00-000, 9178, 3922, 5256, 40, 1349.70, 53, 1350.47, 9085
7, 14:02:00-000, 3580, 80, 3500, 47, 1351.06, 47, 1352.00, 3486
7, 14:03:00-000, 7925, 3410, 4515, 10, 1356.00, 0, 0.00, 7915
7, 14:04:00-000, 5804, 2053, 3751, 2, 1349.00, 2, 1346.00, 5800
7, 14:05:00-000, 13933, 10509, 3424, 4, 1347.50, 4, 1350.00, 13925
7, 14:06:00-000, 4501, 2198, 2303, 28, 1346.21, 19, 1350.68, 4454
7, 14:07:00-000, 11641, 7936, 3705, 0, 0.00, 9, 1348.56, 10734
7, 14:08:00-000, 15406, 9842, 5564, 5, 1348.00, 5, 1347.80, 16294
7, 14:09:00-000, 19426, 6323, 13103, 33, 1348.18, 33, 1350.54, 19360
7, 14:10:00-000, 900, 884, 16, 4, 1352.75, 4, 1350.00, 892
7, 14:11:00-000, 2718, 1247, 1471, 27, 1346.67, 20, 1348.35, 2671
7, 14:12:00-000, 13489, 7246, 6243, 35, 1347.77, 27, 1347.85, 13427
7, 14:13:00-000, 10592, 7836, 2756, 15, 1351.00, 37, 1347.89, 9733
7, 14:14:00-000, 6282, 3840, 2442, 20, 1352.45, 13, 1351.31, 7056
7, 14:16:00-000, 8793, 4796, 3997, 4, 1351.25, 4, 1351.00, 8785
7, 14:17:00-000, 2684, 679, 2005, 15, 1347.80, 15, 1348.87, 2654
7, 14:18:00-000, 11945, 5335, 6610, 17, 1348.06, 17, 1351.35, 11911
7, 14:19:00-000, 6646, 5131, 1515, 4, 1349.00, 4, 1349.75, 6638
7, 14:20:00-000, 12603, 3105, 9498, 17, 1350.53, 17, 1351.41, 11749
7, 14:21:00-000, 16464, 9090, 7374, 5, 1349.80, 9, 1350.78, 17270
7, 14:22:00-000, 20243, 10228, 10015, 11, 1349.36, 6, 1350.50, 20226
7, 14:23:00-000, 13054, 7980, 5074, 10, 1351.30, 12, 1350.50, 13032
7, 14:24:00-000, 3593, 2729, 864, 9, 1352.44, 8, 1351.88, 3576
7, 14:25:00-000, 19025, 8496, 10529, 40, 1346.35, 40, 1347.07, 18945
7, 14:26:00-000, 18812, 7761, 11051, 19, 1347.42, 18, 1349.44, 18775
7, 14:27:00-000, 9520, 4098, 5422, 33, 1347.06, 34, 1349.50, 9453
7, 14:28:00-000, 14588, 6526, 8062, 41, 1348.29, 41, 1350.53, 14501
7, 14:29:00-000, 7287, 3023, 4264, 3, 1349.67, 3, 1350.00, 7286
7, 14:30:00-000, 6082, 986, 5096, 10, 1350.70, 10, 1350.20, 4902
7, 14:31:00-000, 15096, 9783, 5313, 0, 0.00, 0, 0.00, 16256
7, 14:32:00-000, 7495, 5905, 1590, 85, 1351.04, 83, 1351.59, 7327
7, 14:33:00-000, 6455, 1841, 4614, 4, 1349.50, 6, 1347.33, 6445
7, 14:34:00-000, 10172, 8228, 1944, 18, 1347.89, 20, 1350.20, 10134
7, 14:35:00-000, 8066, 6657, 1409, 18, 1352.22, 16, 1350.50, 6552
7, 14:36:00-000, 2711, 1747, 964, 11, 1353.00, 11, 1351.18, 4169
7, 14:37:00-000, 5856, 926, 4930, 11, 1351.36, 11, 1351.82, 5834
7, 14:38:00-000, 11758, 6036, 5722, 19, 1346.10, 19, 1351.42, 11720
7, 14:39:00-000, 8042, 2815, 5227, 5, 1352.00, 5, 1351.80, 8030
7, 14:40:00-000, 101, 91, 10, 1, 1356.00, 1, 1350.00, 101
7, 14:42:00-000, 21089, 12138, 8951, 5, 1351.00, 5, 1347.40, 21079
7, 14:43:00-000, 18543, 11678, 6865, 22, 1352.54, 24, 1352.04, 17390
7, 14:44:00-000, 5207, 2894, 2313, 6, 1352.17, 4, 1353.00, 6304
7, 14:45:00-000, 9374, 4882, 4492, 22, 1349.54, 25, 1349.72, 8287
7, 14:46:00-000, 20047, 10939, 9108, 11, 1349.00, 8, 1352.75, 21068
7, 14:47:00-000, 12139, 4351, 7788, 8, 1352.75, 8, 1352.00, 12117
7, 14:48:00-000, 9453, 3386, 6067, 0, 0.00, 2, 1350.00, 8622
7, 14:49:00-000, 10940, 8149, 2791, 2, 1350.00, 5, 1351.00, 11753
7, 14:50:00-000, 3689, 1457, 2232, 12, 1350.08, 7, 1348.14, 3685
7, 14:51:00-000, 9035, 3922, 5113, 25, 1350.36, 25, 1350.24, 8985
7, 14:52:00-000, 3308, 1060, 2248, 62, 1350.27, 62, 1350.88, 3184
7, 14:53:00-000, 1384, 4, 1380, 4, 1354.00, 4, 1352.00, 1376
7, 14:54:00-000, 6095, 5153, 942, 13, 1348.62, 13, 1347.54, 6069
7, 14:55:00-000, 10230, 5598, 4632, 3, 1349.00, 3, 1350.00, 10224
7, 14:56:00-000, 1953, 1236, 717, 0, 0.00, 0, 0.00, 1593
7, 14:57:00-000, 2422, 2400, 22, 0, 0.00, 0, 0.00, 2782
7, 14:58:00-000, 5901, 4603, 1298, 49, 1351.36, 49, 1352.18, 5803
7, 14:59:00-000, 854, 844, 10, 4, 1353.50, 4, 1348.00, 846
7, 15:00:00-000, 15240, 4635, 10605, 10, 1349.10, 10, 1348.80, 15220
7, 15:01:00-000, 14961, 8263, 6698, 2, 1353.00, 3, 1350.67, 13973
7, 15:02:00-000, 10443, 5550, 4893, 24, 1350.12, 23, 1351.17, 11379
7, 15:03:00-000, 4316, 1972, 2344, 9, 1354.00, 9, 1350.44, 4298
7, 15:04:00-000, 8965, 5331, 3634, 1, 1350.00, 1, 1350.00, 8963
7, 15:05:00-000, 7524, 4002, 3522, 0, 0.00, 0, 0.00, 7524
7, 15:06:00-000, 1274, 1260, 14, 2, 1348.00, 2, 1355.00, 1270
7, 15:08:00-000, 803, 18, 785, 0, 0.00, 0, 0.00, 803
7, 15:09:00-000, 10514, 7933, 2581, 15, 1349.00, 15, 1347.73, 9785
7, 15:10:00-000, 8353, 1995, 6358, 22, 1347.36, 13, 1350.69, 9017
7, 15:11:00-000, 2937, 1750, 1187, 0, 0.00, 9, 1348.33, 2928
7, 15:12:00-000, 16502, 9294, 7208, 5, 1348.80, 5, 1349.80, 16492
7, 15:13:00-000, 11566, 5495, 6071, 5, 1350.00, 5, 1353.00, 11556
7, 15:14:00-000, 17072, 9058, 8014, 36, 1353.27, 56, 1351.32, 16980
7, 15:15:00-000, 1614, 370, 1244, 20, 1355.55, 0, 0.00, 1594
7, 15:16:00-000, 5064, 3703, 1361, 0, 0.00, 0, 0.00, 5064
7, 15:17:00-000, 2598, 28, 2570, 0, 0.00, 0, 0.00, 2598
7, 15:18:00-000, 6774, 4321, 2453, 13, 1354.62, 13, 1350.85, 6748
7, 15:19:00-000, 3472, 2615, 857, 0, 0.00, 0, 0.00, 3472
7, 15:20:00-000, 11019, 8443, 2576, 5, 1350.80, 8, 1350.25, 9982
7, 15:21:00-000, 19193, 6248, 12945, 7, 1349.71, 4, 1346.25, 20206
7, 15:22:00-000, 2437, 21, 2416, 14, 1347.36, 14, 1344.28, 2409
7, 15:23:00-000, 3481, 2562, 919, 10, 1348.00, 11, 1349.27, 3460
7, 15:24:00-000, 2471, 1135, 1336, 9, 1349.67, 8, 1351.38, 2454
7, 15:25:00-000, 8380, 3367, 5013, 19, 1346.89, 19, 1350.74, 8342
7, 15:26:00-000, 7714, 5703, 2011, 22, 1351.00, 23, 1351.00, 7669
7, 15:27:00-000, 5885, 4652, 1233, 10, 1345.80, 9, 1348.00, 5866
7, 15:28:00-000, 6997, 2034, 4963, 20, 1347.10, 20, 1350.55, 6957
7, 15:29:00-000, 7308, 1776, 5532, 18, 1349.61, 18, 1349.39, 6074
7, 15:30:00-000, 7761, 2847, 4914, 10, 1350.50, 16, 1351.38, 8933
7, 15:31:00-000, 3829, 1978, 1851, 21, 1350.47, 15, 1349.20, 3793
7, 15:32:00-000, 10337, 7423, 2914, 30, 1350.93, 30, 1351.97, 10277
7, 15:33:00-000, 1137, 17, 1120, 1, 1353.00, 1, 1352.00, 1135
7, 15:35:00-000, 6242, 4456, 1786, 0, 0.00, 0, 0.00, 6242
7, 15:36:00-000, 6913, 3806, 3107, 11, 1350.54, 13, 1351.77, 6889
7, 15:37:00-000, 3591, 2792, 799, 2, 1356.00, 0, 0.00, 3589
7, 15:38:00-000, 12571, 8126, 4445, 12, 1349.50, 11, 1350.18, 12548
7, 15:39:00-000, 3454, 1858, 1596, 2, 1351.00, 3, 1346.00, 3449
7, 15:40:00-000, 2151, 1471, 680, 39, 1349.74, 26, 1350.65, 2086
7, 15:41:00-000, 2540, 2491, 49, 1, 1351.00, 17, 1347.70, 2522
7, 15:42:00-000, 2737, 2011, 726, 7, 1352.57, 4, 1351.00, 2726
7, 15:43:00-000, 3496, 1000, 2496, 2, 1348.00, 2, 1350.00, 3492
7, 15:44:00-000, 2358, 928, 1430, 0, 0.00, 0, 0.00, 2358
7, 15:45:00-000, 6707, 2241, 4466, 0, 0.00, 0, 0.00, 6707
7, 15:46:00-000, 6342, 4529, 1813, 11, 1350.82, 31, 1351.58, 6300
7, 15:47:00-000, 6552, 2359, 4193, 20, 1353.80, 0, 0.00, 6532
7, 15:48:00-000, 5608, 2684, 2924, 36, 1347.36, 36, 1346.83, 5536
7, 15:49:00-000, 4716, 3022, 1694, 15, 1351.40, 15, 1350.13, 4686
7, 15:50:00-000, 7343, 3823, 3520, 4, 1349.00, 4, 1349.00, 7335
7, 15:51:00-000, 2955, 1994, 961, 0, 0.00, 0, 0.00, 2955
7, 15:52:00-000, 4444, 1916, 2528, 10, 1346.60, 5, 1346.00, 4429
7, 15:53:00-000, 5, 0, 5, 0, 0.00, 5, 1348.80, 0
7, 15:54:00-000, 8298, 5987, 2311, 10, 1352.70, 10, 1351.00, 8278
7, 15:55:00-000, 952, 940, 12, 12, 1346.42, 12, 1350.42, 928
7, 15:56:00-000, 787, 780, 7, 0, 0.00, 0, 0.00, 787
7, 15:58:00-000, 1528, 604, 924, 0, 0.00, 2, 1351.00, 1526
7, 15:59:00-000, 2369, 1189, 1180, 6, 1353.67, 4, 1351.00, 2359
7, 16:00:00-000, 108, 8, 100, 0, 0.00, 0, 0.00, 108
7, 16:01:00-000, 3583, 2129, 1454, 1, 1349.00, 1, 1349.00, 3580
7, 16:02:00-000, 4199, 2885, 1314, 15, 1352.00, 15, 1352.00, 4170
7, 16:03:00-000, 2384, 24, 2360, 0, 0.00, 0, 0.00, 2384
7, 16:04:00-000, 4040, 10, 4030, 0, 0.00, 0, 0.00, 4038
7, 16:05:00-000, 3756, 2490, 1266, 0, 0.00, 0, 0.00, 3758
7, 16:06:00-000, 5980, 1636, 4344, 15, 1350.86, 17, 1350.41, 5948
7, 16:07:00-000, 2518, 18, 2500, 2, 1350.00, 0, 0.00, 1726
7, 16:08:00-000, 10913, 4288, 6625, 0, 0.00, 1, 1350.00, 11702
7, 16:09:00-000, 1132, 1131, 1, 1, 1351.00, 0, 0.00, 1131
7, 16:10:00-000, 911, 19, 892, 12, 1345.17, 12, 1347.17, 887
7, 16:11:00-000, 3596, 3550, 46, 0, 0.00, 0, 0.00, 3596
7, 16:12:00-000, 2694, 2643, 51, 27, 1348.48, 27, 1349.96, 2640
7, 16:13:00-000, 2466, 6, 2460, 0, 0.00, 0, 0.00, 2466
7, 16:14:00-000, 5796, 3419, 2377, 2, 1352.00, 2, 1352.00, 5792
7, 16:16:00-000, 5422, 4050, 1372, 9, 1351.00, 9, 1351.00, 5387
7, 16:17:00-000, 8032, 5061, 2971, 0, 0.00, 0, 0.00, 8049
7, 16:18:00-000, 2287, 1558, 729, 2, 1351.00, 2, 1351.00, 2283
7, 16:19:00-000, 11639, 8913, 2726, 2, 1351.00, 2, 1351.50, 11635
7, 16:20:00-000, 4138, 2300, 1838, 0, 0.00, 0, 0.00, 4138
7, 16:21:00-000, 10446, 7325, 3121, 1, 1354.00, 1, 1351.00, 10444
7, 16:22:00-000, 3187, 2355, 832, 18, 1349.39, 15, 1351.33, 3154
7, 16:23:00-000, 10046, 4582, 5464, 1, 1349.00, 3, 1349.00, 10042
7, 16:24:00-000, 1691, 10, 1681, 0, 0.00, 1, 1348.00, 1180
7, 16:25:00-000, 14169, 9985, 4184, 0, 0.00, 0, 0.00, 13234
7, 16:26:00-000, 7513, 3292, 4221, 4, 1348.00, 11, 1350.36, 8943
7, 16:27:00-000, 11756, 6700, 5056, 32, 1349.49, 25, 1349.84, 11692
7, 16:28:00-000, 12571, 7367, 5204, 39, 1347.89, 40, 1348.34, 12499
7, 16:29:00-000, 12037, 3030, 9007, 45, 1352.64, 44, 1351.24, 11948
8, 09:07:00-000, 747, 7, 740, 0, 0.00, 0, 0.00, 747
8, 09:16:00-000, 1707, 7, 1700, 0, 0.00, 0, 0.00, 1707
8, 09:23:00-000, 3649, 2110, 1539, 0, 0.00, 0, 0.00, 3649
8, 09:29:00-000, 139, 77, 62, 0, 0.00, 0, 0.00, 139
8, 09:30:00-000, 90, 80, 10, 10, 1349.00, 10, 1351.00, 70
8, 09:32:00-000, 1230, 1124, 106, 14, 1351.21, 14, 1351.79, 1202
8, 09:33:00-000, 893, 13, 880, 13, 1348.08, 13, 1352.00, 867
8, 09:34:00-000, 970, 10, 960, 0, 0.00, 0, 0.00, 970
8, 09:50:00-000, 1992, 1898, 94, 3, 1352.00, 3, 1351.00, 1961
8, 09:51:00-000, 1221, 770, 451, 0, 0.00, 0, 0.00, 1246
8, 09:54:00-000, 117, 110, 7, 0, 0.00, 0, 0.00, 117
8, 09:58:00-000, 3171, 2354, 817, 5, 1350.00, 5, 1345.40, 3161
8, 09:59:00-000, 1570, 15, 1555, 0, 0.00, 0, 0.00, 1570
8, 10:00:00-000, 1099, 91, 1008, 11, 1345.00, 11, 1345.91, 1077
8, 10:01:00-000, 959, 911, 48, 0, 0.00, 0, 0.00, 959
8, 10:02:00-000, 683, 117, 566, 7, 1350.00, 21, 1351.52, 655
8, 10:03:00-000, 502, 313, 189, 20, 1352.05, 6, 1350.00, 476
8, 10:08:00-000, 842, 105, 737, 0, 0.00, 0, 0.00, 842
8, 10:09:00-000, 209, 9, 200, 0, 0.00, 0, 0.00, 209
8, 10:10:00-000, 1237, 198, 1039, 37, 1347.59, 37, 1348.35, 1163
8, 10:11:00-000, 919, 29, 890, 0, 0.00, 0, 0.00, 919
8, 10:12:00-000, 210, 166, 44, 0, 0.00, 0, 0.00, 210
8, 10:13:00-000, 2746, 1830, 916, 0, 0.00, 0, 0.00, 2746
8, 10:15:00-000, 1938, 1071, 867, 2, 1350.00, 2, 1349.00, 1934
8, 10:16:00-000, 91, 63, 28, 20, 1352.60, 20, 1352.00, 51
8, 10:17:00-000, 256, 240, 16, 0, 0.00, 0, 0.00, 256
8, 10:21:00-000, 350, 104, 246, 1, 1350.00, 0, 0.00, 349
8, 10:22:00-000, 1137, 1130, 7, 2, 1351.00, 3, 1351.33, 1132
8, 10:23:00-000, 503, 181, 322, 0, 0.00, 0, 0.00, 503
8, 10:24:00-000, 2104, 2080, 24, 0, 0.00, 0, 0.00, 2104
8, 10:25:00-000, 5048, 48, 5000, 0, 0.00, 0, 0.00, 5048
8, 10:26:00-000, 1616, 936, 680, 8, 1349.00, 8, 1350.37, 973
8, 10:27:00-000, 2740, 844, 1896, 0, 0.00, 0, 0.00, 3367
8, 10:28:00-000, 1604, 1580, 24, 0, 0.00, 0, 0.00, 1604
8, 10:29:00-000, 1773, 819, 954, 0, 0.00, 0, 0.00, 1773
8, 10:30:00-000, 1734, 911, 823, 7, 1352.43, 7, 1352.00, 1720
8, 10:31:00-000, 736, 730, 6, 0, 0.00, 0, 0.00, 736
8, 10:32:00-000, 765, 760, 5, 0, 0.00, 0, 0.00, 765
8, 10:33:00-000, 3071, 2828, 243, 0, 0.00, 0, 0.00, 3071
8, 10:34:00-000, 1229, 1111, 118, 4, 1346.00, 4, 1349.25, 1221
8, 10:35:00-000, 3423, 1045, 2378, 0, 0.00, 0, 0.00, 3423
8, 10:36:00-000, 5392, 1552, 3840, 3, 1354.67, 3, 1352.00, 5386
8, 10:38:00-000, 98, 90, 8, 0, 0.00, 0, 0.00, 98
8, 10:39:00-000, 510, 500, 10, 0, 0.00, 0, 0.00, 510
8, 10:40:00-000, 1029, 990, 39, 9, 1347.00, 7, 1349.57, 1013
8, 10:41:00-000, 67, 61, 6, 1, 1349.00, 3, 1348.67, 63
8, 10:42:00-000, 840, 10, 830, 0, 0.00, 0, 0.00, 840
8, 10:46:00-000, 757, 7, 750, 0, 0.00, 0, 0.00, 757
8, 10:47:00-000, 197, 96, 101, 0, 0.00, 0, 0.00, 197
8, 10:48:00-000, 1570, 1545, 25, 0, 0.00, 0, 0.00, 1570
8, 10:49:00-000, 2770, 650, 2120, 15, 1350.87, 15, 1351.93, 2740
8, 10:50:00-000, 1662, 1650, 12, 0, 0.00, 0, 0.00, 1662
8, 10:52:00-000, 288, 179, 109, 3, 1346.00, 3, 1353.00, 282
8, 10:53:00-000, 203, 3, 200, 0, 0.00, 0, 0.00, 203
8, 10:54:00-000, 1551, 1550, 1, 0, 0.00, 0, 0.00, 1551
8, 10:55:00-000, 1720, 39, 1681, 0, 0.00, 0, 0.00, 1720
8, 10:56:00-000, 1012, 580, 432, 0, 0.00, 0, 0.00, 1012
8, 10:57:00-000, 4732, 3798, 934, 0, 0.00, 0, 0.00, 4732
8, 10:58:00-000, 74, 14, 60, 0, 0.00, 8, 1352.00, 66
8, 10:59:00-000, 8, 8, 0, 8, 1355.00, 0, 0.00, 0
8, 11:00:00-000, 784, 780, 4, 0, 0.00, 0, 0.00, 784
8, 11:01:00-000, 4415, 1354, 3061, 2, 1347.50, 2, 1348.50, 4411
8, 11:02:00-000, 414, 331, 83, 4, 1351.00, 8, 1352.00, 402
8, 11:03:00-000, 4, 4, 0, 4, 1356.00, 0, 0.00, 0
8, 11:05:00-000, 3490, 2525, 965, 0, 0.00, 0, 0.00, 3490
8, 11:06:00-000, 1916, 1018, 898, 7, 1351.71, 7, 1351.71, 1902
8, 11:07:00-000, 4004, 3646, 358, 11, 1349.91, 11, 1351.09, 3982
8, 11:08:00-000, 617, 610, 7, 0, 0.00, 2, 1351.00, 615
8, 11:09:00-000, 2, 2, 0, 2, 1355.00, 0, 0.00, 0
8, 11:10:00-000, 789, 109, 680, 3, 1350.67, 3, 1354.00, 783
8, 11:15:00-000, 2024, 132, 1892, 0, 0.00, 0, 0.00, 2024
8, 11:16:00-000, 307, 7, 300, 0, 0.00, 0, 0.00, 307
8, 11:17:00-000, 1665, 123, 1542, 0, 0.00, 0, 0.00, 1665
8, 11:18:00-000, 3992, 2349, 1643, 12, 1353.50, 12, 1351.75, 3968
8, 11:19:00-000, 355, 165, 190, 2, 1349.00, 2, 1347.00, 351
8, 11:20:00-000, 208, 200, 8, 0, 0.00, 0, 0.00, 208
8, 11:21:00-000, 387, 341, 46, 0, 0.00, 0, 0.00, 387
8, 11:22:00-000, 100, 10, 90, 0, 0.00, 0, 0.00, 100
8, 11:23:00-000, 2044, 1849, 195, 0, 0.00, 0, 0.00, 2044
8, 11:24:00-000, 1876, 1759, 117, 9, 1350.00, 9, 1347.78, 1858
8, 11:26:00-000, 769, 9, 760, 0, 0.00, 0, 0.00, 769
8, 11:27:00-000, 382, 173, 209, 0, 0.00, 0, 0.00, 382
8, 11:28:00-000, 1841, 1768, 73, 5, 1349.60, 5, 1350.80, 1831
8, 11:29:00-000, 271, 260, 11, 0, 0.00, 0, 0.00, 271
8, 11:30:00-000, 1302, 833, 469, 1, 1350.00, 1, 1348.00, 1300
8, 11:31:00-000, 2335, 1566, 769, 0, 0.00, 0, 0.00, 2335
8, 11:32:00-000, 425, 189, 236, 0, 0.00, 0, 0.00, 425
8, 11:33:00-000, 1411, 50, 1361, 6, 1352.50, 6, 1352.00, 1399
8, 11:34:00-000, 116, 10, 106, 6, 1349.00, 6, 1350.00, 104
8, 11:36:00-000, 1983, 1921, 62, 0, 0.00, 0, 0.00, 1983
8, 11:38:00-000, 2264, 2104, 160, 0, 0.00, 0, 0.00, 2264
8, 11:39:00-000, 3068, 2492, 576, 0, 0.00, 0, 0.00, 3068
8, 11:40:00-000, 691, 690, 1, 0, 0.00, 0, 0.00, 691
8, 11:41:00-000, 151, 140, 11, 0, 0.00, 0, 0.00, 151
8, 11:42:00-000, 240, 103, 137, 0, 0.00, 0, 0.00, 240
8, 11:43:00-000, 2663, 284, 2379, 5, 1348.00, 5, 1347.40, 2568
8, 11:44:00-000, 209, 186, 23, 6, 1352.67, 6, 1351.00, 282
8, 11:45:00-000, 1050, 889, 161, 1, 1351.00, 1, 1353.00, 1048
8, 11:46:00-000, 987, 817, 170, 0, 0.00, 0, 0.00, 987
8, 11:47:00-000, 2881, 33, 2848, 6, 1350.00, 6, 1347.33, 2869
8, 11:48:00-000, 183, 177, 6, 5, 1353.60, 5, 1352.00, 173
8, 11:49:00-000, 1420, 1416, 4, 1, 1354.00, 1, 1350.00, 1418
8, 11:50:00-000, 2684, 1654, 1030, 0, 0.00, 0, 0.00, 2684
8, 11:51:00-000, 3166, 3140, 26, 0, 0.00, 0, 0.00, 2284
8, 11:52:00-000, 882, 750, 132, 9, 1347.33, 9, 1350.67, 1746
8, 11:53:00-000, 968, 798, 170, 0, 0.00, 0, 0.00, 968
8, 11:54:00-000, 260, 162, 98, 0, 0.00, 0, 0.00, 260
8, 11:55:00-000, 363, 355, 8, 0, 0.00, 0, 0.00, 358
8, 11:56:00-000, 166, 76, 90, 0, 0.00, 0, 0.00, 171
8, 11:57:00-000, 89, 80, 9, 0, 0.00, 0, 0.00, 89
8, 11:58:00-000, 3224, 2518, 706, 16, 1351.75, 16, 1352.00, 3192
8, 12:00:00-000, 524, 14, 510, 0, 0.00, 0, 0.00, 516
8, 12:01:00-000, 4138, 259, 3879, 4, 1353.00, 4, 1350.00, 4138
8, 12:02:00-000, 4134, 3838, 296, 0, 0.00, 0, 0.00, 4134
8, 12:03:00-000, 3062, 12, 3050, 0, 0.00, 0, 0.00, 3062
8, 12:04:00-000, 4197, 107, 4090, 0, 0.00, 0, 0.00, 4197
8, 12:06:00-000, 1620, 1590, 30, 22, 1348.00, 22, 1347.82, 1576
8, 12:07:00-000, 792, 716, 76, 2, 1347.00, 2, 1348.00, 788
8, 12:09:00-000, 2007, 821, 1186, 0, 0.00, 0, 0.00, 2007
8, 12:10:00-000, 2904, 314, 2590, 4, 1348.00, 2, 1348.50, 2898
8, 12:11:00-000, 1585, 415, 1170, 0, 0.00, 2, 1351.00, 1583
8, 12:12:00-000, 1153, 136, 1017, 1, 1352.00, 1, 1351.00, 1151
8, 12:13:00-000, 3447, 1819, 1628, 1, 1348.00, 1, 1351.00, 3445
8, 12:16:00-000, 161, 77, 84, 0, 0.00, 0, 0.00, 161
8, 12:18:00-000, 1452, 1339, 113, 0, 0.00, 0, 0.00, 1452
8, 12:19:00-000, 4327, 841, 3486, 1, 1349.00, 1, 1351.00, 4325
8, 12:20:00-000, 118, 9, 109, 9, 1349.00, 9, 1347.44, 100
8, 12:25:00-000, 759, 9, 750, 0, 0.00, 0, 0.00, 759
8, 12:28:00-000, 93, 90, 3, 0, 0.00, 0, 0.00, 93
8, 12:29:00-000, 183, 13, 170, 0, 0.00, 0, 0.00, 183
8, 12:32:00-000, 1087, 1060, 27, 0, 0.00, 0, 0.00, 1087
8, 12:33:00-000, 181, 112, 69, 4, 1351.00, 4, 1352.00, 173
8, 12:35:00-000, 18, 3, 15, 0, 0.00, 0, 0.00, 18
8, 12:37:00-000, 156, 153, 3, 3, 1350.33, 3, 1351.00, 150
8, 12:38:00-000, 215, 108, 107, 0, 0.00, 0, 0.00, 215
8, 12:40:00-000, 164, 131, 33, 0, 0.00, 0, 0.00, 164
8, 12:42:00-000, 63, 3, 60, 0, 0.00, 0, 0.00, 63
8, 12:49:00-000, 92, 84, 8, 8, 1349.88, 8, 1354.00, 76
8, 12:50:00-000, 729, 661, 68, 1, 1351.00, 1, 1348.00, 727
8, 12:52:00-000, 394, 156, 238, 0, 0.00, 0, 0.00, 394
8, 12:53:00-000, 313, 206, 107, 0, 0.00, 0, 0.00, 313
8, 12:54:00-000, 103, 3, 100, 0, 0.00, 0, 0.00, 103
8, 12:55:00-000, 57, 7, 50, 0, 0.00, 0, 0.00, 57
8, 12:56:00-000, 68, 8, 60, 0, 0.00, 0, 0.00, 68
8, 12:57:00-000, 1502, 6, 1496, 6, 1349.00, 6, 1349.17, 1490
8, 13:01:00-000, 194, 93, 101, 3, 1348.67, 3, 1349.00, 188
8, 13:02:00-000, 86, 3, 83, 3, 1349.00, 3, 1351.00, 80
8, 13:03:00-000, 402, 100, 302, 0, 0.00, 0, 0.00, 402
8, 13:04:00-000, 3421, 1400, 2021, 7, 1349.14, 1, 1351.00, 3413
8, 13:05:00-000, 1161, 155, 1006, 0, 0.00, 6, 1347.83, 1155
8, 13:06:00-000, 28, 24, 4, 4, 1355.50, 4, 1351.00, 20
8, 13:07:00-000, 1455, 1450, 5, 0, 0.00, 0, 0.00, 1455
8, 13:08:00-000, 97, 90, 7, 0, 0.00, 0, 0.00, 97
8, 13:09:00-000, 2826, 2608, 218, 1, 1354.00, 1, 1351.00, 2824
8, 13:10:00-000, 1026, 841, 185, 7, 1353.00, 7, 1351.00, 1012
8, 13:11:00-000, 958, 28, 930, 17, 1355.35, 17, 1353.00, 924
8, 13:13:00-000, 69, 60, 9, 0, 0.00, 0, 0.00, 69
8, 13:14:00-000, 393, 90, 303, 2, 1349.50, 2, 1350.50, 389
8, 13:15:00-000, 370, 168, 202, 0, 0.00, 0, 0.00, 281
8, 13:16:00-000, 1323, 85, 1238, 2, 1349.00, 2, 1347.50, 1408
8, 13:17:00-000, 245, 134, 111, 0, 0.00, 0, 0.00, 245
8, 13:18:00-000, 848, 18, 830, 0, 0.00, 0, 0.00, 841
8, 13:19:00-000, 2816, 959, 1857, 0, 0.00, 0, 0.00, 2823
8, 13:20:00-000, 2199, 2174, 25, 4, 1354.25, 4, 1351.00, 2191
8, 13:21:00-000, 821, 680, 141, 28, 1352.46, 28, 1351.85, 765
8, 13:23:00-000, 87, 7, 80, 0, 0.00, 0, 0.00, 87
8, 13:24:00-000, 3106, 613, 2493, 9, 1353.00, 9, 1350.55, 3088
8, 13:25:00-000, 1125, 325, 800, 0, 0.00, 0, 0.00, 1125
8, 13:26:00-000, 61, 1, 60, 0, 0.00, 0, 0.00, 61
8, 13:27:00-000, 5897, 3674, 2223, 0, 0.00, 0, 0.00, 5897
8, 13:28:00-000, 737, 7, 730, 0, 0.00, 0, 0.00, 737
8, 13:29:00-000, 2875, 622, 2253, 3, 1351.00, 3, 1351.00, 2869
8, 13:30:00-000, 194, 97, 97, 16, 1350.06, 16, 1349.44, 162
8, 13:31:00-000, 206, 192, 14, 2, 1352.00, 2, 1351.00, 202
8, 13:32:00-000, 1313, 841, 472, 0, 0.00, 0, 0.00, 1313
8, 13:33:00-000, 4319, 1839, 2480, 19, 1348.31, 19, 1347.94, 4281
8, 13:34:00-000, 1805, 44, 1761, 0, 0.00, 0, 0.00, 1805
8, 13:36:00-000, 94, 4, 90, 0, 0.00, 0, 0.00, 94
8, 13:37:00-000, 978, 18, 960, 3, 1351.33, 3, 1352.00, 972
8, 13:38:00-000, 101, 91, 10, 1, 1353.00, 1, 1351.00, 99
8, 13:39:00-000, 340, 163, 177, 0, 0.00, 0, 0.00, 340
8, 13:40:00-000, 1912, 188, 1724, 0, 0.00, 0, 0.00, 1912
8, 13:41:00-000, 1637, 1287, 350, 0, 0.00, 0, 0.00, 1637
8, 13:42:00-000, 549, 128, 421, 0, 0.00, 0, 0.00, 549
8, 13:43:00-000, 324, 310, 14, 0, 0.00, 0, 0.00, 224
8, 13:44:00-000, 1541, 573, 968, 0, 0.00, 0, 0.00, 1641
8, 13:45:00-000, 199, 97, 102, 1, 1350.00, 1, 1349.00, 197
8, 13:46:00-000, 3485, 1766, 1719, 12, 1346.67, 12, 1349.58, 3461
8, 13:47:00-000, 4540, 1707, 2833, 3, 1348.00, 3, 1348.00, 4534
8, 13:48:00-000, 2347, 1590, 757, 3, 1351.00, 3, 1350.00, 2341
8, 13:49:00-000, 240, 19, 221, 11, 1350.27, 11, 1352.00, 218
8, 13:50:00-000, 1408, 1400, 8, 0, 0.00, 0, 0.00, 1408
8, 13:51:00-000, 2509, 838, 1671, 0, 0.00, 0, 0.00, 2509
8, 13:52:00-000, 1259, 1113, 146, 28, 1345.78, 28, 1346.57, 227
8, 13:53:00-000, 430, 58, 372, 0, 0.00, 0, 0.00, 1406
8, 13:54:00-000, 700, 690, 10, 2, 1352.00, 10, 1351.00, 688
8, 13:55:00-000, 167, 17, 150, 8, 1353.75, 0, 0.00, 159
8, 13:56:00-000, 2512, 1587, 925, 11, 1349.91, 11, 1352.00, 2469
8, 13:57:00-000, 384, 372, 12, 2, 1349.00, 2, 1352.00, 401
8, 13:58:00-000, 3817, 2182, 1635, 10, 1346.60, 10, 1349.20, 3797
8, 13:59:00-000, 898, 111, 787, 0, 0.00, 0, 0.00, 898
8, 14:00:00-000, 2479, 1603, 876, 4, 1351.00, 4, 1350.50, 2471
8, 14:01:00-000, 1058, 201, 857, 1, 1348.00, 1, 1351.00, 1056
8, 14:02:00-000, 3035, 3021, 14, 8, 1352.75, 8, 1350.37, 3019
8, 14:03:00-000, 167, 67, 100, 0, 0.00, 0, 0.00, 167
8, 14:04:00-000, 1203, 23, 1180, 0, 0.00, 0, 0.00, 1203
8, 14:05:00-000, 2855, 1639, 1216, 0, 0.00, 1, 1349.00, 2854
8, 14:06:00-000, 3635, 1445, 2190, 1, 1351.00, 0, 0.00, 3634
8, 14:07:00-000, 190, 10, 180, 0, 0.00, 0, 0.00, 190
8, 14:08:00-000, 938, 904, 34, 15, 1348.60, 15, 1350.33, 908
8, 14:09:00-000, 3054, 1891, 1163, 3, 1350.00, 3, 1350.00, 3048
8, 14:10:00-000, 801, 795, 6, 0, 0.00, 0, 0.00, 801
8, 14:11:00-000, 22, 1, 21, 1, 1349.00, 1, 1345.00, 20
8, 14:12:00-000, 1423, 130, 1293, 22, 1350.00, 22, 1349.32, 1379
8, 14:13:00-000, 182, 12, 170, 0, 0.00, 0, 0.00, 182
8, 14:14:00-000, 298, 89, 209, 3, 1351.00, 3, 1351.00, 292
8, 14:16:00-000, 3337, 1540, 1797, 0, 0.00, 0, 0.00, 3337
8, 14:17:00-000, 1246, 1240, 6, 0, 0.00, 0, 0.00, 1246
8, 14:18:00-000, 987, 768, 219, 0, 0.00, 0, 0.00, 987
8, 14:19:00-000, 437, 303, 134, 0, 0.00, 0, 0.00, 437
8, 14:20:00-000, 1859, 1557, 302, 19, 1347.95, 19, 1347.79, 1821
8, 14:21:00-000, 2391, 1207, 1184, 5, 1350.20, 5, 1350.00, 2171
8, 14:22:00-000, 1953, 238, 1715, 29, 1347.48, 29, 1351.07, 2105
8, 14:23:00-000, 1078, 224, 854, 9, 1349.33, 9, 1349.11, 1060
8, 14:24:00-000, 1156, 204, 952, 0, 0.00, 0, 0.00, 1156
8, 14:25:00-000, 2720, 1816, 904, 0, 0.00, 0, 0.00, 2720
8, 14:26:00-000, 1504, 222, 1282, 9, 1349.44, 9, 1350.22, 1486
8, 14:27:00-000, 1147, 861, 286, 17, 1348.17, 17, 1349.82, 1113
8, 14:28:00-000, 772, 79, 693, 5, 1349.00, 0, 0.00, 767
8, 14:29:00-000, 2398, 2240, 158, 3, 1348.00, 8, 1349.13, 2387
8, 14:30:00-000, 941, 133, 808, 8, 1349.00, 8, 1347.00, 925
8, 14:31:00-000, 269, 152, 117, 2, 1353.00, 2, 1352.00, 265
8, 14:32:00-000, 1645, 5, 1640, 0, 0.00, 0, 0.00, 1645
8, 14:33:00-000, 93, 8, 85, 0, 0.00, 0, 0.00, 92
8, 14:34:00-000, 224, 83, 141, 8, 1351.00, 8, 1350.50, 209
8, 14:35:00-000, 338, 331, 7, 1, 1352.00, 1, 1350.00, 336
8, 14:36:00-000, 1390, 0, 1390, 0, 0.00, 0, 0.00, 1390
8, 14:37:00-000, 3052, 1524, 1528, 2, 1348.00, 2, 1350.00, 3048
8, 14:38:00-000, 1631, 85, 1546, 0, 0.00, 0, 0.00, 1631
8, 14:39:00-000, 163, 23, 140, 0, 0.00, 0, 0.00, 163
8, 14:40:00-000, 216, 109, 107, 9, 1349.00, 9, 1351.22, 198
8, 14:42:00-000, 1437, 225, 1212, 0, 0.00, 0, 0.00, 1437
8, 14:43:00-000, 2238, 397, 1841, 0, 0.00, 0, 0.00, 2165
8, 14:44:00-000, 1246, 190, 1056, 4, 1348.75, 2, 1348.00, 1313
8, 14:45:00-000, 2649, 2542, 107, 4, 1351.75, 6, 1350.00, 2639
8, 14:46:00-000, 3129, 2462, 667, 2, 1345.00, 2, 1350.50, 3125
8, 14:47:00-000, 1762, 1671, 91, 0, 0.00, 0, 0.00, 1762
8, 14:48:00-000, 2250, 2170, 80, 0, 0.00, 0, 0.00, 2250
8, 14:49:00-000, 653, 621, 32, 0, 0.00, 0, 0.00, 653
8, 14:50:00-000, 655, 112, 543, 8, 1348.88, 7, 1345.29, 640
8, 14:51:00-000, 642, 82, 560, 2, 1350.00, 3, 1348.00, 637
8, 14:53:00-000, 167, 70, 97, 10, 1348.00, 10, 1349.90, 147
8, 14:54:00-000, 394, 21, 373, 3, 1347.67, 3, 1347.33, 388
8, 14:55:00-000, 1903, 598, 1305, 0, 0.00, 1, 1352.00, 1902
8, 14:56:00-000, 1, 1, 0, 1, 1353.00, 0, 0.00, 0
8, 14:57:00-000, 21, 20, 1, 0, 0.00, 0, 0.00, 21
8, 14:58:00-000, 3181, 2344, 837, 22, 1350.73, 22, 1352.23, 3137
8, 15:00:00-000, 2709, 987, 1722, 2, 1348.00, 2, 1347.00, 2705
8, 15:01:00-000, 1933, 1745, 188, 2, 1350.00, 2, 1350.00, 1929
8, 15:02:00-000, 3646, 1226, 2420, 5, 1348.80, 11, 1350.09, 3630
8, 15:03:00-000, 4632, 1562, 3070, 7, 1350.43, 1, 1350.00, 4624
8, 15:04:00-000, 1779, 1672, 107, 0, 0.00, 0, 0.00, 1779
8, 15:05:00-000, 1203, 560, 643, 0, 0.00, 0, 0.00, 1203
8, 15:08:00-000, 668, 650, 18, 0, 0.00, 0, 0.00, 668
8, 15:09:00-000, 3631, 779, 2852, 2, 1352.00, 2, 1351.00, 3627
8, 15:10:00-000, 3025, 28, 2997, 17, 1351.76, 17, 1350.70, 2991
8, 15:11:00-000, 3755, 466, 3289, 0, 0.00, 0, 0.00, 3739
8, 15:12:00-000, 1068, 69, 999, 3, 1351.00, 3, 1351.00, 1078
8, 15:13:00-000, 3153, 2677, 476, 0, 0.00, 0, 0.00, 3153
8, 15:14:00-000, 1144, 127, 1017, 0, 0.00, 0, 0.00, 1144
8, 15:15:00-000, 755, 700, 55, 20, 1347.65, 20, 1349.60, 715
8, 15:16:00-000, 62, 2, 60, 0, 0.00, 0, 0.00, 62
8, 15:17:00-000, 2428, 2410, 18, 0, 0.00, 0, 0.00, 2428
8, 15:18:00-000, 4443, 1214, 3229, 20, 1348.90, 42, 1351.31, 4381
8, 15:19:00-000, 1358, 1354, 4, 22, 1354.13, 0, 0.00, 1336
8, 15:20:00-000, 90, 61, 29, 0, 0.00, 0, 0.00, 21
8, 15:21:00-000, 3101, 676, 2425, 4, 1347.00, 4, 1350.00, 3162
8, 15:22:00-000, 1787, 104, 1683, 2, 1348.00, 2, 1350.00, 1783
8, 15:23:00-000, 688, 27, 661, 0, 0.00, 0, 0.00, 688
8, 15:24:00-000, 172, 107, 65, 11, 1345.36, 6, 1351.00, 155
8, 15:25:00-000, 810, 800, 10, 0, 0.00, 5, 1349.80, 805
8, 15:26:00-000, 250, 153, 97, 3, 1350.00, 3, 1349.00, 244
8, 15:27:00-000, 2876, 1871, 1005, 4, 1347.50, 4, 1345.25, 1338
8, 15:28:00-000, 477, 450, 27, 0, 0.00, 0, 0.00, 2007
8, 15:29:00-000, 1846, 823, 1023, 0, 0.00, 0, 0.00, 1846
8, 15:30:00-000, 974, 139, 835, 1, 1348.00, 1, 1349.00, 972
8, 15:31:00-000, 124, 23, 101, 0, 0.00, 0, 0.00, 124
8, 15:32:00-000, 826, 724, 102, 1, 1350.00, 1, 1349.00, 824
8, 15:34:00-000, 21, 20, 1, 0, 0.00, 1, 1350.00, 20
8, 15:35:00-000, 954, 222, 732, 2, 1352.50, 1, 1352.00, 951
8, 15:36:00-000, 1171, 963, 208, 4, 1356.00, 4, 1352.00, 1163
8, 15:37:00-000, 656, 15, 641, 5, 1352.00, 8, 1351.25, 643
8, 15:38:00-000, 1645, 1457, 188, 4, 1350.00, 1, 1351.00, 1640
8, 15:39:00-000, 1702, 1636, 66, 0, 0.00, 0, 0.00, 1702
8, 15:40:00-000, 1547, 18, 1529, 9, 1349.00, 9, 1347.00, 1529
8, 15:41:00-000, 100, 12, 88, 8, 1349.00, 8, 1347.00, 84
8, 15:42:00-000, 1129, 15, 1114, 4, 1348.00, 4, 1350.00, 1121
8, 15:44:00-000, 1715, 1423, 292, 0, 0.00, 0, 0.00, 1715
8, 15:45:00-000, 166, 62, 104, 2, 1348.00, 2, 1347.50, 162
8, 15:46:00-000, 828, 83, 745, 5, 1349.00, 5, 1347.20, 818
8, 15:47:00-000, 3546, 2032, 1514, 9, 1348.33, 9, 1348.67, 3528
8, 15:48:00-000, 334, 4, 330, 0, 0.00, 0, 0.00, 334
8, 15:49:00-000, 1342, 587, 755, 7, 1351.00, 7, 1349.57, 1328
8, 15:50:00-000, 1327, 807, 520, 1, 1351.00, 2, 1349.50, 1324
8, 15:51:00-000, 1, 1, 0, 1, 1350.00, 0, 0.00, 0
8, 15:52:00-000, 1027, 50, 977, 11, 1345.82, 11, 1349.27, 105
8, 15:53:00-000, 0, 0, 0, 0, 0.00, 0, 0.00, 900
8, 15:54:00-000, 80, 80, 0, 0, 0.00, 0, 0.00, 80
8, 15:55:00-000, 1228, 1210, 18, 0, 0.00, 0, 0.00, 1228
8, 16:01:00-000, 1114, 34, 1080, 0, 0.00, 0, 0.00, 84
8, 16:02:00-000, 0, 0, 0, 0, 0.00, 0, 0.00, 1030
8, 16:04:00-000, 93, 71, 22, 0, 0.00, 0, 0.00, 92
8, 16:05:00-000, 57, 50, 7, 0, 0.00, 0, 0.00, 58
8, 16:06:00-000, 312, 10, 302, 2, 1350.00, 2, 1349.50, 308
8, 16:07:00-000, 86, 80, 6, 0, 0.00, 0, 0.00, 86
8, 16:08:00-000, 270, 174, 96, 0, 0.00, 0, 0.00, 270
8, 16:09:00-000, 21, 1, 20, 0, 0.00, 0, 0.00, 21
8, 16:10:00-000, 306, 208, 98, 0, 0.00, 0, 0.00, 306
8, 16:11:00-000, 767, 683, 84, 4, 1348.25, 4, 1351.00, 759
8, 16:12:00-000, 1066, 1027, 39, 1, 1353.00, 1, 1351.00, 1064
8, 16:13:00-000, 132, 102, 30, 1, 1352.00, 1, 1351.00, 130
8, 16:14:00-000, 59, 9, 50, 0, 0.00, 0, 0.00, 59
8, 16:16:00-000, 1152, 312, 840, 0, 0.00, 0, 0.00, 1152
8, 16:17:00-000, 3039, 1854, 1185, 0, 0.00, 0, 0.00, 3039
8, 16:18:00-000, 405, 382, 23, 2, 1351.00, 2, 1351.00, 401
8, 16:19:00-000, 1538, 1510, 28, 0, 0.00, 0, 0.00, 1538
8, 16:20:00-000, 198, 180, 18, 0, 0.00, 0, 0.00, 198
8, 16:21:00-000, 568, 382, 186, 17, 1351.47, 17, 1350.35, 534
8, 16:22:00-000, 341, 132, 209, 2, 1354.00, 2, 1352.00, 337
8, 16:23:00-000, 1812, 1714, 98, 0, 0.00, 0, 0.00, 1812
8, 16:24:00-000, 1428, 8, 1420, 0, 0.00, 0, 0.00, 1428
8, 16:25:00-000, 1521, 1477, 44, 5, 1350.60, 5, 1350.00, 1511
8, 16:26:00-000, 1107, 80, 1027, 19, 1350.26, 19, 1353.53, 1069
8, 16:27:00-000, 1025, 454, 571, 9, 1346.78, 9, 1350.22, 1007
8, 16:28:00-000, 908, 784, 124, 20, 1350.15, 20, 1347.40, 868
8, 16:29:00-000, 1138, 326, 812, 16, 1352.75, 16, 1350.88, 1106
9, 09:06:00-000, 880, 880, 0, 0, 0.00, 0, 0.00, 880
9, 09:07:00-000, 6380, 2040, 4340, 0, 0.00, 0, 0.00, 6380
9, 09:23:00-000, 9440, 4390, 5050, 0, 0.00, 0, 0.00, 8610
9, 09:24:00-000, 0, 0, 0, 0, 0.00, 0, 0.00, 830
9, 09:29:00-000, 5860, 2670, 3190, 0, 0.00, 0, 0.00, 4720
9, 09:30:00-000, 3006, 1396, 1610, 53, 1352.41, 53, 1350.40, 4040
9, 09:32:00-000, 1480, 1480, 0, 0, 0.00, 0, 0.00, 1480
9, 09:49:00-000, 1190, 0, 1190, 0, 0.00, 0, 0.00, 1190
9, 09:50:00-000, 1060, 0, 1060, 0, 0.00, 0, 0.00, 1060
9, 09:51:00-000, 5210, 930, 4280, 0, 0.00, 0, 0.00, 5210
9, 09:54:00-000, 5110, 2230, 2880, 0, 0.00, 0, 0.00, 5110
9, 09:56:00-000, 4880, 1100, 3780, 0, 0.00, 0, 0.00, 4880
9, 09:58:00-000, 3350, 780, 2570, 0, 0.00, 0, 0.00, 3350
9, 09:59:00-000, 4780, 1100, 3680, 0, 0.00, 0, 0.00, 4780
9, 10:00:00-000, 3154, 2230, 924, 14, 1348.00, 14, 1345.71, 3126
9, 10:01:00-000, 6242, 3700, 2542, 2, 1348.00, 2, 1346.00, 6238
9, 10:02:00-000, 1171, 11, 1160, 11, 1352.82, 11, 1352.00, 1149
9, 10:03:00-000, 4880, 2440, 2440, 0, 0.00, 0, 0.00, 4880
9, 10:04:00-000, 1541, 1, 1540, 1, 1351.00, 1, 1350.00, 1539
9, 10:05:00-000, 2610, 0, 2610, 0, 0.00, 0, 0.00, 2610
9, 10:08:00-000, 1270, 1270, 0, 0, 0.00, 0, 0.00, 1270
9, 10:09:00-000, 1929, 961, 968, 19, 1345.47, 19, 1350.74, 1891
9, 10:10:00-000, 4292, 1432, 2860, 2, 1351.00, 2, 1352.00, 4288
9, 10:11:00-000, 3630, 2410, 1220, 0, 0.00, 0, 0.00, 3630
9, 10:12:00-000, 5431, 1, 5430, 1, 1355.00, 1, 1353.00, 5429
9, 10:13:00-000, 1990, 0, 1990, 0, 0.00, 0, 0.00, 1990
9, 10:15:00-000, 8480, 2000, 6480, 0, 0.00, 0, 0.00, 8480
9, 10:16:00-000, 4600, 1240, 3360, 0, 0.00, 0, 0.00, 4600
9, 10:21:00-000, 2310, 2310, 0, 0, 0.00, 0, 0.00, 2310
9, 10:22:00-000, 4850, 0, 4850, 0, 0.00, 0, 0.00, 4010
9, 10:23:00-000, 11410, 9940, 1470, 0, 0.00, 0, 0.00, 12250
9, 10:24:00-000, 1350, 0, 1350, 0, 0.00, 0, 0.00, 1350
9, 10:25:00-000, 8350, 4090, 4260, 0, 0.00, 0, 0.00, 8350
9, 10:26:00-000, 8097, 5817, 2280, 27, 1351.96, 27, 1351.00, 8043
9, 10:27:00-000, 4611, 1580, 3031, 1, 1347.00, 1, 1349.00, 4609
9, 10:28:00-000, 6120, 2580, 3540, 0, 0.00, 0, 0.00, 6120
9, 10:29:00-000, 5520, 2370, 3150, 0, 0.00, 0, 0.00, 4350
9, 10:30:00-000, 3183, 3180, 3, 3, 1345.00, 3, 1348.00, 4347
9, 10:32:00-000, 2620, 1420, 1200, 0, 0.00, 0, 0.00, 2620
9, 10:33:00-000, 14080, 7270, 6810, 0, 0.00, 0, 0.00, 13320
9, 10:34:00-000, 4580, 1500, 3080, 0, 0.00, 0, 0.00, 5340
9, 10:35:00-000, 9158, 3140, 6018, 13, 1347.00, 10, 1348.50, 9135
9, 10:36:00-000, 7954, 4051, 3903, 1, 1350.00, 4, 1351.25, 7949
9, 10:38:00-000, 4412, 2910, 1502, 2, 1350.00, 2, 1349.00, 4408
9, 10:39:00-000, 1390, 1390, 0, 0, 0.00, 0, 0.00, 1390
9, 10:40:00-000, 6870, 900, 5970, 0, 0.00, 0, 0.00, 6870
9, 10:41:00-000, 1370, 1370, 0, 0, 0.00, 0, 0.00, 1370
9, 10:42:00-000, 1548, 1510, 38, 38, 1348.00, 38, 1346.78, 1472
9, 10:45:00-000, 1110, 0, 1110, 0, 0.00, 0, 0.00, 1110
9, 10:46:00-000, 750, 750, 0, 0, 0.00, 0, 0.00, 750
9, 10:47:00-000, 1960, 0, 1960, 0, 0.00, 0, 0.00, 1960
9, 10:49:00-000, 3440, 2230, 1210, 0, 0.00, 0, 0.00, 3440
9, 10:50:00-000, 2600, 1600, 1000, 0, 0.00, 0, 0.00, 2600
9, 10:52:00-000, 4870, 1100, 3770, 0, 0.00, 0, 0.00, 4870
9, 10:53:00-000, 4860, 2360, 2500, 0, 0.00, 0, 0.00, 4860
9, 10:54:00-000, 1360, 1360, 0, 0, 0.00, 0, 0.00, 1360
9, 10:55:00-000, 5400, 0, 5400, 0, 0.00, 0, 0.00, 5400
9, 10:56:00-000, 12899, 6379, 6520, 9, 1355.00, 9, 1352.00, 12881
9, 10:57:00-000, 3980, 1490, 2490, 0, 0.00, 0, 0.00, 3980
9, 10:59:00-000, 880, 880, 0, 0, 0.00, 0, 0.00, 880
9, 11:01:00-000, 12210, 4660, 7550, 0, 0.00, 0, 0.00, 12210
9, 11:02:00-000, 3690, 2110, 1580, 0, 0.00, 0, 0.00, 3690
9, 11:04:00-000, 2047, 1940, 107, 61, 1348.42, 61, 1347.57, 1925
9, 11:05:00-000, 2790, 840, 1950, 0, 0.00, 0, 0.00, 2790
9, 11:06:00-000, 6439, 2330, 4109, 9, 1347.00, 9, 1348.22, 6421
9, 11:07:00-000, 5116, 3980, 1136, 6, 1348.00, 6, 1348.00, 5104
9, 11:08:00-000, 8158, 6140, 2018, 8, 1348.00, 8, 1348.75, 8142
9, 11:09:00-000, 880, 0, 880, 0, 0.00, 0, 0.00, 880
9, 11:10:00-000, 1890, 1890, 0, 0, 0.00, 0, 0.00, 1890
9, 11:15:00-000, 12148, 9660, 2488, 8, 1346.00, 8, 1349.37, 12132
9, 11:16:00-000, 5220, 1420, 3800, 0, 0.00, 0, 0.00, 5220
9, 11:17:00-000, 6060, 1750, 4310, 0, 0.00, 0, 0.00, 5940
9, 11:18:00-000, 8405, 1155, 7250, 30, 1352.47, 75, 1352.18, 8420
9, 11:19:00-000, 2425, 885, 1540, 45, 1356.00, 0, 0.00, 2380
9, 11:21:00-000, 6470, 3470, 3000, 10, 1347.00, 10, 1349.00, 6450
9, 11:22:00-000, 2310, 900, 1410, 0, 0.00, 0, 0.00, 2310
9, 11:23:00-000, 6260, 4980, 1280, 0, 0.00, 0, 0.00, 6260
9, 11:24:00-000, 1240, 1240, 0, 0, 0.00, 0, 0.00, 1240
9, 11:26:00-000, 1500, 1500, 0, 0, 0.00, 0, 0.00, 1500
9, 11:27:00-000, 4872, 4100, 772, 2, 1349.00, 2, 1350.00, 4868
9, 11:28:00-000, 5400, 2140, 3260, 0, 0.00, 0, 0.00, 5400
9, 11:29:00-000, 1360, 0, 1360, 0, 0.00, 0, 0.00, 1360
9, 11:30:00-000, 4960, 2600, 2360, 0, 0.00, 0, 0.00, 4960
9, 11:31:00-000, 7400, 2750, 4650, 0, 0.00, 0, 0.00, 7400
9, 11:32:00-000, 12670, 7810, 4860, 0, 0.00, 0, 0.00, 12670
9, 11:33:00-000, 7205, 3605, 3600, 10, 1353.30, 10, 1352.00, 7185
9, 11:34:00-000, 2440, 2440, 0, 0, 0.00, 0, 0.00, 2440
9, 11:36:00-000, 6590, 3640, 2950, 0, 0.00, 0, 0.00, 6590
9, 11:37:00-000, 977, 17, 960, 17, 1350.94, 17, 1352.00, 943
9, 11:38:00-000, 6280, 4090, 2190, 0, 0.00, 0, 0.00, 6280
9, 11:39:00-000, 3460, 0, 3460, 0, 0.00, 0, 0.00, 3460
9, 11:40:00-000, 1610, 0, 1610, 0, 0.00, 0, 0.00, 1610
9, 11:41:00-000, 1550, 0, 1550, 0, 0.00, 0, 0.00, 1550
9, 11:42:00-000, 9630, 4390, 5240, 0, 0.00, 0, 0.00, 9630
9, 11:43:00-000, 1860, 1860, 0, 0, 0.00, 0, 0.00, 1860
9, 11:44:00-000, 3815, 2395, 1420, 46, 1349.85, 46, 1348.60, 3723
9, 11:45:00-000, 4527, 3391, 1136, 62, 1348.44, 62, 1348.04, 4403
9, 11:46:00-000, 2430, 1330, 1100, 0, 0.00, 0, 0.00, 2430
9, 11:47:00-000, 1350, 0, 1350, 0, 0.00, 0, 0.00, 1350
9, 11:48:00-000, 4914, 1034, 3880, 4, 1354.25, 4, 1353.00, 4906
9, 11:49:00-000, 1510, 0, 1510, 0, 0.00, 0, 0.00, 1510
9, 11:50:00-000, 8624, 4, 8620, 4, 1350.00, 4, 1353.00, 8616
9, 11:51:00-000, 4980, 2550, 2430, 0, 0.00, 0, 0.00, 4980
9, 11:52:00-000, 2100, 2100, 0, 0, 0.00, 0, 0.00, 2100
9, 11:54:00-000, 7123, 3670, 3453, 3, 1348.00, 3, 1346.00, 7117
9, 11:55:00-000, 3070, 1520, 1550, 0, 0.00, 0, 0.00, 2790
9, 11:56:00-000, 3971, 1961, 2010, 1, 1350.00, 1, 1349.00, 4249
9, 11:57:00-000, 8751, 4101, 4650, 21, 1352.76, 21, 1353.00, 8709
9, 11:58:00-000, 1090, 1090, 0, 0, 0.00, 0, 0.00, 1090
9, 11:59:00-000, 920, 920, 0, 0, 0.00, 0, 0.00, 920
9, 12:00:00-000, 5991, 4581, 1410, 1, 1351.00, 1, 1350.00, 5989
9, 12:01:00-000, 6935, 4100, 2835, 14, 1347.29, 14, 1348.50, 6907
9, 12:02:00-000, 5310, 3910, 1400, 0, 0.00, 0, 0.00, 5310
9, 12:03:00-000, 1860, 1860, 0, 0, 0.00, 0, 0.00, 1860
9, 12:04:00-000, 3630, 1020, 2610, 0, 0.00, 0, 0.00, 3630
9, 12:06:00-000, 9100, 3640, 5460, 0, 0.00, 0, 0.00, 9100
9, 12:08:00-000, 1000, 1000, 0, 0, 0.00, 0, 0.00, 1000
9, 12:09:00-000, 5010, 1890, 3120, 0, 0.00, 0, 0.00, 5010
9, 12:10:00-000, 7960, 3850, 4110, 0, 0.00, 0, 0.00, 7960
9, 12:11:00-000, 8580, 3940, 4640, 0, 0.00, 0, 0.00, 8580
9, 12:12:00-000, 2320, 0, 2320, 0, 0.00, 0, 0.00, 1000
9, 12:13:00-000, 10100, 3690, 6410, 0, 0.00, 0, 0.00, 11420
9, 12:16:00-000, 6339, 4449, 1890, 29, 1356.00, 29, 1352.00, 6281
9, 12:18:00-000, 8030, 2550, 5480, 0, 0.00, 0, 0.00, 8030
9, 12:19:00-000, 9367, 6897, 2470, 7, 1349.00, 7, 1352.00, 9353
9, 12:20:00-000, 1732, 552, 1180, 278, 1352.59, 278, 1351.05, 1176
9, 12:21:00-000, 940, 940, 0, 0, 0.00, 0, 0.00, 940
9, 12:25:00-000, 1220, 0, 1220, 0, 0.00, 0, 0.00, 1220
9, 12:28:00-000, 1110, 0, 1110, 0, 0.00, 0, 0.00, 1110
9, 12:29:00-000, 3250, 840, 2410, 0, 0.00, 0, 0.00, 3250
9, 12:30:00-000, 5383, 1853, 3530, 3, 1353.00, 3, 1350.00, 5377
9, 12:32:00-000, 3300, 0, 3300, 0, 0.00, 0, 0.00, 3300
9, 12:33:00-000, 2230, 1420, 810, 0, 0.00, 0, 0.00, 2230
9, 12:34:00-000, 1320, 1320, 0, 0, 0.00, 0, 0.00, 1320
9, 12:35:00-000, 770, 0, 770, 0, 0.00, 0, 0.00, 770
9, 12:36:00-000, 906, 6, 900, 3, 1353.00, 6, 1352.00, 897
9, 12:37:00-000, 2168, 1053, 1115, 28, 1349.61, 25, 1348.60, 2115
9, 12:38:00-000, 810, 810, 0, 0, 0.00, 0, 0.00, 810
9, 12:40:00-000, 1230, 1230, 0, 0, 0.00, 0, 0.00, 1230
9, 12:44:00-000, 931, 920, 11, 11, 1348.00, 11, 1348.00, 909
9, 12:50:00-000, 1380, 1380, 0, 0, 0.00, 0, 0.00, 1380
9, 12:52:00-000, 5600, 3490, 2110, 0, 0.00, 0, 0.00, 5600
9, 12:53:00-000, 4611, 3470, 1141, 1, 1348.00, 1, 1349.00, 4609
9, 12:54:00-000, 1260, 0, 1260, 0, 0.00, 0, 0.00, 1260
9, 12:55:00-000, 770, 0, 770, 0, 0.00, 0, 0.00, 770
9, 12:56:00-000, 2050, 2050, 0, 0, 0.00, 0, 0.00, 2050
9, 12:57:00-000, 4243, 960, 3283, 3, 1348.00, 3, 1347.00, 4237
9, 13:00:00-000, 850, 850, 0, 0, 0.00, 0, 0.00, 850
9, 13:01:00-000, 1794, 1790, 4, 4, 1346.00, 4, 1349.00, 1786
9, 13:02:00-000, 940, 940, 0, 0, 0.00, 0, 0.00, 940
9, 13:03:00-000, 2720, 2720, 0, 0, 0.00, 0, 0.00, 2720
9, 13:04:00-000, 3140, 740, 2400, 0, 0.00, 0, 0.00, 3140
9, 13:05:00-000, 3922, 752, 3170, 2, 1350.00, 2, 1353.00, 3918
9, 13:06:00-000, 1132, 1130, 2, 2, 1348.00, 2, 1353.00, 1128
9, 13:09:00-000, 9252, 3712, 5540, 2, 1352.00, 2, 1353.00, 9248
9, 13:10:00-000, 1820, 780, 1040, 0, 0.00, 0, 0.00, 1820
9, 13:13:00-000, 1240, 0, 1240, 0, 0.00, 0, 0.00, 1240
9, 13:14:00-000, 9316, 3674, 5642, 6, 1350.67, 6, 1351.67, 9304
9, 13:15:00-000, 3050, 3050, 0, 0, 0.00, 0, 0.00, 3050
9, 13:16:00-000, 2300, 950, 1350, 0, 0.00, 0, 0.00, 2300
9, 13:17:00-000, 6450, 2340, 4110, 0, 0.00, 0, 0.00, 6450
9, 13:18:00-000, 670, 0, 670, 0, 0.00, 0, 0.00, 670
9, 13:19:00-000, 5750, 3750, 2000, 0, 0.00, 0, 0.00, 5750
9, 13:20:00-000, 2914, 44, 2870, 30, 1352.96, 30, 1353.00, 2854
9, 13:21:00-000, 3031, 1111, 1920, 1, 1353.00, 1, 1351.00, 3029
9, 13:22:00-000, 1150, 1150, 0, 0, 0.00, 0, 0.00, 1150
9, 13:23:00-000, 4113, 1663, 2450, 13, 1354.23, 13, 1351.00, 4087
9, 13:24:00-000, 9472, 4212, 5260, 9, 1351.56, 14, 1353.36, 9449
9, 13:25:00-000, 2235, 1005, 1230, 5, 1350.00, 0, 0.00, 2230
9, 13:26:00-000, 5113, 3730, 1383, 3, 1348.00, 3, 1348.67, 5107
9, 13:27:00-000, 9480, 6290, 3190, 0, 0.00, 0, 0.00, 9480
9, 13:28:00-000, 799, 780, 19, 19, 1348.00, 19, 1349.47, 761
9, 13:29:00-000, 5716, 906, 4810, 16, 1353.44, 16, 1353.00, 5684
9, 13:31:00-000, 2993, 2130, 863, 3, 1348.00, 3, 1350.00, 2987
9, 13:32:00-000, 4970, 4070, 900, 0, 0.00, 0, 0.00, 4970
9, 13:33:00-000, 12430, 8830, 3600, 0, 0.00, 0, 0.00, 12430
9, 13:34:00-000, 4260, 3020, 1240, 0, 0.00, 0, 0.00, 4260
9, 13:35:00-000, 869, 830, 39, 20, 1346.25, 20, 1346.45, 829
9, 13:36:00-000, 2500, 1660, 840, 0, 0.00, 0, 0.00, 2500
9, 13:38:00-000, 1220, 1220, 0, 0, 0.00, 0, 0.00, 1220
9, 13:39:00-000, 4620, 950, 3670, 0, 0.00, 0, 0.00, 4620
9, 13:40:00-000, 2170, 890, 1280, 0, 0.00, 0, 0.00, 2170
9, 13:41:00-000, 4353, 1813, 2540, 3, 1351.67, 3, 1352.00, 4347
9, 13:42:00-000, 6960, 4380, 2580, 20, 1348.00, 20, 1346.50, 6920
9, 13:43:00-000, 5551, 1, 5550, 1, 1350.00, 1, 1352.00, 5549
9, 13:44:00-000, 1021, 1, 1020, 1, 1353.00, 1, 1352.00, 1019
9, 13:45:00-000, 8570, 2940, 5630, 0, 0.00, 0, 0.00, 8570
9, 13:46:00-000, 6062, 2102, 3960, 2, 1354.00, 2, 1351.00, 6058
9, 13:47:00-000, 3420, 3410, 10, 10, 1347.00, 10, 1345.90, 3400
9, 13:48:00-000, 3090, 0, 3090, 0, 0.00, 0, 0.00, 3090
9, 13:50:00-000, 3130, 1770, 1360, 0, 0.00, 0, 0.00, 2640
9, 13:51:00-000, 10970, 3380, 7590, 0, 0.00, 0, 0.00, 11460
9, 13:52:00-000, 2611, 2590, 21, 11, 1346.09, 11, 1346.09, 2589
9, 13:54:00-000, 960, 0, 960, 0, 0.00, 0, 0.00, 960
9, 13:55:00-000, 2050, 2050, 0, 0, 0.00, 0, 0.00, 2050
9, 13:56:00-000, 3470, 2340, 1130, 0, 0.00, 0, 0.00, 3470
9, 13:57:00-000, 9204, 4822, 4382, 24, 1348.50, 24, 1349.50, 9156
9, 13:58:00-000, 4120, 3080, 1040, 0, 0.00, 0, 0.00, 4120
9, 13:59:00-000, 4991, 4230, 761, 8, 1348.00, 8, 1349.38, 4975
9, 14:00:00-000, 7750, 4140, 3610, 0, 0.00, 0, 0.00, 6960
9, 14:01:00-000, 4180, 4180, 0, 0, 0.00, 0, 0.00, 4970
9, 14:02:00-000, 4660, 2960, 1700, 0, 0.00, 0, 0.00, 4660
9, 14:03:00-000, 8720, 3940, 4780, 0, 0.00, 0, 0.00, 8720
9, 14:04:00-000, 2380, 1350, 1030, 47, 1348.00, 47, 1346.46, 2286
9, 14:05:00-000, 1420, 1420, 0, 0, 0.00, 0, 0.00, 1420
9, 14:06:00-000, 7176, 5216, 1960, 26, 1351.92, 26, 1352.00, 7124
9, 14:07:00-000, 4990, 2310, 2680, 0, 0.00, 0, 0.00, 4990
9, 14:08:00-000, 3432, 3430, 2, 2, 1349.00, 2, 1348.00, 3428
9, 14:09:00-000, 7950, 5770, 2180, 0, 0.00, 0, 0.00, 7660
9, 14:10:00-000, 3119, 1400, 1719, 9, 1350.33, 11, 1349.18, 3389
9, 14:11:00-000, 1113, 1112, 1, 3, 1353.00, 1, 1345.00, 1109
9, 14:12:00-000, 6120, 1470, 4650, 0, 0.00, 0, 0.00, 6120
9, 14:13:00-000, 4224, 3340, 884, 4, 1347.00, 4, 1347.75, 4216
9, 14:14:00-000, 3370, 840, 2530, 22, 1352.04, 22, 1352.00, 3326
9, 14:16:00-000, 10271, 4250, 6021, 1, 1350.00, 1, 1351.00, 10269
9, 14:17:00-000, 5000, 2640, 2360, 0, 0.00, 0, 0.00, 5000
9, 14:18:00-000, 7320, 3210, 4110, 0, 0.00, 0, 0.00, 7320
9, 14:19:00-000, 7762, 4232, 3530, 12, 1351.42, 12, 1350.00, 6178
9, 14:20:00-000, 11352, 8190, 3162, 2, 1347.00, 2, 1349.00, 12908
9, 14:21:00-000, 5400, 4520, 880, 0, 0.00, 0, 0.00, 5400
9, 14:22:00-000, 11100, 7660, 3440, 10, 1348.00, 10, 1346.30, 11080
9, 14:23:00-000, 4982, 1460, 3522, 2, 1347.00, 2, 1351.00, 4978
9, 14:24:00-000, 2780, 1230, 1550, 0, 0.00, 0, 0.00, 1230
9, 14:25:00-000, 5320, 1640, 3680, 0, 0.00, 0, 0.00, 6870
9, 14:26:00-000, 6150, 1310, 4840, 0, 0.00, 10, 1352.00, 6140
9, 14:27:00-000, 4773, 2153, 2620, 10, 1350.70, 0, 0.00, 4763
9, 14:28:00-000, 6591, 1221, 5370, 1, 1353.00, 1, 1351.00, 5369
9, 14:29:00-000, 4170, 4170, 0, 0, 0.00, 0, 0.00, 5390
9, 14:30:00-000, 4289, 1799, 2490, 9, 1351.00, 9, 1351.00, 4271
9, 14:31:00-000, 9590, 3610, 5980, 0, 0.00, 0, 0.00, 9590
9, 14:32:00-000, 2190, 0, 2190, 0, 0.00, 0, 0.00, 2190
9, 14:33:00-000, 6860, 4490, 2370, 0, 0.00, 0, 0.00, 5900
9, 14:34:00-000, 9529, 3889, 5640, 9, 1351.00, 9, 1352.00, 10471
9, 14:35:00-000, 2210, 1410, 800, 0, 0.00, 0, 0.00, 2210
9, 14:36:00-000, 5320, 2660, 2660, 0, 0.00, 0, 0.00, 5320
9, 14:37:00-000, 7121, 6150, 971, 1, 1348.00, 1, 1349.00, 7119
9, 14:38:00-000, 10240, 7060, 3180, 0, 0.00, 0, 0.00, 10240
9, 14:39:00-000, 3410, 1400, 2010, 0, 0.00, 0, 0.00, 3410
9, 14:42:00-000, 2100, 0, 2100, 0, 0.00, 0, 0.00, 2100
9, 14:43:00-000, 5303, 3330, 1973, 3, 1348.00, 3, 1350.00, 5297
9, 14:44:00-000, 7149, 2532, 4617, 32, 1349.72, 32, 1349.94, 7085
9, 14:45:00-000, 7723, 5280, 2443, 3, 1345.00, 3, 1349.00, 7717
9, 14:46:00-000, 7715, 2625, 5090, 5, 1356.00, 5, 1351.00, 7705
9, 14:47:00-000, 3590, 2480, 1110, 0, 0.00, 0, 0.00, 3590
9, 14:48:00-000, 6280, 2840, 3440, 0, 0.00, 0, 0.00, 6280
9, 14:49:00-000, 6845, 3963, 2882, 9, 1349.89, 9, 1351.33, 6827
9, 14:50:00-000, 6630, 4090, 2540, 0, 0.00, 0, 0.00, 6630
9, 14:51:00-000, 3750, 2810, 940, 0, 0.00, 0, 0.00, 3750
9, 14:52:00-000, 2080, 1460, 620, 0, 0.00, 0, 0.00, 2080
9, 14:54:00-000, 4320, 4320, 0, 0, 0.00, 0, 0.00, 4320
9, 14:55:00-000, 4890, 1230, 3660, 0, 0.00, 0, 0.00, 4890
9, 14:56:00-000, 2644, 884, 1760, 14, 1353.00, 14, 1352.00, 2616
9, 14:57:00-000, 101, 100, 1, 1, 1347.00, 1, 1349.00, 99
9, 14:58:00-000, 930, 930, 0, 0, 0.00, 0, 0.00, 930
9, 14:59:00-000, 1140, 1140, 0, 0, 0.00, 0, 0.00, 1140
9, 15:00:00-000, 7770, 4060, 3710, 0, 0.00, 0, 0.00, 6890
9, 15:01:00-000, 2374, 220, 2154, 4, 1346.00, 4, 1352.00, 3246
9, 15:02:00-000, 2730, 1340, 1390, 0, 0.00, 0, 0.00, 2730
9, 15:03:00-000, 803, 3, 800, 3, 1353.00, 3, 1353.00, 797
9, 15:04:00-000, 13785, 7035, 6750, 5, 1351.40, 5, 1352.00, 13775
9, 15:05:00-000, 11620, 4870, 6750, 10, 1355.80, 10, 1351.00, 11600
9, 15:06:00-000, 1900, 1900, 0, 0, 0.00, 0, 0.00, 1900
9, 15:08:00-000, 910, 0, 910, 0, 0.00, 0, 0.00, 0
9, 15:09:00-000, 1400, 0, 1400, 0, 0.00, 0, 0.00, 2310
9, 15:10:00-000, 3173, 1943, 1230, 3, 1354.00, 3, 1354.00, 3167
9, 15:11:00-000, 5920, 820, 5100, 0, 0.00, 0, 0.00, 5920
9, 15:12:00-000, 9451, 2165, 7286, 11, 1349.82, 9, 1351.22, 9431
9, 15:13:00-000, 8858, 3690, 5168, 6, 1346.00, 8, 1347.25, 8844
9, 15:14:00-000, 8380, 4830, 3550, 0, 0.00, 0, 0.00, 8380
9, 15:16:00-000, 5330, 2000, 3330, 0, 0.00, 0, 0.00, 4500
9, 15:17:00-000, 0, 0, 0, 0, 0.00, 0, 0.00, 830
9, 15:18:00-000, 4070, 1610, 2460, 0, 0.00, 0, 0.00, 4070
9, 15:20:00-000, 4270, 2380, 1890, 0, 0.00, 0, 0.00, 4270
9, 15:21:00-000, 8210, 2340, 5870, 0, 0.00, 0, 0.00, 8210
9, 15:22:00-000, 1903, 953, 950, 3, 1347.00, 3, 1351.00, 1897
9, 15:23:00-000, 7370, 3610, 3760, 0, 0.00, 0, 0.00, 7370
9, 15:24:00-000, 910, 0, 910, 0, 0.00, 0, 0.00, 910
9, 15:25:00-000, 3207, 875, 2332, 15, 1351.93, 15, 1352.20, 3177
9, 15:26:00-000, 7169, 3803, 3366, 9, 1347.78, 5, 1351.80, 7155
9, 15:27:00-000, 2474, 2470, 4, 0, 0.00, 4, 1348.50, 2470
9, 15:28:00-000, 5440, 4360, 1080, 0, 0.00, 0, 0.00, 5440
9, 15:29:00-000, 7239, 4900, 2339, 20, 1346.15, 20, 1345.70, 7199
9, 15:30:00-000, 8195, 5914, 2281, 51, 1348.00, 51, 1348.62, 8093
9, 15:32:00-000, 6200, 3460, 2740, 0, 0.00, 0, 0.00, 6200
9, 15:35:00-000, 1930, 1930, 0, 0, 0.00, 0, 0.00, 1930
9, 15:36:00-000, 4682, 1612, 3070, 6, 1350.50, 11, 1352.82, 4665
9, 15:37:00-000, 7, 6, 1, 6, 1356.00, 1, 1347.00, 0
9, 15:38:00-000, 7250, 4380, 2870, 0, 0.00, 0, 0.00, 7250
9, 15:39:00-000, 3570, 1850, 1720, 0, 0.00, 0, 0.00, 3570
9, 15:41:00-000, 2348, 918, 1430, 8, 1351.00, 8, 1352.00, 2332
9, 15:43:00-000, 6810, 2510, 4300, 0, 0.00, 0, 0.00, 6810
9, 15:44:00-000, 2310, 980, 1330, 0, 0.00, 0, 0.00, 2310
9, 15:45:00-000, 6530, 1020, 5510, 0, 0.00, 0, 0.00, 5620
9, 15:46:00-000, 3748, 848, 2900, 8, 1352.00, 8, 1352.00, 4642
9, 15:47:00-000, 4510, 3750, 760, 0, 0.00, 0, 0.00, 4510
9, 15:48:00-000, 670, 670, 0, 0, 0.00, 0, 0.00, 670
9, 15:49:00-000, 1521, 1, 1520, 1, 1354.00, 1, 1352.00, 1519
9, 15:50:00-000, 8636, 4976, 3660, 8, 1350.00, 16, 1352.00, 8612
9, 15:51:00-000, 2814, 1484, 1330, 8, 1352.25, 0, 0.00, 2806
9, 15:52:00-000, 2510, 1020, 1490, 0, 0.00, 0, 0.00, 2510
9, 15:53:00-000, 1391, 1390, 1, 1, 1348.00, 1, 1351.00, 1389
9, 15:54:00-000, 3630, 2330, 1300, 8, 1350.38, 20, 1353.00, 3602
9, 15:55:00-000, 12, 12, 0, 12, 1355.00, 0, 0.00, 0
9, 16:01:00-000, 1250, 1250, 0, 0, 0.00, 0, 0.00, 1250
9, 16:02:00-000, 2081, 1100, 981, 1, 1349.00, 1, 1348.00, 2079
9, 16:03:00-000, 940, 0, 940, 0, 0.00, 0, 0.00, 940
9, 16:04:00-000, 2431, 1330, 1101, 1, 1347.00, 1, 1350.00, 2429
9, 16:05:00-000, 3442, 2, 3440, 2, 1351.00, 2, 1351.00, 3438
9, 16:06:00-000, 7125, 2295, 4830, 15, 1355.00, 15, 1352.00, 7095
9, 16:08:00-000, 4959, 4950, 9, 9, 1348.00, 9, 1346.00, 4941
9, 16:10:00-000, 830, 0, 830, 0, 0.00, 0, 0.00, 830
9, 16:12:00-000, 760, 760, 0, 0, 0.00, 0, 0.00, 760
9, 16:13:00-000, 3303, 3, 3300, 3, 1351.00, 3, 1352.00, 3297
9, 16:14:00-000, 7690, 6670, 1020, 60, 1346.36, 21, 1348.14, 7609
9, 16:15:00-000, 121, 0, 121, 0, 0.00, 39, 1347.36, 82
9, 16:16:00-000, 2130, 0, 2130, 0, 0.00, 0, 0.00, 2130
9, 16:17:00-000, 3020, 2080, 940, 0, 0.00, 0, 0.00, 3020
9, 16:18:00-000, 3305, 35, 3270, 35, 1353.94, 35, 1351.00, 3235
9, 16:19:00-000, 1080, 0, 1080, 0, 0.00, 0, 0.00, 1080
9, 16:20:00-000, 3117, 3110, 7, 7, 1347.00, 7, 1349.43, 3103
9, 16:21:00-000, 2910, 1050, 1860, 0, 0.00, 0, 0.00, 2910
9, 16:22:00-000, 2560, 1540, 1020, 0, 0.00, 0, 0.00, 2560
9, 16:23:00-000, 8250, 2410, 5840, 0, 0.00, 0, 0.00, 8250
9, 16:24:00-000, 2624, 4, 2620, 4, 1355.00, 4, 1352.00, 2616
9, 16:25:00-000, 7944, 4840, 3104, 4, 1348.00, 5, 1349.60, 7935
9, 16:26:00-000, 5451, 5451, 0, 1, 1352.00, 0, 0.00, 5450
9, 16:27:00-000, 8297, 5250, 3047, 17, 1345.59, 17, 1345.88, 8263
9, 16:28:00-000, 7359, 3090, 4269, 79, 1348.63, 79, 1346.31, 7201
9, 16:29:00-000, 10320, 5420, 4900, 0, 0.00, 6, 1353.00, 10314
