TraderType,Time,EnterQty,BuyEnterQty,SellEnterQty,BuyExecutedQty,BuyExecutedPx,SellExecutedQty,SellExecutedPx,CanceledQty
1, 09:06:00-000, 3038, 3038, 0, 838, 1348.13, 0, 0.00, 0
1, 09:07:00-000, 0, 0, 0, 0, 0.00, 0, 0.00, 2195
1, 09:08:00-000, 0, 0, 0, 0, 0.00, 0, 0.00, 5
1, 09:13:00-000, 3133, 2295, 838, 994, 1347.99, 838, 1347.42, 0
1, 09:14:00-000, 14, 9, 5, 0, 0.00, 5, 1347.00, 1301
1, 09:15:00-000, 20, 10, 10, 1, 1351.00, 10, 1352.40, 9
1, 09:16:00-000, 204, 125, 79, 63, 1347.64, 79, 1351.75, 30
1, 09:17:00-000, 166, 120, 46, 67, 1348.72, 46, 1349.34, 34
1, 09:18:00-000, 576, 393, 183, 145, 1348.81, 183, 1352.13, 102
1, 09:19:00-000, 333, 208, 125, 98, 1348.26, 125, 1351.98, 189
1, 09:20:00-000, 781, 589, 192, 202, 1349.96, 191, 1352.13, 208
1, 09:21:00-000, 343, 231, 112, 140, 1349.96, 113, 1350.07, 250
1, 09:22:00-000, 623, 399, 224, 214, 1348.46, 222, 1349.80, 164
1, 09:23:00-000, 311, 219, 92, 86, 1350.23, 94, 1351.78, 164
1, 09:24:00-000, 561, 380, 181, 132, 1351.11, 177, 1357.74, 151
1, 09:25:00-000, 344, 222, 122, 135, 1348.91, 123, 1349.60, 178
1, 09:26:00-000, 580, 422, 158, 205, 1349.42, 161, 1350.98, 218
1, 09:27:00-000, 339, 243, 96, 114, 1349.10, 96, 1348.83, 142
1, 09:28:00-000, 676, 476, 200, 212, 1348.04, 200, 1348.64, 208
1, 09:29:00-000, 279, 181, 98, 77, 1348.82, 98, 1350.31, 173
1, 09:30:00-000, 637, 436, 201, 241, 1348.06, 201, 1348.42, 133
1, 09:31:00-000, 308, 209, 99, 73, 1348.84, 99, 1352.75, 155
1, 09:32:00-000, 625, 427, 198, 261, 1349.31, 198, 1349.21, 172
1, 09:33:00-000, 294, 205, 89, 134, 1348.71, 88, 1349.23, 128
1, 09:34:00-000, 624, 466, 158, 199, 1348.42, 159, 1348.20, 139
1, 09:35:00-000, 305, 191, 114, 129, 1348.15, 114, 1347.72, 189
1, 09:36:00-000, 648, 380, 268, 228, 1348.10, 268, 1347.69, 92
1, 09:37:00-000, 289, 191, 98, 94, 1348.98, 98, 1349.65, 148
1, 09:38:00-000, 668, 429, 239, 247, 1347.98, 239, 1347.93, 143
1, 09:39:00-000, 286, 190, 96, 110, 1349.00, 96, 1349.81, 130
1, 09:40:00-000, 614, 394, 220, 265, 1348.22, 220, 1348.45, 119
1, 09:41:00-000, 304, 208, 96, 123, 1347.35, 96, 1346.88, 90
1, 09:42:00-000, 620, 347, 273, 248, 1347.10, 273, 1346.79, 105
1, 09:43:00-000, 282, 167, 115, 98, 1349.26, 115, 1349.54, 88
1, 09:44:00-000, 645, 442, 203, 270, 1348.26, 203, 1347.51, 83
1, 09:45:00-000, 318, 190, 128, 161, 1347.48, 128, 1346.96, 137
1, 09:46:00-000, 613, 420, 193, 257, 1348.75, 193, 1348.41, 80
1, 09:47:00-000, 348, 200, 148, 154, 1348.26, 148, 1348.23, 98
1, 09:48:00-000, 593, 334, 259, 236, 1348.24, 259, 1347.46, 80
1, 09:49:00-000, 357, 227, 130, 152, 1347.60, 130, 1347.06, 91
1, 09:50:00-000, 680, 359, 321, 309, 1347.48, 321, 1347.08, 76
1, 09:51:00-000, 290, 158, 132, 138, 1346.92, 132, 1346.77, 46
1, 09:52:00-000, 609, 349, 260, 214, 1348.29, 260, 1347.70, 58
1, 09:53:00-000, 308, 169, 139, 123, 1346.60, 139, 1347.22, 92
1, 09:54:00-000, 705, 406, 299, 298, 1347.38, 299, 1346.64, 65
1, 09:55:00-000, 269, 170, 99, 101, 1347.75, 99, 1347.43, 96
1, 09:56:00-000, 573, 335, 238, 256, 1348.14, 238, 1347.40, 103
1, 09:57:00-000, 308, 194, 114, 86, 1348.96, 114, 1348.80, 60
1, 09:58:00-000, 663, 389, 274, 275, 1348.07, 274, 1347.23, 146
1, 09:59:00-000, 302, 170, 132, 138, 1346.75, 132, 1346.22, 60
1, 10:00:00-000, 590, 352, 238, 288, 1347.03, 238, 1346.69, 55
1, 10:01:00-000, 363, 220, 143, 137, 1348.23, 143, 1347.85, 56
1, 10:02:00-000, 687, 427, 260, 257, 1348.77, 260, 1348.20, 113
1, 10:03:00-000, 273, 162, 111, 108, 1348.11, 111, 1348.04, 122
1, 10:04:00-000, 531, 346, 185, 209, 1347.78, 185, 1347.34, 89
1, 10:05:00-000, 314, 184, 130, 132, 1348.14, 130, 1347.80, 96
1, 10:06:00-000, 691, 374, 317, 307, 1348.05, 317, 1346.82, 73
1, 10:07:00-000, 353, 195, 158, 148, 1347.70, 158, 1346.79, 51
1, 10:08:00-000, 635, 366, 269, 231, 1348.41, 269, 1348.53, 76
1, 10:09:00-000, 308, 184, 124, 132, 1347.17, 124, 1348.00, 98
1, 10:10:00-000, 648, 362, 286, 280, 1347.98, 286, 1347.36, 73
1, 10:11:00-000, 307, 201, 106, 139, 1348.00, 106, 1347.96, 74
1, 10:12:00-000, 597, 386, 211, 245, 1347.33, 211, 1346.74, 97
1, 10:13:00-000, 378, 211, 167, 126, 1348.47, 167, 1347.29, 115
1, 10:14:00-000, 648, 397, 251, 309, 1347.02, 251, 1346.60, 73
1, 10:15:00-000, 343, 187, 156, 127, 1346.48, 156, 1346.21, 96
1, 10:16:00-000, 617, 378, 239, 278, 1347.43, 239, 1346.39, 84
1, 10:17:00-000, 255, 140, 115, 89, 1347.37, 115, 1346.22, 70
1, 10:18:00-000, 664, 385, 279, 266, 1347.63, 279, 1347.18, 90
1, 10:19:00-000, 299, 169, 130, 136, 1348.69, 130, 1348.47, 83
1, 10:20:00-000, 590, 311, 279, 229, 1348.03, 279, 1347.11, 56
1, 10:21:00-000, 299, 189, 110, 109, 1348.63, 110, 1348.24, 71
1, 10:22:00-000, 613, 316, 297, 257, 1346.86, 297, 1346.35, 59
1, 10:23:00-000, 316, 181, 135, 141, 1347.31, 135, 1346.70, 75
1, 10:24:00-000, 628, 389, 239, 254, 1348.38, 239, 1348.53, 81
1, 10:25:00-000, 272, 146, 126, 91, 1347.69, 126, 1348.05, 91
1, 10:26:00-000, 597, 371, 226, 252, 1348.76, 226, 1347.40, 62
1, 10:27:00-000, 289, 201, 88, 108, 1348.27, 88, 1347.62, 104
1, 10:28:00-000, 647, 359, 288, 276, 1347.68, 288, 1347.13, 121
1, 10:29:00-000, 243, 159, 84, 78, 1348.36, 84, 1348.12, 53
1, 10:30:00-000, 642, 378, 264, 232, 1347.59, 264, 1347.14, 124
1, 10:31:00-000, 396, 216, 180, 184, 1347.98, 180, 1346.96, 106
1, 10:32:00-000, 624, 369, 255, 255, 1347.24, 255, 1347.39, 65
1, 10:33:00-000, 331, 204, 127, 144, 1348.36, 127, 1347.26, 82
1, 10:34:00-000, 592, 336, 256, 265, 1347.86, 256, 1347.20, 55
1, 10:35:00-000, 268, 170, 98, 97, 1348.43, 98, 1347.94, 88
1, 10:36:00-000, 629, 360, 269, 267, 1347.86, 269, 1347.34, 85
1, 10:37:00-000, 328, 178, 150, 114, 1348.30, 150, 1347.95, 82
1, 10:38:00-000, 547, 315, 232, 231, 1348.07, 232, 1347.53, 81
1, 10:39:00-000, 317, 193, 124, 147, 1348.07, 124, 1347.06, 61
1, 10:40:00-000, 688, 387, 301, 270, 1347.91, 301, 1347.09, 80
1, 10:41:00-000, 310, 185, 125, 102, 1347.60, 125, 1347.16, 91
1, 10:42:00-000, 517, 350, 167, 243, 1348.43, 167, 1347.97, 97
1, 10:43:00-000, 326, 199, 127, 110, 1348.54, 127, 1347.63, 76
1, 10:44:00-000, 604, 346, 258, 247, 1348.52, 258, 1348.15, 112
1, 10:45:00-000, 404, 249, 155, 146, 1348.56, 155, 1347.20, 80
1, 10:46:00-000, 614, 396, 218, 228, 1348.20, 218, 1348.41, 151
1, 10:47:00-000, 309, 182, 127, 112, 1347.44, 127, 1347.45, 116
1, 10:48:00-000, 561, 338, 223, 239, 1347.92, 223, 1347.82, 99
1, 10:49:00-000, 340, 224, 116, 133, 1349.00, 116, 1349.43, 68
1, 10:50:00-000, 689, 405, 284, 318, 1348.06, 280, 1347.67, 84
1, 10:51:00-000, 294, 184, 110, 129, 1347.66, 114, 1347.95, 93
1, 10:52:00-000, 670, 427, 243, 292, 1348.43, 243, 1347.61, 107
1, 10:53:00-000, 311, 206, 105, 102, 1348.78, 105, 1348.31, 82
1, 10:54:00-000, 621, 331, 290, 259, 1347.43, 290, 1347.32, 127
1, 10:55:00-000, 329, 186, 143, 124, 1347.27, 143, 1347.73, 56
1, 10:56:00-000, 662, 365, 297, 246, 1347.11, 297, 1345.94, 85
1, 10:57:00-000, 291, 200, 91, 128, 1348.26, 91, 1347.48, 97
1, 10:58:00-000, 632, 371, 261, 250, 1347.58, 261, 1346.99, 105
1, 10:59:00-000, 229, 131, 98, 113, 1347.84, 98, 1347.02, 85
1, 11:00:00-000, 703, 409, 294, 286, 1348.00, 294, 1347.82, 41
1, 11:01:00-000, 329, 195, 134, 148, 1347.94, 134, 1346.67, 84
1, 11:02:00-000, 644, 428, 216, 218, 1349.05, 216, 1348.46, 101
1, 11:03:00-000, 326, 195, 131, 110, 1347.75, 131, 1347.71, 156
1, 11:04:00-000, 597, 339, 258, 222, 1347.57, 258, 1347.76, 135
1, 11:05:00-000, 276, 152, 124, 123, 1347.39, 124, 1347.23, 73
1, 11:06:00-000, 601, 329, 272, 193, 1347.76, 272, 1347.27, 75
1, 11:07:00-000, 270, 145, 125, 101, 1348.18, 125, 1346.93, 105
1, 11:08:00-000, 663, 336, 327, 254, 1347.03, 327, 1346.42, 53
1, 11:09:00-000, 293, 217, 76, 78, 1350.61, 76, 1349.53, 81
1, 11:10:00-000, 643, 455, 188, 298, 1349.26, 188, 1348.87, 134
1, 11:11:00-000, 333, 201, 132, 162, 1348.84, 132, 1347.91, 116
1, 11:12:00-000, 612, 378, 234, 231, 1348.74, 234, 1348.42, 98
1, 11:13:00-000, 302, 201, 101, 105, 1349.06, 101, 1348.48, 119
1, 11:14:00-000, 608, 344, 264, 286, 1348.25, 264, 1347.27, 108
1, 11:15:00-000, 294, 196, 98, 101, 1349.32, 98, 1349.35, 61
1, 11:16:00-000, 664, 391, 273, 283, 1348.28, 273, 1348.16, 88
1, 11:17:00-000, 303, 173, 130, 121, 1348.34, 130, 1347.47, 100
1, 11:18:00-000, 661, 460, 201, 267, 1348.87, 201, 1348.03, 110
1, 11:19:00-000, 363, 244, 119, 142, 1347.79, 119, 1346.99, 119
1, 11:20:00-000, 592, 339, 253, 246, 1347.88, 253, 1347.83, 131
1, 11:21:00-000, 344, 200, 144, 133, 1348.69, 144, 1346.74, 89
1, 11:22:00-000, 528, 333, 195, 212, 1347.87, 195, 1347.38, 89
1, 11:23:00-000, 373, 209, 164, 147, 1347.86, 164, 1347.32, 101
1, 11:24:00-000, 689, 394, 295, 292, 1347.95, 295, 1346.75, 72
1, 11:25:00-000, 297, 159, 138, 96, 1348.45, 138, 1347.43, 78
1, 11:26:00-000, 568, 365, 203, 212, 1348.49, 203, 1348.16, 107
1, 11:27:00-000, 370, 196, 174, 141, 1347.37, 174, 1347.98, 105
1, 11:28:00-000, 676, 393, 283, 262, 1347.03, 283, 1347.21, 77
1, 11:29:00-000, 296, 174, 122, 116, 1348.54, 122, 1348.39, 113
1, 11:30:00-000, 515, 306, 209, 194, 1347.98, 209, 1347.78, 85
1, 11:31:00-000, 350, 232, 118, 124, 1348.48, 118, 1348.60, 87
1, 11:32:00-000, 548, 317, 231, 256, 1347.50, 231, 1346.95, 99
1, 11:33:00-000, 358, 222, 136, 158, 1347.29, 136, 1347.52, 80
1, 11:34:00-000, 596, 352, 244, 255, 1347.63, 244, 1347.15, 74
1, 11:35:00-000, 279, 159, 120, 126, 1347.95, 120, 1347.29, 65
1, 11:36:00-000, 637, 370, 267, 267, 1348.05, 267, 1347.10, 66
1, 11:37:00-000, 285, 162, 123, 98, 1348.10, 123, 1348.05, 89
1, 11:38:00-000, 515, 307, 208, 202, 1347.69, 208, 1347.26, 77
1, 11:39:00-000, 364, 204, 160, 123, 1346.68, 160, 1346.15, 90
1, 11:40:00-000, 569, 367, 202, 271, 1347.71, 202, 1346.70, 97
1, 11:41:00-000, 310, 171, 139, 145, 1348.64, 139, 1347.29, 84
1, 11:42:00-000, 688, 424, 264, 273, 1347.66, 264, 1347.73, 73
1, 11:43:00-000, 274, 152, 122, 110, 1347.28, 122, 1347.52, 93
1, 11:44:00-000, 571, 341, 230, 239, 1348.55, 230, 1348.65, 61
1, 11:45:00-000, 280, 157, 123, 119, 1348.06, 123, 1347.58, 81
1, 11:46:00-000, 627, 331, 296, 214, 1347.31, 296, 1347.37, 55
1, 11:47:00-000, 287, 185, 102, 133, 1348.31, 102, 1347.53, 102
1, 11:48:00-000, 646, 397, 249, 255, 1348.31, 249, 1347.74, 98
1, 11:49:00-000, 337, 178, 159, 148, 1347.24, 159, 1346.21, 101
1, 11:50:00-000, 704, 492, 212, 279, 1348.02, 212, 1347.26, 72
1, 11:51:00-000, 309, 185, 124, 174, 1347.67, 124, 1347.00, 131
1, 11:52:00-000, 581, 299, 282, 228, 1347.43, 282, 1346.68, 84
1, 11:53:00-000, 295, 199, 96, 84, 1349.03, 96, 1348.56, 47
1, 11:54:00-000, 672, 389, 283, 306, 1347.73, 283, 1347.05, 106
1, 11:55:00-000, 350, 232, 118, 156, 1347.94, 118, 1347.67, 88
1, 11:56:00-000, 648, 369, 279, 243, 1347.84, 279, 1347.64, 109
1, 11:57:00-000, 292, 169, 123, 120, 1348.08, 123, 1347.62, 98
1, 11:58:00-000, 573, 315, 258, 220, 1347.17, 254, 1346.52, 56
1, 11:59:00-000, 291, 188, 103, 117, 1348.27, 107, 1348.53, 78
1, 12:00:00-000, 691, 371, 320, 296, 1347.32, 320, 1346.36, 88
1, 12:01:00-000, 279, 171, 108, 143, 1347.62, 108, 1347.05, 73
1, 12:02:00-000, 662, 394, 268, 299, 1347.31, 268, 1346.02, 42
1, 12:03:00-000, 257, 170, 87, 126, 1347.53, 87, 1347.51, 61
1, 12:04:00-000, 512, 331, 181, 232, 1349.09, 181, 1347.88, 57
1, 12:05:00-000, 349, 215, 134, 120, 1348.80, 134, 1348.05, 96
1, 12:06:00-000, 575, 286, 289, 226, 1348.01, 289, 1347.59, 102
1, 12:07:00-000, 323, 140, 183, 127, 1346.14, 183, 1345.50, 55
1, 12:08:00-000, 656, 361, 295, 239, 1347.74, 295, 1347.29, 49
1, 12:09:00-000, 255, 180, 75, 102, 1347.88, 75, 1347.56, 73
1, 12:10:00-000, 617, 358, 259, 275, 1347.78, 259, 1347.44, 79
1, 12:11:00-000, 310, 188, 122, 100, 1347.37, 122, 1347.20, 96
1, 12:12:00-000, 587, 323, 264, 258, 1348.22, 264, 1347.48, 94
1, 12:13:00-000, 291, 158, 133, 104, 1348.74, 133, 1348.37, 61
1, 12:14:00-000, 649, 421, 228, 250, 1347.39, 228, 1347.66, 95
1, 12:15:00-000, 371, 269, 102, 146, 1349.15, 102, 1348.30, 113
1, 12:16:00-000, 528, 320, 208, 232, 1347.82, 208, 1347.62, 118
1, 12:17:00-000, 313, 185, 128, 148, 1348.26, 128, 1347.41, 102
1, 12:18:00-000, 594, 354, 240, 259, 1348.45, 240, 1347.28, 54
1, 12:19:00-000, 324, 198, 126, 125, 1349.23, 126, 1349.09, 64
1, 12:20:00-000, 633, 375, 258, 241, 1348.88, 258, 1347.54, 112
1, 12:21:00-000, 242, 145, 97, 106, 1348.38, 97, 1347.57, 95
1, 12:22:00-000, 637, 349, 288, 198, 1348.41, 288, 1346.64, 110
1, 12:23:00-000, 323, 183, 140, 101, 1347.84, 140, 1347.04, 101
1, 12:24:00-000, 673, 380, 293, 281, 1348.22, 293, 1347.42, 95
1, 12:25:00-000, 267, 160, 107, 118, 1347.63, 107, 1347.25, 83
1, 12:26:00-000, 663, 405, 258, 277, 1347.65, 258, 1347.06, 80
1, 12:27:00-000, 240, 136, 104, 92, 1348.57, 104, 1347.27, 91
1, 12:28:00-000, 574, 385, 189, 206, 1348.82, 189, 1347.63, 92
1, 12:29:00-000, 319, 198, 121, 135, 1348.16, 121, 1348.00, 120
1, 12:30:00-000, 570, 347, 223, 235, 1347.63, 223, 1347.55, 77
1, 12:31:00-000, 261, 174, 87, 123, 1348.60, 87, 1347.71, 89
1, 12:32:00-000, 631, 349, 282, 280, 1347.95, 282, 1346.49, 64
1, 12:33:00-000, 361, 210, 151, 106, 1347.51, 151, 1347.64, 74
1, 12:34:00-000, 627, 358, 269, 278, 1348.11, 269, 1347.08, 121
1, 12:35:00-000, 252, 149, 103, 91, 1347.95, 103, 1347.11, 61
1, 12:36:00-000, 587, 349, 238, 204, 1347.76, 238, 1347.00, 82
1, 12:37:00-000, 331, 201, 130, 137, 1347.74, 130, 1346.91, 110
1, 12:38:00-000, 669, 428, 241, 241, 1348.00, 241, 1347.56, 89
1, 12:39:00-000, 300, 158, 142, 134, 1347.30, 142, 1347.49, 141
1, 12:40:00-000, 603, 376, 227, 219, 1348.37, 227, 1347.86, 80
1, 12:41:00-000, 308, 199, 109, 115, 1347.90, 109, 1347.50, 138
1, 12:42:00-000, 615, 361, 254, 262, 1346.95, 254, 1346.64, 75
1, 12:43:00-000, 280, 156, 124, 107, 1347.18, 124, 1346.39, 103
1, 12:44:00-000, 635, 386, 249, 240, 1348.01, 249, 1347.56, 64
1, 12:45:00-000, 303, 162, 141, 100, 1347.51, 141, 1348.34, 134
1, 12:46:00-000, 533, 358, 175, 206, 1347.88, 175, 1347.43, 97
1, 12:47:00-000, 284, 151, 133, 112, 1347.80, 133, 1347.13, 87
1, 12:48:00-000, 697, 446, 251, 298, 1347.52, 251, 1347.10, 97
1, 12:49:00-000, 330, 214, 116, 150, 1348.78, 116, 1347.97, 114
1, 12:50:00-000, 579, 377, 202, 239, 1348.33, 202, 1347.89, 86
1, 12:51:00-000, 281, 162, 119, 100, 1348.47, 119, 1347.56, 114
1, 12:52:00-000, 606, 344, 262, 270, 1347.76, 262, 1347.03, 87
1, 12:53:00-000, 251, 162, 89, 89, 1347.79, 89, 1347.31, 57
1, 12:54:00-000, 564, 300, 264, 242, 1347.10, 264, 1345.99, 78
1, 12:55:00-000, 376, 244, 132, 129, 1347.89, 132, 1347.29, 63
1, 12:56:00-000, 559, 346, 213, 216, 1348.79, 213, 1347.90, 139
1, 12:57:00-000, 319, 189, 130, 120, 1348.68, 130, 1347.91, 81
1, 12:58:00-000, 596, 341, 255, 272, 1347.83, 255, 1347.51, 99
1, 12:59:00-000, 345, 199, 146, 139, 1348.24, 146, 1348.27, 57
1, 13:00:00-000, 509, 294, 215, 235, 1347.74, 215, 1347.12, 65
1, 13:01:00-000, 335, 220, 115, 120, 1348.60, 115, 1348.30, 47
1, 13:02:00-000, 725, 425, 300, 332, 1347.70, 300, 1347.67, 84
1, 13:03:00-000, 280, 189, 91, 118, 1349.00, 91, 1348.28, 111
1, 13:04:00-000, 575, 360, 215, 255, 1347.98, 215, 1346.75, 75
1, 13:05:00-000, 324, 176, 148, 139, 1348.74, 148, 1347.70, 86
1, 13:06:00-000, 650, 384, 266, 260, 1347.65, 266, 1347.43, 64
1, 13:07:00-000, 281, 145, 136, 119, 1347.50, 136, 1346.99, 101
1, 13:08:00-000, 674, 417, 257, 350, 1347.09, 257, 1346.09, 58
1, 13:09:00-000, 357, 218, 139, 158, 1348.69, 139, 1348.27, 48
1, 13:10:00-000, 607, 327, 280, 242, 1347.34, 280, 1347.67, 83
1, 13:11:00-000, 297, 177, 120, 107, 1348.25, 120, 1347.10, 65
1, 13:12:00-000, 677, 382, 295, 293, 1347.66, 295, 1347.06, 82
1, 13:13:00-000, 308, 173, 135, 125, 1347.11, 135, 1346.60, 64
1, 13:14:00-000, 703, 370, 333, 287, 1347.32, 333, 1346.45, 51
1, 13:15:00-000, 358, 210, 148, 181, 1347.38, 148, 1346.87, 59
1, 13:16:00-000, 657, 436, 221, 264, 1348.85, 221, 1348.49, 93
1, 13:17:00-000, 329, 177, 152, 150, 1348.05, 152, 1347.38, 98
1, 13:18:00-000, 545, 343, 202, 222, 1347.90, 202, 1348.17, 91
1, 13:19:00-000, 357, 213, 144, 143, 1348.37, 144, 1347.88, 80
1, 13:20:00-000, 752, 411, 341, 302, 1347.80, 341, 1347.35, 90
1, 13:21:00-000, 337, 196, 141, 134, 1347.51, 141, 1347.82, 99
1, 13:22:00-000, 663, 354, 309, 292, 1348.20, 309, 1347.57, 50
1, 13:23:00-000, 244, 154, 90, 121, 1347.76, 90, 1348.04, 73
1, 13:24:00-000, 590, 296, 294, 248, 1347.02, 294, 1346.77, 39
1, 13:25:00-000, 322, 170, 152, 112, 1347.64, 152, 1346.06, 43
1, 13:26:00-000, 686, 386, 300, 276, 1347.40, 300, 1346.33, 71
1, 13:27:00-000, 247, 129, 118, 106, 1346.86, 118, 1346.79, 87
1, 13:28:00-000, 621, 365, 256, 216, 1347.53, 256, 1347.05, 73
1, 13:29:00-000, 269, 137, 132, 91, 1347.60, 132, 1346.78, 103
1, 13:30:00-000, 624, 374, 250, 195, 1348.18, 250, 1348.00, 110
1, 13:31:00-000, 348, 213, 135, 159, 1348.45, 135, 1347.19, 113
1, 13:32:00-000, 599, 315, 284, 205, 1347.47, 284, 1347.46, 97
1, 13:33:00-000, 286, 214, 72, 77, 1348.47, 72, 1348.46, 77
1, 13:34:00-000, 564, 345, 219, 230, 1348.42, 219, 1347.77, 140
1, 13:35:00-000, 262, 177, 85, 103, 1347.80, 85, 1346.81, 87
1, 13:36:00-000, 659, 440, 219, 290, 1348.34, 219, 1347.85, 127
1, 13:37:00-000, 324, 233, 91, 128, 1349.22, 91, 1348.85, 108
1, 13:38:00-000, 589, 362, 227, 284, 1347.88, 227, 1348.12, 146
1, 13:39:00-000, 326, 230, 96, 121, 1349.91, 96, 1349.16, 64
1, 13:40:00-000, 582, 341, 241, 254, 1348.14, 241, 1347.59, 86
1, 13:41:00-000, 310, 188, 122, 133, 1348.42, 122, 1347.76, 103
1, 13:42:00-000, 661, 351, 310, 301, 1347.51, 305, 1346.36, 61
1, 13:43:00-000, 271, 146, 125, 137, 1346.94, 130, 1346.20, 26
1, 13:44:00-000, 674, 424, 250, 265, 1348.47, 250, 1347.43, 52
1, 13:45:00-000, 328, 195, 133, 142, 1347.82, 133, 1346.84, 109
1, 13:46:00-000, 579, 327, 252, 261, 1347.59, 252, 1346.85, 90
1, 13:47:00-000, 326, 158, 168, 143, 1346.35, 168, 1345.57, 35
1, 13:48:00-000, 618, 358, 260, 274, 1348.12, 260, 1347.20, 47
1, 13:49:00-000, 327, 202, 125, 137, 1348.66, 125, 1347.60, 67
1, 13:50:00-000, 629, 309, 320, 231, 1347.04, 320, 1346.77, 78
1, 13:51:00-000, 314, 202, 112, 136, 1347.69, 112, 1346.73, 74
1, 13:52:00-000, 647, 360, 287, 251, 1347.82, 287, 1346.76, 71
1, 13:53:00-000, 280, 162, 118, 130, 1347.05, 118, 1345.95, 73
1, 13:54:00-000, 621, 410, 211, 307, 1348.63, 211, 1348.55, 78
1, 13:55:00-000, 363, 194, 169, 169, 1347.38, 169, 1346.67, 69
1, 13:56:00-000, 612, 363, 249, 242, 1348.45, 249, 1347.45, 75
1, 13:57:00-000, 315, 180, 135, 114, 1347.78, 135, 1347.03, 88
1, 13:58:00-000, 600, 347, 253, 256, 1347.41, 253, 1347.64, 79
1, 13:59:00-000, 272, 163, 109, 137, 1347.26, 109, 1346.07, 56
1, 14:00:00-000, 592, 344, 248, 221, 1347.40, 248, 1347.11, 67
1, 14:01:00-000, 369, 208, 161, 156, 1346.91, 161, 1346.38, 68
1, 14:02:00-000, 713, 401, 312, 336, 1348.20, 308, 1346.89, 84
1, 14:03:00-000, 313, 167, 146, 153, 1347.47, 150, 1346.64, 45
1, 14:04:00-000, 616, 383, 233, 219, 1348.44, 233, 1348.64, 71
1, 14:05:00-000, 322, 172, 150, 145, 1348.89, 150, 1348.11, 111
1, 14:06:00-000, 659, 314, 345, 258, 1346.74, 345, 1345.90, 47
1, 14:07:00-000, 304, 193, 111, 120, 1348.31, 111, 1347.22, 56
1, 14:08:00-000, 601, 368, 233, 241, 1348.55, 233, 1347.67, 91
1, 14:09:00-000, 378, 208, 170, 173, 1348.22, 170, 1346.87, 70
1, 14:10:00-000, 573, 367, 206, 264, 1348.35, 206, 1347.89, 91
1, 14:11:00-000, 312, 192, 120, 100, 1347.25, 120, 1347.26, 90
1, 14:12:00-000, 580, 329, 251, 278, 1347.45, 251, 1346.66, 84
1, 14:13:00-000, 276, 137, 139, 113, 1349.03, 139, 1347.83, 48
1, 14:14:00-000, 596, 332, 264, 234, 1347.33, 264, 1346.63, 44
1, 14:15:00-000, 340, 173, 167, 165, 1347.00, 167, 1346.42, 58
1, 14:16:00-000, 629, 394, 235, 292, 1347.61, 235, 1347.40, 58
1, 14:17:00-000, 240, 147, 93, 90, 1349.39, 93, 1348.12, 86
1, 14:18:00-000, 600, 342, 258, 229, 1348.14, 258, 1347.33, 64
1, 14:19:00-000, 367, 216, 151, 153, 1347.18, 151, 1347.24, 77
1, 14:20:00-000, 623, 362, 261, 222, 1348.45, 261, 1347.49, 110
1, 14:21:00-000, 312, 169, 143, 125, 1348.54, 143, 1347.16, 90
1, 14:22:00-000, 555, 348, 207, 197, 1348.85, 207, 1347.30, 97
1, 14:23:00-000, 286, 129, 157, 128, 1347.93, 157, 1347.27, 77
1, 14:24:00-000, 573, 351, 222, 266, 1347.85, 222, 1346.82, 47
1, 14:25:00-000, 284, 134, 150, 132, 1347.46, 150, 1346.75, 59
1, 14:26:00-000, 628, 389, 239, 257, 1347.58, 239, 1346.77, 47
1, 14:27:00-000, 267, 174, 93, 114, 1348.14, 93, 1347.98, 101
1, 14:28:00-000, 642, 392, 250, 304, 1347.58, 250, 1346.93, 73
1, 14:29:00-000, 337, 193, 144, 119, 1348.01, 144, 1347.43, 80
1, 14:30:00-000, 587, 324, 263, 275, 1348.23, 263, 1347.36, 80
1, 14:31:00-000, 232, 130, 102, 87, 1347.80, 102, 1346.94, 51
1, 14:32:00-000, 676, 421, 255, 315, 1348.66, 255, 1347.75, 40
1, 14:33:00-000, 352, 188, 164, 145, 1347.10, 164, 1346.88, 94
1, 14:34:00-000, 564, 337, 227, 181, 1348.36, 227, 1348.00, 83
1, 14:35:00-000, 307, 162, 145, 133, 1346.92, 145, 1346.01, 100
1, 14:36:00-000, 664, 422, 242, 244, 1348.74, 242, 1348.19, 89
1, 14:37:00-000, 312, 194, 118, 113, 1347.48, 117, 1347.59, 139
1, 14:38:00-000, 570, 293, 277, 242, 1347.72, 278, 1346.55, 79
1, 14:39:00-000, 357, 217, 140, 142, 1348.33, 140, 1347.96, 51
1, 14:40:00-000, 581, 330, 251, 241, 1348.12, 251, 1347.50, 96
1, 14:41:00-000, 273, 153, 120, 92, 1348.49, 120, 1348.74, 75
1, 14:42:00-000, 591, 381, 210, 211, 1348.57, 210, 1347.97, 82
1, 14:43:00-000, 285, 155, 130, 108, 1349.12, 130, 1347.67, 113
1, 14:44:00-000, 628, 376, 252, 272, 1347.74, 252, 1347.27, 87
1, 14:45:00-000, 307, 189, 118, 134, 1347.23, 118, 1346.79, 71
1, 14:46:00-000, 664, 441, 223, 280, 1348.50, 223, 1347.16, 89
1, 14:47:00-000, 350, 216, 134, 170, 1348.15, 134, 1347.77, 123
1, 14:48:00-000, 575, 302, 273, 256, 1347.83, 273, 1347.16, 72
1, 14:49:00-000, 391, 237, 154, 104, 1348.72, 154, 1348.47, 64
1, 14:50:00-000, 562, 335, 227, 264, 1348.96, 227, 1348.08, 122
1, 14:51:00-000, 271, 156, 115, 106, 1348.69, 115, 1348.75, 69
1, 14:52:00-000, 630, 344, 286, 272, 1347.41, 286, 1346.88, 63
1, 14:53:00-000, 279, 178, 101, 110, 1348.07, 101, 1347.67, 60
1, 14:54:00-000, 619, 354, 265, 256, 1347.67, 265, 1346.87, 97
1, 14:55:00-000, 293, 194, 99, 134, 1348.65, 99, 1347.81, 69
1, 14:56:00-000, 635, 365, 270, 248, 1348.23, 270, 1348.10, 81
1, 14:57:00-000, 352, 221, 131, 112, 1349.28, 131, 1348.42, 89
1, 14:58:00-000, 649, 370, 279, 257, 1348.24, 279, 1347.52, 150
1, 14:59:00-000, 289, 183, 106, 101, 1349.47, 103, 1347.89, 85
1, 15:00:00-000, 650, 360, 290, 244, 1348.22, 293, 1347.48, 92
1, 15:01:00-000, 310, 200, 110, 124, 1348.51, 110, 1347.69, 96
1, 15:02:00-000, 554, 351, 203, 243, 1348.33, 203, 1348.25, 81
1, 15:03:00-000, 352, 205, 147, 159, 1347.97, 147, 1347.44, 91
1, 15:04:00-000, 638, 377, 261, 250, 1348.68, 261, 1348.33, 97
1, 15:05:00-000, 287, 212, 75, 91, 1348.96, 75, 1348.93, 77
1, 15:06:00-000, 590, 367, 223, 244, 1348.49, 223, 1347.90, 159
1, 15:07:00-000, 294, 175, 119, 124, 1347.66, 118, 1347.16, 93
1, 15:08:00-000, 606, 320, 286, 260, 1347.81, 287, 1347.27, 68
1, 15:09:00-000, 293, 175, 118, 110, 1348.61, 118, 1347.75, 53
1, 15:10:00-000, 618, 327, 291, 246, 1347.22, 291, 1346.69, 93
1, 15:11:00-000, 285, 160, 125, 126, 1347.53, 125, 1347.19, 61
1, 15:12:00-000, 499, 288, 211, 222, 1347.93, 211, 1347.03, 44
1, 15:13:00-000, 309, 184, 125, 132, 1349.30, 125, 1347.66, 51
1, 15:14:00-000, 577, 364, 213, 224, 1347.92, 213, 1347.28, 83
1, 15:15:00-000, 317, 206, 111, 138, 1348.83, 111, 1348.13, 86
1, 15:16:00-000, 617, 359, 258, 265, 1348.12, 258, 1347.99, 75
1, 15:17:00-000, 290, 164, 126, 130, 1348.30, 126, 1347.44, 89
1, 15:18:00-000, 584, 328, 256, 231, 1348.23, 256, 1346.99, 61
1, 15:19:00-000, 281, 176, 105, 120, 1348.22, 105, 1348.23, 67
1, 15:20:00-000, 619, 339, 280, 276, 1347.76, 280, 1347.15, 82
1, 15:21:00-000, 323, 186, 137, 94, 1347.45, 137, 1347.39, 59
1, 15:22:00-000, 551, 339, 212, 244, 1348.21, 212, 1347.39, 104
1, 15:23:00-000, 273, 164, 109, 118, 1347.68, 109, 1347.79, 61
1, 15:24:00-000, 669, 430, 239, 263, 1348.75, 237, 1347.90, 95
1, 15:25:00-000, 325, 187, 138, 148, 1347.88, 140, 1346.99, 104
1, 15:26:00-000, 606, 370, 236, 235, 1348.07, 236, 1346.99, 110
1, 15:27:00-000, 328, 190, 138, 159, 1347.62, 138, 1346.46, 79
1, 15:28:00-000, 587, 360, 227, 213, 1348.74, 227, 1348.31, 74
1, 15:29:00-000, 374, 217, 157, 166, 1348.40, 157, 1347.03, 94
1, 15:30:00-000, 644, 346, 298, 268, 1347.26, 298, 1346.74, 76
1, 15:31:00-000, 328, 216, 112, 141, 1349.64, 112, 1348.66, 84
1, 15:32:00-000, 620, 393, 227, 266, 1348.20, 227, 1347.19, 93
1, 15:33:00-000, 363, 204, 159, 157, 1348.22, 159, 1347.63, 95
1, 15:34:00-000, 620, 355, 265, 220, 1348.34, 265, 1348.24, 71
1, 15:35:00-000, 356, 213, 143, 189, 1346.85, 143, 1346.68, 75
1, 15:36:00-000, 576, 325, 251, 238, 1347.29, 251, 1346.32, 82
1, 15:37:00-000, 301, 177, 124, 144, 1348.88, 123, 1348.15, 66
1, 15:38:00-000, 645, 393, 252, 301, 1347.77, 253, 1347.12, 59
1, 15:39:00-000, 351, 203, 148, 147, 1347.49, 148, 1346.69, 61
1, 15:40:00-000, 626, 335, 291, 170, 1348.68, 291, 1347.55, 113
1, 15:41:00-000, 319, 178, 141, 114, 1348.12, 141, 1347.23, 122
1, 15:42:00-000, 622, 388, 234, 187, 1348.95, 234, 1347.49, 107
1, 15:43:00-000, 295, 148, 147, 124, 1347.84, 147, 1347.43, 125
1, 15:44:00-000, 606, 330, 276, 225, 1348.87, 276, 1347.49, 77
1, 15:45:00-000, 266, 170, 96, 104, 1347.85, 96, 1347.27, 78
1, 15:46:00-000, 581, 358, 223, 220, 1348.73, 223, 1347.49, 109
1, 15:47:00-000, 346, 212, 134, 120, 1348.16, 134, 1347.50, 108
1, 15:48:00-000, 550, 375, 175, 206, 1348.77, 175, 1347.82, 120
1, 15:49:00-000, 286, 182, 104, 126, 1348.57, 104, 1348.21, 125
1, 15:50:00-000, 668, 424, 244, 242, 1348.77, 244, 1348.20, 104
1, 15:51:00-000, 286, 166, 120, 161, 1347.25, 120, 1346.49, 124
1, 15:52:00-000, 551, 354, 197, 191, 1348.56, 197, 1347.89, 52
1, 15:53:00-000, 338, 199, 139, 112, 1349.04, 139, 1348.14, 116
1, 15:54:00-000, 595, 397, 198, 292, 1348.97, 198, 1347.42, 120
1, 15:55:00-000, 306, 215, 91, 102, 1348.71, 91, 1347.37, 83
1, 15:56:00-000, 651, 352, 299, 282, 1347.99, 299, 1347.41, 128
1, 15:57:00-000, 280, 176, 104, 69, 1348.96, 104, 1349.01, 67
1, 15:58:00-000, 584, 322, 262, 265, 1347.83, 262, 1347.77, 97
1, 15:59:00-000, 321, 187, 134, 147, 1348.19, 134, 1348.35, 66
1, 16:00:00-000, 590, 358, 232, 257, 1348.00, 232, 1347.39, 67
1, 16:01:00-000, 307, 163, 144, 98, 1348.03, 144, 1347.35, 72
1, 16:02:00-000, 620, 398, 222, 255, 1348.57, 222, 1347.77, 71
1, 16:03:00-000, 295, 203, 92, 103, 1349.28, 92, 1349.13, 105
1, 16:04:00-000, 651, 418, 233, 287, 1348.73, 233, 1348.35, 115
1, 16:05:00-000, 360, 180, 180, 175, 1347.86, 180, 1346.83, 119
1, 16:06:00-000, 618, 345, 273, 214, 1348.25, 273, 1347.46, 67
1, 16:07:00-000, 273, 159, 114, 110, 1348.04, 114, 1347.92, 98
1, 16:08:00-000, 590, 344, 246, 246, 1347.95, 246, 1346.70, 88
1, 16:09:00-000, 291, 162, 129, 116, 1348.66, 129, 1347.36, 67
1, 16:10:00-000, 594, 319, 275, 264, 1347.73, 275, 1346.25, 41
1, 16:11:00-000, 351, 201, 150, 138, 1348.52, 150, 1346.03, 45
1, 16:12:00-000, 627, 416, 211, 254, 1348.56, 210, 1348.49, 95
1, 16:13:00-000, 315, 177, 138, 135, 1347.02, 138, 1346.64, 114
1, 16:14:00-000, 546, 362, 184, 242, 1349.13, 184, 1347.68, 91
1, 16:15:00-000, 294, 203, 91, 110, 1349.85, 91, 1348.20, 84
1, 16:16:00-000, 660, 372, 288, 281, 1347.79, 288, 1347.15, 62
1, 16:17:00-000, 298, 164, 134, 147, 1347.78, 134, 1347.28, 113
1, 16:18:00-000, 672, 353, 319, 267, 1347.56, 319, 1347.35, 41
1, 16:19:00-000, 296, 180, 116, 143, 1347.75, 116, 1345.83, 68
1, 16:20:00-000, 643, 344, 299, 237, 1347.50, 299, 1347.31, 72
1, 16:21:00-000, 334, 207, 127, 148, 1348.80, 127, 1347.48, 84
1, 16:22:00-000, 641, 400, 241, 283, 1348.17, 241, 1347.63, 64
1, 16:23:00-000, 357, 245, 112, 138, 1348.85, 112, 1347.04, 101
1, 16:24:00-000, 609, 374, 235, 224, 1347.93, 235, 1348.20, 137
1, 16:25:00-000, 371, 208, 163, 162, 1347.43, 163, 1347.31, 108
1, 16:26:00-000, 696, 419, 277, 272, 1348.30, 277, 1347.79, 86
1, 16:27:00-000, 240, 141, 99, 77, 1347.72, 99, 1347.83, 124
1, 16:28:00-000, 540, 316, 224, 221, 1347.28, 224, 1347.25, 71
1, 16:29:00-000, 309, 171, 138, 118, 1347.70, 138, 1346.97, 62
2, 09:06:00-000, 3098, 0, 3098, 0, 0.00, 1115, 1348.76, 0
2, 09:07:00-000, 0, 0, 0, 0, 0.00, 0, 0.00, 1979
2, 09:08:00-000, 0, 0, 0, 0, 0.00, 0, 0.00, 4
2, 09:13:00-000, 3140, 1115, 2025, 1115, 1352.00, 1532, 1350.95, 0
2, 09:14:00-000, 20, 16, 4, 16, 1356.18, 33, 1355.21, 464
2, 09:15:00-000, 21, 11, 10, 11, 1356.18, 9, 1354.22, 0
2, 09:16:00-000, 167, 79, 88, 79, 1356.43, 83, 1354.54, 0
2, 09:17:00-000, 250, 115, 135, 115, 1353.08, 139, 1352.09, 0
2, 09:18:00-000, 514, 264, 250, 264, 1354.60, 241, 1352.68, 0
2, 09:19:00-000, 389, 212, 177, 212, 1353.64, 188, 1352.00, 0
2, 09:20:00-000, 776, 368, 408, 368, 1354.81, 403, 1353.47, 0
2, 09:21:00-000, 357, 149, 208, 149, 1353.39, 180, 1352.69, 0
2, 09:22:00-000, 605, 323, 282, 323, 1353.77, 315, 1352.97, 0
2, 09:23:00-000, 300, 146, 154, 146, 1353.20, 135, 1352.34, 0
2, 09:24:00-000, 544, 287, 257, 287, 1357.23, 247, 1353.80, 0
2, 09:25:00-000, 271, 142, 129, 142, 1353.51, 155, 1352.59, 0
2, 09:26:00-000, 635, 293, 342, 293, 1353.70, 300, 1351.43, 5
2, 09:27:00-000, 346, 177, 169, 177, 1354.11, 145, 1350.67, 30
2, 09:28:00-000, 620, 333, 287, 333, 1353.93, 242, 1350.68, 42
2, 09:29:00-000, 306, 178, 128, 177, 1354.76, 157, 1354.05, 8
2, 09:30:00-000, 505, 218, 287, 219, 1353.42, 281, 1352.21, 0
2, 09:31:00-000, 356, 202, 154, 202, 1354.28, 160, 1352.73, 0
2, 09:32:00-000, 658, 308, 350, 308, 1353.55, 338, 1352.68, 0
2, 09:33:00-000, 305, 144, 161, 144, 1352.91, 111, 1350.39, 12
2, 09:34:00-000, 619, 268, 351, 268, 1353.26, 310, 1352.04, 24
2, 09:35:00-000, 285, 105, 180, 105, 1353.18, 113, 1351.32, 62
2, 09:36:00-000, 575, 290, 285, 290, 1353.68, 265, 1352.68, 52
2, 09:37:00-000, 295, 138, 157, 138, 1352.89, 123, 1351.54, 40
2, 09:38:00-000, 581, 295, 286, 295, 1353.55, 248, 1351.90, 33
2, 09:39:00-000, 370, 195, 175, 195, 1353.68, 143, 1351.66, 32
2, 09:40:00-000, 603, 270, 333, 270, 1353.20, 287, 1351.19, 40
2, 09:41:00-000, 319, 125, 194, 125, 1352.71, 141, 1351.29, 42
2, 09:42:00-000, 569, 228, 341, 228, 1351.97, 253, 1350.22, 69
2, 09:43:00-000, 349, 177, 172, 177, 1352.73, 150, 1352.06, 52
2, 09:44:00-000, 636, 274, 362, 274, 1351.93, 324, 1351.43, 64
2, 09:45:00-000, 297, 123, 174, 123, 1351.72, 121, 1351.10, 18
2, 09:46:00-000, 600, 242, 358, 242, 1352.57, 267, 1351.61, 56
2, 09:47:00-000, 317, 182, 135, 182, 1353.32, 149, 1352.50, 53
2, 09:48:00-000, 635, 306, 329, 306, 1352.74, 265, 1351.40, 28
2, 09:49:00-000, 286, 143, 143, 143, 1352.22, 116, 1350.88, 47
2, 09:50:00-000, 556, 255, 301, 255, 1352.46, 260, 1351.10, 32
2, 09:51:00-000, 305, 133, 172, 133, 1353.25, 116, 1351.86, 40
2, 09:52:00-000, 628, 309, 319, 309, 1352.01, 250, 1351.40, 67
2, 09:53:00-000, 299, 122, 177, 122, 1350.46, 117, 1349.32, 65
2, 09:54:00-000, 505, 200, 305, 200, 1352.21, 218, 1351.07, 50
2, 09:55:00-000, 361, 186, 175, 186, 1353.46, 154, 1352.88, 62
2, 09:56:00-000, 664, 294, 370, 294, 1352.37, 283, 1351.01, 68
2, 09:57:00-000, 357, 154, 203, 154, 1352.70, 153, 1351.83, 62
2, 09:58:00-000, 550, 233, 317, 233, 1352.66, 263, 1351.99, 51
2, 09:59:00-000, 276, 106, 170, 106, 1352.16, 147, 1350.45, 49
2, 10:00:00-000, 628, 247, 381, 247, 1352.22, 306, 1350.61, 40
2, 10:01:00-000, 267, 118, 149, 118, 1352.25, 126, 1351.78, 52
2, 10:02:00-000, 631, 276, 355, 276, 1352.68, 280, 1351.70, 41
2, 10:03:00-000, 287, 130, 157, 130, 1353.32, 142, 1352.20, 55
2, 10:04:00-000, 717, 294, 423, 294, 1352.28, 326, 1351.21, 47
2, 10:05:00-000, 290, 165, 125, 165, 1354.06, 101, 1352.22, 78
2, 10:06:00-000, 685, 245, 440, 245, 1352.38, 321, 1351.19, 55
2, 10:07:00-000, 268, 135, 133, 135, 1352.24, 126, 1350.45, 90
2, 10:08:00-000, 540, 279, 261, 279, 1353.40, 222, 1351.57, 10
2, 10:09:00-000, 314, 145, 169, 145, 1353.16, 151, 1350.67, 21
2, 10:10:00-000, 657, 306, 351, 306, 1352.54, 297, 1351.40, 38
2, 10:11:00-000, 311, 124, 187, 124, 1352.74, 148, 1350.81, 44
2, 10:12:00-000, 628, 283, 345, 283, 1352.52, 252, 1350.89, 57
2, 10:13:00-000, 298, 135, 163, 135, 1354.04, 139, 1352.38, 60
2, 10:14:00-000, 666, 266, 400, 266, 1351.93, 261, 1351.07, 90
2, 10:15:00-000, 214, 93, 121, 93, 1352.32, 69, 1351.61, 94
2, 10:16:00-000, 762, 322, 440, 322, 1352.36, 352, 1351.20, 54
2, 10:17:00-000, 298, 140, 158, 140, 1352.41, 155, 1351.46, 63
2, 10:18:00-000, 630, 263, 367, 263, 1351.93, 245, 1351.29, 70
2, 10:19:00-000, 309, 176, 133, 176, 1353.97, 118, 1352.68, 84
2, 10:20:00-000, 679, 272, 407, 272, 1352.13, 301, 1351.30, 23
2, 10:21:00-000, 277, 118, 159, 118, 1352.74, 139, 1352.73, 59
2, 10:22:00-000, 633, 235, 398, 235, 1351.94, 274, 1350.93, 59
2, 10:23:00-000, 257, 123, 134, 123, 1351.59, 108, 1351.08, 105
2, 10:24:00-000, 673, 347, 326, 347, 1353.82, 313, 1351.77, 28
2, 10:25:00-000, 304, 150, 154, 150, 1352.26, 115, 1351.77, 23
2, 10:26:00-000, 681, 251, 430, 251, 1351.69, 337, 1351.45, 60
2, 10:27:00-000, 253, 90, 163, 90, 1351.85, 119, 1350.56, 70
2, 10:28:00-000, 702, 316, 386, 316, 1352.43, 277, 1351.02, 73
2, 10:29:00-000, 284, 122, 162, 122, 1352.12, 131, 1351.21, 75
2, 10:30:00-000, 582, 291, 291, 291, 1352.08, 229, 1351.36, 39
2, 10:31:00-000, 290, 128, 162, 128, 1352.56, 138, 1351.69, 50
2, 10:32:00-000, 638, 304, 334, 304, 1352.62, 290, 1350.98, 47
2, 10:33:00-000, 314, 131, 183, 131, 1352.60, 157, 1351.44, 30
2, 10:34:00-000, 572, 234, 338, 234, 1352.52, 218, 1351.66, 45
2, 10:35:00-000, 334, 162, 172, 162, 1352.00, 177, 1351.43, 71
2, 10:36:00-000, 732, 324, 408, 324, 1352.95, 364, 1351.48, 37
2, 10:37:00-000, 300, 125, 175, 125, 1353.28, 135, 1351.07, 44
2, 10:38:00-000, 614, 278, 336, 278, 1353.05, 277, 1352.21, 36
2, 10:39:00-000, 316, 123, 193, 123, 1352.15, 181, 1351.21, 43
2, 10:40:00-000, 624, 301, 323, 301, 1353.30, 280, 1351.45, 31
2, 10:41:00-000, 274, 121, 153, 121, 1352.28, 113, 1350.46, 44
2, 10:42:00-000, 631, 274, 357, 274, 1353.15, 268, 1351.78, 44
2, 10:43:00-000, 356, 182, 174, 182, 1352.85, 160, 1352.70, 49
2, 10:44:00-000, 654, 274, 380, 274, 1352.51, 288, 1350.65, 64
2, 10:45:00-000, 274, 99, 175, 99, 1351.59, 140, 1351.60, 64
2, 10:46:00-000, 637, 310, 327, 310, 1353.34, 310, 1352.08, 41
2, 10:47:00-000, 345, 150, 195, 150, 1352.66, 178, 1351.79, 25
2, 10:48:00-000, 673, 324, 349, 324, 1353.25, 278, 1351.63, 31
2, 10:49:00-000, 303, 146, 157, 146, 1352.97, 150, 1351.75, 44
2, 10:50:00-000, 534, 272, 262, 272, 1353.39, 216, 1351.35, 29
2, 10:51:00-000, 330, 127, 203, 127, 1352.66, 155, 1351.64, 24
2, 10:52:00-000, 589, 264, 325, 262, 1352.83, 291, 1350.96, 53
2, 10:53:00-000, 296, 124, 172, 126, 1351.77, 108, 1350.88, 42
2, 10:54:00-000, 657, 319, 338, 319, 1352.84, 282, 1351.76, 77
2, 10:55:00-000, 342, 148, 194, 148, 1351.95, 140, 1350.51, 41
2, 10:56:00-000, 600, 275, 325, 275, 1351.14, 233, 1350.76, 61
2, 10:57:00-000, 303, 141, 162, 141, 1353.16, 147, 1351.38, 59
2, 10:58:00-000, 613, 267, 346, 267, 1352.32, 256, 1350.66, 44
2, 10:59:00-000, 331, 156, 175, 156, 1352.13, 173, 1351.00, 65
2, 11:00:00-000, 711, 296, 415, 296, 1352.16, 287, 1350.40, 47
2, 11:01:00-000, 324, 157, 167, 157, 1352.52, 164, 1351.49, 65
2, 11:02:00-000, 593, 251, 342, 251, 1353.05, 255, 1352.25, 44
2, 11:03:00-000, 288, 123, 165, 123, 1353.19, 139, 1351.66, 71
2, 11:04:00-000, 611, 263, 348, 263, 1352.53, 262, 1351.18, 56
2, 11:05:00-000, 297, 107, 190, 107, 1351.53, 141, 1350.14, 63
2, 11:06:00-000, 653, 317, 336, 317, 1352.13, 270, 1351.41, 54
2, 11:07:00-000, 354, 130, 224, 130, 1352.19, 156, 1351.11, 56
2, 11:08:00-000, 641, 295, 346, 295, 1352.55, 270, 1351.41, 83
2, 11:09:00-000, 295, 140, 155, 140, 1353.97, 141, 1353.07, 60
2, 11:10:00-000, 649, 318, 331, 318, 1353.66, 303, 1351.57, 17
2, 11:11:00-000, 253, 95, 158, 95, 1352.12, 138, 1351.62, 35
2, 11:12:00-000, 625, 283, 342, 283, 1353.28, 261, 1351.61, 39
2, 11:13:00-000, 275, 114, 161, 114, 1352.21, 135, 1352.12, 34
2, 11:14:00-000, 606, 259, 347, 259, 1352.67, 292, 1351.78, 47
2, 11:15:00-000, 325, 179, 146, 179, 1352.89, 147, 1352.03, 43
2, 11:16:00-000, 642, 313, 329, 313, 1353.52, 284, 1352.05, 36
2, 11:17:00-000, 295, 144, 151, 144, 1352.92, 108, 1351.71, 33
2, 11:18:00-000, 588, 265, 323, 265, 1353.58, 277, 1351.85, 31
2, 11:19:00-000, 331, 98, 233, 98, 1351.60, 147, 1350.43, 50
2, 11:20:00-000, 592, 250, 342, 250, 1352.59, 317, 1351.57, 46
2, 11:21:00-000, 327, 158, 169, 158, 1353.07, 134, 1350.85, 63
2, 11:22:00-000, 671, 289, 382, 289, 1352.31, 255, 1351.84, 51
2, 11:23:00-000, 347, 185, 162, 185, 1352.64, 164, 1351.70, 85
2, 11:24:00-000, 648, 280, 368, 280, 1352.19, 270, 1351.13, 57
2, 11:25:00-000, 294, 108, 186, 108, 1352.40, 129, 1352.30, 65
2, 11:26:00-000, 575, 278, 297, 275, 1353.22, 287, 1351.81, 63
2, 11:27:00-000, 302, 156, 146, 159, 1353.08, 118, 1351.49, 8
2, 11:28:00-000, 674, 280, 394, 280, 1351.95, 267, 1351.03, 69
2, 11:29:00-000, 274, 148, 126, 148, 1353.39, 123, 1352.68, 72
2, 11:30:00-000, 619, 277, 342, 277, 1352.99, 315, 1351.37, 12
2, 11:31:00-000, 241, 106, 135, 106, 1353.22, 113, 1351.48, 37
2, 11:32:00-000, 637, 256, 381, 256, 1351.98, 258, 1350.62, 40
2, 11:33:00-000, 286, 137, 149, 137, 1354.10, 144, 1351.49, 75
2, 11:34:00-000, 592, 233, 359, 233, 1351.57, 253, 1350.67, 56
2, 11:35:00-000, 312, 150, 162, 150, 1352.43, 138, 1351.23, 73
2, 11:36:00-000, 686, 296, 390, 296, 1352.13, 305, 1351.25, 62
2, 11:37:00-000, 263, 136, 127, 136, 1352.53, 110, 1351.84, 35
2, 11:38:00-000, 646, 272, 374, 272, 1352.29, 304, 1350.67, 68
2, 11:39:00-000, 336, 153, 183, 153, 1351.49, 153, 1351.00, 34
2, 11:40:00-000, 641, 234, 407, 234, 1351.69, 311, 1350.96, 38
2, 11:41:00-000, 279, 139, 140, 139, 1352.21, 129, 1352.40, 69
2, 11:42:00-000, 578, 252, 326, 252, 1352.21, 250, 1351.46, 65
2, 11:43:00-000, 301, 160, 141, 160, 1353.53, 128, 1352.15, 36
2, 11:44:00-000, 664, 293, 371, 289, 1353.42, 252, 1351.58, 40
2, 11:45:00-000, 278, 142, 136, 146, 1351.95, 97, 1350.93, 90
2, 11:46:00-000, 776, 380, 396, 380, 1352.03, 306, 1351.11, 60
2, 11:47:00-000, 322, 136, 186, 136, 1353.42, 154, 1351.52, 77
2, 11:48:00-000, 589, 266, 323, 266, 1352.73, 257, 1351.54, 53
2, 11:49:00-000, 241, 105, 136, 105, 1352.99, 116, 1351.64, 32
2, 11:50:00-000, 586, 252, 334, 252, 1352.11, 283, 1351.67, 38
2, 11:51:00-000, 296, 134, 162, 134, 1352.72, 159, 1350.79, 25
2, 11:52:00-000, 640, 240, 400, 240, 1351.42, 281, 1350.58, 42
2, 11:53:00-000, 335, 158, 177, 158, 1352.25, 116, 1351.59, 94
2, 11:54:00-000, 538, 257, 281, 257, 1352.69, 235, 1350.80, 70
2, 11:55:00-000, 303, 139, 164, 139, 1353.01, 126, 1350.31, 43
2, 11:56:00-000, 695, 308, 387, 304, 1352.51, 335, 1351.16, 33
2, 11:57:00-000, 285, 110, 175, 114, 1352.29, 113, 1350.88, 46
2, 11:58:00-000, 554, 241, 313, 241, 1352.78, 245, 1351.91, 94
2, 11:59:00-000, 278, 130, 148, 130, 1353.42, 135, 1351.91, 37
2, 12:00:00-000, 677, 299, 378, 299, 1352.27, 296, 1350.83, 46
2, 12:01:00-000, 311, 110, 201, 110, 1351.50, 144, 1350.38, 69
2, 12:02:00-000, 518, 234, 284, 234, 1350.86, 222, 1350.19, 60
2, 12:03:00-000, 311, 122, 189, 122, 1351.49, 147, 1350.38, 55
2, 12:04:00-000, 681, 336, 345, 336, 1353.00, 304, 1351.77, 33
2, 12:05:00-000, 284, 123, 161, 123, 1353.38, 130, 1351.86, 35
2, 12:06:00-000, 588, 277, 311, 277, 1352.32, 261, 1351.25, 43
2, 12:07:00-000, 342, 147, 195, 147, 1351.75, 143, 1350.74, 42
2, 12:08:00-000, 663, 273, 390, 273, 1351.98, 290, 1351.32, 65
2, 12:09:00-000, 280, 100, 180, 100, 1351.51, 121, 1350.74, 72
2, 12:10:00-000, 654, 300, 354, 300, 1352.31, 302, 1351.35, 82
2, 12:11:00-000, 357, 161, 196, 161, 1351.63, 152, 1351.12, 56
2, 12:12:00-000, 666, 315, 351, 315, 1353.09, 289, 1351.61, 43
2, 12:13:00-000, 329, 129, 200, 129, 1350.84, 145, 1351.02, 49
2, 12:14:00-000, 649, 272, 377, 272, 1351.87, 290, 1350.67, 96
2, 12:15:00-000, 287, 124, 163, 124, 1352.63, 124, 1351.64, 43
2, 12:16:00-000, 615, 271, 344, 271, 1352.80, 250, 1350.91, 71
2, 12:17:00-000, 344, 129, 215, 129, 1352.01, 129, 1350.63, 67
2, 12:18:00-000, 718, 344, 374, 344, 1352.81, 358, 1351.95, 68
2, 12:19:00-000, 295, 145, 150, 145, 1353.35, 118, 1352.80, 43
2, 12:20:00-000, 585, 239, 346, 239, 1351.92, 169, 1350.22, 74
2, 12:21:00-000, 315, 121, 194, 121, 1351.53, 138, 1350.65, 125
2, 12:22:00-000, 622, 260, 362, 260, 1351.81, 213, 1350.14, 96
2, 12:23:00-000, 276, 104, 172, 104, 1351.21, 113, 1350.35, 119
2, 12:24:00-000, 581, 256, 325, 256, 1351.88, 213, 1350.76, 80
2, 12:25:00-000, 318, 142, 176, 142, 1352.39, 120, 1351.04, 88
2, 12:26:00-000, 588, 226, 362, 226, 1352.05, 254, 1350.79, 90
2, 12:27:00-000, 389, 165, 224, 165, 1352.34, 151, 1351.03, 76
2, 12:28:00-000, 650, 275, 375, 275, 1351.86, 277, 1350.82, 96
2, 12:29:00-000, 303, 92, 211, 92, 1351.49, 112, 1350.70, 73
2, 12:30:00-000, 536, 206, 330, 206, 1351.82, 239, 1350.56, 118
2, 12:31:00-000, 308, 112, 196, 112, 1352.11, 122, 1351.06, 70
2, 12:32:00-000, 722, 282, 440, 282, 1351.62, 314, 1350.57, 101
2, 12:33:00-000, 328, 155, 173, 155, 1351.63, 137, 1350.69, 87
2, 12:34:00-000, 579, 248, 331, 248, 1352.33, 267, 1351.01, 64
2, 12:35:00-000, 306, 148, 158, 148, 1352.71, 119, 1351.35, 55
2, 12:36:00-000, 639, 258, 381, 258, 1351.55, 264, 1350.89, 65
2, 12:37:00-000, 307, 134, 173, 134, 1352.47, 146, 1351.25, 75
2, 12:38:00-000, 640, 241, 399, 241, 1351.88, 273, 1351.09, 76
2, 12:39:00-000, 284, 125, 159, 125, 1352.67, 141, 1350.50, 82
2, 12:40:00-000, 683, 253, 430, 253, 1351.85, 284, 1351.03, 59
2, 12:41:00-000, 307, 122, 185, 122, 1351.86, 95, 1350.23, 103
2, 12:42:00-000, 668, 229, 439, 229, 1351.26, 299, 1350.16, 131
2, 12:43:00-000, 254, 125, 129, 125, 1351.76, 107, 1351.43, 86
2, 12:44:00-000, 704, 353, 351, 350, 1352.63, 283, 1350.98, 72
2, 12:45:00-000, 353, 168, 185, 171, 1352.87, 128, 1350.49, 40
2, 12:46:00-000, 673, 273, 400, 273, 1352.79, 297, 1351.54, 79
2, 12:47:00-000, 305, 108, 197, 108, 1351.72, 132, 1351.16, 85
2, 12:48:00-000, 619, 218, 401, 218, 1351.86, 272, 1350.97, 78
2, 12:49:00-000, 317, 117, 200, 117, 1352.43, 152, 1351.08, 101
2, 12:50:00-000, 628, 297, 331, 297, 1352.48, 240, 1350.94, 67
2, 12:51:00-000, 351, 137, 214, 137, 1352.13, 160, 1351.45, 77
2, 12:52:00-000, 627, 277, 350, 277, 1351.95, 272, 1351.04, 69
2, 12:53:00-000, 348, 154, 194, 154, 1351.34, 150, 1351.01, 49
2, 12:54:00-000, 626, 247, 379, 247, 1351.64, 257, 1350.38, 96
2, 12:55:00-000, 287, 135, 152, 135, 1351.73, 108, 1351.72, 77
2, 12:56:00-000, 598, 285, 313, 285, 1352.60, 257, 1351.42, 67
2, 12:57:00-000, 277, 148, 129, 148, 1352.72, 102, 1351.48, 47
2, 12:58:00-000, 612, 263, 349, 263, 1351.95, 315, 1350.95, 38
2, 12:59:00-000, 289, 125, 164, 125, 1352.77, 133, 1351.56, 26
2, 13:00:00-000, 666, 312, 354, 312, 1352.81, 279, 1351.26, 37
2, 13:01:00-000, 328, 127, 201, 127, 1351.51, 120, 1350.93, 69
2, 13:02:00-000, 586, 248, 338, 248, 1352.52, 280, 1350.96, 96
2, 13:03:00-000, 304, 153, 151, 153, 1353.82, 133, 1352.00, 36
2, 13:04:00-000, 561, 251, 310, 251, 1352.52, 235, 1351.66, 47
2, 13:05:00-000, 294, 117, 177, 117, 1352.11, 140, 1351.24, 50
2, 13:06:00-000, 603, 239, 364, 239, 1351.65, 252, 1351.04, 61
2, 13:07:00-000, 313, 120, 193, 120, 1351.73, 140, 1350.61, 76
2, 13:08:00-000, 623, 238, 385, 238, 1351.52, 295, 1349.71, 74
2, 13:09:00-000, 367, 167, 200, 167, 1353.68, 209, 1352.48, 54
2, 13:10:00-000, 686, 281, 405, 281, 1352.39, 305, 1351.12, 43
2, 13:11:00-000, 323, 162, 161, 162, 1353.11, 126, 1351.53, 58
2, 13:12:00-000, 611, 243, 368, 243, 1352.17, 264, 1351.13, 67
2, 13:13:00-000, 275, 130, 145, 130, 1352.00, 114, 1350.44, 75
2, 13:14:00-000, 681, 258, 423, 258, 1352.09, 311, 1351.15, 74
2, 13:15:00-000, 377, 198, 179, 198, 1353.53, 167, 1351.49, 48
2, 13:16:00-000, 666, 339, 327, 336, 1353.65, 330, 1351.90, 35
2, 13:17:00-000, 299, 142, 157, 145, 1352.16, 125, 1350.75, 14
2, 13:18:00-000, 628, 279, 349, 279, 1352.04, 251, 1350.82, 43
2, 13:19:00-000, 260, 138, 122, 138, 1353.13, 120, 1352.41, 55
2, 13:20:00-000, 703, 336, 367, 336, 1352.56, 292, 1351.10, 46
2, 13:21:00-000, 303, 130, 173, 130, 1353.26, 149, 1351.08, 44
2, 13:22:00-000, 646, 293, 353, 293, 1352.13, 292, 1351.08, 45
2, 13:23:00-000, 291, 139, 152, 139, 1352.57, 122, 1351.24, 56
2, 13:24:00-000, 593, 291, 302, 291, 1353.18, 265, 1351.45, 32
2, 13:25:00-000, 236, 81, 155, 81, 1350.97, 87, 1351.45, 32
2, 13:26:00-000, 722, 343, 379, 343, 1352.11, 326, 1350.96, 63
2, 13:27:00-000, 370, 143, 227, 143, 1351.52, 153, 1350.98, 39
2, 13:28:00-000, 604, 263, 341, 263, 1351.31, 263, 1350.55, 109
2, 13:29:00-000, 294, 131, 163, 131, 1351.62, 124, 1350.83, 58
2, 13:30:00-000, 639, 273, 366, 273, 1352.16, 246, 1351.23, 48
2, 13:31:00-000, 292, 117, 175, 117, 1352.09, 143, 1352.07, 98
2, 13:32:00-000, 640, 278, 362, 278, 1352.08, 268, 1350.34, 88
2, 13:33:00-000, 322, 148, 174, 148, 1352.62, 137, 1351.52, 46
2, 13:34:00-000, 643, 263, 380, 263, 1352.47, 275, 1351.09, 59
2, 13:35:00-000, 334, 130, 204, 130, 1351.64, 160, 1351.03, 75
2, 13:36:00-000, 489, 201, 288, 201, 1353.27, 223, 1351.65, 62
2, 13:37:00-000, 304, 157, 147, 157, 1353.19, 133, 1351.66, 49
2, 13:38:00-000, 740, 309, 431, 309, 1352.62, 317, 1350.52, 30
2, 13:39:00-000, 368, 176, 192, 176, 1352.21, 185, 1351.78, 59
2, 13:40:00-000, 603, 286, 317, 286, 1351.95, 258, 1351.40, 79
2, 13:41:00-000, 265, 112, 153, 112, 1352.25, 131, 1351.07, 48
2, 13:42:00-000, 622, 283, 339, 283, 1352.40, 273, 1351.19, 29
2, 13:43:00-000, 283, 128, 155, 128, 1350.29, 119, 1350.90, 60
2, 13:44:00-000, 537, 242, 295, 242, 1352.27, 255, 1351.01, 28
2, 13:45:00-000, 332, 149, 183, 149, 1351.54, 162, 1351.40, 26
2, 13:46:00-000, 622, 280, 342, 280, 1352.47, 253, 1351.17, 44
2, 13:47:00-000, 289, 139, 150, 139, 1351.20, 121, 1350.94, 66
2, 13:48:00-000, 594, 231, 363, 231, 1352.38, 214, 1351.57, 87
2, 13:49:00-000, 297, 144, 153, 144, 1352.39, 142, 1351.87, 89
2, 13:50:00-000, 658, 295, 363, 295, 1352.04, 252, 1351.00, 39
2, 13:51:00-000, 285, 128, 157, 128, 1352.00, 136, 1350.76, 58
2, 13:52:00-000, 515, 254, 261, 254, 1352.40, 208, 1351.10, 73
2, 13:53:00-000, 293, 118, 175, 118, 1351.51, 116, 1350.55, 45
2, 13:54:00-000, 615, 296, 319, 296, 1353.62, 286, 1351.66, 40
2, 13:55:00-000, 358, 128, 230, 128, 1352.00, 173, 1350.49, 55
2, 13:56:00-000, 516, 233, 283, 233, 1352.54, 211, 1351.15, 62
2, 13:57:00-000, 337, 139, 198, 139, 1351.72, 138, 1351.00, 68
2, 13:58:00-000, 666, 252, 414, 252, 1352.03, 287, 1350.79, 74
2, 13:59:00-000, 319, 136, 183, 136, 1352.82, 139, 1350.95, 94
2, 14:00:00-000, 525, 241, 284, 241, 1352.54, 264, 1351.99, 28
2, 14:01:00-000, 302, 104, 198, 104, 1351.08, 121, 1350.37, 50
2, 14:02:00-000, 587, 291, 296, 288, 1353.00, 266, 1351.07, 69
2, 14:03:00-000, 346, 146, 200, 149, 1351.27, 159, 1351.10, 43
2, 14:04:00-000, 640, 277, 363, 277, 1352.38, 286, 1351.30, 54
2, 14:05:00-000, 297, 116, 181, 116, 1352.49, 125, 1351.60, 43
2, 14:06:00-000, 654, 242, 412, 242, 1351.36, 306, 1350.77, 69
2, 14:07:00-000, 297, 137, 160, 137, 1351.44, 111, 1350.97, 67
2, 14:08:00-000, 614, 285, 329, 285, 1352.62, 284, 1351.48, 87
2, 14:09:00-000, 297, 142, 155, 142, 1352.76, 116, 1351.96, 45
2, 14:10:00-000, 654, 279, 375, 279, 1352.87, 307, 1351.35, 45
2, 14:11:00-000, 334, 161, 173, 161, 1352.44, 129, 1351.84, 58
2, 14:12:00-000, 592, 242, 350, 242, 1350.97, 236, 1350.13, 68
2, 14:13:00-000, 341, 178, 163, 178, 1353.33, 130, 1351.76, 69
2, 14:14:00-000, 545, 218, 327, 218, 1351.65, 242, 1350.85, 67
2, 14:15:00-000, 293, 120, 173, 120, 1351.52, 122, 1350.42, 79
2, 14:16:00-000, 662, 248, 414, 248, 1351.51, 258, 1350.41, 64
2, 14:17:00-000, 269, 96, 173, 96, 1350.73, 153, 1351.27, 100
2, 14:18:00-000, 653, 306, 347, 306, 1352.47, 287, 1351.27, 49
2, 14:19:00-000, 310, 113, 197, 113, 1353.26, 132, 1350.23, 76
2, 14:20:00-000, 696, 319, 377, 319, 1351.88, 291, 1351.52, 45
2, 14:21:00-000, 323, 137, 186, 137, 1352.16, 121, 1351.05, 90
2, 14:22:00-000, 596, 235, 361, 235, 1351.96, 268, 1351.53, 82
2, 14:23:00-000, 306, 160, 146, 160, 1352.34, 143, 1351.79, 67
2, 14:24:00-000, 605, 257, 348, 257, 1351.87, 276, 1350.92, 52
2, 14:25:00-000, 304, 124, 180, 124, 1351.51, 113, 1350.21, 47
2, 14:26:00-000, 652, 308, 344, 308, 1351.39, 262, 1350.70, 91
2, 14:27:00-000, 315, 138, 177, 138, 1352.00, 129, 1350.83, 47
2, 14:28:00-000, 615, 225, 390, 225, 1351.91, 263, 1350.65, 97
2, 14:29:00-000, 368, 156, 212, 156, 1352.42, 191, 1351.63, 73
2, 14:30:00-000, 610, 248, 362, 248, 1352.43, 295, 1350.68, 30
2, 14:31:00-000, 401, 177, 224, 177, 1351.94, 166, 1351.55, 42
2, 14:32:00-000, 643, 243, 400, 243, 1352.76, 275, 1351.09, 105
2, 14:33:00-000, 298, 117, 181, 117, 1351.61, 149, 1351.53, 84
2, 14:34:00-000, 548, 261, 287, 261, 1352.55, 265, 1351.79, 30
2, 14:35:00-000, 366, 155, 211, 155, 1352.58, 177, 1351.10, 41
2, 14:36:00-000, 639, 348, 291, 348, 1353.22, 268, 1352.02, 27
2, 14:37:00-000, 355, 163, 192, 163, 1351.65, 118, 1350.61, 32
2, 14:38:00-000, 513, 239, 274, 239, 1352.03, 201, 1351.17, 62
2, 14:39:00-000, 362, 175, 187, 175, 1351.51, 150, 1351.85, 70
2, 14:40:00-000, 632, 283, 349, 283, 1352.03, 267, 1350.84, 88
2, 14:41:00-000, 339, 155, 184, 155, 1353.78, 170, 1352.19, 32
2, 14:42:00-000, 631, 273, 358, 273, 1352.45, 291, 1351.45, 46
2, 14:43:00-000, 332, 146, 186, 146, 1353.14, 154, 1352.31, 32
2, 14:44:00-000, 678, 238, 440, 238, 1351.60, 294, 1350.83, 77
2, 14:45:00-000, 310, 109, 201, 109, 1351.48, 128, 1350.67, 119
2, 14:46:00-000, 584, 241, 343, 241, 1351.69, 262, 1351.35, 84
2, 14:47:00-000, 250, 108, 142, 108, 1353.17, 107, 1351.37, 57
2, 14:48:00-000, 635, 278, 357, 278, 1352.00, 258, 1350.46, 70
2, 14:49:00-000, 351, 190, 161, 190, 1352.89, 151, 1352.27, 49
2, 14:50:00-000, 656, 293, 363, 293, 1353.46, 302, 1351.66, 50
2, 14:51:00-000, 336, 177, 159, 177, 1354.05, 144, 1352.74, 48
2, 14:52:00-000, 546, 230, 316, 230, 1352.90, 237, 1351.12, 38
2, 14:53:00-000, 314, 139, 175, 139, 1352.77, 130, 1351.55, 46
2, 14:54:00-000, 702, 264, 438, 264, 1351.24, 312, 1350.81, 80
2, 14:55:00-000, 350, 151, 199, 151, 1352.02, 188, 1351.51, 70
2, 14:56:00-000, 602, 281, 321, 281, 1352.10, 260, 1351.41, 38
2, 14:57:00-000, 340, 166, 174, 166, 1352.49, 150, 1351.53, 65
2, 14:58:00-000, 625, 258, 367, 258, 1352.64, 261, 1351.31, 44
2, 14:59:00-000, 254, 124, 130, 124, 1353.28, 111, 1351.98, 72
2, 15:00:00-000, 670, 287, 383, 287, 1352.53, 284, 1351.59, 51
2, 15:01:00-000, 250, 101, 149, 101, 1351.94, 112, 1351.08, 78
2, 15:02:00-000, 625, 294, 331, 294, 1352.78, 286, 1351.57, 45
2, 15:03:00-000, 350, 132, 218, 132, 1352.26, 155, 1351.31, 47
2, 15:04:00-000, 652, 327, 325, 327, 1352.91, 253, 1351.92, 78
2, 15:05:00-000, 303, 133, 170, 133, 1353.25, 104, 1351.41, 47
2, 15:06:00-000, 637, 281, 356, 281, 1352.80, 262, 1351.46, 66
2, 15:07:00-000, 347, 130, 217, 130, 1351.82, 148, 1350.77, 76
2, 15:08:00-000, 679, 269, 410, 269, 1351.71, 313, 1351.29, 82
2, 15:09:00-000, 264, 105, 159, 105, 1351.97, 114, 1349.86, 104
2, 15:10:00-000, 649, 291, 358, 291, 1352.01, 271, 1350.88, 77
2, 15:11:00-000, 297, 134, 163, 134, 1353.09, 119, 1350.77, 53
2, 15:12:00-000, 686, 250, 436, 250, 1351.27, 274, 1350.64, 76
2, 15:13:00-000, 299, 119, 180, 119, 1352.04, 181, 1351.77, 89
2, 15:14:00-000, 629, 247, 382, 247, 1351.16, 245, 1351.03, 65
2, 15:15:00-000, 256, 121, 135, 121, 1352.26, 131, 1351.55, 74
2, 15:16:00-000, 728, 335, 393, 335, 1353.19, 319, 1352.03, 44
2, 15:17:00-000, 291, 110, 181, 110, 1352.35, 143, 1351.23, 54
2, 15:18:00-000, 589, 281, 308, 281, 1351.98, 270, 1350.76, 46
2, 15:19:00-000, 384, 160, 224, 160, 1352.08, 175, 1351.32, 55
2, 15:20:00-000, 602, 292, 310, 292, 1352.51, 255, 1351.17, 56
2, 15:21:00-000, 258, 105, 153, 105, 1352.68, 101, 1351.22, 48
2, 15:22:00-000, 599, 255, 344, 255, 1352.27, 260, 1351.53, 54
2, 15:23:00-000, 343, 153, 190, 153, 1352.00, 137, 1350.97, 69
2, 15:24:00-000, 614, 273, 341, 273, 1352.39, 298, 1351.58, 61
2, 15:25:00-000, 357, 156, 201, 156, 1352.01, 146, 1350.99, 48
2, 15:26:00-000, 672, 283, 389, 283, 1351.99, 288, 1350.55, 52
2, 15:27:00-000, 287, 121, 166, 121, 1351.52, 124, 1351.19, 102
2, 15:28:00-000, 575, 255, 320, 255, 1352.21, 261, 1351.32, 48
2, 15:29:00-000, 330, 167, 163, 167, 1352.61, 139, 1351.48, 38
2, 15:30:00-000, 674, 256, 418, 256, 1351.61, 305, 1350.97, 69
2, 15:31:00-000, 347, 152, 195, 152, 1351.97, 162, 1351.48, 60
2, 15:32:00-000, 581, 259, 322, 259, 1353.14, 282, 1351.95, 57
2, 15:33:00-000, 275, 135, 140, 135, 1352.94, 91, 1351.34, 46
2, 15:34:00-000, 638, 318, 320, 318, 1353.54, 288, 1351.83, 47
2, 15:35:00-000, 342, 104, 238, 104, 1350.92, 169, 1349.43, 37
2, 15:36:00-000, 635, 263, 372, 263, 1351.69, 250, 1351.04, 67
2, 15:37:00-000, 332, 162, 170, 162, 1353.10, 160, 1351.99, 97
2, 15:38:00-000, 596, 274, 322, 274, 1352.87, 257, 1351.28, 44
2, 15:39:00-000, 367, 165, 202, 165, 1351.57, 165, 1350.78, 42
2, 15:40:00-000, 724, 354, 370, 354, 1352.05, 216, 1350.18, 81
2, 15:41:00-000, 339, 121, 218, 121, 1351.97, 154, 1349.82, 113
2, 15:42:00-000, 639, 258, 381, 258, 1351.68, 247, 1350.59, 95
2, 15:43:00-000, 366, 189, 177, 189, 1352.62, 148, 1351.29, 77
2, 15:44:00-000, 587, 267, 320, 267, 1353.02, 204, 1350.82, 87
2, 15:45:00-000, 297, 99, 198, 99, 1351.70, 142, 1349.98, 81
2, 15:46:00-000, 617, 230, 387, 230, 1351.82, 225, 1351.00, 97
2, 15:47:00-000, 331, 121, 210, 121, 1351.98, 141, 1351.00, 116
2, 15:48:00-000, 630, 254, 376, 254, 1352.24, 271, 1350.89, 119
2, 15:49:00-000, 290, 137, 153, 137, 1352.75, 139, 1351.52, 54
2, 15:50:00-000, 558, 224, 334, 224, 1352.16, 238, 1350.99, 52
2, 15:51:00-000, 358, 134, 224, 134, 1352.62, 171, 1350.77, 58
2, 15:52:00-000, 600, 232, 368, 232, 1351.78, 253, 1351.49, 83
2, 15:53:00-000, 320, 151, 169, 151, 1352.45, 132, 1352.04, 74
2, 15:54:00-000, 595, 227, 368, 227, 1352.79, 268, 1351.96, 77
2, 15:55:00-000, 388, 190, 198, 190, 1353.08, 156, 1351.80, 71
2, 15:56:00-000, 690, 286, 404, 286, 1353.02, 304, 1350.77, 86
2, 15:57:00-000, 276, 96, 180, 96, 1352.46, 105, 1351.83, 62
2, 15:58:00-000, 605, 271, 334, 271, 1352.35, 271, 1351.08, 79
2, 15:59:00-000, 360, 164, 196, 164, 1352.66, 155, 1351.74, 65
2, 16:00:00-000, 612, 257, 355, 257, 1352.39, 295, 1350.53, 61
2, 16:01:00-000, 358, 160, 198, 160, 1351.97, 137, 1351.41, 31
2, 16:02:00-000, 638, 272, 366, 272, 1352.54, 271, 1351.39, 73
2, 16:03:00-000, 298, 127, 171, 127, 1352.32, 135, 1351.97, 91
2, 16:04:00-000, 540, 257, 283, 257, 1353.05, 208, 1351.93, 63
2, 16:05:00-000, 317, 132, 185, 132, 1352.06, 135, 1350.58, 50
2, 16:06:00-000, 696, 331, 365, 331, 1352.58, 298, 1351.84, 63
2, 16:07:00-000, 300, 127, 173, 127, 1352.55, 144, 1351.37, 44
2, 16:08:00-000, 543, 216, 327, 216, 1351.65, 199, 1350.20, 63
2, 16:09:00-000, 294, 158, 136, 158, 1352.25, 128, 1351.37, 58
2, 16:10:00-000, 709, 271, 438, 271, 1351.56, 289, 1350.70, 82
2, 16:11:00-000, 359, 152, 207, 152, 1351.53, 153, 1351.27, 100
2, 16:12:00-000, 536, 234, 302, 234, 1352.36, 250, 1351.42, 75
2, 16:13:00-000, 282, 126, 156, 126, 1351.53, 122, 1350.97, 42
2, 16:14:00-000, 606, 221, 385, 221, 1351.78, 258, 1351.27, 70
2, 16:15:00-000, 275, 109, 166, 109, 1352.60, 145, 1351.82, 88
2, 16:16:00-000, 687, 279, 408, 279, 1352.28, 276, 1350.55, 68
2, 16:17:00-000, 361, 176, 185, 176, 1352.61, 164, 1351.62, 71
2, 16:18:00-000, 611, 269, 342, 269, 1351.67, 214, 1350.52, 70
2, 16:19:00-000, 336, 110, 226, 110, 1352.43, 180, 1349.99, 86
2, 16:20:00-000, 592, 260, 332, 260, 1352.37, 227, 1351.08, 96
2, 16:21:00-000, 315, 162, 153, 162, 1352.12, 98, 1351.27, 83
2, 16:22:00-000, 624, 249, 375, 249, 1352.77, 282, 1350.84, 84
2, 16:23:00-000, 306, 101, 205, 101, 1351.24, 150, 1351.33, 43
2, 16:24:00-000, 626, 276, 350, 276, 1352.80, 266, 1351.55, 70
2, 16:25:00-000, 296, 114, 182, 114, 1351.19, 116, 1350.81, 78
2, 16:26:00-000, 589, 261, 328, 261, 1352.75, 268, 1351.77, 64
2, 16:27:00-000, 320, 168, 152, 168, 1352.78, 124, 1351.35, 58
2, 16:28:00-000, 681, 279, 402, 278, 1351.84, 285, 1350.76, 48
2, 16:29:00-000, 341, 152, 189, 153, 1352.46, 162, 1351.88, 71
3, 09:00:00-000, 183, 169, 14, 1, 1349.00, 1, 1349.00, 179
3, 09:01:00-000, 188, 188, 0, 0, 0.00, 0, 0.00, 186
3, 09:02:00-000, 190, 190, 0, 0, 0.00, 0, 0.00, 189
3, 09:03:00-000, 232, 232, 0, 0, 0.00, 0, 0.00, 229
3, 09:04:00-000, 193, 193, 0, 0, 0.00, 0, 0.00, 196
3, 09:05:00-000, 197, 197, 0, 0, 0.00, 0, 0.00, 197
3, 09:06:00-000, 183, 183, 0, 1, 1348.50, 0, 0.00, 186
3, 09:07:00-000, 192, 192, 0, 0, 0.00, 0, 0.00, 192
3, 09:08:00-000, 209, 209, 0, 0, 0.00, 0, 0.00, 208
3, 09:09:00-000, 210, 210, 0, 0, 0.00, 0, 0.00, 202
3, 09:10:00-000, 218, 218, 0, 0, 0.00, 0, 0.00, 228
3, 09:11:00-000, 227, 227, 0, 3, 1462.00, 0, 0.00, 213
3, 09:12:00-000, 169, 169, 0, 0, 0.00, 0, 0.00, 175
3, 09:13:00-000, 213, 210, 3, 3, 1459.33, 2, 1355.00, 201
3, 09:14:00-000, 230, 230, 0, 0, 0.00, 0, 0.00, 236
3, 09:15:00-000, 199, 197, 2, 9, 1353.78, 2, 1355.50, 185
3, 09:16:00-000, 207, 193, 14, 20, 1359.35, 11, 1359.27, 178
3, 09:17:00-000, 217, 217, 0, 1, 1351.00, 0, 0.00, 221
3, 09:18:00-000, 222, 220, 2, 7, 1348.29, 0, 0.00, 214
3, 09:19:00-000, 198, 187, 11, 2, 1355.50, 5, 1356.40, 193
3, 09:20:00-000, 188, 188, 0, 5, 1352.40, 0, 0.00, 182
3, 09:21:00-000, 192, 175, 17, 6, 1350.17, 1, 1351.00, 179
3, 09:22:00-000, 208, 172, 36, 12, 1349.67, 6, 1353.17, 193
3, 09:23:00-000, 196, 189, 7, 1, 1351.00, 1, 1359.00, 193
3, 09:24:00-000, 211, 191, 20, 9, 1355.56, 3, 1364.67, 195
3, 09:25:00-000, 225, 170, 55, 6, 1348.33, 0, 0.00, 223
3, 09:26:00-000, 193, 171, 22, 3, 1351.33, 15, 1352.13, 172
3, 09:27:00-000, 236, 216, 20, 6, 1349.83, 5, 1353.80, 226
3, 09:28:00-000, 212, 170, 42, 11, 1350.45, 10, 1353.90, 197
3, 09:29:00-000, 204, 197, 7, 1, 1359.00, 5, 1359.00, 197
3, 09:30:00-000, 218, 206, 12, 9, 1349.78, 3, 1351.67, 196
3, 09:31:00-000, 204, 188, 16, 3, 1349.67, 6, 1355.17, 205
3, 09:32:00-000, 217, 194, 23, 11, 1352.54, 6, 1352.33, 190
3, 09:33:00-000, 181, 136, 45, 4, 1349.25, 0, 0.00, 187
3, 09:34:00-000, 200, 165, 35, 5, 1348.80, 10, 1351.70, 185
3, 09:35:00-000, 230, 190, 40, 7, 1350.14, 7, 1350.00, 215
3, 09:36:00-000, 170, 142, 28, 6, 1350.67, 14, 1352.21, 151
3, 09:37:00-000, 209, 180, 29, 14, 1350.64, 5, 1351.20, 192
3, 09:38:00-000, 226, 187, 39, 15, 1351.46, 19, 1351.42, 191
3, 09:39:00-000, 199, 140, 59, 1, 1349.00, 14, 1350.36, 183
3, 09:40:00-000, 213, 177, 36, 9, 1348.78, 1, 1351.00, 189
3, 09:41:00-000, 171, 135, 36, 0, 0.00, 5, 1349.20, 181
3, 09:42:00-000, 178, 128, 50, 8, 1347.62, 2, 1352.00, 169
3, 09:43:00-000, 189, 137, 52, 8, 1349.50, 8, 1351.50, 167
3, 09:44:00-000, 220, 180, 40, 1, 1349.00, 6, 1351.17, 213
3, 09:45:00-000, 216, 197, 19, 9, 1353.11, 14, 1353.29, 198
3, 09:46:00-000, 202, 181, 21, 11, 1349.09, 5, 1351.20, 178
3, 09:47:00-000, 210, 195, 15, 4, 1352.25, 6, 1353.17, 203
3, 09:48:00-000, 166, 106, 60, 9, 1348.78, 11, 1350.27, 152
3, 09:49:00-000, 192, 130, 62, 15, 1349.80, 22, 1351.09, 156
3, 09:50:00-000, 202, 155, 47, 7, 1348.00, 3, 1351.00, 186
3, 09:51:00-000, 185, 166, 19, 11, 1351.09, 14, 1354.21, 166
3, 09:52:00-000, 212, 168, 44, 13, 1347.92, 9, 1351.33, 186
3, 09:53:00-000, 210, 182, 28, 3, 1347.67, 2, 1350.50, 204
3, 09:54:00-000, 180, 132, 48, 16, 1347.44, 9, 1351.55, 151
3, 09:55:00-000, 186, 155, 31, 3, 1350.00, 16, 1350.06, 169
3, 09:56:00-000, 192, 172, 20, 8, 1348.75, 6, 1351.33, 185
3, 09:57:00-000, 188, 154, 34, 7, 1347.57, 2, 1352.00, 170
3, 09:58:00-000, 241, 218, 23, 11, 1350.63, 5, 1353.40, 229
3, 09:59:00-000, 221, 176, 45, 4, 1350.00, 6, 1351.17, 210
3, 10:00:00-000, 210, 162, 48, 18, 1349.94, 20, 1352.60, 170
3, 10:01:00-000, 187, 132, 55, 10, 1348.30, 4, 1349.50, 177
3, 10:02:00-000, 228, 140, 88, 3, 1349.67, 15, 1350.27, 206
3, 10:03:00-000, 186, 163, 23, 12, 1349.33, 6, 1351.67, 174
3, 10:04:00-000, 211, 135, 76, 12, 1350.00, 3, 1351.33, 194
3, 10:05:00-000, 242, 146, 96, 22, 1347.63, 4, 1351.25, 209
3, 10:06:00-000, 231, 121, 110, 16, 1348.31, 25, 1351.08, 201
3, 10:07:00-000, 193, 138, 55, 3, 1349.00, 11, 1351.09, 172
3, 10:08:00-000, 206, 145, 61, 15, 1348.60, 9, 1350.78, 186
3, 10:09:00-000, 209, 134, 75, 5, 1348.00, 7, 1350.43, 200
3, 10:10:00-000, 195, 136, 59, 11, 1347.55, 4, 1351.50, 172
3, 10:11:00-000, 174, 133, 41, 3, 1347.67, 8, 1350.75, 170
3, 10:12:00-000, 190, 143, 47, 5, 1348.00, 9, 1350.89, 172
3, 10:13:00-000, 203, 165, 38, 2, 1348.50, 5, 1351.80, 194
3, 10:14:00-000, 218, 193, 25, 12, 1346.50, 4, 1352.25, 202
3, 10:15:00-000, 212, 150, 62, 8, 1349.75, 9, 1352.11, 193
3, 10:16:00-000, 175, 140, 35, 4, 1347.25, 14, 1351.36, 161
3, 10:17:00-000, 209, 180, 29, 7, 1351.29, 3, 1352.67, 197
3, 10:18:00-000, 185, 158, 27, 12, 1347.42, 11, 1351.54, 167
3, 10:19:00-000, 167, 137, 30, 6, 1348.00, 15, 1351.00, 147
3, 10:20:00-000, 186, 160, 26, 11, 1349.18, 8, 1352.25, 168
3, 10:21:00-000, 222, 176, 46, 15, 1348.20, 9, 1351.11, 194
3, 10:22:00-000, 227, 178, 49, 11, 1347.54, 8, 1351.37, 208
3, 10:23:00-000, 193, 140, 53, 4, 1347.75, 11, 1350.73, 179
3, 10:24:00-000, 162, 139, 23, 17, 1350.94, 8, 1355.00, 139
3, 10:25:00-000, 193, 148, 45, 3, 1350.00, 7, 1352.43, 180
3, 10:26:00-000, 185, 127, 58, 14, 1347.14, 6, 1350.33, 167
3, 10:27:00-000, 224, 145, 79, 2, 1349.00, 7, 1351.14, 215
3, 10:28:00-000, 198, 136, 62, 7, 1347.43, 12, 1351.17, 174
3, 10:29:00-000, 197, 129, 68, 12, 1347.33, 13, 1351.00, 179
3, 10:30:00-000, 212, 162, 50, 11, 1347.27, 3, 1351.67, 195
3, 10:31:00-000, 206, 161, 45, 7, 1347.86, 5, 1351.40, 195
3, 10:32:00-000, 210, 150, 60, 4, 1349.00, 7, 1352.00, 197
3, 10:33:00-000, 177, 153, 24, 1, 1349.00, 12, 1350.92, 167
3, 10:34:00-000, 192, 148, 44, 8, 1348.00, 1, 1350.00, 175
3, 10:35:00-000, 177, 150, 27, 0, 0.00, 21, 1351.09, 154
3, 10:36:00-000, 222, 161, 61, 20, 1351.45, 7, 1352.00, 205
3, 10:37:00-000, 225, 187, 38, 20, 1347.70, 14, 1351.07, 186
3, 10:38:00-000, 195, 142, 53, 13, 1347.15, 6, 1352.00, 174
3, 10:39:00-000, 194, 137, 57, 4, 1348.00, 12, 1351.17, 183
3, 10:40:00-000, 210, 150, 60, 20, 1347.45, 7, 1350.14, 179
3, 10:41:00-000, 194, 130, 64, 6, 1349.33, 13, 1350.77, 180
3, 10:42:00-000, 232, 180, 52, 20, 1350.45, 5, 1353.80, 204
3, 10:43:00-000, 179, 88, 91, 9, 1349.22, 18, 1350.72, 144
3, 10:44:00-000, 194, 136, 58, 6, 1349.33, 16, 1351.00, 178
3, 10:45:00-000, 196, 156, 40, 7, 1348.57, 13, 1351.00, 178
3, 10:46:00-000, 194, 171, 23, 4, 1349.50, 12, 1351.00, 182
3, 10:47:00-000, 222, 218, 4, 5, 1353.40, 1, 1353.00, 210
3, 10:48:00-000, 170, 152, 18, 13, 1353.46, 1, 1352.00, 163
3, 10:49:00-000, 181, 137, 44, 3, 1354.00, 8, 1353.12, 170
3, 10:50:00-000, 215, 163, 52, 17, 1348.11, 7, 1350.00, 188
3, 10:51:00-000, 231, 159, 72, 18, 1348.94, 15, 1350.80, 182
3, 10:52:00-000, 180, 118, 62, 16, 1350.25, 17, 1352.59, 161
3, 10:53:00-000, 205, 159, 46, 3, 1351.67, 16, 1351.81, 188
3, 10:54:00-000, 214, 162, 52, 11, 1347.36, 12, 1350.50, 185
3, 10:55:00-000, 220, 148, 72, 18, 1347.61, 9, 1351.44, 198
3, 10:56:00-000, 200, 124, 76, 8, 1348.37, 19, 1351.42, 169
3, 10:57:00-000, 200, 146, 54, 7, 1348.86, 2, 1349.00, 197
3, 10:58:00-000, 194, 155, 39, 3, 1347.00, 7, 1349.86, 176
3, 10:59:00-000, 206, 168, 38, 4, 1350.00, 11, 1351.54, 194
3, 11:00:00-000, 199, 162, 37, 13, 1349.84, 12, 1350.67, 179
3, 11:01:00-000, 199, 145, 54, 5, 1348.80, 9, 1351.00, 185
3, 11:02:00-000, 221, 204, 17, 22, 1348.77, 9, 1351.67, 181
3, 11:03:00-000, 206, 148, 58, 11, 1350.00, 15, 1352.46, 184
3, 11:04:00-000, 218, 138, 80, 14, 1350.35, 12, 1351.25, 198
3, 11:05:00-000, 218, 133, 85, 11, 1349.00, 5, 1350.60, 200
3, 11:06:00-000, 213, 125, 88, 12, 1349.58, 9, 1350.11, 188
3, 11:07:00-000, 215, 131, 84, 11, 1349.09, 17, 1351.70, 183
3, 11:08:00-000, 211, 161, 50, 11, 1347.36, 15, 1351.20, 184
3, 11:09:00-000, 198, 144, 54, 10, 1345.90, 8, 1351.12, 192
3, 11:10:00-000, 228, 147, 81, 9, 1349.56, 14, 1351.64, 191
3, 11:11:00-000, 218, 199, 19, 2, 1350.00, 6, 1351.17, 218
3, 11:12:00-000, 210, 189, 21, 6, 1348.67, 7, 1350.43, 192
3, 11:13:00-000, 200, 190, 10, 7, 1350.14, 4, 1351.75, 195
3, 11:14:00-000, 193, 161, 32, 2, 1348.00, 0, 0.00, 195
3, 11:15:00-000, 219, 203, 16, 5, 1350.40, 10, 1352.40, 191
3, 11:16:00-000, 224, 153, 71, 30, 1349.09, 22, 1351.86, 183
3, 11:17:00-000, 174, 140, 34, 10, 1348.80, 10, 1351.00, 155
3, 11:18:00-000, 189, 174, 15, 15, 1350.40, 7, 1352.14, 165
3, 11:19:00-000, 219, 174, 45, 1, 1348.00, 6, 1350.67, 210
3, 11:20:00-000, 185, 156, 29, 13, 1352.61, 8, 1352.50, 160
3, 11:21:00-000, 191, 133, 58, 15, 1348.67, 10, 1350.80, 168
3, 11:22:00-000, 207, 114, 93, 12, 1349.33, 15, 1350.53, 180
3, 11:23:00-000, 224, 140, 84, 19, 1349.84, 8, 1352.12, 192
3, 11:24:00-000, 200, 159, 41, 16, 1347.06, 23, 1350.34, 163
3, 11:25:00-000, 190, 156, 34, 1, 1350.00, 14, 1352.78, 168
3, 11:26:00-000, 172, 151, 21, 9, 1349.78, 8, 1353.37, 170
3, 11:27:00-000, 184, 155, 29, 13, 1347.77, 2, 1351.50, 162
3, 11:28:00-000, 195, 165, 30, 2, 1348.00, 9, 1351.22, 194
3, 11:29:00-000, 215, 182, 33, 7, 1347.71, 0, 0.00, 198
3, 11:30:00-000, 175, 123, 52, 15, 1349.93, 17, 1351.17, 153
3, 11:31:00-000, 202, 157, 45, 0, 0.00, 6, 1350.33, 193
3, 11:32:00-000, 215, 174, 41, 12, 1347.33, 7, 1350.86, 195
3, 11:33:00-000, 221, 158, 63, 6, 1346.83, 16, 1350.19, 191
3, 11:34:00-000, 198, 143, 55, 21, 1349.00, 17, 1351.23, 171
3, 11:35:00-000, 174, 113, 61, 12, 1349.42, 16, 1352.81, 143
3, 11:36:00-000, 190, 149, 41, 15, 1347.80, 16, 1350.69, 154
3, 11:37:00-000, 202, 160, 42, 10, 1347.40, 18, 1351.44, 180
3, 11:38:00-000, 203, 158, 45, 18, 1346.94, 1, 1351.00, 183
3, 11:39:00-000, 211, 145, 66, 4, 1346.00, 2, 1349.00, 206
3, 11:40:00-000, 215, 136, 79, 15, 1347.40, 12, 1350.92, 191
3, 11:41:00-000, 223, 140, 83, 7, 1346.29, 9, 1350.89, 203
3, 11:42:00-000, 176, 121, 55, 20, 1351.70, 21, 1352.47, 139
3, 11:43:00-000, 200, 145, 55, 8, 1348.87, 21, 1351.47, 169
3, 11:44:00-000, 200, 166, 34, 19, 1349.89, 15, 1351.20, 160
3, 11:45:00-000, 192, 143, 49, 15, 1350.13, 15, 1351.47, 158
3, 11:46:00-000, 235, 182, 53, 9, 1349.22, 16, 1350.25, 207
3, 11:47:00-000, 183, 178, 5, 6, 1350.00, 3, 1351.33, 185
3, 11:48:00-000, 198, 124, 74, 14, 1348.57, 7, 1353.14, 181
3, 11:49:00-000, 180, 109, 71, 3, 1347.00, 9, 1350.33, 156
3, 11:50:00-000, 212, 170, 42, 12, 1348.33, 15, 1352.86, 189
3, 11:51:00-000, 196, 138, 58, 4, 1348.00, 3, 1350.00, 195
3, 11:52:00-000, 188, 150, 38, 9, 1347.89, 3, 1351.67, 177
3, 11:53:00-000, 183, 134, 49, 2, 1350.00, 8, 1350.87, 169
3, 11:54:00-000, 192, 158, 34, 11, 1346.64, 9, 1351.00, 160
3, 11:55:00-000, 204, 170, 34, 1, 1350.00, 11, 1350.64, 199
3, 11:56:00-000, 205, 191, 14, 22, 1351.13, 4, 1352.00, 185
3, 11:57:00-000, 232, 167, 65, 12, 1347.58, 1, 1355.00, 218
3, 11:58:00-000, 213, 155, 58, 19, 1350.63, 20, 1351.50, 174
3, 11:59:00-000, 193, 105, 88, 17, 1349.94, 8, 1351.37, 171
3, 12:00:00-000, 194, 88, 106, 13, 1346.38, 13, 1350.15, 168
3, 12:01:00-000, 201, 80, 121, 4, 1347.00, 4, 1350.75, 192
3, 12:02:00-000, 170, 96, 74, 5, 1349.80, 16, 1350.69, 151
3, 12:03:00-000, 219, 153, 66, 5, 1348.80, 15, 1351.20, 184
3, 12:04:00-000, 207, 149, 58, 22, 1348.86, 16, 1351.62, 182
3, 12:05:00-000, 204, 147, 57, 13, 1348.46, 3, 1353.67, 184
3, 12:06:00-000, 192, 112, 80, 11, 1347.55, 25, 1352.52, 163
3, 12:07:00-000, 206, 159, 47, 8, 1345.13, 5, 1350.80, 191
3, 12:08:00-000, 215, 186, 29, 3, 1348.67, 3, 1350.00, 209
3, 12:09:00-000, 192, 143, 49, 7, 1345.86, 2, 1348.00, 177
3, 12:10:00-000, 187, 122, 65, 6, 1348.33, 5, 1350.60, 179
3, 12:11:00-000, 201, 141, 60, 8, 1347.38, 6, 1350.67, 190
3, 12:12:00-000, 168, 112, 56, 14, 1348.50, 18, 1351.39, 137
3, 12:13:00-000, 187, 138, 49, 8, 1348.75, 6, 1350.50, 171
3, 12:14:00-000, 196, 98, 98, 20, 1348.80, 16, 1350.56, 157
3, 12:15:00-000, 185, 102, 83, 1, 1348.00, 7, 1351.86, 173
3, 12:16:00-000, 183, 96, 87, 8, 1348.87, 20, 1351.20, 164
3, 12:17:00-000, 186, 150, 36, 2, 1349.00, 8, 1350.62, 168
3, 12:18:00-000, 229, 177, 52, 20, 1349.20, 10, 1351.40, 191
3, 12:19:00-000, 169, 121, 48, 4, 1349.00, 9, 1351.67, 173
3, 12:20:00-000, 229, 184, 45, 13, 1348.15, 11, 1351.27, 202
3, 12:21:00-000, 210, 167, 43, 12, 1349.00, 9, 1350.33, 192
3, 12:22:00-000, 188, 134, 54, 10, 1347.80, 12, 1352.00, 156
3, 12:23:00-000, 190, 127, 63, 2, 1348.00, 7, 1349.71, 188
3, 12:24:00-000, 180, 155, 25, 4, 1347.50, 7, 1352.00, 172
3, 12:25:00-000, 196, 176, 20, 4, 1346.75, 7, 1351.00, 185
3, 12:26:00-000, 200, 186, 14, 12, 1348.17, 4, 1352.75, 179
3, 12:27:00-000, 196, 158, 38, 14, 1348.78, 5, 1350.80, 176
3, 12:28:00-000, 212, 132, 80, 30, 1348.43, 13, 1351.77, 175
3, 12:29:00-000, 212, 130, 82, 2, 1349.00, 31, 1350.96, 171
3, 12:30:00-000, 163, 136, 27, 14, 1347.93, 10, 1350.80, 145
3, 12:31:00-000, 220, 162, 58, 11, 1348.54, 8, 1350.75, 199
3, 12:32:00-000, 182, 126, 56, 2, 1347.50, 9, 1352.33, 169
3, 12:33:00-000, 189, 139, 50, 17, 1348.41, 14, 1352.29, 158
3, 12:34:00-000, 216, 173, 43, 29, 1349.27, 6, 1352.17, 184
3, 12:35:00-000, 187, 109, 78, 5, 1349.00, 9, 1351.00, 175
3, 12:36:00-000, 220, 148, 72, 16, 1349.44, 18, 1351.50, 186
3, 12:37:00-000, 164, 87, 77, 17, 1348.59, 16, 1351.19, 131
3, 12:38:00-000, 176, 113, 63, 8, 1348.25, 16, 1350.75, 146
3, 12:39:00-000, 214, 134, 80, 11, 1347.91, 9, 1350.55, 201
3, 12:40:00-000, 179, 104, 75, 5, 1348.80, 8, 1350.25, 160
3, 12:41:00-000, 188, 131, 57, 6, 1348.50, 11, 1351.18, 175
3, 12:42:00-000, 207, 138, 69, 7, 1347.86, 13, 1350.00, 176
3, 12:43:00-000, 205, 180, 25, 6, 1350.33, 14, 1351.00, 186
3, 12:44:00-000, 169, 133, 36, 11, 1348.91, 3, 1351.00, 159
3, 12:45:00-000, 200, 150, 50, 13, 1349.31, 10, 1351.30, 183
3, 12:46:00-000, 196, 148, 48, 13, 1347.38, 18, 1352.72, 167
3, 12:47:00-000, 191, 162, 29, 12, 1348.33, 8, 1352.12, 162
3, 12:48:00-000, 191, 172, 19, 5, 1348.00, 5, 1351.20, 187
3, 12:49:00-000, 215, 152, 63, 12, 1348.33, 2, 1351.00, 193
3, 12:50:00-000, 213, 131, 82, 5, 1348.00, 17, 1352.29, 197
3, 12:51:00-000, 191, 154, 37, 9, 1350.11, 7, 1353.00, 178
3, 12:52:00-000, 217, 178, 39, 17, 1348.41, 9, 1351.33, 185
3, 12:53:00-000, 194, 150, 44, 8, 1349.12, 9, 1351.89, 181
3, 12:54:00-000, 219, 152, 67, 7, 1347.57, 11, 1352.45, 201
3, 12:55:00-000, 174, 119, 55, 6, 1349.67, 7, 1352.29, 160
3, 12:56:00-000, 197, 153, 44, 12, 1348.67, 17, 1351.23, 164
3, 12:57:00-000, 181, 150, 31, 6, 1349.50, 13, 1351.23, 168
3, 12:58:00-000, 197, 163, 34, 11, 1348.73, 7, 1349.86, 182
3, 12:59:00-000, 206, 153, 53, 16, 1348.12, 10, 1351.80, 177
3, 13:00:00-000, 185, 116, 69, 16, 1348.94, 19, 1351.84, 145
3, 13:01:00-000, 197, 177, 20, 5, 1349.00, 7, 1350.86, 192
3, 13:02:00-000, 238, 192, 46, 15, 1347.80, 4, 1355.00, 217
3, 13:03:00-000, 204, 169, 35, 2, 1349.50, 11, 1353.00, 191
3, 13:04:00-000, 211, 132, 79, 22, 1348.45, 24, 1351.54, 163
3, 13:05:00-000, 198, 165, 33, 3, 1349.33, 14, 1351.57, 176
3, 13:06:00-000, 200, 172, 28, 14, 1348.00, 13, 1350.92, 182
3, 13:07:00-000, 208, 200, 8, 18, 1348.83, 1, 1350.00, 183
3, 13:08:00-000, 230, 159, 71, 8, 1347.75, 3, 1351.00, 224
3, 13:09:00-000, 189, 124, 65, 6, 1349.00, 7, 1351.43, 168
3, 13:10:00-000, 183, 123, 60, 11, 1349.09, 8, 1350.87, 167
3, 13:11:00-000, 206, 121, 85, 19, 1346.79, 8, 1350.12, 182
3, 13:12:00-000, 207, 108, 99, 4, 1348.25, 13, 1351.77, 193
3, 13:13:00-000, 203, 127, 76, 12, 1346.67, 7, 1351.43, 184
3, 13:14:00-000, 172, 105, 67, 12, 1346.58, 8, 1349.87, 145
3, 13:15:00-000, 213, 116, 97, 2, 1347.00, 5, 1350.80, 213
3, 13:16:00-000, 213, 175, 38, 12, 1349.92, 25, 1352.84, 176
3, 13:17:00-000, 214, 192, 22, 11, 1349.91, 9, 1353.67, 192
3, 13:18:00-000, 201, 175, 26, 8, 1349.25, 5, 1352.20, 190
3, 13:19:00-000, 200, 167, 33, 8, 1348.62, 6, 1350.83, 184
3, 13:20:00-000, 212, 172, 40, 8, 1350.37, 17, 1351.53, 183
3, 13:21:00-000, 198, 156, 42, 9, 1348.89, 3, 1351.67, 190
3, 13:22:00-000, 202, 139, 63, 17, 1348.11, 20, 1351.30, 159
3, 13:23:00-000, 227, 162, 65, 8, 1346.75, 14, 1350.43, 209
3, 13:24:00-000, 170, 118, 52, 16, 1346.62, 7, 1351.00, 151
3, 13:25:00-000, 215, 139, 76, 15, 1348.27, 17, 1351.29, 182
3, 13:26:00-000, 184, 107, 77, 11, 1347.27, 8, 1352.00, 163
3, 13:27:00-000, 198, 132, 66, 2, 1350.00, 16, 1349.06, 178
3, 13:28:00-000, 229, 186, 43, 17, 1346.65, 23, 1350.48, 184
3, 13:29:00-000, 202, 174, 28, 10, 1349.10, 10, 1352.00, 178
3, 13:30:00-000, 219, 156, 63, 17, 1347.76, 7, 1352.29, 203
3, 13:31:00-000, 205, 174, 31, 0, 0.00, 6, 1351.83, 205
3, 13:32:00-000, 209, 146, 63, 14, 1349.14, 3, 1352.33, 192
3, 13:33:00-000, 234, 188, 46, 7, 1348.86, 16, 1351.81, 201
3, 13:34:00-000, 201, 170, 31, 32, 1351.15, 10, 1354.40, 167
3, 13:35:00-000, 224, 172, 52, 3, 1349.67, 10, 1350.30, 214
3, 13:36:00-000, 174, 114, 60, 23, 1350.13, 16, 1352.62, 128
3, 13:37:00-000, 178, 113, 65, 15, 1348.46, 14, 1350.57, 153
3, 13:38:00-000, 191, 114, 77, 6, 1348.50, 16, 1351.12, 157
3, 13:39:00-000, 210, 131, 79, 9, 1350.00, 7, 1351.43, 199
3, 13:40:00-000, 204, 153, 51, 11, 1348.73, 15, 1351.80, 186
3, 13:41:00-000, 208, 154, 54, 10, 1347.60, 9, 1350.11, 183
3, 13:42:00-000, 184, 137, 47, 27, 1347.89, 15, 1350.60, 149
3, 13:43:00-000, 218, 127, 91, 7, 1346.86, 21, 1351.81, 182
3, 13:44:00-000, 246, 207, 39, 19, 1349.74, 34, 1351.76, 198
3, 13:45:00-000, 180, 147, 33, 5, 1346.20, 5, 1351.00, 172
3, 13:46:00-000, 203, 167, 36, 6, 1347.33, 7, 1348.43, 181
3, 13:47:00-000, 226, 206, 20, 1, 1344.00, 1, 1351.00, 227
3, 13:48:00-000, 226, 182, 44, 9, 1349.00, 3, 1351.33, 208
3, 13:49:00-000, 190, 142, 48, 12, 1349.00, 1, 1350.00, 182
3, 13:50:00-000, 184, 109, 75, 8, 1347.75, 13, 1351.84, 169
3, 13:51:00-000, 189, 128, 61, 8, 1346.50, 6, 1350.83, 177
3, 13:52:00-000, 208, 103, 105, 24, 1347.67, 20, 1351.80, 156
3, 13:53:00-000, 220, 146, 74, 10, 1349.40, 22, 1352.09, 187
3, 13:54:00-000, 161, 144, 17, 4, 1347.00, 2, 1351.00, 160
3, 13:55:00-000, 208, 157, 51, 14, 1348.00, 0, 0.00, 197
3, 13:56:00-000, 225, 143, 82, 18, 1346.72, 21, 1351.81, 179
3, 13:57:00-000, 203, 104, 99, 11, 1348.09, 6, 1350.17, 179
3, 13:58:00-000, 184, 105, 79, 8, 1347.50, 16, 1350.75, 173
3, 13:59:00-000, 213, 175, 38, 2, 1346.50, 7, 1348.29, 201
3, 14:00:00-000, 195, 165, 30, 18, 1349.94, 19, 1353.26, 158
3, 14:01:00-000, 164, 123, 41, 13, 1348.00, 11, 1350.72, 139
3, 14:02:00-000, 217, 186, 31, 11, 1348.73, 5, 1351.80, 207
3, 14:03:00-000, 207, 123, 84, 10, 1346.90, 10, 1350.00, 182
3, 14:04:00-000, 188, 123, 65, 14, 1349.21, 9, 1352.00, 169
3, 14:05:00-000, 205, 122, 83, 5, 1347.80, 2, 1350.00, 200
3, 14:06:00-000, 198, 70, 128, 10, 1347.10, 8, 1350.25, 176
3, 14:07:00-000, 198, 93, 105, 2, 1347.00, 24, 1350.29, 168
3, 14:08:00-000, 186, 142, 44, 14, 1348.21, 18, 1351.78, 162
3, 14:09:00-000, 193, 167, 26, 16, 1347.56, 9, 1352.11, 167
3, 14:10:00-000, 205, 150, 55, 18, 1350.27, 7, 1351.00, 172
3, 14:11:00-000, 174, 121, 53, 1, 1351.00, 3, 1350.33, 179
3, 14:12:00-000, 190, 122, 68, 14, 1346.36, 9, 1351.44, 166
3, 14:13:00-000, 227, 116, 111, 26, 1347.69, 2, 1350.50, 192
3, 14:14:00-000, 219, 101, 118, 6, 1346.50, 22, 1348.63, 188
3, 14:15:00-000, 208, 92, 116, 18, 1347.17, 17, 1351.17, 182
3, 14:16:00-000, 202, 96, 106, 5, 1348.20, 21, 1350.90, 173
3, 14:17:00-000, 205, 134, 71, 11, 1348.18, 3, 1351.00, 192
3, 14:18:00-000, 202, 164, 38, 15, 1348.80, 14, 1351.71, 176
3, 14:19:00-000, 189, 151, 38, 1, 1351.00, 7, 1353.86, 175
3, 14:20:00-000, 220, 170, 50, 15, 1347.13, 14, 1352.07, 189
3, 14:21:00-000, 184, 142, 42, 18, 1348.39, 7, 1350.43, 158
3, 14:22:00-000, 179, 132, 47, 5, 1351.00, 11, 1350.73, 173
3, 14:23:00-000, 227, 169, 58, 5, 1346.20, 21, 1351.38, 190
3, 14:24:00-000, 186, 163, 23, 26, 1348.84, 8, 1352.12, 157
3, 14:25:00-000, 192, 141, 51, 6, 1347.33, 4, 1350.50, 183
3, 14:26:00-000, 222, 134, 88, 8, 1347.87, 16, 1349.31, 199
3, 14:27:00-000, 227, 146, 81, 4, 1348.50, 10, 1351.10, 214
3, 14:28:00-000, 211, 123, 88, 17, 1347.47, 12, 1349.08, 178
3, 14:29:00-000, 179, 128, 51, 11, 1347.54, 13, 1351.54, 154
3, 14:30:00-000, 196, 138, 58, 23, 1349.13, 2, 1349.50, 168
3, 14:31:00-000, 207, 105, 102, 0, 0.00, 16, 1350.50, 188
3, 14:32:00-000, 188, 154, 34, 8, 1349.50, 19, 1352.26, 175
3, 14:33:00-000, 195, 155, 40, 13, 1347.92, 10, 1351.00, 171
3, 14:34:00-000, 176, 124, 52, 8, 1348.12, 8, 1350.87, 155
3, 14:35:00-000, 175, 160, 15, 2, 1353.00, 2, 1352.00, 175
3, 14:36:00-000, 200, 143, 57, 28, 1348.39, 6, 1352.33, 156
3, 14:37:00-000, 168, 96, 72, 2, 1348.00, 9, 1350.44, 167
3, 14:38:00-000, 189, 153, 36, 13, 1349.61, 18, 1352.28, 155
3, 14:39:00-000, 203, 133, 70, 3, 1349.00, 15, 1351.13, 179
3, 14:40:00-000, 206, 183, 23, 2, 1347.50, 3, 1350.00, 211
3, 14:41:00-000, 219, 192, 27, 9, 1352.89, 14, 1350.64, 195
3, 14:42:00-000, 214, 179, 35, 16, 1350.06, 7, 1355.43, 190
3, 14:43:00-000, 221, 160, 61, 7, 1347.57, 8, 1350.75, 207
3, 14:44:00-000, 204, 148, 56, 9, 1347.67, 10, 1351.70, 181
3, 14:45:00-000, 209, 161, 48, 9, 1349.55, 10, 1351.10, 183
3, 14:46:00-000, 203, 170, 33, 19, 1349.16, 11, 1351.18, 171
3, 14:47:00-000, 182, 109, 73, 6, 1350.50, 8, 1350.87, 178
3, 14:48:00-000, 209, 147, 62, 27, 1349.11, 20, 1351.80, 155
3, 14:49:00-000, 193, 166, 27, 5, 1353.20, 21, 1352.38, 173
3, 14:50:00-000, 194, 172, 22, 15, 1349.27, 4, 1352.00, 175
3, 14:51:00-000, 157, 106, 51, 3, 1348.67, 3, 1351.00, 152
3, 14:52:00-000, 217, 126, 91, 16, 1348.06, 2, 1351.50, 198
3, 14:53:00-000, 225, 123, 102, 1, 1354.00, 26, 1351.84, 201
3, 14:54:00-000, 191, 143, 48, 22, 1348.13, 4, 1350.00, 167
3, 14:55:00-000, 191, 100, 91, 13, 1350.15, 22, 1351.13, 156
3, 14:56:00-000, 241, 191, 50, 25, 1349.16, 24, 1351.95, 186
3, 14:57:00-000, 225, 162, 63, 6, 1347.83, 16, 1351.18, 207
3, 14:58:00-000, 204, 154, 50, 13, 1349.54, 9, 1351.00, 181
3, 14:59:00-000, 193, 154, 39, 13, 1350.46, 11, 1350.18, 170
3, 15:00:00-000, 195, 136, 59, 8, 1347.50, 9, 1351.89, 176
3, 15:01:00-000, 212, 158, 54, 22, 1349.86, 22, 1352.54, 162
3, 15:02:00-000, 213, 160, 53, 16, 1348.06, 19, 1352.10, 186
3, 15:03:00-000, 216, 179, 37, 6, 1349.33, 11, 1351.27, 198
3, 15:04:00-000, 197, 145, 52, 8, 1346.50, 13, 1352.08, 178
3, 15:05:00-000, 225, 197, 28, 9, 1350.89, 4, 1353.00, 208
3, 15:06:00-000, 190, 178, 12, 15, 1351.06, 9, 1352.33, 167
3, 15:07:00-000, 163, 128, 35, 6, 1348.17, 3, 1350.00, 155
3, 15:08:00-000, 216, 133, 83, 29, 1347.55, 13, 1351.31, 174
3, 15:09:00-000, 229, 122, 107, 11, 1346.64, 6, 1350.17, 205
3, 15:10:00-000, 193, 122, 71, 24, 1346.75, 20, 1351.40, 158
3, 15:11:00-000, 194, 40, 154, 4, 1346.50, 3, 1350.00, 188
3, 15:12:00-000, 191, 67, 124, 13, 1348.00, 13, 1351.07, 162
3, 15:13:00-000, 194, 92, 102, 6, 1348.17, 9, 1350.33, 175
3, 15:14:00-000, 191, 89, 102, 5, 1346.80, 29, 1350.41, 160
3, 15:15:00-000, 180, 160, 20, 7, 1348.29, 11, 1352.18, 161
3, 15:16:00-000, 203, 188, 15, 6, 1353.33, 10, 1354.80, 178
3, 15:17:00-000, 192, 163, 29, 10, 1348.90, 1, 1350.00, 182
3, 15:18:00-000, 198, 137, 61, 24, 1349.91, 15, 1353.20, 171
3, 15:19:00-000, 225, 157, 68, 15, 1349.33, 15, 1350.46, 196
3, 15:20:00-000, 191, 134, 57, 11, 1349.09, 24, 1350.58, 153
3, 15:21:00-000, 218, 144, 74, 9, 1345.89, 3, 1350.67, 209
3, 15:22:00-000, 221, 146, 75, 14, 1347.00, 11, 1351.45, 196
3, 15:23:00-000, 208, 140, 68, 6, 1348.83, 12, 1351.58, 190
3, 15:24:00-000, 191, 151, 40, 12, 1348.25, 10, 1350.60, 165
3, 15:25:00-000, 192, 147, 45, 5, 1347.60, 17, 1352.29, 172
3, 15:26:00-000, 236, 181, 55, 25, 1349.04, 8, 1352.00, 202
3, 15:27:00-000, 203, 121, 82, 3, 1348.67, 22, 1350.81, 173
3, 15:28:00-000, 177, 144, 33, 12, 1350.58, 5, 1351.40, 161
3, 15:29:00-000, 219, 172, 47, 14, 1348.86, 10, 1350.50, 199
3, 15:30:00-000, 172, 122, 50, 13, 1347.31, 4, 1350.50, 153
3, 15:31:00-000, 214, 132, 82, 2, 1349.00, 21, 1352.28, 191
3, 15:32:00-000, 208, 166, 42, 33, 1348.72, 5, 1351.00, 170
3, 15:33:00-000, 194, 106, 88, 9, 1349.22, 24, 1350.95, 159
3, 15:34:00-000, 213, 154, 59, 9, 1350.11, 18, 1350.94, 184
3, 15:35:00-000, 191, 175, 16, 1, 1347.00, 4, 1348.50, 193
3, 15:36:00-000, 193, 148, 45, 28, 1347.78, 8, 1351.50, 154
3, 15:37:00-000, 193, 153, 40, 8, 1350.25, 13, 1352.07, 170
3, 15:38:00-000, 204, 147, 57, 7, 1346.71, 4, 1350.25, 198
3, 15:39:00-000, 202, 155, 47, 6, 1347.33, 10, 1351.00, 187
3, 15:40:00-000, 208, 129, 79, 9, 1347.55, 9, 1350.00, 183
3, 15:41:00-000, 217, 155, 62, 4, 1348.50, 15, 1352.13, 198
3, 15:42:00-000, 203, 170, 33, 17, 1348.70, 9, 1351.11, 183
3, 15:43:00-000, 205, 177, 28, 8, 1347.88, 4, 1350.50, 195
3, 15:44:00-000, 212, 171, 41, 4, 1351.50, 6, 1351.83, 196
3, 15:45:00-000, 181, 132, 49, 9, 1349.78, 13, 1351.92, 165
3, 15:46:00-000, 199, 165, 34, 12, 1348.17, 8, 1351.62, 177
3, 15:47:00-000, 170, 120, 50, 12, 1350.00, 21, 1352.00, 139
3, 15:48:00-000, 189, 165, 24, 7, 1349.29, 16, 1351.31, 164
3, 15:49:00-000, 220, 208, 12, 15, 1350.06, 6, 1352.00, 195
3, 15:50:00-000, 240, 158, 82, 41, 1350.73, 20, 1351.80, 179
3, 15:51:00-000, 192, 110, 82, 12, 1347.92, 11, 1350.45, 174
3, 15:52:00-000, 243, 173, 70, 7, 1347.71, 9, 1352.11, 228
3, 15:53:00-000, 234, 117, 117, 8, 1349.12, 11, 1351.09, 211
3, 15:54:00-000, 182, 123, 59, 7, 1348.00, 12, 1351.17, 165
3, 15:55:00-000, 215, 183, 32, 5, 1349.20, 13, 1350.69, 197
3, 15:56:00-000, 211, 192, 19, 2, 1348.00, 6, 1352.67, 201
3, 15:57:00-000, 219, 208, 11, 5, 1348.60, 3, 1352.00, 211
3, 15:58:00-000, 188, 166, 22, 13, 1348.38, 4, 1349.50, 175
3, 15:59:00-000, 196, 144, 52, 3, 1350.33, 9, 1351.44, 178
3, 16:00:00-000, 181, 129, 52, 13, 1348.92, 6, 1349.83, 147
3, 16:01:00-000, 193, 144, 49, 12, 1347.92, 9, 1349.89, 192
3, 16:02:00-000, 186, 139, 47, 7, 1350.00, 22, 1352.45, 146
3, 16:03:00-000, 187, 175, 12, 2, 1353.50, 3, 1351.33, 194
3, 16:04:00-000, 260, 232, 28, 11, 1349.82, 4, 1352.75, 245
3, 16:05:00-000, 188, 148, 40, 11, 1348.27, 7, 1352.14, 170
3, 16:06:00-000, 219, 157, 62, 18, 1348.11, 12, 1351.08, 176
3, 16:07:00-000, 202, 148, 54, 4, 1349.50, 12, 1351.33, 191
3, 16:08:00-000, 205, 169, 36, 9, 1348.00, 10, 1351.80, 194
3, 16:09:00-000, 217, 162, 55, 11, 1348.09, 12, 1351.42, 186
3, 16:10:00-000, 225, 162, 63, 7, 1348.00, 5, 1352.80, 219
3, 16:11:00-000, 193, 142, 51, 4, 1349.50, 9, 1351.56, 165
3, 16:12:00-000, 193, 138, 55, 21, 1348.52, 11, 1350.91, 173
3, 16:13:00-000, 221, 141, 80, 14, 1349.86, 19, 1351.21, 192
3, 16:14:00-000, 183, 160, 23, 6, 1347.83, 15, 1352.87, 161
3, 16:15:00-000, 178, 171, 7, 7, 1349.43, 7, 1351.14, 167
3, 16:16:00-000, 183, 136, 47, 15, 1348.06, 9, 1352.11, 158
3, 16:17:00-000, 235, 164, 71, 12, 1348.00, 7, 1350.29, 213
3, 16:18:00-000, 183, 130, 53, 3, 1345.33, 14, 1351.35, 167
3, 16:19:00-000, 177, 145, 32, 12, 1348.58, 13, 1351.15, 148
3, 16:20:00-000, 211, 142, 69, 12, 1347.83, 7, 1351.71, 189
3, 16:21:00-000, 196, 139, 57, 7, 1348.00, 5, 1351.00, 187
3, 16:22:00-000, 212, 173, 39, 10, 1348.90, 15, 1351.07, 187
3, 16:23:00-000, 205, 164, 41, 4, 1352.00, 7, 1352.00, 200
3, 16:24:00-000, 196, 172, 24, 13, 1349.00, 7, 1350.29, 167
3, 16:25:00-000, 191, 160, 31, 4, 1349.25, 1, 1353.00, 193
3, 16:26:00-000, 205, 157, 48, 24, 1350.75, 10, 1351.70, 170
3, 16:27:00-000, 197, 157, 40, 3, 1348.67, 2, 1350.50, 195
3, 16:28:00-000, 191, 115, 76, 18, 1347.94, 18, 1351.83, 144
3, 16:29:00-000, 188, 133, 55, 5, 1350.40, 12, 1352.17, 170
4, 09:03:00-000, 295, 295, 0, 0, 0.00, 0, 0.00, 294
4, 09:04:00-000, 0, 0, 0, 0, 0.00, 0, 0.00, 1
4, 09:06:00-000, 277, 277, 0, 276, 1351.00, 0, 0.00, 0
4, 09:07:00-000, 1, 1, 0, 0, 0.00, 0, 0.00, 1
4, 09:08:00-000, 30, 28, 2, 2, 1364.00, 2, 1364.00, 14
4, 09:09:00-000, 102, 78, 24, 24, 1382.70, 24, 1382.70, 43
4, 09:10:00-000, 113, 94, 19, 19, 1418.47, 19, 1418.47, 68
4, 09:11:00-000, 75, 60, 15, 12, 1459.91, 15, 1460.33, 61
4, 09:12:00-000, 83, 58, 25, 22, 1495.04, 22, 1495.04, 40
4, 09:13:00-000, 94, 87, 7, 79, 1399.81, 9, 1436.89, 21
4, 09:14:00-000, 90, 71, 19, 48, 1355.02, 16, 1353.12, 4
4, 09:15:00-000, 71, 55, 16, 42, 1356.18, 3, 1355.67, 41
4, 09:16:00-000, 86, 52, 34, 51, 1358.27, 40, 1358.77, 1
4, 09:17:00-000, 97, 44, 53, 41, 1352.16, 39, 1352.51, 14
4, 09:18:00-000, 75, 45, 30, 35, 1352.17, 27, 1352.51, 6
4, 09:19:00-000, 82, 47, 35, 37, 1355.18, 31, 1354.83, 17
4, 09:20:00-000, 89, 46, 43, 50, 1352.05, 31, 1352.15, 0
4, 09:21:00-000, 72, 37, 35, 34, 1351.00, 35, 1351.14, 19
4, 09:22:00-000, 73, 31, 42, 26, 1351.27, 32, 1350.37, 4
4, 09:23:00-000, 78, 32, 46, 34, 1351.76, 37, 1351.51, 11
4, 09:24:00-000, 86, 45, 41, 45, 1359.08, 46, 1357.15, 0
4, 09:25:00-000, 71, 32, 39, 30, 1350.59, 35, 1350.17, 6
4, 09:26:00-000, 91, 41, 50, 42, 1351.97, 46, 1352.32, 2
4, 09:27:00-000, 82, 45, 37, 37, 1351.45, 36, 1350.60, 12
4, 09:28:00-000, 78, 28, 50, 26, 1352.92, 36, 1351.41, 7
4, 09:29:00-000, 81, 48, 33, 41, 1357.24, 35, 1357.94, 9
4, 09:30:00-000, 105, 53, 52, 53, 1353.65, 41, 1352.60, 11
4, 09:31:00-000, 69, 29, 40, 27, 1354.81, 37, 1353.83, 5
4, 09:32:00-000, 86, 46, 40, 47, 1353.16, 31, 1353.70, 5
4, 09:33:00-000, 102, 47, 55, 36, 1349.97, 45, 1350.17, 13
4, 09:34:00-000, 83, 46, 37, 54, 1350.88, 39, 1351.35, 0
4, 09:35:00-000, 101, 44, 57, 46, 1351.58, 43, 1351.67, 19
4, 09:36:00-000, 90, 47, 43, 44, 1352.81, 29, 1352.13, 3
4, 09:37:00-000, 69, 30, 39, 30, 1350.99, 38, 1351.20, 13
4, 09:38:00-000, 114, 57, 57, 59, 1352.11, 49, 1352.85, 0
4, 09:39:00-000, 87, 35, 52, 30, 1350.06, 41, 1349.77, 19
4, 09:40:00-000, 62, 22, 40, 23, 1350.08, 39, 1350.12, 1
4, 09:41:00-000, 88, 41, 47, 42, 1349.70, 45, 1349.61, 2
4, 09:42:00-000, 76, 34, 42, 31, 1350.70, 33, 1350.69, 10
4, 09:43:00-000, 74, 48, 26, 50, 1351.85, 28, 1351.85, 1
4, 09:44:00-000, 99, 36, 63, 35, 1350.34, 57, 1350.26, 7
4, 09:45:00-000, 84, 55, 29, 47, 1353.33, 21, 1352.43, 16
4, 09:46:00-000, 71, 36, 35, 29, 1350.92, 31, 1351.51, 5
4, 09:47:00-000, 99, 44, 55, 39, 1352.40, 41, 1352.33, 12
4, 09:48:00-000, 65, 25, 40, 30, 1349.63, 40, 1350.30, 4
4, 09:49:00-000, 44, 17, 27, 17, 1350.94, 25, 1351.08, 2
4, 09:50:00-000, 75, 31, 44, 30, 1350.49, 37, 1351.32, 6
4, 09:51:00-000, 98, 65, 33, 58, 1353.94, 29, 1352.41, 14
4, 09:52:00-000, 108, 54, 54, 52, 1350.38, 48, 1351.45, 2
4, 09:53:00-000, 74, 31, 43, 32, 1349.28, 34, 1349.38, 15
4, 09:54:00-000, 85, 42, 43, 34, 1350.58, 31, 1350.77, 5
4, 09:55:00-000, 77, 32, 45, 38, 1350.57, 37, 1350.59, 17
4, 09:56:00-000, 86, 35, 51, 29, 1350.34, 38, 1350.02, 3
4, 09:57:00-000, 68, 27, 41, 28, 1350.92, 50, 1350.83, 5
4, 09:58:00-000, 81, 40, 41, 38, 1352.60, 32, 1352.65, 7
4, 09:59:00-000, 102, 58, 44, 49, 1349.87, 46, 1349.34, 9
4, 10:00:00-000, 80, 56, 24, 43, 1351.53, 23, 1351.52, 8
4, 10:01:00-000, 100, 28, 72, 30, 1349.99, 48, 1350.09, 18
4, 10:02:00-000, 69, 38, 31, 39, 1349.97, 45, 1349.92, 0
4, 10:03:00-000, 80, 37, 43, 36, 1351.46, 37, 1351.51, 2
4, 10:04:00-000, 77, 35, 42, 34, 1351.73, 46, 1351.90, 2
4, 10:05:00-000, 78, 36, 42, 22, 1352.09, 27, 1352.44, 13
4, 10:06:00-000, 77, 43, 34, 57, 1350.57, 30, 1351.43, 4
4, 10:07:00-000, 83, 33, 50, 33, 1352.48, 37, 1350.67, 6
4, 10:08:00-000, 79, 37, 42, 33, 1350.06, 40, 1351.24, 7
4, 10:09:00-000, 86, 39, 47, 40, 1350.52, 37, 1350.80, 11
4, 10:10:00-000, 66, 24, 42, 21, 1349.38, 38, 1350.18, 11
4, 10:11:00-000, 97, 41, 56, 43, 1349.99, 49, 1350.08, 3
4, 10:12:00-000, 77, 44, 33, 41, 1350.19, 36, 1350.55, 5
4, 10:13:00-000, 69, 39, 30, 38, 1350.86, 26, 1350.80, 3
4, 10:14:00-000, 91, 38, 53, 31, 1349.51, 54, 1350.34, 3
4, 10:15:00-000, 87, 42, 45, 38, 1351.02, 33, 1351.30, 9
4, 10:16:00-000, 79, 28, 51, 31, 1350.09, 53, 1349.95, 1
4, 10:17:00-000, 94, 58, 36, 53, 1352.03, 29, 1352.30, 10
4, 10:18:00-000, 85, 42, 43, 45, 1350.55, 41, 1351.07, 1
4, 10:19:00-000, 84, 43, 41, 38, 1351.89, 32, 1351.71, 15
4, 10:20:00-000, 86, 49, 37, 50, 1352.57, 37, 1351.99, 1
4, 10:21:00-000, 76, 37, 39, 36, 1349.69, 28, 1349.67, 12
4, 10:22:00-000, 71, 30, 41, 28, 1350.28, 36, 1350.35, 8
4, 10:23:00-000, 63, 28, 35, 22, 1349.86, 27, 1350.81, 3
4, 10:24:00-000, 95, 55, 40, 52, 1353.35, 36, 1353.00, 11
4, 10:25:00-000, 103, 49, 54, 51, 1351.17, 47, 1351.12, 5
4, 10:26:00-000, 67, 20, 47, 20, 1349.75, 43, 1350.29, 9
4, 10:27:00-000, 69, 36, 33, 33, 1351.60, 32, 1351.00, 3
4, 10:28:00-000, 81, 48, 33, 48, 1350.07, 33, 1349.57, 2
4, 10:29:00-000, 91, 35, 56, 35, 1350.91, 55, 1350.70, 3
4, 10:30:00-000, 82, 43, 39, 37, 1350.80, 40, 1350.62, 6
4, 10:31:00-000, 75, 35, 40, 34, 1350.44, 26, 1350.65, 9
4, 10:32:00-000, 73, 29, 44, 25, 1351.07, 32, 1350.52, 4
4, 10:33:00-000, 79, 43, 36, 48, 1351.24, 44, 1351.27, 5
4, 10:34:00-000, 77, 34, 43, 34, 1349.38, 37, 1349.61, 1
4, 10:35:00-000, 68, 42, 26, 31, 1354.06, 26, 1351.34, 8
4, 10:36:00-000, 63, 32, 31, 32, 1351.56, 21, 1352.23, 6
4, 10:37:00-000, 97, 52, 45, 51, 1351.99, 41, 1352.16, 12
4, 10:38:00-000, 75, 26, 49, 25, 1352.00, 39, 1351.22, 11
4, 10:39:00-000, 96, 49, 47, 48, 1350.57, 39, 1349.89, 5
4, 10:40:00-000, 67, 24, 43, 23, 1348.21, 47, 1350.21, 2
4, 10:41:00-000, 95, 39, 56, 38, 1349.07, 58, 1350.35, 3
4, 10:42:00-000, 59, 32, 27, 31, 1351.99, 18, 1351.66, 3
4, 10:43:00-000, 75, 38, 37, 38, 1351.04, 32, 1351.09, 7
4, 10:44:00-000, 81, 44, 37, 42, 1351.37, 34, 1351.49, 4
4, 10:45:00-000, 68, 38, 30, 38, 1351.20, 23, 1350.87, 1
4, 10:46:00-000, 81, 38, 43, 31, 1349.87, 47, 1350.05, 3
4, 10:47:00-000, 81, 45, 36, 36, 1353.30, 27, 1352.70, 15
4, 10:48:00-000, 82, 36, 46, 40, 1351.92, 35, 1352.25, 8
4, 10:49:00-000, 69, 42, 27, 36, 1352.38, 30, 1350.63, 9
4, 10:50:00-000, 96, 35, 61, 42, 1350.97, 57, 1351.39, 1
4, 10:51:00-000, 86, 44, 42, 44, 1349.79, 33, 1349.14, 2
4, 10:52:00-000, 78, 46, 32, 38, 1351.57, 36, 1351.69, 4
4, 10:53:00-000, 95, 43, 52, 48, 1352.01, 44, 1352.36, 8
4, 10:54:00-000, 91, 42, 49, 39, 1348.81, 48, 1349.11, 8
4, 10:55:00-000, 109, 49, 60, 49, 1352.30, 46, 1351.60, 7
4, 10:56:00-000, 97, 39, 58, 41, 1350.41, 58, 1349.61, 0
4, 10:57:00-000, 81, 34, 47, 33, 1348.27, 38, 1348.54, 5
4, 10:58:00-000, 99, 51, 48, 37, 1350.86, 43, 1350.95, 8
4, 10:59:00-000, 81, 41, 40, 43, 1351.51, 32, 1350.84, 19
4, 11:00:00-000, 80, 39, 41, 40, 1351.09, 48, 1351.53, 1
4, 11:01:00-000, 83, 46, 37, 44, 1350.90, 35, 1351.25, 2
4, 11:02:00-000, 95, 42, 53, 40, 1351.34, 42, 1351.33, 8
4, 11:03:00-000, 56, 39, 17, 37, 1352.29, 19, 1352.58, 5
4, 11:04:00-000, 87, 46, 41, 45, 1351.48, 36, 1351.61, 2
4, 11:05:00-000, 87, 39, 48, 38, 1350.44, 43, 1350.76, 5
4, 11:06:00-000, 66, 32, 34, 29, 1349.86, 41, 1350.55, 4
4, 11:07:00-000, 77, 40, 37, 40, 1351.19, 29, 1351.61, 0
4, 11:08:00-000, 89, 37, 52, 33, 1350.33, 55, 1350.99, 5
4, 11:09:00-000, 76, 37, 39, 36, 1349.46, 31, 1348.64, 9
4, 11:10:00-000, 71, 30, 41, 26, 1349.96, 25, 1350.04, 15
4, 11:11:00-000, 87, 44, 43, 41, 1351.29, 38, 1351.28, 6
4, 11:12:00-000, 105, 53, 52, 49, 1349.66, 47, 1349.56, 5
4, 11:13:00-000, 115, 52, 63, 57, 1351.64, 53, 1350.31, 15
4, 11:14:00-000, 62, 30, 32, 21, 1350.42, 29, 1350.79, 7
4, 11:15:00-000, 72, 28, 44, 29, 1350.55, 29, 1351.34, 10
4, 11:16:00-000, 84, 54, 30, 54, 1351.49, 40, 1351.59, 3
4, 11:17:00-000, 101, 54, 47, 46, 1350.01, 43, 1350.41, 7
4, 11:18:00-000, 100, 39, 61, 37, 1354.02, 36, 1354.61, 17
4, 11:19:00-000, 80, 35, 45, 37, 1350.96, 46, 1351.08, 9
4, 11:20:00-000, 82, 37, 45, 33, 1352.21, 36, 1352.97, 6
4, 11:21:00-000, 77, 40, 37, 32, 1349.84, 34, 1350.14, 5
4, 11:22:00-000, 64, 32, 32, 39, 1349.63, 35, 1350.65, 2
4, 11:23:00-000, 81, 39, 42, 36, 1350.66, 34, 1351.11, 3
4, 11:24:00-000, 87, 39, 48, 42, 1350.42, 47, 1350.76, 4
4, 11:25:00-000, 107, 57, 50, 53, 1351.95, 53, 1351.59, 5
4, 11:26:00-000, 81, 52, 29, 46, 1352.12, 30, 1351.89, 2
4, 11:27:00-000, 88, 38, 50, 40, 1350.29, 32, 1349.96, 13
4, 11:28:00-000, 90, 42, 48, 40, 1351.07, 50, 1351.13, 5
4, 11:29:00-000, 105, 34, 71, 33, 1349.72, 46, 1349.47, 11
4, 11:30:00-000, 78, 44, 34, 41, 1350.55, 43, 1350.48, 5
4, 11:31:00-000, 78, 35, 43, 36, 1350.13, 38, 1349.96, 6
4, 11:32:00-000, 78, 29, 49, 24, 1349.41, 42, 1349.92, 7
4, 11:33:00-000, 88, 48, 40, 42, 1350.02, 28, 1349.74, 14
4, 11:34:00-000, 84, 53, 31, 55, 1351.34, 42, 1351.94, 2
4, 11:35:00-000, 87, 57, 30, 44, 1352.51, 21, 1352.04, 13
4, 11:36:00-000, 62, 25, 37, 25, 1350.56, 35, 1351.31, 7
4, 11:37:00-000, 109, 42, 67, 41, 1352.94, 68, 1351.54, 2
4, 11:38:00-000, 84, 39, 45, 33, 1348.99, 35, 1349.53, 13
4, 11:39:00-000, 76, 28, 48, 28, 1349.53, 26, 1347.73, 11
4, 11:40:00-000, 83, 34, 49, 33, 1349.78, 48, 1349.78, 1
4, 11:41:00-000, 88, 47, 41, 44, 1350.63, 50, 1350.41, 8
4, 11:42:00-000, 96, 61, 35, 58, 1352.21, 33, 1353.00, 2
4, 11:43:00-000, 83, 47, 36, 44, 1352.08, 32, 1352.18, 5
4, 11:44:00-000, 63, 31, 32, 35, 1350.91, 34, 1350.96, 2
4, 11:45:00-000, 91, 44, 47, 39, 1351.64, 44, 1352.15, 0
4, 11:46:00-000, 89, 43, 46, 44, 1350.97, 47, 1351.29, 4
4, 11:47:00-000, 87, 42, 45, 37, 1351.18, 42, 1351.47, 2
4, 11:48:00-000, 58, 21, 37, 24, 1349.37, 32, 1349.71, 5
4, 11:49:00-000, 95, 40, 55, 40, 1351.12, 48, 1351.22, 9
4, 11:50:00-000, 96, 59, 37, 59, 1353.85, 26, 1351.80, 7
4, 11:51:00-000, 87, 42, 45, 39, 1349.22, 42, 1349.28, 8
4, 11:52:00-000, 67, 27, 40, 29, 1349.34, 32, 1349.65, 7
4, 11:53:00-000, 70, 32, 38, 30, 1349.76, 27, 1349.92, 6
4, 11:54:00-000, 79, 26, 53, 22, 1349.68, 48, 1349.99, 10
4, 11:55:00-000, 73, 33, 40, 32, 1350.90, 40, 1351.52, 2
4, 11:56:00-000, 112, 61, 51, 57, 1352.38, 46, 1353.28, 3
4, 11:57:00-000, 91, 53, 38, 49, 1350.07, 38, 1350.73, 9
4, 11:58:00-000, 100, 52, 48, 56, 1351.15, 47, 1351.67, 2
4, 11:59:00-000, 78, 44, 34, 36, 1351.44, 26, 1351.46, 0
4, 12:00:00-000, 88, 47, 41, 54, 1348.10, 44, 1348.72, 1
4, 12:01:00-000, 84, 35, 49, 35, 1348.71, 43, 1348.27, 7
4, 12:02:00-000, 74, 35, 39, 33, 1350.81, 40, 1349.71, 7
4, 12:03:00-000, 82, 44, 38, 43, 1351.29, 33, 1350.63, 1
4, 12:04:00-000, 76, 36, 40, 35, 1350.99, 45, 1350.86, 4
4, 12:05:00-000, 72, 25, 47, 23, 1349.87, 20, 1350.35, 8
4, 12:06:00-000, 90, 58, 32, 44, 1351.70, 44, 1351.26, 9
4, 12:07:00-000, 51, 27, 24, 20, 1349.50, 19, 1349.73, 17
4, 12:08:00-000, 89, 43, 46, 44, 1348.65, 43, 1349.25, 2
4, 12:09:00-000, 91, 40, 51, 40, 1349.37, 51, 1349.50, 1
4, 12:10:00-000, 71, 27, 44, 29, 1348.37, 36, 1349.38, 5
4, 12:11:00-000, 87, 51, 36, 48, 1349.97, 34, 1349.91, 8
4, 12:12:00-000, 73, 43, 30, 44, 1351.58, 28, 1352.32, 1
4, 12:13:00-000, 80, 36, 44, 32, 1350.37, 27, 1350.33, 9
4, 12:14:00-000, 61, 24, 37, 29, 1349.44, 46, 1349.88, 4
4, 12:15:00-000, 93, 41, 52, 39, 1351.56, 38, 1351.31, 7
4, 12:16:00-000, 73, 46, 27, 41, 1350.70, 31, 1350.99, 9
4, 12:17:00-000, 79, 34, 45, 34, 1350.85, 38, 1350.78, 3
4, 12:18:00-000, 86, 45, 41, 45, 1352.01, 46, 1350.34, 0
4, 12:19:00-000, 83, 40, 43, 40, 1350.57, 40, 1350.64, 0
4, 12:20:00-000, 91, 36, 55, 36, 1349.63, 38, 1349.84, 15
4, 12:21:00-000, 101, 36, 65, 33, 1349.30, 60, 1348.94, 8
4, 12:22:00-000, 88, 44, 44, 44, 1350.74, 42, 1350.92, 3
4, 12:23:00-000, 72, 29, 43, 25, 1348.47, 40, 1349.17, 0
4, 12:24:00-000, 87, 43, 44, 44, 1350.20, 42, 1350.30, 3
4, 12:25:00-000, 81, 39, 42, 39, 1351.10, 39, 1351.38, 3
4, 12:26:00-000, 63, 31, 32, 27, 1350.44, 26, 1350.69, 4
4, 12:27:00-000, 82, 37, 45, 38, 1350.96, 34, 1351.26, 14
4, 12:28:00-000, 70, 35, 35, 33, 1350.57, 40, 1350.34, 1
4, 12:29:00-000, 78, 41, 37, 43, 1350.69, 32, 1350.21, 4
4, 12:30:00-000, 120, 45, 75, 45, 1349.63, 63, 1350.18, 1
4, 12:31:00-000, 78, 31, 47, 28, 1350.03, 35, 1350.14, 17
4, 12:32:00-000, 86, 33, 53, 35, 1350.11, 61, 1349.09, 4
4, 12:33:00-000, 99, 55, 44, 53, 1351.78, 35, 1350.62, 4
4, 12:34:00-000, 77, 39, 38, 32, 1351.96, 27, 1351.77, 12
4, 12:35:00-000, 75, 31, 44, 35, 1349.88, 48, 1349.95, 6
4, 12:36:00-000, 99, 46, 53, 46, 1351.23, 50, 1351.13, 0
4, 12:37:00-000, 69, 35, 34, 32, 1350.52, 29, 1350.37, 2
4, 12:38:00-000, 73, 40, 33, 38, 1350.44, 33, 1350.57, 4
4, 12:39:00-000, 89, 43, 46, 43, 1350.18, 39, 1350.33, 6
4, 12:40:00-000, 87, 44, 43, 41, 1349.16, 46, 1348.84, 1
4, 12:41:00-000, 98, 54, 44, 51, 1350.50, 44, 1350.45, 2
4, 12:42:00-000, 59, 32, 27, 32, 1349.68, 29, 1350.10, 2
4, 12:43:00-000, 93, 36, 57, 37, 1351.15, 45, 1350.90, 2
4, 12:44:00-000, 95, 47, 48, 48, 1350.45, 46, 1351.40, 3
4, 12:45:00-000, 96, 43, 53, 40, 1351.67, 46, 1351.16, 5
4, 12:46:00-000, 81, 57, 24, 53, 1352.58, 36, 1352.41, 1
4, 12:47:00-000, 52, 28, 24, 27, 1352.92, 20, 1352.95, 7
4, 12:48:00-000, 87, 49, 38, 46, 1351.10, 36, 1350.97, 5
4, 12:49:00-000, 90, 27, 63, 30, 1349.93, 33, 1349.36, 7
4, 12:50:00-000, 87, 49, 38, 50, 1352.03, 59, 1351.31, 0
4, 12:51:00-000, 82, 46, 36, 43, 1350.48, 28, 1349.68, 5
4, 12:52:00-000, 77, 42, 35, 43, 1350.85, 35, 1350.34, 0
4, 12:53:00-000, 97, 51, 46, 50, 1349.93, 40, 1350.32, 3
4, 12:54:00-000, 100, 57, 43, 44, 1349.81, 53, 1349.90, 8
4, 12:55:00-000, 63, 16, 47, 23, 1349.48, 34, 1349.11, 5
4, 12:56:00-000, 78, 45, 33, 41, 1351.87, 38, 1351.44, 3
4, 12:57:00-000, 64, 26, 38, 26, 1352.84, 28, 1352.92, 2
4, 12:58:00-000, 88, 48, 40, 47, 1351.44, 35, 1351.76, 15
4, 12:59:00-000, 75, 45, 30, 43, 1351.20, 21, 1351.76, 8
4, 13:00:00-000, 65, 34, 31, 32, 1349.09, 32, 1349.62, 4
4, 13:01:00-000, 80, 31, 49, 30, 1351.26, 48, 1351.47, 1
4, 13:02:00-000, 96, 35, 61, 38, 1349.04, 45, 1348.88, 3
4, 13:03:00-000, 98, 59, 39, 54, 1351.06, 45, 1350.50, 6
4, 13:04:00-000, 81, 42, 39, 43, 1349.53, 40, 1349.64, 5
4, 13:05:00-000, 76, 33, 43, 33, 1351.11, 24, 1350.70, 2
4, 13:06:00-000, 105, 57, 48, 53, 1351.46, 52, 1351.24, 4
4, 13:07:00-000, 77, 27, 50, 24, 1350.62, 45, 1351.06, 10
4, 13:08:00-000, 65, 29, 36, 30, 1348.83, 38, 1350.26, 3
4, 13:09:00-000, 103, 59, 44, 52, 1350.35, 45, 1351.12, 0
4, 13:10:00-000, 75, 36, 39, 41, 1349.04, 34, 1349.64, 0
4, 13:11:00-000, 87, 26, 61, 28, 1348.67, 43, 1349.64, 14
4, 13:12:00-000, 78, 34, 44, 34, 1348.70, 55, 1349.92, 0
4, 13:13:00-000, 70, 36, 34, 37, 1350.56, 33, 1350.81, 1
4, 13:14:00-000, 104, 47, 57, 42, 1348.61, 34, 1348.58, 7
4, 13:15:00-000, 83, 32, 51, 27, 1350.11, 45, 1350.48, 21
4, 13:16:00-000, 81, 50, 31, 47, 1355.37, 34, 1353.02, 3
4, 13:17:00-000, 82, 51, 31, 43, 1352.41, 29, 1352.20, 9
4, 13:18:00-000, 62, 34, 28, 36, 1350.94, 30, 1351.46, 6
4, 13:19:00-000, 114, 56, 58, 56, 1350.44, 53, 1350.84, 0
4, 13:20:00-000, 96, 47, 49, 46, 1349.86, 54, 1351.27, 0
4, 13:21:00-000, 67, 43, 24, 41, 1350.77, 19, 1352.26, 0
4, 13:22:00-000, 97, 43, 54, 45, 1349.68, 49, 1349.91, 5
4, 13:23:00-000, 95, 35, 60, 35, 1349.68, 42, 1349.32, 11
4, 13:24:00-000, 80, 47, 33, 42, 1349.47, 42, 1350.42, 0
4, 13:25:00-000, 104, 46, 58, 47, 1350.74, 48, 1350.68, 11
4, 13:26:00-000, 81, 41, 40, 37, 1349.48, 38, 1349.73, 7
4, 13:27:00-000, 77, 32, 45, 35, 1347.99, 22, 1347.95, 3
4, 13:28:00-000, 98, 47, 51, 48, 1349.30, 61, 1349.50, 0
4, 13:29:00-000, 84, 48, 36, 41, 1350.89, 44, 1351.38, 6
4, 13:30:00-000, 73, 39, 34, 30, 1350.53, 30, 1350.76, 9
4, 13:31:00-000, 83, 42, 41, 39, 1351.38, 46, 1351.08, 1
4, 13:32:00-000, 87, 36, 51, 40, 1349.77, 34, 1349.40, 5
4, 13:33:00-000, 93, 42, 51, 38, 1351.05, 40, 1350.57, 13
4, 13:34:00-000, 80, 50, 30, 43, 1352.48, 37, 1352.88, 10
4, 13:35:00-000, 87, 46, 41, 44, 1350.86, 39, 1350.73, 7
4, 13:36:00-000, 81, 35, 46, 37, 1351.56, 33, 1351.30, 0
4, 13:37:00-000, 88, 45, 43, 44, 1351.31, 47, 1351.46, 4
4, 13:38:00-000, 79, 48, 31, 46, 1350.75, 31, 1351.32, 1
4, 13:39:00-000, 75, 37, 38, 37, 1349.83, 30, 1349.83, 7
4, 13:40:00-000, 66, 33, 33, 33, 1351.84, 34, 1351.20, 4
4, 13:41:00-000, 80, 28, 52, 26, 1349.23, 50, 1349.43, 3
4, 13:42:00-000, 91, 34, 57, 37, 1349.10, 38, 1350.15, 9
4, 13:43:00-000, 74, 34, 40, 34, 1350.14, 43, 1350.41, 9
4, 13:44:00-000, 89, 55, 34, 53, 1352.08, 33, 1352.24, 2
4, 13:45:00-000, 92, 47, 45, 43, 1350.30, 43, 1350.11, 0
4, 13:46:00-000, 68, 36, 32, 32, 1347.90, 26, 1349.03, 3
4, 13:47:00-000, 74, 34, 40, 36, 1350.49, 34, 1351.05, 9
4, 13:48:00-000, 95, 53, 42, 47, 1351.52, 39, 1351.22, 3
4, 13:49:00-000, 65, 31, 34, 35, 1350.02, 34, 1350.26, 5
4, 13:50:00-000, 69, 22, 47, 20, 1350.00, 35, 1350.25, 6
4, 13:51:00-000, 93, 42, 51, 45, 1349.04, 48, 1349.28, 6
4, 13:52:00-000, 73, 32, 41, 32, 1350.09, 38, 1350.68, 0
4, 13:53:00-000, 86, 52, 34, 50, 1351.79, 27, 1351.88, 14
4, 13:54:00-000, 102, 29, 73, 30, 1351.00, 56, 1350.38, 7
4, 13:55:00-000, 106, 44, 62, 40, 1348.64, 54, 1349.18, 15
4, 13:56:00-000, 77, 41, 36, 38, 1349.81, 39, 1350.53, 4
4, 13:57:00-000, 73, 26, 47, 27, 1349.10, 37, 1349.94, 12
4, 13:58:00-000, 62, 28, 34, 29, 1348.82, 35, 1349.76, 0
4, 13:59:00-000, 79, 47, 32, 37, 1350.61, 24, 1349.95, 0
4, 14:00:00-000, 95, 66, 29, 76, 1352.53, 34, 1352.73, 2
4, 14:01:00-000, 71, 41, 30, 41, 1350.70, 29, 1350.58, 4
4, 14:02:00-000, 93, 39, 54, 38, 1351.07, 45, 1351.04, 1
4, 14:03:00-000, 72, 30, 42, 29, 1350.24, 37, 1350.29, 7
4, 14:04:00-000, 86, 39, 47, 41, 1350.16, 46, 1349.60, 0
4, 14:05:00-000, 81, 35, 46, 32, 1348.28, 52, 1348.72, 0
4, 14:06:00-000, 79, 34, 45, 37, 1346.80, 37, 1347.59, 1
4, 14:07:00-000, 99, 49, 50, 46, 1348.28, 37, 1348.37, 7
4, 14:08:00-000, 65, 36, 29, 34, 1351.11, 38, 1351.60, 6
4, 14:09:00-000, 88, 53, 35, 45, 1352.26, 35, 1352.54, 0
4, 14:10:00-000, 79, 45, 34, 53, 1350.58, 34, 1350.96, 5
4, 14:11:00-000, 78, 34, 44, 34, 1350.61, 28, 1350.71, 10
4, 14:12:00-000, 72, 36, 36, 36, 1349.33, 39, 1350.43, 3
4, 14:13:00-000, 83, 26, 57, 26, 1348.84, 37, 1348.94, 7
4, 14:14:00-000, 104, 45, 59, 34, 1345.52, 66, 1347.56, 9
4, 14:15:00-000, 92, 62, 30, 65, 1350.07, 30, 1350.90, 2
4, 14:16:00-000, 76, 33, 43, 26, 1351.15, 41, 1351.11, 2
4, 14:17:00-000, 74, 25, 49, 25, 1349.63, 36, 1349.94, 10
4, 14:18:00-000, 98, 53, 45, 54, 1350.92, 55, 1351.12, 0
4, 14:19:00-000, 84, 38, 46, 38, 1350.99, 28, 1350.00, 5
4, 14:20:00-000, 75, 41, 34, 41, 1351.94, 48, 1351.87, 0
4, 14:21:00-000, 70, 27, 43, 24, 1349.50, 33, 1350.72, 2
4, 14:22:00-000, 100, 51, 49, 47, 1350.56, 55, 1350.70, 2
4, 14:23:00-000, 97, 46, 51, 48, 1351.89, 48, 1351.62, 7
4, 14:24:00-000, 75, 50, 25, 50, 1352.99, 17, 1351.64, 5
4, 14:25:00-000, 97, 44, 53, 41, 1350.23, 44, 1349.45, 2
4, 14:26:00-000, 66, 29, 37, 29, 1348.13, 40, 1349.79, 3
4, 14:27:00-000, 100, 43, 57, 42, 1350.47, 41, 1350.67, 7
4, 14:28:00-000, 71, 36, 35, 38, 1348.49, 48, 1349.72, 4
4, 14:29:00-000, 95, 59, 36, 57, 1350.64, 31, 1351.32, 4
4, 14:30:00-000, 74, 39, 35, 36, 1349.52, 30, 1350.09, 10
4, 14:31:00-000, 102, 49, 53, 49, 1350.52, 52, 1350.55, 1
4, 14:32:00-000, 78, 42, 36, 39, 1351.48, 33, 1352.36, 0
4, 14:33:00-000, 78, 40, 38, 37, 1350.80, 35, 1351.14, 5
4, 14:34:00-000, 104, 46, 58, 47, 1348.76, 48, 1349.26, 1
4, 14:35:00-000, 77, 39, 38, 34, 1351.14, 38, 1351.18, 8
4, 14:36:00-000, 82, 34, 48, 38, 1351.34, 54, 1352.49, 0
4, 14:37:00-000, 91, 41, 50, 41, 1349.63, 44, 1350.38, 2
4, 14:38:00-000, 89, 41, 48, 41, 1351.65, 45, 1350.41, 1
4, 14:39:00-000, 88, 45, 43, 44, 1350.24, 47, 1350.18, 0
4, 14:40:00-000, 73, 26, 47, 27, 1349.11, 50, 1349.11, 0
4, 14:41:00-000, 77, 22, 55, 21, 1350.00, 34, 1349.73, 2
4, 14:42:00-000, 108, 67, 41, 61, 1355.04, 46, 1354.10, 11
4, 14:43:00-000, 98, 52, 46, 49, 1350.46, 44, 1350.51, 11
4, 14:44:00-000, 66, 35, 31, 39, 1349.61, 27, 1349.92, 3
4, 14:45:00-000, 80, 44, 36, 44, 1350.74, 36, 1350.96, 1
4, 14:46:00-000, 88, 46, 42, 46, 1351.51, 42, 1351.06, 0
4, 14:47:00-000, 83, 39, 44, 36, 1351.19, 39, 1350.81, 3
4, 14:48:00-000, 84, 57, 27, 48, 1351.59, 31, 1351.51, 0
4, 14:49:00-000, 108, 49, 59, 40, 1352.39, 47, 1352.67, 9
4, 14:50:00-000, 81, 50, 31, 55, 1353.64, 27, 1352.96, 20
4, 14:51:00-000, 68, 21, 47, 21, 1349.81, 25, 1350.83, 6
4, 14:52:00-000, 96, 35, 61, 35, 1348.65, 58, 1349.21, 8
4, 14:53:00-000, 79, 32, 47, 29, 1351.48, 40, 1350.79, 11
4, 14:54:00-000, 99, 30, 69, 31, 1350.19, 62, 1350.89, 8
4, 14:55:00-000, 80, 50, 30, 49, 1350.64, 35, 1350.68, 5
4, 14:56:00-000, 72, 43, 29, 38, 1351.81, 23, 1352.47, 7
4, 14:57:00-000, 71, 40, 31, 39, 1351.20, 30, 1351.39, 5
4, 14:58:00-000, 94, 43, 51, 41, 1350.09, 46, 1349.97, 1
4, 14:59:00-000, 85, 48, 37, 48, 1349.83, 36, 1349.97, 1
4, 15:00:00-000, 85, 39, 46, 32, 1350.49, 51, 1350.44, 1
4, 15:01:00-000, 76, 33, 43, 38, 1351.55, 36, 1351.49, 4
4, 15:02:00-000, 72, 36, 36, 37, 1351.61, 43, 1350.97, 0
4, 15:03:00-000, 98, 51, 47, 43, 1350.88, 45, 1351.35, 1
4, 15:04:00-000, 87, 49, 38, 46, 1351.97, 30, 1352.29, 8
4, 15:05:00-000, 68, 31, 37, 33, 1352.48, 26, 1352.69, 11
4, 15:06:00-000, 93, 47, 46, 39, 1352.07, 44, 1351.97, 11
4, 15:07:00-000, 82, 39, 43, 41, 1349.48, 47, 1349.56, 0
4, 15:08:00-000, 67, 27, 40, 28, 1350.21, 39, 1350.10, 0
4, 15:09:00-000, 87, 38, 49, 32, 1348.12, 47, 1348.25, 3
4, 15:10:00-000, 72, 43, 29, 49, 1350.85, 23, 1351.26, 0
4, 15:11:00-000, 88, 38, 50, 34, 1345.67, 39, 1346.40, 6
4, 15:12:00-000, 83, 25, 58, 22, 1348.72, 61, 1349.12, 2
4, 15:13:00-000, 82, 34, 48, 38, 1349.04, 38, 1349.86, 0
4, 15:14:00-000, 92, 40, 52, 41, 1349.63, 69, 1349.47, 2
4, 15:15:00-000, 64, 28, 36, 26, 1350.69, 30, 1350.90, 3
4, 15:16:00-000, 59, 37, 22, 39, 1353.15, 23, 1353.26, 0
4, 15:17:00-000, 94, 53, 41, 50, 1350.69, 31, 1350.12, 3
4, 15:18:00-000, 100, 65, 35, 63, 1351.86, 44, 1351.15, 4
4, 15:19:00-000, 92, 39, 53, 40, 1350.59, 40, 1350.39, 1
4, 15:20:00-000, 66, 42, 24, 36, 1351.35, 28, 1352.07, 0
4, 15:21:00-000, 71, 35, 36, 37, 1349.97, 34, 1350.11, 7
4, 15:22:00-000, 108, 53, 55, 49, 1350.77, 51, 1350.74, 5
4, 15:23:00-000, 84, 42, 42, 41, 1350.99, 44, 1351.51, 7
4, 15:24:00-000, 77, 35, 42, 35, 1350.11, 44, 1350.52, 0
4, 15:25:00-000, 82, 39, 43, 32, 1351.52, 31, 1350.09, 2
4, 15:26:00-000, 85, 49, 36, 48, 1351.24, 41, 1352.07, 7
4, 15:27:00-000, 86, 49, 37, 47, 1350.12, 40, 1350.69, 1
4, 15:28:00-000, 79, 32, 47, 34, 1350.47, 40, 1351.12, 0
4, 15:29:00-000, 86, 44, 42, 42, 1350.99, 35, 1351.17, 7
4, 15:30:00-000, 79, 37, 42, 38, 1349.15, 49, 1349.99, 0
4, 15:31:00-000, 88, 52, 36, 44, 1352.36, 32, 1352.27, 3
4, 15:32:00-000, 89, 51, 38, 57, 1350.87, 42, 1352.01, 2
4, 15:33:00-000, 76, 49, 27, 45, 1351.15, 20, 1350.40, 1
4, 15:34:00-000, 66, 33, 33, 37, 1350.10, 34, 1351.17, 1
4, 15:35:00-000, 76, 37, 39, 33, 1350.15, 33, 1349.81, 5
4, 15:36:00-000, 112, 47, 65, 51, 1349.74, 58, 1350.46, 1
4, 15:37:00-000, 88, 52, 36, 50, 1349.91, 36, 1350.72, 8
4, 15:38:00-000, 73, 29, 44, 31, 1349.80, 39, 1350.20, 3
4, 15:39:00-000, 73, 23, 50, 19, 1349.68, 42, 1349.52, 3
4, 15:40:00-000, 78, 36, 42, 31, 1349.25, 44, 1350.06, 9
4, 15:41:00-000, 74, 35, 39, 30, 1350.53, 32, 1350.56, 9
4, 15:42:00-000, 96, 56, 40, 50, 1351.33, 41, 1351.75, 9
4, 15:43:00-000, 91, 36, 55, 38, 1351.57, 43, 1351.71, 8
4, 15:44:00-000, 66, 30, 36, 28, 1350.46, 41, 1350.07, 1
4, 15:45:00-000, 81, 34, 47, 31, 1350.25, 41, 1350.26, 2
4, 15:46:00-000, 88, 63, 25, 56, 1352.18, 32, 1352.12, 4
4, 15:47:00-000, 73, 46, 27, 49, 1350.95, 24, 1351.45, 3
4, 15:48:00-000, 93, 52, 41, 37, 1350.35, 40, 1350.34, 6
4, 15:49:00-000, 99, 49, 50, 55, 1352.41, 44, 1352.17, 10
4, 15:50:00-000, 106, 47, 59, 45, 1352.13, 51, 1351.89, 8
4, 15:51:00-000, 89, 29, 60, 29, 1349.86, 34, 1350.88, 10
4, 15:52:00-000, 69, 26, 43, 26, 1350.92, 53, 1350.76, 0
4, 15:53:00-000, 84, 41, 43, 40, 1350.87, 47, 1351.31, 6
4, 15:54:00-000, 79, 34, 45, 32, 1351.03, 38, 1350.89, 4
4, 15:55:00-000, 97, 45, 52, 46, 1350.77, 44, 1350.90, 4
4, 15:56:00-000, 72, 44, 28, 36, 1351.52, 36, 1351.63, 7
4, 15:57:00-000, 103, 53, 50, 46, 1350.88, 49, 1349.95, 6
4, 15:58:00-000, 87, 39, 48, 38, 1348.34, 49, 1348.42, 7
4, 15:59:00-000, 68, 30, 38, 30, 1351.16, 27, 1351.07, 0
4, 16:00:00-000, 88, 51, 37, 48, 1350.14, 43, 1350.32, 1
4, 16:01:00-000, 99, 53, 46, 50, 1349.41, 46, 1349.93, 1
4, 16:02:00-000, 80, 40, 40, 46, 1353.10, 39, 1353.79, 0
4, 16:03:00-000, 83, 47, 36, 42, 1352.44, 31, 1352.61, 3
4, 16:04:00-000, 97, 48, 49, 48, 1352.84, 43, 1352.57, 9
4, 16:05:00-000, 86, 37, 49, 32, 1351.43, 38, 1351.76, 16
4, 16:06:00-000, 91, 57, 34, 48, 1350.47, 34, 1351.05, 10
4, 16:07:00-000, 69, 33, 36, 37, 1350.83, 23, 1350.56, 4
4, 16:08:00-000, 69, 33, 36, 32, 1349.90, 44, 1349.54, 4
4, 16:09:00-000, 88, 38, 50, 36, 1350.58, 51, 1349.83, 0
4, 16:10:00-000, 79, 37, 42, 36, 1348.44, 35, 1348.73, 8
4, 16:11:00-000, 93, 44, 49, 42, 1350.68, 45, 1349.88, 2
4, 16:12:00-000, 61, 30, 31, 30, 1350.06, 33, 1350.27, 1
4, 16:13:00-000, 97, 45, 52, 44, 1350.61, 46, 1350.86, 1
4, 16:14:00-000, 112, 54, 58, 50, 1352.19, 51, 1351.90, 16
4, 16:15:00-000, 89, 49, 40, 48, 1351.72, 29, 1351.13, 1
4, 16:16:00-000, 75, 37, 38, 33, 1350.48, 44, 1351.40, 4
4, 16:17:00-000, 98, 37, 61, 41, 1349.77, 48, 1349.86, 3
4, 16:18:00-000, 64, 30, 34, 27, 1349.03, 40, 1349.71, 2
4, 16:19:00-000, 85, 44, 41, 45, 1352.10, 42, 1351.32, 0
4, 16:20:00-000, 85, 34, 51, 33, 1349.05, 45, 1349.17, 7
4, 16:21:00-000, 80, 34, 46, 28, 1349.60, 35, 1350.71, 3
4, 16:22:00-000, 90, 46, 44, 47, 1350.74, 60, 1351.56, 1
4, 16:23:00-000, 61, 34, 27, 32, 1349.90, 25, 1350.35, 1
4, 16:24:00-000, 70, 38, 32, 41, 1350.28, 28, 1350.28, 0
4, 16:25:00-000, 73, 38, 35, 37, 1349.86, 29, 1349.65, 8
4, 16:26:00-000, 81, 48, 33, 52, 1351.56, 35, 1351.82, 2
4, 16:27:00-000, 76, 38, 38, 35, 1350.54, 36, 1350.60, 1
4, 16:28:00-000, 101, 58, 43, 56, 1350.20, 41, 1350.16, 6
4, 16:29:00-000, 94, 44, 50, 43, 1353.04, 51, 1352.42, 0
5, 09:13:00-000, 10196, 5578, 4618, 3906, 1348.19, 3716, 1349.46, 0
5, 09:14:00-000, 0, 0, 0, 7, 1347.00, 17, 1356.59, 562
5, 09:15:00-000, 0, 0, 0, 0, 0.00, 39, 1357.00, 1941
5, 09:16:00-000, 0, 0, 0, 0, 0.00, 0, 0.00, 8
5, 09:26:00-000, 10107, 5422, 4685, 3685, 1348.18, 3706, 1348.30, 0
5, 09:27:00-000, 0, 0, 0, 43, 1348.00, 95, 1356.00, 0
5, 09:28:00-000, 4, 3, 1, 39, 1348.00, 133, 1356.91, 1828
5, 09:29:00-000, 18, 9, 9, 8, 1349.75, 9, 1357.33, 581
5, 09:30:00-000, 97, 52, 45, 46, 1349.64, 42, 1350.94, 1
5, 09:31:00-000, 0, 0, 0, 0, 0.00, 3, 1359.33, 1
5, 09:32:00-000, 192, 82, 110, 56, 1349.45, 110, 1351.64, 3
5, 09:33:00-000, 374, 158, 216, 112, 1349.38, 186, 1351.01, 16
5, 09:34:00-000, 637, 335, 302, 220, 1349.12, 228, 1349.96, 26
5, 09:35:00-000, 0, 0, 0, 16, 1347.94, 26, 1356.76, 49
5, 09:36:00-000, 933, 531, 402, 395, 1348.71, 387, 1350.18, 95
5, 09:37:00-000, 1232, 655, 577, 447, 1348.66, 459, 1349.00, 146
5, 09:38:00-000, 1414, 734, 680, 522, 1348.99, 583, 1350.03, 134
5, 09:39:00-000, 0, 0, 0, 9, 1347.00, 51, 1357.27, 195
5, 09:40:00-000, 1327, 708, 619, 513, 1349.22, 533, 1349.96, 237
5, 09:41:00-000, 1258, 629, 629, 514, 1348.32, 517, 1348.59, 201
5, 09:42:00-000, 1138, 598, 540, 512, 1348.32, 466, 1349.30, 164
5, 09:43:00-000, 0, 0, 0, 0, 0.00, 32, 1355.96, 158
5, 09:44:00-000, 1053, 514, 539, 402, 1348.65, 392, 1348.87, 128
5, 09:45:00-000, 931, 457, 474, 331, 1348.49, 387, 1349.28, 178
5, 09:46:00-000, 919, 472, 447, 335, 1349.19, 378, 1349.65, 141
5, 09:47:00-000, 0, 0, 0, 0, 0.00, 35, 1356.20, 181
5, 09:48:00-000, 916, 466, 450, 388, 1348.59, 394, 1350.34, 123
5, 09:49:00-000, 927, 491, 436, 337, 1348.45, 355, 1348.94, 128
5, 09:50:00-000, 1062, 539, 523, 449, 1348.40, 445, 1349.59, 137
5, 09:51:00-000, 2, 2, 0, 1, 1344.00, 50, 1356.47, 115
5, 09:52:00-000, 1067, 560, 507, 394, 1348.50, 415, 1349.80, 141
5, 09:53:00-000, 1056, 530, 526, 405, 1348.47, 393, 1348.66, 190
5, 09:54:00-000, 987, 542, 445, 409, 1348.46, 400, 1349.33, 137
5, 09:55:00-000, 0, 0, 0, 9, 1346.00, 31, 1356.26, 161
5, 09:56:00-000, 1070, 534, 536, 393, 1348.50, 415, 1349.89, 169
5, 09:57:00-000, 1111, 594, 517, 440, 1349.69, 371, 1349.59, 153
5, 09:58:00-000, 987, 496, 491, 395, 1348.37, 403, 1349.63, 213
5, 09:59:00-000, 0, 0, 0, 41, 1345.29, 7, 1355.00, 192
5, 10:00:00-000, 1012, 520, 492, 398, 1348.63, 407, 1349.60, 133
5, 10:01:00-000, 1039, 551, 488, 403, 1349.17, 377, 1349.35, 152
5, 10:02:00-000, 1054, 584, 470, 434, 1348.90, 386, 1349.71, 156
5, 10:03:00-000, 0, 0, 0, 13, 1347.00, 26, 1356.42, 157
5, 10:04:00-000, 1094, 600, 494, 421, 1348.89, 410, 1349.51, 169
5, 10:05:00-000, 1041, 498, 543, 378, 1348.26, 457, 1349.44, 187
5, 10:06:00-000, 1021, 513, 508, 446, 1348.05, 378, 1349.15, 152
5, 10:07:00-000, 0, 0, 0, 46, 1344.41, 33, 1356.00, 137
5, 10:08:00-000, 1068, 579, 489, 427, 1349.32, 445, 1350.58, 116
5, 10:09:00-000, 1020, 532, 488, 405, 1348.99, 408, 1349.50, 144
5, 10:10:00-000, 1064, 542, 522, 403, 1348.08, 396, 1349.32, 166
5, 10:11:00-000, 1, 0, 1, 16, 1346.00, 14, 1355.64, 157
5, 10:12:00-000, 1046, 504, 542, 384, 1347.79, 450, 1349.20, 184
5, 10:13:00-000, 940, 472, 468, 412, 1348.53, 376, 1349.63, 145
5, 10:14:00-000, 997, 446, 551, 356, 1348.05, 404, 1348.42, 143
5, 10:15:00-000, 0, 0, 0, 22, 1344.63, 21, 1355.00, 131
5, 10:16:00-000, 1083, 563, 520, 473, 1348.00, 450, 1349.54, 142
5, 10:17:00-000, 1078, 538, 540, 432, 1348.82, 419, 1349.28, 163
5, 10:18:00-000, 961, 493, 468, 366, 1349.32, 376, 1349.79, 108
5, 10:19:00-000, 0, 0, 0, 0, 0.00, 61, 1356.60, 156
5, 10:20:00-000, 956, 512, 444, 435, 1348.30, 372, 1349.55, 128
5, 10:21:00-000, 967, 520, 447, 365, 1349.99, 352, 1349.35, 124
5, 10:22:00-000, 1062, 558, 504, 456, 1348.30, 372, 1348.96, 116
5, 10:23:00-000, 0, 0, 0, 8, 1344.00, 22, 1354.00, 157
5, 10:24:00-000, 1118, 598, 520, 447, 1349.62, 521, 1351.07, 160
5, 10:25:00-000, 1028, 551, 477, 386, 1349.48, 386, 1349.89, 159
5, 10:26:00-000, 974, 531, 443, 414, 1349.49, 339, 1349.83, 137
5, 10:27:00-000, 0, 0, 0, 21, 1346.00, 8, 1356.00, 180
5, 10:28:00-000, 1088, 537, 551, 412, 1348.55, 450, 1350.10, 158
5, 10:29:00-000, 1022, 559, 463, 391, 1349.39, 339, 1349.21, 137
5, 10:30:00-000, 1007, 455, 552, 404, 1347.81, 453, 1349.15, 192
5, 10:31:00-000, 0, 0, 0, 25, 1344.72, 30, 1354.83, 130
5, 10:32:00-000, 1010, 530, 480, 428, 1348.94, 432, 1350.00, 152
5, 10:33:00-000, 971, 502, 469, 375, 1348.92, 359, 1349.47, 120
5, 10:34:00-000, 1019, 557, 462, 366, 1349.36, 364, 1350.15, 123
5, 10:35:00-000, 0, 0, 0, 23, 1346.00, 22, 1356.00, 170
5, 10:36:00-000, 1114, 582, 532, 439, 1348.79, 421, 1350.09, 198
5, 10:37:00-000, 977, 545, 432, 394, 1349.01, 364, 1349.85, 208
5, 10:38:00-000, 1171, 616, 555, 451, 1349.15, 444, 1349.85, 179
5, 10:39:00-000, 0, 0, 0, 34, 1346.00, 0, 0.00, 152
5, 10:40:00-000, 1098, 579, 519, 470, 1348.16, 449, 1349.69, 179
5, 10:41:00-000, 1013, 549, 464, 414, 1348.57, 372, 1349.05, 160
5, 10:42:00-000, 1038, 513, 525, 349, 1348.85, 459, 1349.82, 160
5, 10:43:00-000, 0, 0, 0, 18, 1346.00, 20, 1357.00, 142
5, 10:44:00-000, 961, 535, 426, 387, 1348.68, 360, 1350.24, 160
5, 10:45:00-000, 962, 500, 462, 389, 1349.63, 348, 1350.07, 191
5, 10:46:00-000, 1104, 630, 474, 423, 1349.53, 409, 1350.28, 144
5, 10:47:00-000, 1, 0, 1, 36, 1346.16, 6, 1356.50, 132
5, 10:48:00-000, 998, 497, 501, 367, 1348.59, 446, 1350.24, 197
5, 10:49:00-000, 1113, 605, 508, 421, 1349.39, 435, 1349.84, 144
5, 10:50:00-000, 938, 485, 453, 356, 1348.65, 445, 1350.25, 157
5, 10:51:00-000, 0, 0, 0, 0, 0.00, 1, 1358.00, 146
5, 10:52:00-000, 996, 502, 494, 369, 1348.87, 390, 1350.37, 141
5, 10:53:00-000, 1031, 531, 500, 359, 1349.11, 365, 1349.60, 179
5, 10:54:00-000, 991, 511, 480, 430, 1348.60, 432, 1349.72, 145
5, 10:55:00-000, 0, 0, 0, 21, 1345.00, 16, 1356.00, 202
5, 10:56:00-000, 1113, 558, 555, 469, 1347.63, 434, 1349.07, 98
5, 10:57:00-000, 937, 486, 451, 356, 1348.63, 385, 1349.36, 154
5, 10:58:00-000, 1092, 526, 566, 446, 1348.25, 436, 1349.67, 139
5, 10:59:00-000, 0, 0, 0, 21, 1344.67, 23, 1354.87, 113
5, 11:00:00-000, 1004, 542, 462, 406, 1348.82, 400, 1350.10, 154
5, 11:01:00-000, 1064, 536, 528, 407, 1348.56, 419, 1349.26, 157
5, 11:02:00-000, 906, 505, 401, 343, 1349.42, 352, 1350.20, 164
5, 11:03:00-000, 1, 0, 1, 38, 1347.00, 15, 1356.40, 161
5, 11:04:00-000, 992, 536, 456, 413, 1348.80, 389, 1349.74, 128
5, 11:05:00-000, 947, 511, 436, 379, 1349.26, 345, 1349.60, 118
5, 11:06:00-000, 1004, 535, 469, 424, 1348.42, 383, 1349.78, 147
5, 11:07:00-000, 5, 5, 0, 47, 1345.01, 2, 1355.50, 138
5, 11:08:00-000, 977, 523, 454, 449, 1347.99, 375, 1349.34, 147
5, 11:09:00-000, 1044, 575, 469, 379, 1349.64, 387, 1350.11, 150
5, 11:10:00-000, 1001, 487, 514, 355, 1348.78, 476, 1350.44, 114
5, 11:11:00-000, 0, 0, 0, 15, 1346.26, 1, 1357.00, 155
5, 11:12:00-000, 1042, 572, 470, 433, 1349.02, 453, 1350.34, 155
5, 11:13:00-000, 1134, 602, 532, 414, 1349.43, 404, 1349.64, 134
5, 11:14:00-000, 1098, 552, 546, 468, 1348.33, 451, 1349.09, 197
5, 11:15:00-000, 0, 0, 0, 0, 0.00, 30, 1355.70, 161
5, 11:16:00-000, 1011, 528, 483, 379, 1349.21, 440, 1350.40, 159
5, 11:17:00-000, 967, 470, 497, 351, 1348.90, 381, 1349.83, 118
5, 11:18:00-000, 941, 502, 439, 343, 1348.82, 406, 1350.22, 174
5, 11:19:00-000, 6, 6, 0, 40, 1347.10, 0, 0.00, 142
5, 11:20:00-000, 1058, 603, 455, 443, 1349.63, 371, 1350.47, 179
5, 11:21:00-000, 1008, 516, 492, 404, 1348.18, 420, 1349.75, 151
5, 11:22:00-000, 998, 483, 515, 349, 1349.04, 401, 1349.68, 155
5, 11:23:00-000, 0, 0, 0, 19, 1346.00, 36, 1355.72, 132
5, 11:24:00-000, 1027, 514, 513, 426, 1348.45, 421, 1349.74, 155
5, 11:25:00-000, 1052, 564, 488, 453, 1349.05, 377, 1349.27, 135
5, 11:26:00-000, 978, 501, 477, 388, 1349.07, 402, 1350.15, 137
5, 11:27:00-000, 0, 0, 0, 8, 1346.00, 35, 1357.00, 139
5, 11:28:00-000, 989, 506, 483, 404, 1348.56, 379, 1349.14, 123
5, 11:29:00-000, 1117, 593, 524, 417, 1348.68, 430, 1349.16, 180
5, 11:30:00-000, 1015, 545, 470, 448, 1349.35, 391, 1350.32, 123
5, 11:31:00-000, 1, 1, 0, 22, 1347.09, 13, 1357.00, 188
5, 11:32:00-000, 1037, 494, 543, 398, 1348.40, 408, 1349.32, 148
5, 11:33:00-000, 940, 476, 464, 379, 1348.86, 398, 1349.53, 140
5, 11:34:00-000, 1056, 515, 541, 380, 1348.86, 405, 1349.16, 160
5, 11:35:00-000, 0, 0, 0, 21, 1345.14, 41, 1355.27, 129
5, 11:36:00-000, 976, 507, 469, 409, 1348.48, 390, 1349.55, 156
5, 11:37:00-000, 981, 538, 443, 398, 1349.57, 351, 1349.84, 151
5, 11:38:00-000, 1102, 575, 527, 440, 1349.11, 429, 1350.23, 156
5, 11:39:00-000, 0, 0, 0, 45, 1344.64, 12, 1356.00, 127
5, 11:40:00-000, 1065, 542, 523, 427, 1348.78, 407, 1348.96, 166
5, 11:41:00-000, 1033, 521, 512, 404, 1348.55, 412, 1348.95, 174
5, 11:42:00-000, 938, 483, 455, 335, 1348.93, 372, 1349.70, 154
5, 11:43:00-000, 0, 0, 0, 16, 1346.00, 33, 1356.39, 144
5, 11:44:00-000, 1036, 554, 482, 402, 1349.79, 453, 1350.86, 141
5, 11:45:00-000, 951, 456, 495, 313, 1348.13, 353, 1348.93, 151
5, 11:46:00-000, 1047, 551, 496, 444, 1349.05, 397, 1350.23, 125
5, 11:47:00-000, 0, 0, 0, 14, 1346.64, 54, 1356.11, 176
5, 11:48:00-000, 982, 508, 474, 389, 1349.08, 403, 1350.14, 151
5, 11:49:00-000, 961, 507, 454, 403, 1348.58, 331, 1348.82, 145
5, 11:50:00-000, 1028, 482, 546, 350, 1348.74, 452, 1349.94, 150
5, 11:51:00-000, 0, 0, 0, 7, 1346.00, 30, 1355.60, 154
5, 11:52:00-000, 1041, 525, 516, 443, 1348.29, 374, 1349.14, 170
5, 11:53:00-000, 970, 518, 452, 359, 1349.40, 363, 1350.29, 143
5, 11:54:00-000, 1050, 516, 534, 414, 1347.95, 435, 1349.43, 138
5, 11:55:00-000, 0, 0, 0, 10, 1346.20, 43, 1356.00, 146
5, 11:56:00-000, 1043, 566, 477, 459, 1349.33, 421, 1350.56, 187
5, 11:57:00-000, 1101, 530, 571, 419, 1348.48, 439, 1348.98, 133
5, 11:58:00-000, 998, 531, 467, 408, 1348.45, 378, 1349.40, 150
5, 11:59:00-000, 0, 0, 0, 0, 0.00, 24, 1356.00, 152
5, 12:00:00-000, 1047, 519, 528, 449, 1347.66, 438, 1349.19, 133
5, 12:01:00-000, 981, 489, 492, 392, 1349.03, 385, 1349.39, 165
5, 12:02:00-000, 1061, 482, 579, 415, 1347.69, 440, 1348.79, 112
5, 12:03:00-000, 5, 5, 0, 0, 0.00, 14, 1353.00, 144
5, 12:04:00-000, 1066, 548, 518, 404, 1348.72, 483, 1350.15, 145
5, 12:05:00-000, 1071, 570, 501, 411, 1349.45, 403, 1350.07, 144
5, 12:06:00-000, 920, 471, 449, 457, 1348.57, 396, 1349.61, 165
5, 12:07:00-000, 2, 2, 0, 62, 1344.33, 14, 1356.00, 95
5, 12:08:00-000, 1065, 582, 483, 461, 1348.96, 389, 1349.77, 79
5, 12:09:00-000, 1104, 524, 580, 389, 1348.02, 389, 1348.03, 109
5, 12:10:00-000, 1050, 603, 447, 432, 1349.80, 443, 1350.44, 203
5, 12:11:00-000, 0, 0, 0, 15, 1346.00, 15, 1356.00, 156
5, 12:12:00-000, 1063, 541, 522, 453, 1348.35, 485, 1349.91, 135
5, 12:13:00-000, 978, 532, 446, 384, 1348.73, 346, 1349.01, 137
5, 12:14:00-000, 976, 495, 481, 357, 1349.10, 348, 1349.29, 158
5, 12:15:00-000, 0, 0, 0, 0, 0.00, 39, 1354.38, 181
5, 12:16:00-000, 958, 475, 483, 335, 1349.03, 381, 1350.41, 141
5, 12:17:00-000, 1104, 546, 558, 455, 1348.72, 462, 1349.21, 161
5, 12:18:00-000, 969, 489, 480, 422, 1348.57, 436, 1349.92, 206
5, 12:19:00-000, 0, 0, 0, 0, 0.00, 21, 1357.14, 113
5, 12:20:00-000, 985, 513, 472, 320, 1349.61, 298, 1348.17, 116
5, 12:21:00-000, 989, 507, 482, 351, 1348.98, 354, 1348.77, 163
5, 12:22:00-000, 1114, 531, 583, 384, 1349.08, 386, 1348.75, 277
5, 12:23:00-000, 1, 1, 0, 10, 1346.00, 0, 0.00, 236
5, 12:24:00-000, 1030, 561, 469, 404, 1348.85, 332, 1349.07, 237
5, 12:25:00-000, 1033, 547, 486, 393, 1349.43, 370, 1349.22, 232
5, 12:26:00-000, 1005, 509, 496, 382, 1349.40, 335, 1349.07, 218
5, 12:27:00-000, 0, 0, 0, 0, 0.00, 0, 0.00, 214
5, 12:28:00-000, 963, 478, 485, 365, 1348.98, 344, 1348.80, 199
5, 12:29:00-000, 974, 508, 466, 385, 1349.22, 357, 1348.89, 193
5, 12:30:00-000, 1044, 534, 510, 412, 1348.87, 384, 1349.14, 186
5, 12:31:00-000, 2, 1, 1, 0, 0.00, 22, 1355.00, 160
5, 12:32:00-000, 993, 507, 486, 369, 1348.46, 379, 1349.40, 170
5, 12:33:00-000, 1117, 598, 519, 412, 1348.84, 406, 1349.49, 179
5, 12:34:00-000, 980, 511, 469, 364, 1348.95, 424, 1349.80, 194
5, 12:35:00-000, 2, 2, 0, 2, 1347.00, 0, 0.00, 224
5, 12:36:00-000, 1016, 517, 499, 436, 1348.59, 393, 1349.35, 173
5, 12:37:00-000, 928, 460, 468, 335, 1348.62, 334, 1349.23, 157
5, 12:38:00-000, 1084, 608, 476, 430, 1349.56, 393, 1350.08, 143
5, 12:39:00-000, 0, 0, 0, 32, 1345.65, 0, 0.00, 177
5, 12:40:00-000, 1036, 565, 471, 425, 1348.92, 375, 1349.58, 192
5, 12:41:00-000, 1015, 464, 551, 358, 1348.26, 393, 1348.96, 162
5, 12:42:00-000, 1074, 584, 490, 426, 1348.41, 355, 1348.80, 192
5, 12:43:00-000, 0, 0, 0, 27, 1345.00, 18, 1354.06, 181
5, 12:44:00-000, 1045, 526, 519, 402, 1348.97, 430, 1350.14, 210
5, 12:45:00-000, 1053, 582, 471, 428, 1349.38, 369, 1349.46, 155
5, 12:46:00-000, 999, 531, 468, 388, 1349.19, 379, 1349.47, 190
5, 12:47:00-000, 6, 6, 0, 34, 1345.58, 0, 0.00, 163
5, 12:48:00-000, 951, 472, 479, 374, 1349.01, 377, 1349.34, 139
5, 12:49:00-000, 1002, 531, 471, 374, 1349.73, 380, 1350.17, 190
5, 12:50:00-000, 1011, 519, 492, 353, 1349.09, 420, 1350.19, 160
5, 12:51:00-000, 0, 0, 0, 37, 1346.37, 12, 1356.00, 128
5, 12:52:00-000, 898, 412, 486, 351, 1348.20, 380, 1349.43, 169
5, 12:53:00-000, 1018, 478, 540, 342, 1348.58, 355, 1348.76, 146
5, 12:54:00-000, 1015, 488, 527, 435, 1347.86, 413, 1348.96, 161
5, 12:55:00-000, 1, 1, 0, 0, 0.00, 20, 1354.30, 189
5, 12:56:00-000, 1064, 555, 509, 371, 1348.92, 400, 1350.37, 144
5, 12:57:00-000, 1150, 593, 557, 461, 1348.98, 473, 1350.08, 177
5, 12:58:00-000, 964, 493, 471, 381, 1348.79, 367, 1349.43, 202
5, 12:59:00-000, 6, 1, 5, 6, 1346.33, 16, 1356.00, 192
5, 13:00:00-000, 999, 460, 539, 417, 1347.98, 465, 1349.44, 150
5, 13:01:00-000, 999, 499, 500, 383, 1348.51, 375, 1348.73, 108
5, 13:02:00-000, 956, 472, 484, 392, 1348.96, 396, 1349.61, 129
5, 13:03:00-000, 0, 0, 0, 4, 1345.00, 51, 1356.66, 113
5, 13:04:00-000, 1024, 480, 544, 393, 1348.92, 450, 1349.82, 139
5, 13:05:00-000, 1054, 587, 467, 376, 1350.05, 342, 1350.76, 144
5, 13:06:00-000, 1033, 504, 529, 404, 1348.68, 385, 1349.03, 160
5, 13:07:00-000, 2, 2, 0, 39, 1345.31, 0, 0.00, 219
5, 13:08:00-000, 1050, 531, 519, 403, 1347.90, 436, 1348.84, 158
5, 13:09:00-000, 1056, 551, 505, 418, 1349.02, 401, 1349.20, 162
5, 13:10:00-000, 1138, 609, 529, 451, 1348.87, 429, 1349.85, 160
5, 13:11:00-000, 1, 1, 0, 56, 1345.03, 45, 1355.26, 174
5, 13:12:00-000, 1015, 552, 463, 413, 1348.96, 360, 1349.78, 151
5, 13:13:00-000, 984, 449, 535, 356, 1348.66, 371, 1349.42, 159
5, 13:14:00-000, 937, 510, 427, 453, 1348.84, 366, 1350.03, 163
5, 13:15:00-000, 0, 0, 0, 9, 1344.44, 52, 1356.23, 128
5, 13:16:00-000, 982, 531, 451, 382, 1349.50, 431, 1351.12, 95
5, 13:17:00-000, 1045, 519, 526, 359, 1348.35, 393, 1349.32, 127
5, 13:18:00-000, 1137, 550, 587, 415, 1348.34, 472, 1349.07, 166
5, 13:19:00-000, 3, 0, 3, 9, 1346.00, 31, 1354.64, 161
5, 13:20:00-000, 1175, 629, 546, 500, 1348.73, 485, 1350.24, 193
5, 13:21:00-000, 1039, 529, 510, 412, 1349.63, 417, 1350.14, 159
5, 13:22:00-000, 993, 482, 511, 391, 1348.50, 395, 1349.35, 145
5, 13:23:00-000, 1, 1, 0, 17, 1345.00, 25, 1356.00, 148
5, 13:24:00-000, 1040, 546, 494, 428, 1348.56, 417, 1349.98, 137
5, 13:25:00-000, 1000, 492, 508, 408, 1348.48, 359, 1348.96, 148
5, 13:26:00-000, 940, 490, 450, 407, 1348.46, 401, 1350.28, 131
5, 13:27:00-000, 2, 2, 0, 22, 1344.68, 0, 0.00, 143
5, 13:28:00-000, 1037, 552, 485, 423, 1348.44, 364, 1349.06, 145
5, 13:29:00-000, 1015, 539, 476, 402, 1348.90, 365, 1349.47, 165
5, 13:30:00-000, 1105, 602, 503, 422, 1349.06, 404, 1349.94, 166
5, 13:31:00-000, 1, 0, 1, 19, 1346.05, 4, 1353.25, 177
5, 13:32:00-000, 1004, 556, 448, 421, 1349.15, 371, 1350.82, 209
5, 13:33:00-000, 1097, 575, 522, 419, 1348.97, 422, 1349.45, 174
5, 13:34:00-000, 1010, 525, 485, 365, 1349.20, 392, 1350.47, 177
5, 13:35:00-000, 0, 0, 0, 19, 1346.05, 5, 1355.00, 151
5, 13:36:00-000, 1043, 511, 532, 380, 1348.76, 440, 1349.51, 201
5, 13:37:00-000, 1041, 533, 508, 359, 1349.07, 418, 1349.96, 164
5, 13:38:00-000, 942, 456, 486, 359, 1348.64, 413, 1349.87, 151
5, 13:39:00-000, 1, 0, 1, 0, 0.00, 25, 1355.40, 173
5, 13:40:00-000, 958, 483, 475, 359, 1348.65, 395, 1349.46, 154
5, 13:41:00-000, 1013, 527, 486, 385, 1348.52, 354, 1348.96, 165
5, 13:42:00-000, 997, 474, 523, 419, 1348.14, 436, 1349.57, 165
5, 13:43:00-000, 1, 0, 1, 24, 1343.71, 1, 1356.00, 133
5, 13:44:00-000, 1029, 509, 520, 410, 1348.38, 433, 1349.98, 138
5, 13:45:00-000, 1116, 563, 553, 435, 1348.68, 431, 1348.90, 155
5, 13:46:00-000, 1018, 462, 556, 424, 1348.05, 464, 1349.35, 130
5, 13:47:00-000, 0, 0, 0, 24, 1343.71, 20, 1355.00, 133
5, 13:48:00-000, 1054, 526, 528, 406, 1348.24, 451, 1349.36, 118
5, 13:49:00-000, 1020, 518, 502, 361, 1348.83, 387, 1349.34, 132
5, 13:50:00-000, 1013, 502, 511, 438, 1348.16, 372, 1349.60, 154
5, 13:51:00-000, 6, 0, 6, 12, 1344.00, 27, 1353.44, 148
5, 13:52:00-000, 1048, 544, 504, 417, 1348.56, 426, 1349.95, 164
5, 13:53:00-000, 968, 463, 505, 349, 1348.82, 373, 1349.40, 172
5, 13:54:00-000, 1022, 555, 467, 380, 1349.06, 467, 1350.18, 155
5, 13:55:00-000, 2, 0, 2, 53, 1345.16, 3, 1357.00, 134
5, 13:56:00-000, 962, 486, 476, 394, 1348.65, 405, 1349.87, 139
5, 13:57:00-000, 1085, 563, 522, 424, 1349.02, 399, 1349.72, 149
5, 13:58:00-000, 1056, 519, 537, 382, 1348.64, 347, 1348.71, 144
5, 13:59:00-000, 1, 0, 1, 34, 1345.26, 56, 1354.65, 169
5, 14:00:00-000, 975, 490, 485, 419, 1348.89, 410, 1349.80, 183
5, 14:01:00-000, 1037, 487, 550, 392, 1348.66, 385, 1348.96, 130
5, 14:02:00-000, 1058, 515, 543, 457, 1347.97, 505, 1349.97, 125
5, 14:03:00-000, 2, 2, 0, 18, 1344.78, 3, 1357.00, 123
5, 14:04:00-000, 920, 503, 417, 358, 1349.28, 335, 1349.93, 147
5, 14:05:00-000, 1081, 564, 517, 439, 1349.24, 408, 1349.59, 152
5, 14:06:00-000, 985, 471, 514, 452, 1347.38, 303, 1348.32, 130
5, 14:07:00-000, 0, 0, 0, 10, 1344.00, 32, 1353.25, 135
5, 14:08:00-000, 1043, 549, 494, 415, 1348.61, 416, 1349.69, 158
5, 14:09:00-000, 1008, 450, 558, 386, 1348.38, 432, 1349.20, 148
5, 14:10:00-000, 1010, 490, 520, 362, 1348.89, 422, 1349.92, 154
5, 14:11:00-000, 0, 0, 0, 16, 1346.00, 29, 1355.00, 168
5, 14:12:00-000, 1135, 531, 604, 436, 1348.11, 474, 1349.02, 177
5, 14:13:00-000, 1086, 536, 550, 396, 1348.27, 431, 1349.50, 119
5, 14:14:00-000, 1010, 494, 516, 403, 1348.65, 358, 1349.24, 186
5, 14:15:00-000, 2, 2, 0, 35, 1345.65, 14, 1355.00, 182
5, 14:16:00-000, 1068, 496, 572, 398, 1347.69, 408, 1348.15, 186
5, 14:17:00-000, 998, 529, 469, 387, 1349.57, 326, 1349.40, 170
5, 14:18:00-000, 991, 510, 481, 423, 1348.64, 407, 1349.94, 202
5, 14:19:00-000, 2, 2, 0, 38, 1345.26, 31, 1356.00, 123
5, 14:20:00-000, 995, 505, 490, 416, 1348.47, 398, 1349.22, 158
5, 14:21:00-000, 1070, 531, 539, 401, 1348.60, 402, 1349.35, 140
5, 14:22:00-000, 1047, 594, 453, 436, 1349.64, 379, 1350.56, 133
5, 14:23:00-000, 0, 0, 0, 45, 1346.44, 17, 1355.00, 158
5, 14:24:00-000, 1033, 478, 555, 383, 1347.89, 459, 1349.01, 155
5, 14:25:00-000, 1008, 516, 492, 418, 1348.59, 410, 1349.36, 158
5, 14:26:00-000, 1034, 479, 555, 398, 1347.54, 443, 1348.59, 146
5, 14:27:00-000, 0, 0, 0, 0, 0.00, 25, 1354.80, 120
5, 14:28:00-000, 1041, 481, 560, 415, 1348.57, 434, 1349.41, 156
5, 14:29:00-000, 1043, 568, 475, 432, 1349.41, 388, 1349.81, 129
5, 14:30:00-000, 1094, 573, 521, 455, 1348.86, 447, 1350.07, 135
5, 14:31:00-000, 0, 0, 0, 26, 1345.00, 3, 1355.67, 127
5, 14:32:00-000, 1003, 496, 507, 416, 1348.85, 439, 1349.96, 144
5, 14:33:00-000, 941, 504, 437, 386, 1349.50, 340, 1349.45, 143
5, 14:34:00-000, 1114, 624, 490, 459, 1349.26, 408, 1349.91, 123
5, 14:35:00-000, 0, 0, 0, 57, 1345.46, 19, 1356.00, 155
5, 14:36:00-000, 924, 475, 449, 330, 1348.53, 418, 1350.26, 126
5, 14:37:00-000, 1106, 535, 571, 378, 1348.74, 428, 1348.95, 128
5, 14:38:00-000, 1023, 491, 532, 461, 1347.90, 437, 1349.34, 148
5, 14:39:00-000, 0, 0, 0, 0, 0.00, 10, 1355.50, 182
5, 14:40:00-000, 1010, 525, 485, 428, 1348.90, 407, 1350.26, 109
5, 14:41:00-000, 988, 569, 419, 429, 1349.71, 371, 1350.50, 151
5, 14:42:00-000, 1121, 611, 510, 395, 1349.44, 402, 1350.57, 126
5, 14:43:00-000, 8, 7, 1, 48, 1347.22, 22, 1357.00, 134
5, 14:44:00-000, 1025, 532, 493, 404, 1348.88, 385, 1349.22, 209
5, 14:45:00-000, 1014, 467, 547, 356, 1348.70, 353, 1348.71, 186
5, 14:46:00-000, 1017, 496, 521, 366, 1348.51, 411, 1348.86, 177
5, 14:47:00-000, 0, 0, 0, 0, 0.00, 36, 1354.97, 204
5, 14:48:00-000, 1075, 518, 557, 409, 1348.49, 397, 1349.63, 206
5, 14:49:00-000, 1056, 601, 455, 414, 1350.06, 419, 1351.28, 134
5, 14:50:00-000, 988, 508, 480, 379, 1348.62, 446, 1350.54, 180
5, 14:51:00-000, 0, 0, 0, 13, 1346.23, 33, 1357.48, 143
5, 14:52:00-000, 981, 473, 508, 425, 1348.40, 401, 1350.06, 154
5, 14:53:00-000, 968, 536, 432, 359, 1348.86, 335, 1349.47, 136
5, 14:54:00-000, 996, 516, 480, 447, 1348.14, 377, 1348.40, 163
5, 14:55:00-000, 0, 0, 0, 0, 0.00, 3, 1355.00, 120
5, 14:56:00-000, 962, 544, 418, 347, 1349.66, 362, 1350.31, 197
5, 14:57:00-000, 1045, 575, 470, 389, 1349.58, 385, 1350.32, 137
5, 14:58:00-000, 1096, 580, 516, 427, 1348.53, 401, 1349.87, 199
5, 14:59:00-000, 8, 1, 7, 28, 1346.18, 53, 1354.43, 149
5, 15:00:00-000, 1063, 586, 477, 447, 1348.99, 381, 1350.23, 199
5, 15:01:00-000, 1049, 538, 511, 373, 1349.22, 378, 1349.55, 175
5, 15:02:00-000, 969, 468, 501, 361, 1349.20, 400, 1349.78, 198
5, 15:03:00-000, 0, 0, 0, 24, 1346.00, 6, 1356.00, 176
5, 15:04:00-000, 1021, 521, 500, 368, 1349.46, 442, 1350.77, 173
5, 15:05:00-000, 1011, 517, 494, 337, 1349.93, 394, 1350.63, 168
5, 15:06:00-000, 994, 468, 526, 408, 1348.67, 449, 1349.88, 147
5, 15:07:00-000, 0, 0, 0, 26, 1345.73, 10, 1354.00, 148
5, 15:08:00-000, 1042, 543, 499, 456, 1349.02, 391, 1349.38, 129
5, 15:09:00-000, 1087, 552, 535, 435, 1347.91, 407, 1348.60, 166
5, 15:10:00-000, 931, 467, 464, 379, 1349.09, 385, 1350.38, 125
5, 15:11:00-000, 3, 2, 1, 20, 1344.30, 32, 1356.00, 160
5, 15:12:00-000, 1043, 547, 496, 434, 1348.84, 368, 1349.43, 121
5, 15:13:00-000, 972, 510, 462, 388, 1349.19, 339, 1349.31, 167
5, 15:14:00-000, 1072, 573, 499, 436, 1348.77, 362, 1348.67, 181
5, 15:15:00-000, 2, 2, 0, 1, 1352.00, 48, 1354.29, 177
5, 15:16:00-000, 967, 531, 436, 370, 1349.51, 407, 1350.91, 143
5, 15:17:00-000, 978, 500, 478, 384, 1349.16, 385, 1349.68, 167
5, 15:18:00-000, 1128, 567, 561, 483, 1347.91, 473, 1349.25, 138
5, 15:19:00-000, 0, 0, 0, 0, 0.00, 22, 1355.86, 124
5, 15:20:00-000, 1025, 512, 513, 422, 1348.03, 450, 1349.49, 150
5, 15:21:00-000, 1012, 541, 471, 410, 1349.32, 380, 1349.90, 143
5, 15:22:00-000, 993, 505, 488, 354, 1348.59, 379, 1349.26, 130
5, 15:23:00-000, 0, 0, 0, 0, 0.00, 19, 1355.00, 160
5, 15:24:00-000, 1129, 569, 560, 437, 1349.33, 435, 1349.76, 175
5, 15:25:00-000, 1026, 484, 542, 412, 1348.42, 415, 1349.11, 180
5, 15:26:00-000, 1008, 501, 507, 413, 1348.48, 431, 1349.83, 173
5, 15:27:00-000, 6, 6, 0, 16, 1348.75, 11, 1355.00, 129
5, 15:28:00-000, 1136, 619, 517, 435, 1349.32, 427, 1350.09, 138
5, 15:29:00-000, 1094, 503, 591, 423, 1348.93, 471, 1349.94, 175
5, 15:30:00-000, 938, 482, 456, 422, 1348.70, 335, 1349.19, 172
5, 15:31:00-000, 0, 0, 0, 0, 0.00, 18, 1355.72, 148
5, 15:32:00-000, 981, 482, 499, 361, 1348.68, 420, 1349.53, 153
5, 15:33:00-000, 962, 489, 473, 357, 1348.98, 409, 1349.95, 141
5, 15:34:00-000, 1028, 580, 448, 456, 1349.99, 435, 1351.48, 129
5, 15:35:00-000, 2, 1, 1, 23, 1346.22, 1, 1349.00, 129
5, 15:36:00-000, 1079, 533, 546, 439, 1347.89, 451, 1348.83, 119
5, 15:37:00-000, 947, 467, 480, 352, 1349.78, 391, 1350.15, 128
5, 15:38:00-000, 1025, 483, 542, 412, 1348.02, 466, 1349.20, 127
5, 15:39:00-000, 2, 2, 0, 37, 1344.35, 9, 1356.00, 114
5, 15:40:00-000, 1035, 545, 490, 363, 1349.46, 317, 1349.11, 109
5, 15:41:00-000, 1034, 529, 505, 406, 1349.27, 349, 1348.52, 212
5, 15:42:00-000, 987, 524, 463, 366, 1349.62, 304, 1349.16, 261
5, 15:43:00-000, 0, 0, 0, 14, 1347.00, 42, 1354.00, 201
5, 15:44:00-000, 1040, 570, 470, 414, 1349.61, 345, 1349.47, 223
5, 15:45:00-000, 990, 482, 508, 371, 1349.27, 339, 1349.53, 216
5, 15:46:00-000, 1017, 529, 488, 334, 1348.70, 406, 1349.70, 168
5, 15:47:00-000, 3, 0, 3, 30, 1346.00, 2, 1352.00, 169
5, 15:48:00-000, 1094, 567, 527, 447, 1349.46, 376, 1349.57, 227
5, 15:49:00-000, 964, 482, 482, 349, 1349.35, 362, 1349.46, 191
5, 15:50:00-000, 1044, 550, 494, 409, 1348.75, 378, 1349.02, 207
5, 15:51:00-000, 3, 3, 0, 16, 1346.19, 13, 1355.00, 181
5, 15:52:00-000, 1113, 562, 551, 434, 1349.32, 382, 1349.52, 198
5, 15:53:00-000, 979, 567, 412, 374, 1349.65, 356, 1350.22, 208
5, 15:54:00-000, 1054, 486, 568, 392, 1348.16, 420, 1348.77, 171
5, 15:55:00-000, 0, 0, 0, 18, 1346.00, 16, 1355.00, 192
5, 15:56:00-000, 1073, 593, 480, 453, 1349.27, 402, 1349.67, 193
5, 15:57:00-000, 947, 517, 430, 371, 1349.48, 328, 1349.72, 176
5, 15:58:00-000, 970, 493, 477, 368, 1348.25, 359, 1348.99, 163
5, 15:59:00-000, 1, 1, 0, 1, 1353.00, 4, 1356.00, 148
5, 16:00:00-000, 921, 488, 433, 372, 1349.07, 375, 1350.23, 186
5, 16:01:00-000, 1139, 560, 579, 382, 1348.97, 426, 1348.97, 152
5, 16:02:00-000, 1038, 516, 522, 400, 1348.46, 426, 1349.47, 207
5, 16:03:00-000, 1, 0, 1, 0, 0.00, 13, 1354.85, 210
5, 16:04:00-000, 957, 464, 493, 306, 1349.59, 421, 1350.67, 169
5, 16:05:00-000, 906, 422, 484, 330, 1348.41, 363, 1348.87, 144
5, 16:06:00-000, 994, 517, 477, 401, 1348.72, 424, 1349.76, 143
5, 16:07:00-000, 0, 0, 0, 27, 1345.00, 12, 1356.00, 144
5, 16:08:00-000, 1136, 549, 587, 432, 1348.14, 457, 1349.37, 157
5, 16:09:00-000, 1052, 550, 502, 426, 1348.44, 423, 1349.29, 130
5, 16:10:00-000, 1090, 519, 571, 407, 1348.60, 431, 1349.53, 177
5, 16:11:00-000, 0, 0, 0, 9, 1344.00, 30, 1354.70, 160
5, 16:12:00-000, 960, 498, 462, 339, 1349.61, 374, 1349.91, 164
5, 16:13:00-000, 1095, 524, 571, 421, 1348.40, 415, 1348.62, 166
5, 16:14:00-000, 1097, 599, 498, 418, 1348.61, 429, 1349.32, 171
5, 16:15:00-000, 0, 0, 0, 24, 1347.00, 26, 1355.11, 171
5, 16:16:00-000, 1057, 515, 542, 421, 1348.37, 412, 1349.77, 172
5, 16:17:00-000, 1026, 528, 498, 387, 1349.02, 410, 1349.56, 158
5, 16:18:00-000, 995, 516, 479, 418, 1348.98, 363, 1349.79, 175
5, 16:19:00-000, 0, 0, 0, 55, 1344.76, 47, 1355.40, 136
5, 16:20:00-000, 936, 474, 462, 385, 1348.76, 349, 1350.17, 139
5, 16:21:00-000, 1068, 508, 560, 369, 1348.75, 449, 1349.88, 129
5, 16:22:00-000, 1023, 546, 477, 406, 1349.12, 398, 1349.96, 150
5, 16:23:00-000, 1, 0, 1, 20, 1346.00, 1, 1348.00, 172
5, 16:24:00-000, 999, 529, 470, 380, 1349.56, 398, 1350.35, 165
5, 16:25:00-000, 993, 506, 487, 361, 1349.25, 369, 1349.43, 186
5, 16:26:00-000, 1013, 552, 461, 374, 1349.50, 393, 1350.62, 171
5, 16:27:00-000, 2, 2, 0, 20, 1346.00, 42, 1356.00, 177
5, 16:28:00-000, 1034, 498, 536, 418, 1349.14, 423, 1349.60, 148
5, 16:29:00-000, 997, 535, 462, 394, 1349.08, 350, 1349.80, 169
6, 12:20:00-000, 6935, 3422, 3513, 1614, 1347.84, 1689, 1348.53, 0
6, 12:21:00-000, 0, 0, 0, 59, 1346.81, 24, 1353.00, 0
6, 12:22:00-000, 0, 0, 0, 171, 1346.00, 126, 1354.00, 0
6, 12:23:00-000, 0, 0, 0, 58, 1346.00, 0, 0.00, 0
6, 12:24:00-000, 0, 0, 0, 0, 0.00, 102, 1354.00, 0
6, 12:25:00-000, 0, 0, 0, 5, 1345.00, 58, 1355.00, 0
6, 12:26:00-000, 0, 0, 0, 18, 1345.00, 65, 1355.00, 0
6, 12:27:00-000, 0, 0, 0, 28, 1345.00, 43, 1355.00, 0
6, 12:28:00-000, 0, 0, 0, 24, 1345.00, 70, 1355.00, 0
6, 12:29:00-000, 0, 0, 0, 12, 1345.00, 16, 1355.00, 0
6, 12:30:00-000, 0, 0, 0, 7, 1345.00, 0, 0.00, 0
6, 12:32:00-000, 0, 0, 0, 77, 1345.00, 0, 0.00, 0
6, 12:34:00-000, 0, 0, 0, 45, 1345.00, 3, 1356.00, 0
6, 12:35:00-000, 0, 0, 0, 29, 1345.00, 31, 1356.00, 0
6, 12:36:00-000, 0, 0, 0, 4, 1345.00, 1, 1356.00, 0
6, 12:38:00-000, 0, 0, 0, 0, 0.00, 2, 1356.00, 0
6, 12:39:00-000, 0, 0, 0, 0, 0.00, 14, 1356.00, 0
6, 12:40:00-000, 0, 0, 0, 0, 0.00, 3, 1356.00, 125
6, 12:41:00-000, 0, 0, 0, 0, 0.00, 0, 0.00, 110
6, 12:42:00-000, 0, 0, 0, 0, 0.00, 0, 0.00, 141
6, 12:43:00-000, 0, 0, 0, 0, 0.00, 0, 0.00, 140
6, 12:44:00-000, 0, 0, 0, 0, 0.00, 40, 1356.00, 133
6, 12:45:00-000, 0, 0, 0, 0, 0.00, 58, 1356.00, 146
6, 12:46:00-000, 0, 0, 0, 0, 0.00, 28, 1356.00, 107
6, 12:47:00-000, 0, 0, 0, 0, 0.00, 0, 0.00, 105
6, 12:48:00-000, 0, 0, 0, 0, 0.00, 0, 0.00, 107
6, 12:49:00-000, 0, 0, 0, 0, 0.00, 0, 0.00, 114
6, 12:50:00-000, 0, 0, 0, 0, 0.00, 6, 1356.00, 123
6, 12:51:00-000, 0, 0, 0, 0, 0.00, 0, 0.00, 115
6, 12:52:00-000, 0, 0, 0, 0, 0.00, 0, 0.00, 108
6, 12:53:00-000, 0, 0, 0, 0, 0.00, 0, 0.00, 127
6, 12:54:00-000, 0, 0, 0, 23, 1344.00, 0, 0.00, 110
6, 12:55:00-000, 0, 0, 0, 8, 1344.00, 0, 0.00, 106
6, 12:56:00-000, 0, 0, 0, 0, 0.00, 0, 0.00, 112
6, 12:57:00-000, 0, 0, 0, 0, 0.00, 15, 1357.00, 109
6, 12:58:00-000, 0, 0, 0, 0, 0.00, 0, 0.00, 113
6, 12:59:00-000, 0, 0, 0, 0, 0.00, 0, 0.00, 108
6, 15:40:00-000, 6939, 3492, 3447, 1602, 1347.76, 1652, 1348.54, 0
6, 15:41:00-000, 0, 0, 0, 100, 1347.00, 84, 1354.00, 0
6, 15:42:00-000, 0, 0, 0, 74, 1346.00, 117, 1354.00, 0
6, 15:43:00-000, 0, 0, 0, 27, 1346.00, 16, 1354.00, 0
6, 15:44:00-000, 0, 0, 0, 76, 1346.00, 142, 1355.00, 0
6, 15:45:00-000, 0, 0, 0, 17, 1346.00, 0, 0.00, 0
6, 15:46:00-000, 0, 0, 0, 42, 1346.00, 0, 0.00, 0
6, 15:47:00-000, 0, 0, 0, 0, 0.00, 10, 1355.00, 0
6, 15:48:00-000, 0, 0, 0, 0, 0.00, 73, 1355.00, 0
6, 15:49:00-000, 0, 0, 0, 0, 0.00, 27, 1356.00, 0
6, 15:50:00-000, 0, 0, 0, 0, 0.00, 36, 1356.00, 0
6, 15:51:00-000, 0, 0, 0, 3, 1345.00, 0, 0.00, 0
6, 15:52:00-000, 0, 0, 0, 4, 1345.00, 0, 0.00, 0
6, 15:54:00-000, 0, 0, 0, 0, 0.00, 14, 1356.00, 0
6, 15:55:00-000, 0, 0, 0, 0, 0.00, 41, 1356.00, 0
6, 15:56:00-000, 0, 0, 0, 51, 1345.00, 63, 1356.00, 0
6, 15:57:00-000, 0, 0, 0, 2, 1345.00, 0, 0.00, 0
6, 15:58:00-000, 0, 0, 0, 0, 0.00, 10, 1356.00, 0
6, 15:59:00-000, 0, 0, 0, 0, 0.00, 16, 1356.00, 0
6, 16:00:00-000, 1, 0, 1, 11, 1345.00, 7, 1356.00, 137
6, 16:01:00-000, 0, 0, 0, 60, 1345.00, 0, 0.00, 118
6, 16:02:00-000, 0, 0, 0, 0, 0.00, 0, 0.00, 127
6, 16:03:00-000, 0, 0, 0, 0, 0.00, 0, 0.00, 116
6, 16:04:00-000, 0, 0, 0, 0, 0.00, 0, 0.00, 122
6, 16:05:00-000, 0, 0, 0, 43, 1345.00, 0, 0.00, 130
6, 16:06:00-000, 0, 0, 0, 29, 1345.00, 0, 0.00, 124
6, 16:07:00-000, 0, 0, 0, 0, 0.00, 0, 0.00, 121
6, 16:08:00-000, 0, 0, 0, 15, 1344.00, 0, 0.00, 128
6, 16:09:00-000, 0, 0, 0, 2, 1344.00, 0, 0.00, 131
6, 16:10:00-000, 0, 0, 0, 41, 1344.00, 0, 0.00, 119
6, 16:11:00-000, 0, 0, 0, 51, 1344.00, 0, 0.00, 118
6, 16:12:00-000, 0, 0, 0, 0, 0.00, 0, 0.00, 102
6, 16:13:00-000, 0, 0, 0, 0, 0.00, 0, 0.00, 117
6, 16:14:00-000, 0, 0, 0, 0, 0.00, 0, 0.00, 108
6, 16:15:00-000, 0, 0, 0, 0, 0.00, 0, 0.00, 120
6, 16:16:00-000, 0, 0, 0, 0, 0.00, 0, 0.00, 93
6, 16:17:00-000, 0, 0, 0, 0, 0.00, 0, 0.00, 123
6, 16:18:00-000, 0, 0, 0, 0, 0.00, 0, 0.00, 108
6, 16:19:00-000, 0, 0, 0, 0, 0.00, 0, 0.00, 120
6, 16:20:00-000, 17, 9, 8, 6, 1348.17, 7, 1351.57, 0
6, 16:22:00-000, 0, 0, 0, 1, 1344.00, 0, 0.00, 0
7, 09:06:00-000, 7712, 5502, 2210, 0, 0.00, 0, 0.00, 6541
7, 09:07:00-000, 6346, 3164, 3182, 0, 0.00, 0, 0.00, 7517
7, 09:33:00-000, 7696, 149, 7547, 0, 0.00, 0, 0.00, 7696
7, 09:41:00-000, 7676, 4593, 3083, 2, 1349.00, 2, 1350.00, 7672
7, 09:42:00-000, 13719, 4087, 9632, 0, 0.00, 0, 0.00, 13719
7, 09:43:00-000, 4248, 2635, 1613, 1, 1349.00, 1, 1350.00, 4246
7, 09:44:00-000, 15352, 8101, 7251, 23, 1351.74, 23, 1351.52, 15306
7, 09:46:00-000, 2568, 1386, 1182, 0, 0.00, 0, 0.00, 2566
7, 09:47:00-000, 3313, 1182, 2131, 4, 1352.00, 4, 1352.00, 3307
7, 09:48:00-000, 16905, 11008, 5897, 0, 0.00, 0, 0.00, 15814
7, 09:49:00-000, 4262, 31, 4231, 11, 1348.00, 11, 1348.64, 5331
7, 09:50:00-000, 920, 920, 0, 0, 0.00, 0, 0.00, 920
7, 09:52:00-000, 1504, 11, 1493, 10, 1349.00, 10, 1349.60, 1484
7, 09:54:00-000, 4274, 2739, 1535, 17, 1349.00, 17, 1347.59, 4240
7, 09:56:00-000, 5359, 1333, 4026, 0, 0.00, 0, 0.00, 5359
7, 09:57:00-000, 12801, 4447, 8354, 10, 1350.70, 35, 1352.00, 11684
7, 09:58:00-000, 27, 27, 0, 27, 1356.00, 2, 1351.00, 1070
7, 10:00:00-000, 5296, 3628, 1668, 0, 0.00, 0, 0.00, 3704
7, 10:01:00-000, 1792, 762, 1030, 2, 1351.00, 2, 1352.00, 3380
7, 10:02:00-000, 2728, 1307, 1421, 1, 1351.00, 1, 1351.00, 2726
7, 10:06:00-000, 1389, 1380, 9, 0, 0.00, 0, 0.00, 1389
7, 10:07:00-000, 3054, 53, 3001, 1, 1349.00, 1, 1348.00, 3052
7, 10:10:00-000, 6627, 2808, 3819, 1, 1349.00, 1, 1348.00, 6625
7, 10:11:00-000, 5654, 5160, 494, 1, 1349.00, 1, 1348.00, 5652
7, 10:12:00-000, 6215, 4715, 1500, 4, 1352.75, 4, 1351.00, 6207
7, 10:13:00-000, 12907, 4691, 8216, 5, 1345.80, 5, 1348.40, 12897
7, 10:14:00-000, 8840, 1245, 7595, 57, 1352.27, 57, 1351.86, 8726
7, 10:15:00-000, 3783, 1988, 1795, 1, 1351.00, 1, 1350.00, 3781
7, 10:17:00-000, 4326, 4260, 66, 28, 1344.46, 28, 1349.53, 4270
7, 10:18:00-000, 9227, 4963, 4264, 41, 1350.44, 41, 1353.00, 9145
7, 10:19:00-000, 6218, 2578, 3640, 5, 1351.00, 5, 1349.00, 6208
7, 10:20:00-000, 706, 690, 16, 0, 0.00, 0, 0.00, 706
7, 10:21:00-000, 8191, 6734, 1457, 101, 1346.42, 106, 1348.25, 7984
7, 10:22:00-000, 10298, 6015, 4283, 36, 1349.86, 31, 1351.22, 10231
7, 10:23:00-000, 21172, 11111, 10061, 15, 1348.00, 15, 1346.00, 21142
7, 10:24:00-000, 1024, 947, 77, 19, 1351.84, 19, 1352.68, 986
7, 10:26:00-000, 4101, 2664, 1437, 0, 0.00, 0, 0.00, 4101
7, 10:28:00-000, 15230, 6759, 8471, 4, 1349.50, 3, 1352.33, 15223
7, 10:29:00-000, 13181, 8789, 4392, 32, 1350.78, 48, 1352.85, 13101
7, 10:30:00-000, 555, 30, 525, 15, 1352.67, 0, 0.00, 540
7, 10:31:00-000, 20939, 8671, 12268, 14, 1351.71, 14, 1349.57, 19530
7, 10:32:00-000, 410, 1, 409, 12, 1349.33, 12, 1350.08, 1767
7, 10:33:00-000, 7271, 1311, 5960, 10, 1351.70, 10, 1352.70, 7251
7, 10:34:00-000, 10155, 6573, 3582, 7, 1348.57, 38, 1352.00, 10110
7, 10:35:00-000, 61, 61, 0, 31, 1351.19, 0, 0.00, 30
7, 10:36:00-000, 3972, 2017, 1955, 5, 1349.00, 5, 1351.60, 3962
7, 10:37:00-000, 2597, 1084, 1513, 0, 0.00, 0, 0.00, 2597
7, 10:38:00-000, 4595, 341, 4254, 0, 0.00, 0, 0.00, 4595
7, 10:39:00-000, 589, 19, 570, 0, 0.00, 0, 0.00, 589
7, 10:40:00-000, 5382, 4420, 962, 0, 0.00, 0, 0.00, 5382
7, 10:41:00-000, 8036, 4994, 3042, 64, 1349.75, 64, 1350.55, 7908
7, 10:42:00-000, 2310, 1446, 864, 7, 1346.29, 7, 1351.43, 2296
7, 10:43:00-000, 7066, 2991, 4075, 0, 0.00, 0, 0.00, 7066
7, 10:45:00-000, 11651, 4522, 7129, 0, 0.00, 0, 0.00, 10697
7, 10:46:00-000, 0, 0, 0, 0, 0.00, 0, 0.00, 954
7, 10:48:00-000, 712, 32, 680, 19, 1352.58, 19, 1353.00, 674
7, 10:49:00-000, 3958, 1065, 2893, 0, 0.00, 0, 0.00, 3958
7, 10:51:00-000, 10751, 3690, 7061, 0, 0.00, 0, 0.00, 10751
7, 10:52:00-000, 2276, 33, 2243, 12, 1354.42, 12, 1352.83, 2252
7, 10:53:00-000, 1816, 1066, 750, 0, 0.00, 0, 0.00, 1800
7, 10:54:00-000, 2652, 101, 2551, 8, 1350.25, 2, 1352.00, 2658
7, 10:55:00-000, 13482, 7164, 6318, 0, 0.00, 6, 1348.17, 12740
7, 10:56:00-000, 6322, 2440, 3882, 66, 1351.16, 64, 1350.01, 6928
7, 10:57:00-000, 7872, 4596, 3276, 0, 0.00, 2, 1347.00, 7870
7, 10:58:00-000, 7844, 5265, 2579, 0, 0.00, 0, 0.00, 6723
7, 10:59:00-000, 10722, 6243, 4479, 6, 1351.17, 6, 1352.33, 11831
7, 11:00:00-000, 8943, 3902, 5041, 14, 1350.00, 14, 1352.86, 8915
7, 11:01:00-000, 11586, 6858, 4728, 5, 1352.80, 5, 1351.00, 11576
7, 11:02:00-000, 11482, 5729, 5753, 6, 1352.00, 6, 1352.00, 11470
7, 11:04:00-000, 2946, 1971, 975, 0, 0.00, 0, 0.00, 2941
7, 11:05:00-000, 2639, 27, 2612, 2, 1350.00, 2, 1347.00, 2640
7, 11:06:00-000, 9117, 2317, 6800, 3, 1349.67, 3, 1349.00, 9111
7, 11:07:00-000, 5384, 1597, 3787, 9, 1348.22, 9, 1351.00, 5366
7, 11:08:00-000, 13518, 11152, 2366, 25, 1349.60, 25, 1351.76, 13468
7, 11:14:00-000, 10495, 5315, 5180, 0, 0.00, 0, 0.00, 10477
7, 11:15:00-000, 6556, 5384, 1172, 0, 0.00, 0, 0.00, 5549
7, 11:16:00-000, 0, 0, 0, 0, 0.00, 0, 0.00, 1025
7, 11:19:00-000, 2230, 1183, 1047, 0, 0.00, 0, 0.00, 2230
7, 11:20:00-000, 2618, 1511, 1107, 55, 1355.20, 55, 1352.00, 2508
7, 11:21:00-000, 7360, 4626, 2734, 17, 1348.70, 17, 1348.35, 7326
7, 11:22:00-000, 3445, 1613, 1832, 0, 0.00, 0, 0.00, 3445
7, 11:23:00-000, 8446, 5081, 3365, 10, 1353.20, 10, 1351.40, 8426
7, 11:24:00-000, 16814, 11078, 5736, 5, 1349.60, 5, 1351.20, 15716
7, 11:25:00-000, 11490, 5193, 6297, 0, 0.00, 0, 0.00, 12578
7, 11:26:00-000, 7471, 2624, 4847, 0, 0.00, 0, 0.00, 7471
7, 11:27:00-000, 4651, 2517, 2134, 0, 0.00, 0, 0.00, 4651
7, 11:28:00-000, 4305, 822, 3483, 0, 0.00, 0, 0.00, 4305
7, 11:29:00-000, 1131, 1130, 1, 1, 1349.00, 1, 1351.00, 1129
7, 11:30:00-000, 9883, 4091, 5792, 9, 1348.00, 9, 1352.56, 9865
7, 11:32:00-000, 13056, 7350, 5706, 1, 1345.00, 1, 1348.00, 13054
7, 11:33:00-000, 6213, 3066, 3147, 0, 0.00, 0, 0.00, 6213
7, 11:34:00-000, 9862, 4731, 5131, 57, 1348.52, 40, 1351.44, 9765
7, 11:35:00-000, 4031, 1825, 2206, 4, 1355.50, 21, 1349.19, 4006
7, 11:36:00-000, 16658, 4420, 12238, 9, 1348.33, 8, 1349.25, 16641
7, 11:37:00-000, 2060, 1089, 971, 0, 0.00, 1, 1348.00, 2059
7, 11:38:00-000, 6381, 857, 5524, 18, 1349.33, 18, 1347.28, 6345
7, 11:39:00-000, 11381, 5938, 5443, 0, 0.00, 0, 0.00, 11381
7, 11:40:00-000, 6739, 1156, 5583, 13, 1349.85, 13, 1349.85, 6713
7, 11:41:00-000, 16634, 6228, 10406, 3, 1354.67, 3, 1353.00, 16628
7, 11:42:00-000, 1374, 9, 1365, 5, 1349.00, 3, 1352.00, 1366
7, 11:43:00-000, 2, 0, 2, 0, 0.00, 2, 1351.00, 0
7, 11:44:00-000, 2928, 511, 2417, 24, 1349.58, 24, 1352.00, 2880
7, 11:45:00-000, 7398, 4953, 2445, 3, 1351.00, 3, 1351.00, 7392
7, 11:46:00-000, 7100, 3312, 3788, 47, 1350.27, 47, 1350.95, 7006
7, 11:47:00-000, 1177, 7, 1170, 0, 0.00, 0, 0.00, 1177
7, 11:48:00-000, 1098, 18, 1080, 3, 1349.33, 3, 1352.00, 1092
7, 11:49:00-000, 2578, 1850, 728, 40, 1350.95, 40, 1352.00, 2498
7, 11:50:00-000, 2072, 1019, 1053, 4, 1348.00, 4, 1349.75, 2064
7, 11:51:00-000, 1529, 9, 1520, 0, 0.00, 0, 0.00, 1529
7, 11:52:00-000, 1227, 1021, 206, 38, 1348.00, 15, 1348.67, 1174
7, 11:53:00-000, 18491, 9220, 9271, 5, 1350.20, 28, 1346.00, 18458
7, 11:55:00-000, 14352, 5692, 8660, 0, 0.00, 0, 0.00, 13062
7, 11:56:00-000, 7407, 3650, 3757, 1, 1357.00, 1, 1350.00, 8695
7, 11:57:00-000, 13301, 5043, 8258, 16, 1348.25, 16, 1346.94, 13263
7, 11:58:00-000, 5776, 3639, 2137, 17, 1348.82, 17, 1350.94, 4254
7, 11:59:00-000, 0, 0, 0, 0, 0.00, 0, 0.00, 1494
7, 12:00:00-000, 2097, 769, 1328, 0, 0.00, 0, 0.00, 2097
7, 12:01:00-000, 12178, 7423, 4755, 7, 1347.14, 7, 1347.14, 12164
7, 12:02:00-000, 14724, 7568, 7156, 0, 0.00, 0, 0.00, 13810
7, 12:03:00-000, 10340, 5751, 4589, 0, 0.00, 0, 0.00, 11254
7, 12:04:00-000, 11549, 5932, 5617, 10, 1350.30, 10, 1349.80, 11529
7, 12:06:00-000, 5009, 2103, 2906, 5, 1352.40, 5, 1352.00, 4999
7, 12:07:00-000, 11441, 4438, 7003, 2, 1350.00, 2, 1349.00, 11437
7, 12:08:00-000, 7257, 3417, 3840, 0, 0.00, 0, 0.00, 7257
7, 12:09:00-000, 8817, 4333, 4484, 8, 1347.37, 8, 1347.62, 8801
7, 12:10:00-000, 9261, 6532, 2729, 16, 1346.31, 13, 1348.31, 9232
7, 12:11:00-000, 8706, 4847, 3859, 3, 1350.33, 6, 1349.67, 8692
7, 12:12:00-000, 5795, 2777, 3018, 0, 0.00, 0, 0.00, 5791
7, 12:13:00-000, 14323, 6761, 7562, 15, 1352.87, 15, 1351.47, 14302
7, 12:14:00-000, 4376, 2491, 1885, 15, 1348.33, 15, 1352.87, 4346
7, 12:15:00-000, 6393, 2114, 4279, 1, 1351.00, 1, 1351.00, 6391
7, 12:16:00-000, 16544, 8644, 7900, 3, 1349.00, 3, 1350.00, 16538
7, 12:17:00-000, 10192, 3171, 7021, 12, 1348.00, 12, 1350.50, 10168
7, 12:18:00-000, 15930, 7826, 8104, 3, 1353.67, 3, 1352.33, 15924
7, 12:19:00-000, 1220, 10, 1210, 2, 1350.00, 2, 1352.00, 1216
7, 12:20:00-000, 5446, 3451, 1995, 14, 1346.93, 14, 1351.14, 5418
7, 12:25:00-000, 1371, 1353, 18, 6, 1349.50, 6, 1351.00, 1359
7, 12:28:00-000, 3840, 1505, 2335, 6, 1352.17, 6, 1352.17, 3828
7, 12:31:00-000, 6359, 3767, 2592, 0, 0.00, 0, 0.00, 6359
7, 12:32:00-000, 718, 710, 8, 1, 1349.00, 1, 1346.00, 716
7, 12:36:00-000, 5118, 2154, 2964, 1, 1350.00, 1, 1352.00, 5116
7, 12:37:00-000, 1139, 1130, 9, 0, 0.00, 0, 0.00, 1139
7, 12:38:00-000, 2991, 11, 2980, 0, 0.00, 0, 0.00, 2991
7, 12:40:00-000, 1230, 9, 1221, 6, 1349.00, 6, 1348.00, 1218
7, 12:41:00-000, 9402, 8196, 1206, 3, 1348.00, 3, 1349.00, 9396
7, 12:42:00-000, 7792, 3220, 4572, 1, 1349.00, 1, 1350.00, 7790
7, 12:44:00-000, 3242, 728, 2514, 22, 1347.95, 22, 1348.32, 2594
7, 12:45:00-000, 5698, 3109, 2589, 0, 0.00, 0, 0.00, 6302
7, 12:48:00-000, 5107, 2596, 2511, 0, 0.00, 0, 0.00, 5107
7, 12:49:00-000, 4135, 15, 4120, 0, 0.00, 0, 0.00, 4135
7, 12:50:00-000, 6134, 2517, 3617, 0, 0.00, 0, 0.00, 6129
7, 12:51:00-000, 3739, 2062, 1677, 0, 0.00, 0, 0.00, 3744
7, 12:52:00-000, 7965, 4685, 3280, 16, 1351.37, 16, 1351.44, 7933
7, 12:53:00-000, 6302, 3020, 3282, 13, 1348.00, 13, 1348.61, 6276
7, 12:54:00-000, 1404, 14, 1390, 7, 1350.71, 7, 1351.00, 1390
7, 12:55:00-000, 2438, 1621, 817, 0, 0.00, 0, 0.00, 2438
7, 12:56:00-000, 4712, 1539, 3173, 4, 1352.00, 4, 1351.25, 4704
7, 12:57:00-000, 7844, 3920, 3924, 13, 1355.54, 13, 1351.23, 7818
7, 12:58:00-000, 1917, 905, 1012, 2, 1355.00, 2, 1352.00, 1913
7, 12:59:00-000, 10296, 4194, 6102, 2, 1352.00, 0, 0.00, 10292
7, 13:00:00-000, 3933, 726, 3207, 5, 1353.80, 7, 1349.14, 3923
7, 13:01:00-000, 12151, 8107, 4044, 30, 1353.10, 30, 1351.87, 12091
7, 13:02:00-000, 9190, 2998, 6192, 6, 1344.33, 6, 1344.00, 9178
7, 13:03:00-000, 650, 641, 9, 1, 1349.00, 1, 1349.00, 648
7, 13:05:00-000, 5023, 2801, 2222, 0, 0.00, 0, 0.00, 4468
7, 13:06:00-000, 5863, 2566, 3297, 8, 1350.25, 10, 1352.20, 6400
7, 13:07:00-000, 13093, 3001, 10092, 2, 1352.00, 0, 0.00, 11612
7, 13:08:00-000, 4793, 3281, 1512, 14, 1353.00, 14, 1352.00, 6244
7, 13:09:00-000, 2741, 1465, 1276, 5, 1348.80, 5, 1347.00, 2731
7, 13:10:00-000, 6303, 3703, 2600, 65, 1351.27, 35, 1347.97, 6203
7, 13:11:00-000, 8717, 2995, 5722, 0, 0.00, 30, 1345.83, 8687
7, 13:12:00-000, 20221, 10007, 10214, 4, 1349.50, 4, 1349.00, 20213
7, 13:13:00-000, 20400, 14589, 5811, 7, 1352.00, 7, 1350.14, 19521
7, 13:14:00-000, 3683, 3661, 22, 1, 1350.00, 1, 1352.00, 3139
7, 13:15:00-000, 15380, 9013, 6367, 11, 1347.73, 11, 1351.27, 16765
7, 13:16:00-000, 2832, 1391, 1441, 25, 1352.68, 25, 1353.84, 2782
7, 13:18:00-000, 898, 889, 9, 9, 1354.00, 9, 1352.00, 880
7, 13:19:00-000, 14533, 7371, 7162, 0, 0.00, 0, 0.00, 14533
7, 13:20:00-000, 5696, 3737, 1959, 30, 1352.33, 33, 1350.21, 5633
7, 13:21:00-000, 7675, 5803, 1872, 6, 1352.00, 3, 1351.33, 7666
7, 13:22:00-000, 15992, 10786, 5206, 26, 1348.15, 26, 1350.00, 15940
7, 13:23:00-000, 17759, 9368, 8391, 5, 1348.20, 5, 1347.80, 17749
7, 13:24:00-000, 11652, 7075, 4577, 17, 1348.53, 17, 1350.06, 11618
7, 13:25:00-000, 5869, 3327, 2542, 0, 0.00, 0, 0.00, 5869
7, 13:26:00-000, 6438, 4054, 2384, 0, 0.00, 0, 0.00, 6431
7, 13:27:00-000, 2572, 2443, 129, 3, 1351.00, 3, 1346.00, 2573
7, 13:28:00-000, 10493, 6021, 4472, 21, 1348.57, 21, 1348.90, 10451
7, 13:29:00-000, 9845, 6489, 3356, 16, 1349.81, 16, 1350.81, 9813
7, 13:30:00-000, 8367, 4992, 3375, 1, 1349.00, 1, 1350.00, 8365
7, 13:31:00-000, 4980, 144, 4836, 48, 1351.79, 48, 1351.50, 4884
7, 13:32:00-000, 8700, 2083, 6617, 6, 1348.83, 4, 1348.50, 8690
7, 13:33:00-000, 4351, 2935, 1416, 10, 1353.80, 12, 1349.92, 4329
7, 13:34:00-000, 1000, 982, 18, 2, 1356.00, 2, 1352.00, 996
7, 13:35:00-000, 8572, 2429, 6143, 1, 1350.00, 1, 1348.00, 7900
7, 13:36:00-000, 3582, 2515, 1067, 2, 1352.00, 2, 1350.50, 4248
7, 13:37:00-000, 7592, 2142, 5450, 31, 1353.83, 31, 1351.13, 7530
7, 13:38:00-000, 459, 7, 452, 2, 1350.00, 2, 1348.50, 455
7, 13:39:00-000, 4747, 2604, 2143, 17, 1352.35, 17, 1351.47, 4713
7, 13:40:00-000, 227, 7, 220, 5, 1349.60, 5, 1352.00, 217
7, 13:41:00-000, 11903, 5555, 6348, 1, 1350.00, 1, 1352.00, 10690
7, 13:42:00-000, 3916, 2424, 1492, 20, 1346.50, 20, 1348.80, 5087
7, 13:43:00-000, 11425, 6893, 4532, 34, 1351.56, 50, 1346.56, 11341
7, 13:44:00-000, 3230, 2104, 1126, 28, 1353.00, 12, 1351.42, 3190
7, 13:45:00-000, 2939, 2921, 18, 1, 1352.00, 1, 1351.00, 2614
7, 13:46:00-000, 5500, 3255, 2245, 10, 1349.20, 10, 1346.70, 5803
7, 13:47:00-000, 14151, 7711, 6440, 0, 0.00, 0, 0.00, 13304
7, 13:48:00-000, 7616, 5050, 2566, 0, 0.00, 0, 0.00, 7739
7, 13:49:00-000, 10907, 3141, 7766, 4, 1347.25, 4, 1348.50, 11623
7, 13:50:00-000, 12946, 8446, 4500, 3, 1348.00, 3, 1352.00, 12940
7, 13:51:00-000, 14495, 5045, 9450, 2, 1349.00, 2, 1348.00, 13550
7, 13:52:00-000, 6506, 2293, 4213, 5, 1347.00, 4, 1351.25, 7438
7, 13:53:00-000, 11904, 5310, 6594, 0, 0.00, 1, 1354.00, 10666
7, 13:54:00-000, 6362, 4070, 2292, 16, 1349.81, 16, 1350.37, 7567
7, 13:55:00-000, 9530, 4937, 4593, 4, 1347.50, 4, 1346.00, 9522
7, 13:56:00-000, 9961, 6100, 3861, 4, 1348.00, 4, 1348.50, 9953
7, 13:57:00-000, 8828, 5707, 3121, 26, 1353.46, 26, 1349.73, 7908
7, 13:58:00-000, 14120, 11440, 2680, 41, 1349.61, 30, 1350.53, 14917
7, 13:59:00-000, 4602, 2760, 1842, 7, 1353.14, 18, 1346.28, 4577
7, 14:00:00-000, 7575, 4119, 3456, 4, 1355.25, 4, 1352.00, 7558
7, 14:01:00-000, 11160, 6486, 4674, 18, 1349.39, 18, 1350.28, 11133
7, 14:02:00-000, 994, 24, 970, 7, 1353.71, 7, 1352.00, 980
7, 14:03:00-000, 6233, 1934, 4299, 0, 0.00, 0, 0.00, 5987
7, 14:04:00-000, 2039, 799, 1240, 9, 1349.78, 9, 1352.00, 2267
7, 14:05:00-000, 2036, 45, 1991, 15, 1348.33, 15, 1351.67, 2006
7, 14:06:00-000, 5480, 2492, 2988, 12, 1351.75, 12, 1350.00, 5456
7, 14:08:00-000, 1585, 65, 1520, 27, 1351.77, 27, 1351.33, 1531
7, 14:09:00-000, 3425, 1033, 2392, 4, 1345.75, 4, 1352.00, 3417
7, 14:10:00-000, 4116, 112, 4004, 8, 1347.75, 8, 1348.62, 4100
7, 14:11:00-000, 9747, 5047, 4700, 4, 1351.75, 4, 1351.00, 9739
7, 14:12:00-000, 7671, 3886, 3785, 12, 1352.92, 12, 1351.00, 7647
7, 14:13:00-000, 13439, 5610, 7829, 7, 1346.57, 7, 1350.00, 13425
7, 14:14:00-000, 2150, 977, 1173, 0, 0.00, 0, 0.00, 2150
7, 14:15:00-000, 5663, 2757, 2906, 53, 1347.77, 49, 1348.83, 5561
7, 14:16:00-000, 2368, 1254, 1114, 22, 1350.41, 28, 1349.68, 2318
7, 14:17:00-000, 3252, 3167, 85, 17, 1350.76, 15, 1350.67, 3220
7, 14:18:00-000, 4719, 3689, 1030, 21, 1349.33, 21, 1351.19, 4677
7, 14:19:00-000, 7426, 2190, 5236, 2, 1348.00, 2, 1348.00, 7422
7, 14:20:00-000, 3896, 2699, 1197, 29, 1349.79, 30, 1351.83, 3837
7, 14:21:00-000, 6782, 3293, 3489, 1, 1352.00, 0, 0.00, 6781
7, 14:22:00-000, 7775, 4353, 3422, 36, 1351.69, 36, 1351.72, 7703
7, 14:23:00-000, 13402, 4102, 9300, 1, 1352.00, 1, 1353.00, 13400
7, 14:24:00-000, 10119, 4669, 5450, 7, 1349.00, 7, 1353.71, 10105
7, 14:25:00-000, 2745, 1346, 1399, 1, 1348.00, 1, 1352.00, 2743
7, 14:26:00-000, 3617, 1247, 2370, 0, 0.00, 0, 0.00, 3617
7, 14:27:00-000, 9410, 2709, 6701, 0, 0.00, 0, 0.00, 9410
7, 14:28:00-000, 9647, 5067, 4580, 18, 1347.44, 10, 1347.00, 9619
7, 14:29:00-000, 768, 760, 8, 0, 0.00, 8, 1345.25, 760
7, 14:30:00-000, 20643, 13411, 7232, 6, 1346.00, 6, 1348.17, 20631
7, 14:31:00-000, 3358, 1450, 1908, 8, 1350.75, 8, 1352.00, 3342
7, 14:32:00-000, 806, 6, 800, 0, 0.00, 0, 0.00, 806
7, 14:33:00-000, 5183, 2371, 2812, 0, 0.00, 0, 0.00, 5183
7, 14:35:00-000, 1450, 1441, 9, 1, 1355.00, 1, 1350.00, 1448
7, 14:36:00-000, 7579, 2958, 4621, 14, 1353.93, 14, 1351.79, 7551
7, 14:37:00-000, 8491, 3755, 4736, 82, 1347.27, 63, 1348.38, 8346
7, 14:38:00-000, 4734, 2192, 2542, 11, 1348.00, 30, 1347.26, 4693
7, 14:39:00-000, 2521, 2503, 18, 3, 1350.67, 3, 1349.67, 2515
7, 14:40:00-000, 7142, 3253, 3889, 16, 1352.44, 16, 1350.38, 7110
7, 14:41:00-000, 6187, 5415, 772, 23, 1353.39, 23, 1351.17, 6141
7, 14:44:00-000, 8676, 5400, 3276, 6, 1348.00, 0, 0.00, 8670
7, 14:45:00-000, 16958, 7131, 9827, 10, 1348.30, 17, 1350.18, 16931
7, 14:46:00-000, 11559, 6600, 4959, 51, 1347.54, 54, 1351.09, 11454
7, 14:47:00-000, 18561, 10390, 8171, 9, 1349.78, 5, 1351.20, 18547
7, 14:48:00-000, 5242, 1077, 4165, 36, 1351.83, 75, 1352.57, 5131
7, 14:49:00-000, 1535, 1523, 12, 51, 1354.09, 12, 1352.17, 1472
7, 14:52:00-000, 6264, 5163, 1101, 47, 1349.36, 47, 1346.23, 6170
7, 14:53:00-000, 1460, 1460, 0, 0, 0.00, 0, 0.00, 1460
7, 14:54:00-000, 5890, 4296, 1594, 15, 1348.60, 15, 1348.27, 5860
7, 14:55:00-000, 1096, 803, 293, 0, 0.00, 0, 0.00, 1096
7, 14:56:00-000, 2886, 1039, 1847, 13, 1351.15, 13, 1352.00, 2860
7, 14:57:00-000, 1608, 659, 949, 0, 0.00, 0, 0.00, 1608
7, 14:59:00-000, 8450, 6137, 2313, 11, 1350.64, 11, 1349.73, 8428
7, 15:00:00-000, 1012, 990, 22, 3, 1349.00, 3, 1348.00, 1006
7, 15:01:00-000, 2246, 943, 1303, 20, 1353.10, 20, 1351.85, 2206
7, 15:02:00-000, 6476, 2587, 3889, 31, 1349.41, 31, 1351.55, 6414
7, 15:03:00-000, 7086, 5077, 2009, 13, 1351.61, 13, 1351.00, 7060
7, 15:04:00-000, 5720, 1585, 4135, 6, 1356.00, 6, 1354.00, 5708
7, 15:06:00-000, 1725, 896, 829, 0, 0.00, 0, 0.00, 899
7, 15:07:00-000, 18933, 10636, 8297, 5, 1347.80, 6, 1348.83, 18245
7, 15:08:00-000, 4042, 1554, 2488, 13, 1351.38, 12, 1351.00, 5520
7, 15:09:00-000, 4278, 2515, 1763, 19, 1348.57, 20, 1349.10, 4239
7, 15:10:00-000, 6388, 3205, 3183, 31, 1346.96, 30, 1348.30, 6327
7, 15:11:00-000, 3684, 806, 2878, 0, 0.00, 0, 0.00, 3684
7, 15:12:00-000, 13619, 3102, 10517, 2, 1348.00, 16, 1349.75, 13591
7, 15:13:00-000, 13432, 7501, 5931, 15, 1350.13, 6, 1350.17, 13405
7, 15:14:00-000, 7904, 1943, 5961, 7, 1349.14, 2, 1348.50, 7902
7, 15:15:00-000, 5985, 3895, 2090, 0, 0.00, 0, 0.00, 5994
7, 15:16:00-000, 1480, 1470, 10, 0, 0.00, 0, 0.00, 1480
7, 15:17:00-000, 3025, 3010, 15, 2, 1349.00, 0, 0.00, 3023
7, 15:18:00-000, 14562, 9195, 5367, 19, 1350.42, 39, 1352.33, 14504
7, 15:19:00-000, 2868, 2226, 642, 38, 1351.73, 20, 1350.35, 2810
7, 15:20:00-000, 5466, 2684, 2782, 9, 1353.00, 9, 1350.33, 4057
7, 15:21:00-000, 7429, 2298, 5131, 2, 1349.00, 2, 1348.00, 8816
7, 15:22:00-000, 4439, 3490, 949, 3, 1347.00, 3, 1351.00, 4433
7, 15:23:00-000, 11699, 3949, 7750, 16, 1352.37, 16, 1352.62, 11667
7, 15:24:00-000, 17291, 7968, 9323, 38, 1349.31, 34, 1352.67, 17219
7, 15:25:00-000, 1315, 11, 1304, 5, 1354.00, 9, 1349.78, 1301
7, 15:26:00-000, 6881, 2748, 4133, 9, 1351.44, 9, 1352.11, 6863
7, 15:27:00-000, 7409, 1365, 6044, 32, 1352.41, 32, 1352.00, 7345
7, 15:28:00-000, 1373, 1370, 3, 0, 0.00, 0, 0.00, 1370
7, 15:29:00-000, 7478, 3485, 3993, 11, 1349.00, 11, 1347.64, 7459
7, 15:30:00-000, 8189, 4765, 3424, 3, 1348.00, 3, 1348.67, 8183
7, 15:31:00-000, 4931, 1904, 3027, 20, 1350.30, 20, 1352.75, 4891
7, 15:32:00-000, 8131, 3921, 4210, 33, 1349.57, 33, 1351.39, 8065
7, 15:33:00-000, 11642, 2309, 9333, 12, 1347.00, 12, 1350.50, 11609
7, 15:34:00-000, 1383, 1374, 9, 4, 1353.00, 4, 1351.00, 1384
7, 15:35:00-000, 3430, 2217, 1213, 0, 0.00, 0, 0.00, 2213
7, 15:36:00-000, 8301, 2373, 5928, 19, 1348.47, 20, 1351.00, 9479
7, 15:37:00-000, 8813, 3623, 5190, 16, 1347.37, 9, 1350.11, 7505
7, 15:38:00-000, 22085, 12383, 9702, 8, 1345.88, 14, 1349.35, 23346
7, 15:39:00-000, 10851, 2247, 8604, 5, 1349.00, 5, 1344.60, 10841
7, 15:40:00-000, 1051, 11, 1040, 0, 0.00, 0, 0.00, 1051
7, 15:41:00-000, 6697, 2897, 3800, 4, 1353.00, 4, 1351.00, 6689
7, 15:43:00-000, 892, 12, 880, 0, 0.00, 0, 0.00, 0
7, 15:44:00-000, 2461, 41, 2420, 26, 1349.04, 26, 1353.00, 3301
7, 15:45:00-000, 1202, 22, 1180, 0, 0.00, 0, 0.00, 1103
7, 15:46:00-000, 1985, 877, 1108, 4, 1348.00, 4, 1351.00, 2076
7, 15:50:00-000, 658, 650, 8, 0, 0.00, 0, 0.00, 658
7, 15:54:00-000, 3887, 47, 3840, 0, 0.00, 0, 0.00, 3887
7, 15:55:00-000, 4861, 1420, 3441, 0, 0.00, 0, 0.00, 4840
7, 15:56:00-000, 2931, 1339, 1592, 2, 1354.00, 2, 1351.00, 2948
7, 15:57:00-000, 1237, 1230, 7, 0, 0.00, 0, 0.00, 1230
7, 15:58:00-000, 3710, 2783, 927, 12, 1348.83, 12, 1349.92, 3693
7, 15:59:00-000, 2159, 954, 1205, 0, 0.00, 0, 0.00, 2159
7, 16:03:00-000, 2279, 1477, 802, 1, 1354.00, 1, 1352.00, 2277
7, 16:06:00-000, 4316, 2186, 2130, 0, 0.00, 0, 0.00, 4316
7, 16:07:00-000, 3355, 3320, 35, 23, 1349.74, 23, 1347.13, 3309
7, 16:08:00-000, 6004, 1571, 4433, 0, 0.00, 0, 0.00, 6004
7, 16:09:00-000, 830, 0, 830, 0, 0.00, 0, 0.00, 830
7, 16:10:00-000, 1342, 1320, 22, 22, 1347.32, 13, 1345.54, 1307
7, 16:11:00-000, 1472, 13, 1459, 0, 0.00, 9, 1344.00, 1463
7, 16:12:00-000, 13054, 6724, 6330, 4, 1350.00, 4, 1350.00, 13046
7, 16:13:00-000, 9985, 3239, 6746, 4, 1351.00, 4, 1351.50, 9977
7, 16:14:00-000, 4082, 2523, 1559, 89, 1351.58, 89, 1351.00, 3904
7, 16:15:00-000, 1100, 0, 1100, 0, 0.00, 0, 0.00, 1100
7, 16:16:00-000, 2512, 1259, 1253, 0, 0.00, 0, 0.00, 2512
7, 16:17:00-000, 6490, 4480, 2010, 0, 0.00, 0, 0.00, 6490
7, 16:18:00-000, 2019, 497, 1522, 19, 1346.79, 53, 1351.54, 1947
7, 16:19:00-000, 6848, 3535, 3313, 34, 1353.08, 1, 1352.00, 6813
7, 16:20:00-000, 12401, 5700, 6701, 6, 1348.83, 5, 1347.40, 12390
7, 16:21:00-000, 13078, 5430, 7648, 37, 1347.18, 37, 1346.54, 13004
7, 16:22:00-000, 7389, 3759, 3630, 21, 1349.00, 21, 1351.66, 7344
7, 16:23:00-000, 0, 0, 0, 0, 0.00, 0, 0.00, 3
7, 16:24:00-000, 4611, 2080, 2531, 1, 1350.00, 1, 1351.00, 4609
7, 16:25:00-000, 7536, 2097, 5439, 0, 0.00, 0, 0.00, 7536
7, 16:26:00-000, 8370, 6005, 2365, 9, 1352.78, 9, 1351.00, 8352
7, 16:27:00-000, 2886, 26, 2860, 0, 0.00, 0, 0.00, 2886
7, 16:28:00-000, 8698, 3464, 5234, 21, 1347.38, 21, 1350.43, 8656
7, 16:29:00-000, 11224, 4761, 6463, 9, 1355.22, 9, 1351.33, 11206
8, 09:06:00-000, 952, 831, 121, 0, 0.00, 0, 0.00, 952
8, 09:07:00-000, 223, 220, 3, 0, 0.00, 0, 0.00, 223
8, 09:33:00-000, 764, 760, 4, 0, 0.00, 0, 0.00, 764
8, 09:41:00-000, 3037, 1278, 1759, 0, 0.00, 0, 0.00, 3037
8, 09:42:00-000, 3331, 1590, 1741, 5, 1350.60, 5, 1350.20, 3321
8, 09:43:00-000, 151, 50, 101, 46, 1349.00, 46, 1348.78, 59
8, 09:44:00-000, 933, 190, 743, 0, 0.00, 0, 0.00, 933
8, 09:46:00-000, 151, 150, 1, 0, 0.00, 0, 0.00, 151
8, 09:47:00-000, 105, 5, 100, 0, 0.00, 0, 0.00, 105
8, 09:48:00-000, 1062, 354, 708, 6, 1351.00, 6, 1350.00, 1046
8, 09:49:00-000, 0, 0, 0, 0, 0.00, 0, 0.00, 4
8, 09:50:00-000, 98, 90, 8, 0, 0.00, 0, 0.00, 98
8, 09:52:00-000, 251, 250, 1, 0, 0.00, 0, 0.00, 251
8, 09:53:00-000, 861, 18, 843, 5, 1349.00, 5, 1348.80, 851
8, 09:56:00-000, 977, 825, 152, 0, 0.00, 0, 0.00, 977
8, 09:57:00-000, 3448, 155, 3293, 52, 1350.90, 52, 1353.06, 3338
8, 09:58:00-000, 720, 20, 700, 2, 1356.00, 2, 1352.00, 722
8, 10:00:00-000, 678, 511, 167, 0, 0.00, 0, 0.00, 678
8, 10:01:00-000, 2511, 901, 1610, 1, 1350.00, 1, 1349.00, 2509
8, 10:02:00-000, 1565, 106, 1459, 0, 0.00, 0, 0.00, 1565
8, 10:05:00-000, 21, 3, 18, 3, 1349.00, 3, 1349.00, 15
8, 10:07:00-000, 177, 81, 96, 0, 0.00, 0, 0.00, 177
8, 10:10:00-000, 153, 141, 12, 1, 1351.00, 1, 1350.00, 151
8, 10:12:00-000, 1608, 1571, 37, 0, 0.00, 0, 0.00, 1608
8, 10:13:00-000, 4300, 3250, 1050, 0, 0.00, 0, 0.00, 2763
8, 10:14:00-000, 941, 789, 152, 13, 1352.38, 13, 1352.77, 2452
8, 10:16:00-000, 65, 60, 5, 0, 0.00, 0, 0.00, 65
8, 10:17:00-000, 1873, 109, 1764, 0, 0.00, 0, 0.00, 1873
8, 10:18:00-000, 373, 168, 205, 3, 1347.00, 3, 1349.67, 367
8, 10:19:00-000, 1060, 677, 383, 2, 1350.00, 2, 1351.50, 1056
8, 10:20:00-000, 508, 21, 487, 1, 1351.00, 1, 1350.00, 506
8, 10:21:00-000, 1819, 992, 827, 0, 0.00, 0, 0.00, 1819
8, 10:22:00-000, 367, 261, 106, 0, 0.00, 0, 0.00, 367
8, 10:23:00-000, 3804, 2051, 1753, 10, 1347.00, 10, 1347.30, 3784
8, 10:26:00-000, 51, 50, 1, 0, 0.00, 0, 0.00, 51
8, 10:28:00-000, 3719, 2788, 931, 0, 0.00, 0, 0.00, 3719
8, 10:29:00-000, 269, 199, 70, 0, 0.00, 0, 0.00, 269
8, 10:30:00-000, 1411, 1337, 74, 3, 1352.00, 4, 1351.25, 1404
8, 10:31:00-000, 2659, 190, 2469, 1, 1353.00, 0, 0.00, 2658
8, 10:33:00-000, 1588, 1236, 352, 1, 1353.00, 1, 1351.00, 1586
8, 10:34:00-000, 2829, 1793, 1036, 9, 1349.11, 9, 1347.33, 2811
8, 10:36:00-000, 43, 41, 2, 1, 1355.00, 1, 1351.00, 41
8, 10:37:00-000, 756, 750, 6, 0, 0.00, 0, 0.00, 756
8, 10:38:00-000, 78, 70, 8, 0, 0.00, 0, 0.00, 78
8, 10:39:00-000, 379, 307, 72, 0, 0.00, 0, 0.00, 379
8, 10:40:00-000, 348, 48, 300, 25, 1349.68, 25, 1353.00, 298
8, 10:41:00-000, 459, 124, 335, 4, 1351.00, 4, 1349.00, 451
8, 10:43:00-000, 127, 7, 120, 0, 0.00, 0, 0.00, 127
8, 10:45:00-000, 2514, 1507, 1007, 0, 0.00, 0, 0.00, 2514
8, 10:49:00-000, 60, 10, 50, 10, 1353.00, 10, 1355.00, 40
8, 10:51:00-000, 1843, 98, 1745, 4, 1352.00, 4, 1351.00, 1835
8, 10:53:00-000, 98, 8, 90, 1, 1355.00, 1, 1352.00, 96
8, 10:54:00-000, 19, 16, 3, 1, 1353.00, 1, 1351.00, 17
8, 10:55:00-000, 824, 800, 24, 4, 1348.00, 4, 1347.00, 816
8, 10:56:00-000, 3088, 164, 2924, 3, 1348.00, 3, 1349.00, 3082
8, 10:57:00-000, 2143, 1542, 601, 0, 0.00, 0, 0.00, 2143
8, 10:58:00-000, 2171, 861, 1310, 0, 0.00, 0, 0.00, 2171
8, 10:59:00-000, 160, 91, 69, 1, 1352.00, 1, 1351.00, 158
8, 11:00:00-000, 489, 389, 100, 3, 1352.00, 3, 1351.00, 483
8, 11:01:00-000, 2949, 1567, 1382, 1, 1352.00, 1, 1352.00, 2947
8, 11:02:00-000, 1098, 758, 340, 0, 0.00, 0, 0.00, 1098
8, 11:04:00-000, 130, 35, 95, 0, 0.00, 0, 0.00, 130
8, 11:05:00-000, 73, 70, 3, 0, 0.00, 0, 0.00, 73
8, 11:06:00-000, 5042, 3458, 1584, 2, 1355.00, 2, 1350.00, 5038
8, 11:07:00-000, 169, 9, 160, 0, 0.00, 0, 0.00, 169
8, 11:08:00-000, 64, 60, 4, 0, 0.00, 0, 0.00, 64
8, 11:14:00-000, 124, 101, 23, 0, 0.00, 0, 0.00, 124
8, 11:15:00-000, 3113, 1449, 1664, 0, 0.00, 0, 0.00, 3113
8, 11:19:00-000, 969, 765, 204, 1, 1350.00, 1, 1352.00, 967
8, 11:21:00-000, 2309, 736, 1573, 0, 0.00, 0, 0.00, 2309
8, 11:22:00-000, 1317, 247, 1070, 4, 1350.00, 4, 1349.75, 1309
8, 11:23:00-000, 5389, 2629, 2760, 16, 1347.00, 16, 1349.31, 5357
8, 11:24:00-000, 569, 345, 224, 4, 1349.50, 4, 1351.00, 487
8, 11:25:00-000, 2339, 19, 2320, 0, 0.00, 0, 0.00, 2413
8, 11:26:00-000, 845, 265, 580, 0, 0.00, 0, 0.00, 845
8, 11:27:00-000, 682, 2, 680, 0, 0.00, 0, 0.00, 682
8, 11:28:00-000, 1602, 120, 1482, 0, 0.00, 0, 0.00, 1602
8, 11:30:00-000, 1010, 826, 184, 0, 0.00, 0, 0.00, 1010
8, 11:32:00-000, 1888, 120, 1768, 1, 1350.00, 1, 1350.00, 1886
8, 11:33:00-000, 624, 4, 620, 0, 0.00, 0, 0.00, 624
8, 11:34:00-000, 1378, 107, 1271, 1, 1349.00, 1, 1349.00, 1376
8, 11:36:00-000, 1682, 201, 1481, 3, 1351.00, 3, 1351.67, 1676
8, 11:37:00-000, 242, 92, 150, 36, 1352.58, 48, 1353.00, 158
8, 11:38:00-000, 328, 318, 10, 12, 1350.58, 0, 0.00, 316
8, 11:39:00-000, 1315, 1231, 84, 0, 0.00, 0, 0.00, 1012
8, 11:40:00-000, 778, 58, 720, 1, 1350.00, 1, 1349.00, 1079
8, 11:41:00-000, 2218, 1460, 758, 0, 0.00, 0, 0.00, 2218
8, 11:42:00-000, 664, 19, 645, 3, 1355.00, 3, 1352.00, 658
8, 11:44:00-000, 432, 167, 265, 0, 0.00, 0, 0.00, 425
8, 11:45:00-000, 1072, 968, 104, 0, 0.00, 0, 0.00, 1079
8, 11:46:00-000, 717, 78, 639, 0, 0.00, 0, 0.00, 717
8, 11:47:00-000, 21, 20, 1, 0, 0.00, 0, 0.00, 21
8, 11:49:00-000, 1075, 20, 1055, 0, 0.00, 0, 0.00, 1075
8, 11:52:00-000, 1590, 0, 1590, 0, 0.00, 0, 0.00, 1590
8, 11:53:00-000, 2799, 1102, 1697, 0, 0.00, 0, 0.00, 2799
8, 11:55:00-000, 5479, 4412, 1067, 0, 0.00, 0, 0.00, 5479
8, 11:56:00-000, 1835, 1716, 119, 1, 1352.00, 1, 1352.00, 1833
8, 11:57:00-000, 2657, 165, 2492, 0, 0.00, 0, 0.00, 2587
8, 11:58:00-000, 1785, 148, 1637, 2, 1353.00, 2, 1351.00, 1851
8, 11:59:00-000, 130, 120, 10, 0, 0.00, 0, 0.00, 130
8, 12:00:00-000, 86, 6, 80, 1, 1349.00, 1, 1352.00, 84
8, 12:01:00-000, 1796, 1711, 85, 4, 1351.00, 4, 1350.00, 1788
8, 12:02:00-000, 3059, 2916, 143, 5, 1346.40, 5, 1349.80, 3049
8, 12:03:00-000, 173, 13, 160, 0, 0.00, 0, 0.00, 173
8, 12:04:00-000, 1273, 1141, 132, 0, 0.00, 0, 0.00, 1273
8, 12:06:00-000, 754, 750, 4, 0, 0.00, 0, 0.00, 754
8, 12:07:00-000, 917, 792, 125, 0, 0.00, 0, 0.00, 917
8, 12:08:00-000, 1658, 1550, 108, 5, 1347.00, 5, 1350.20, 1648
8, 12:09:00-000, 1541, 1530, 11, 0, 0.00, 0, 0.00, 1541
8, 12:10:00-000, 786, 6, 780, 0, 0.00, 0, 0.00, 786
8, 12:12:00-000, 3037, 1841, 1196, 3, 1349.00, 3, 1353.00, 2724
8, 12:13:00-000, 6814, 4157, 2657, 7, 1349.00, 7, 1346.57, 7107
8, 12:14:00-000, 98, 91, 7, 7, 1350.86, 7, 1352.00, 84
8, 12:15:00-000, 3398, 3380, 18, 0, 0.00, 0, 0.00, 3398
8, 12:16:00-000, 1297, 16, 1281, 4, 1350.50, 1, 1350.00, 1292
8, 12:17:00-000, 1659, 1446, 213, 2, 1348.00, 5, 1348.80, 1652
8, 12:18:00-000, 740, 66, 674, 0, 0.00, 0, 0.00, 740
8, 12:19:00-000, 1285, 116, 1169, 0, 0.00, 0, 0.00, 1285
8, 12:20:00-000, 91, 1, 90, 0, 0.00, 0, 0.00, 91
8, 12:21:00-000, 101, 100, 1, 0, 0.00, 0, 0.00, 101
8, 12:22:00-000, 2380, 2366, 14, 6, 1354.00, 6, 1351.00, 2368
8, 12:25:00-000, 258, 123, 135, 53, 1353.95, 53, 1352.81, 152
8, 12:27:00-000, 119, 100, 19, 0, 0.00, 0, 0.00, 119
8, 12:31:00-000, 1594, 14, 1580, 0, 0.00, 0, 0.00, 1589
8, 12:32:00-000, 21, 20, 1, 0, 0.00, 0, 0.00, 26
8, 12:36:00-000, 1054, 871, 183, 0, 0.00, 0, 0.00, 1054
8, 12:40:00-000, 239, 151, 88, 0, 0.00, 0, 0.00, 239
8, 12:41:00-000, 2343, 2246, 97, 0, 0.00, 0, 0.00, 2343
8, 12:42:00-000, 3155, 1593, 1562, 0, 0.00, 0, 0.00, 3155
8, 12:43:00-000, 1442, 1430, 12, 0, 0.00, 0, 0.00, 1442
8, 12:45:00-000, 2889, 533, 2356, 0, 0.00, 0, 0.00, 2889
8, 12:46:00-000, 127, 7, 120, 0, 0.00, 0, 0.00, 127
8, 12:48:00-000, 1066, 844, 222, 3, 1349.00, 3, 1351.00, 1060
8, 12:49:00-000, 156, 70, 86, 2, 1349.00, 2, 1351.00, 152
8, 12:50:00-000, 2711, 172, 2539, 17, 1348.94, 17, 1353.00, 2677
8, 12:51:00-000, 21, 1, 20, 0, 0.00, 0, 0.00, 20
8, 12:52:00-000, 759, 717, 42, 0, 0.00, 0, 0.00, 760
8, 12:53:00-000, 205, 44, 161, 0, 0.00, 0, 0.00, 205
8, 12:54:00-000, 1450, 1450, 0, 0, 0.00, 0, 0.00, 1450
8, 12:57:00-000, 990, 890, 100, 4, 1348.00, 4, 1350.00, 982
8, 12:58:00-000, 1082, 147, 935, 6, 1350.00, 1, 1352.00, 1075
8, 12:59:00-000, 213, 8, 205, 0, 0.00, 5, 1349.80, 208
8, 13:00:00-000, 2185, 15, 2170, 4, 1351.75, 4, 1354.00, 2177
8, 13:01:00-000, 2089, 138, 1951, 3, 1351.00, 3, 1351.33, 2083
8, 13:02:00-000, 78, 27, 51, 0, 0.00, 0, 0.00, 78
8, 13:05:00-000, 2609, 723, 1886, 0, 0.00, 0, 0.00, 2609
8, 13:06:00-000, 57, 6, 51, 1, 1348.00, 1, 1350.00, 55
8, 13:07:00-000, 2959, 2805, 154, 0, 0.00, 0, 0.00, 2938
8, 13:08:00-000, 1090, 1032, 58, 12, 1349.25, 12, 1352.83, 1087
8, 13:09:00-000, 986, 970, 16, 0, 0.00, 0, 0.00, 986
8, 13:10:00-000, 311, 250, 61, 0, 0.00, 0, 0.00, 311
8, 13:11:00-000, 2547, 807, 1740, 0, 0.00, 0, 0.00, 2547
8, 13:12:00-000, 3217, 2326, 891, 3, 1348.67, 3, 1348.67, 3211
8, 13:13:00-000, 2563, 1634, 929, 1, 1350.00, 1, 1349.00, 2561
8, 13:15:00-000, 2459, 1235, 1224, 0, 0.00, 0, 0.00, 2459
8, 13:18:00-000, 78, 74, 4, 4, 1354.00, 4, 1350.00, 70
8, 13:19:00-000, 125, 73, 52, 0, 0.00, 0, 0.00, 125
8, 13:20:00-000, 1652, 545, 1107, 3, 1352.00, 3, 1350.00, 1646
8, 13:21:00-000, 176, 151, 25, 0, 0.00, 0, 0.00, 176
8, 13:22:00-000, 2756, 1986, 770, 43, 1348.30, 16, 1351.00, 2697
8, 13:23:00-000, 1024, 103, 921, 0, 0.00, 27, 1345.00, 997
8, 13:24:00-000, 95, 31, 64, 11, 1348.27, 11, 1349.55, 73
8, 13:25:00-000, 1033, 13, 1020, 8, 1353.00, 8, 1353.00, 1017
8, 13:26:00-000, 296, 142, 154, 0, 0.00, 1, 1351.00, 295
8, 13:27:00-000, 455, 128, 327, 1, 1351.00, 0, 0.00, 454
8, 13:28:00-000, 771, 745, 26, 0, 0.00, 0, 0.00, 771
8, 13:29:00-000, 868, 70, 798, 0, 0.00, 0, 0.00, 868
8, 13:30:00-000, 241, 133, 108, 0, 0.00, 0, 0.00, 241
8, 13:32:00-000, 395, 281, 114, 0, 0.00, 0, 0.00, 395
8, 13:34:00-000, 660, 660, 0, 0, 0.00, 0, 0.00, 660
8, 13:35:00-000, 1764, 804, 960, 0, 0.00, 0, 0.00, 1764
8, 13:36:00-000, 1044, 14, 1030, 0, 0.00, 0, 0.00, 739
8, 13:37:00-000, 1172, 107, 1065, 0, 0.00, 0, 0.00, 1477
8, 13:39:00-000, 193, 154, 39, 0, 0.00, 0, 0.00, 193
8, 13:41:00-000, 3100, 1477, 1623, 10, 1348.00, 10, 1347.70, 3080
8, 13:42:00-000, 966, 18, 948, 8, 1349.00, 8, 1345.00, 950
8, 13:43:00-000, 1596, 1486, 110, 1, 1349.00, 1, 1349.00, 1594
8, 13:44:00-000, 58, 54, 4, 4, 1356.00, 4, 1352.00, 50
8, 13:45:00-000, 95, 5, 90, 0, 0.00, 0, 0.00, 95
8, 13:46:00-000, 346, 187, 159, 7, 1349.71, 7, 1353.00, 332
8, 13:47:00-000, 1691, 674, 1017, 0, 0.00, 0, 0.00, 1691
8, 13:48:00-000, 3057, 1515, 1542, 0, 0.00, 0, 0.00, 3057
8, 13:49:00-000, 679, 58, 621, 0, 0.00, 0, 0.00, 679
8, 13:50:00-000, 4149, 1073, 3076, 0, 0.00, 0, 0.00, 4140
8, 13:51:00-000, 4934, 2616, 2318, 1, 1348.00, 1, 1348.00, 4941
8, 13:52:00-000, 4908, 1133, 3775, 5, 1353.40, 5, 1353.00, 4898
8, 13:53:00-000, 3287, 1736, 1551, 0, 0.00, 0, 0.00, 3287
8, 13:54:00-000, 892, 701, 191, 5, 1348.00, 0, 0.00, 887
8, 13:55:00-000, 855, 9, 846, 1, 1349.00, 6, 1346.50, 848
8, 13:56:00-000, 2421, 75, 2346, 8, 1351.25, 8, 1351.25, 2405
8, 13:57:00-000, 1514, 675, 839, 0, 0.00, 0, 0.00, 1514
8, 13:58:00-000, 369, 96, 273, 6, 1348.50, 6, 1352.50, 357
8, 13:59:00-000, 891, 785, 106, 0, 0.00, 0, 0.00, 891
8, 14:00:00-000, 266, 141, 125, 20, 1355.35, 20, 1350.00, 226
8, 14:01:00-000, 1538, 907, 631, 3, 1351.00, 2, 1351.50, 1533
8, 14:02:00-000, 1, 0, 1, 0, 0.00, 1, 1349.00, 0
8, 14:03:00-000, 851, 30, 821, 0, 0.00, 0, 0.00, 830
8, 14:04:00-000, 121, 28, 93, 8, 1349.25, 8, 1349.88, 126
8, 14:06:00-000, 1122, 896, 226, 17, 1347.00, 17, 1344.76, 1088
8, 14:08:00-000, 1532, 21, 1511, 0, 0.00, 0, 0.00, 1532
8, 14:09:00-000, 705, 5, 700, 5, 1345.80, 5, 1353.00, 695
8, 14:10:00-000, 36, 30, 6, 0, 0.00, 0, 0.00, 36
8, 14:11:00-000, 874, 718, 156, 0, 0.00, 0, 0.00, 874
8, 14:12:00-000, 1117, 16, 1101, 0, 0.00, 0, 0.00, 1117
8, 14:13:00-000, 1938, 1838, 100, 3, 1349.00, 3, 1349.67, 1932
8, 14:14:00-000, 840, 119, 721, 11, 1352.36, 11, 1350.64, 818
8, 14:15:00-000, 104, 100, 4, 0, 0.00, 0, 0.00, 104
8, 14:16:00-000, 24, 20, 4, 0, 0.00, 0, 0.00, 24
8, 14:17:00-000, 1075, 15, 1060, 5, 1350.00, 5, 1352.00, 1065
8, 14:18:00-000, 84, 4, 80, 0, 0.00, 0, 0.00, 84
8, 14:19:00-000, 395, 386, 9, 1, 1350.00, 1, 1350.00, 393
8, 14:21:00-000, 460, 304, 156, 0, 0.00, 0, 0.00, 460
8, 14:22:00-000, 949, 921, 28, 1, 1355.00, 1, 1351.00, 947
8, 14:23:00-000, 127, 59, 68, 0, 0.00, 0, 0.00, 127
8, 14:24:00-000, 2100, 1963, 137, 14, 1348.43, 14, 1350.78, 2072
8, 14:26:00-000, 1857, 79, 1778, 1, 1353.00, 1, 1347.00, 1855
8, 14:27:00-000, 2523, 1056, 1467, 0, 0.00, 0, 0.00, 2523
8, 14:28:00-000, 69, 60, 9, 0, 0.00, 0, 0.00, 69
8, 14:29:00-000, 1618, 6, 1612, 2, 1349.00, 2, 1351.00, 1614
8, 14:30:00-000, 3307, 918, 2389, 16, 1349.00, 16, 1348.75, 3275
8, 14:31:00-000, 984, 960, 24, 0, 0.00, 0, 0.00, 984
8, 14:32:00-000, 791, 689, 102, 12, 1351.50, 12, 1350.75, 767
8, 14:36:00-000, 2244, 2135, 109, 15, 1347.40, 15, 1349.80, 2214
8, 14:37:00-000, 956, 776, 180, 0, 0.00, 0, 0.00, 956
8, 14:38:00-000, 294, 98, 196, 15, 1346.93, 13, 1349.92, 266
8, 14:39:00-000, 12, 5, 7, 5, 1350.00, 7, 1345.29, 0
8, 14:40:00-000, 1702, 1549, 153, 22, 1346.86, 25, 1347.08, 1655
8, 14:41:00-000, 1341, 109, 1232, 6, 1350.33, 3, 1350.00, 1332
8, 14:44:00-000, 331, 321, 10, 1, 1351.00, 1, 1351.00, 329
8, 14:45:00-000, 3574, 1944, 1630, 17, 1348.65, 17, 1350.76, 3540
8, 14:46:00-000, 286, 209, 77, 0, 0.00, 0, 0.00, 286
8, 14:47:00-000, 2307, 1923, 384, 0, 0.00, 0, 0.00, 2305
8, 14:48:00-000, 739, 81, 658, 8, 1347.25, 8, 1351.63, 725
8, 14:49:00-000, 1376, 46, 1330, 25, 1355.48, 25, 1352.00, 1326
8, 14:52:00-000, 692, 16, 676, 16, 1347.81, 10, 1346.60, 666
8, 14:53:00-000, 119, 106, 13, 6, 1355.00, 12, 1348.00, 101
8, 14:54:00-000, 42, 2, 40, 0, 0.00, 0, 0.00, 42
8, 14:55:00-000, 99, 90, 9, 9, 1347.00, 9, 1350.00, 81
8, 14:57:00-000, 92, 70, 22, 0, 0.00, 0, 0.00, 92
8, 14:59:00-000, 126, 15, 111, 1, 1350.00, 1, 1348.00, 124
8, 15:01:00-000, 1468, 1464, 4, 4, 1352.00, 4, 1351.00, 1460
8, 15:02:00-000, 74, 7, 67, 7, 1348.29, 7, 1349.57, 60
8, 15:03:00-000, 1958, 1843, 115, 5, 1354.40, 5, 1351.00, 1948
8, 15:04:00-000, 608, 81, 527, 0, 0.00, 0, 0.00, 608
8, 15:06:00-000, 99, 90, 9, 0, 0.00, 0, 0.00, 99
8, 15:07:00-000, 4791, 1715, 3076, 0, 0.00, 0, 0.00, 4791
8, 15:08:00-000, 3218, 1617, 1601, 12, 1350.58, 12, 1350.00, 3194
8, 15:09:00-000, 118, 24, 94, 0, 0.00, 0, 0.00, 118
8, 15:10:00-000, 1296, 25, 1271, 1, 1349.00, 1, 1344.00, 1294
8, 15:11:00-000, 1124, 1040, 84, 8, 1346.50, 8, 1351.00, 1108
8, 15:12:00-000, 2061, 398, 1663, 0, 0.00, 0, 0.00, 2061
8, 15:13:00-000, 913, 830, 83, 0, 0.00, 0, 0.00, 913
8, 15:14:00-000, 1954, 1816, 138, 6, 1347.50, 10, 1348.80, 1857
8, 15:15:00-000, 168, 159, 9, 9, 1352.33, 5, 1351.00, 235
8, 15:16:00-000, 100, 0, 100, 0, 0.00, 0, 0.00, 100
8, 15:18:00-000, 1765, 105, 1660, 0, 0.00, 4, 1350.00, 1761
8, 15:19:00-000, 285, 187, 98, 10, 1351.50, 6, 1351.67, 269
8, 15:20:00-000, 929, 9, 920, 0, 0.00, 0, 0.00, 929
8, 15:21:00-000, 54, 4, 50, 0, 0.00, 0, 0.00, 54
8, 15:22:00-000, 314, 181, 133, 0, 0.00, 3, 1353.00, 311
8, 15:23:00-000, 107, 103, 4, 3, 1353.00, 0, 0.00, 104
8, 15:24:00-000, 1299, 208, 1091, 0, 0.00, 0, 0.00, 1299
8, 15:25:00-000, 84, 2, 82, 2, 1347.00, 2, 1352.00, 80
8, 15:26:00-000, 2241, 14, 2227, 7, 1347.57, 7, 1351.86, 2227
8, 15:27:00-000, 443, 194, 249, 1, 1352.00, 1, 1350.00, 441
8, 15:28:00-000, 98, 92, 6, 2, 1352.00, 2, 1352.00, 94
8, 15:29:00-000, 538, 323, 215, 4, 1354.00, 4, 1352.00, 530
8, 15:30:00-000, 275, 177, 98, 3, 1349.33, 9, 1351.00, 263
8, 15:31:00-000, 1605, 1586, 19, 6, 1352.00, 0, 0.00, 1599
8, 15:32:00-000, 1126, 90, 1036, 0, 0.00, 0, 0.00, 1126
8, 15:33:00-000, 1846, 267, 1579, 0, 0.00, 0, 0.00, 1846
8, 15:34:00-000, 154, 18, 136, 9, 1348.00, 9, 1349.33, 136
8, 15:36:00-000, 3631, 360, 3271, 2, 1349.00, 2, 1345.00, 3627
8, 15:37:00-000, 2175, 317, 1858, 6, 1350.17, 6, 1352.33, 2163
8, 15:38:00-000, 3800, 1098, 2702, 0, 0.00, 0, 0.00, 3800
8, 15:39:00-000, 1577, 839, 738, 1, 1348.00, 1, 1348.00, 1575
8, 15:41:00-000, 95, 90, 5, 0, 0.00, 0, 0.00, 95
8, 15:45:00-000, 21, 1, 20, 0, 0.00, 0, 0.00, 21
8, 15:46:00-000, 1631, 1605, 26, 5, 1353.00, 5, 1352.00, 1621
8, 15:47:00-000, 49, 7, 42, 7, 1349.00, 7, 1350.00, 35
8, 15:50:00-000, 114, 17, 97, 10, 1349.00, 10, 1350.10, 94
8, 15:51:00-000, 100, 0, 100, 0, 0.00, 0, 0.00, 100
8, 15:53:00-000, 1685, 78, 1607, 0, 0.00, 0, 0.00, 1685
8, 15:54:00-000, 42, 21, 21, 0, 0.00, 0, 0.00, 42
8, 15:55:00-000, 93, 3, 90, 0, 0.00, 0, 0.00, 93
8, 15:58:00-000, 1558, 8, 1550, 0, 0.00, 0, 0.00, 1558
8, 16:01:00-000, 22, 21, 1, 1, 1351.00, 1, 1351.00, 20
8, 16:08:00-000, 1169, 94, 1075, 10, 1350.80, 4, 1351.00, 1155
8, 16:09:00-000, 1138, 1115, 23, 3, 1347.00, 9, 1347.33, 1126
8, 16:10:00-000, 72, 50, 22, 5, 1346.00, 5, 1344.00, 62
8, 16:11:00-000, 62, 2, 60, 0, 0.00, 0, 0.00, 62
8, 16:12:00-000, 4077, 176, 3901, 0, 0.00, 0, 0.00, 4077
8, 16:13:00-000, 1079, 855, 224, 2, 1352.00, 2, 1352.00, 1075
8, 16:16:00-000, 1582, 1581, 1, 1, 1351.00, 1, 1351.00, 1580
8, 16:18:00-000, 634, 14, 620, 0, 0.00, 0, 0.00, 627
8, 16:19:00-000, 2617, 1052, 1565, 5, 1350.40, 5, 1350.00, 2614
8, 16:20:00-000, 3508, 2645, 863, 2, 1351.00, 2, 1348.50, 3504
8, 16:21:00-000, 355, 125, 230, 6, 1352.00, 6, 1350.17, 343
8, 16:22:00-000, 425, 112, 313, 0, 0.00, 0, 0.00, 425
8, 16:23:00-000, 178, 151, 27, 0, 0.00, 0, 0.00, 178
8, 16:25:00-000, 754, 4, 750, 0, 0.00, 0, 0.00, 754
8, 16:26:00-000, 1031, 768, 263, 0, 0.00, 0, 0.00, 1031
8, 16:28:00-000, 1142, 709, 433, 14, 1349.00, 14, 1348.14, 1114
8, 16:29:00-000, 192, 170, 22, 20, 1354.50, 20, 1352.00, 152
9, 09:06:00-000, 3020, 1840, 1180, 0, 0.00, 0, 0.00, 3020
9, 09:07:00-000, 10440, 7830, 2610, 0, 0.00, 0, 0.00, 10440
9, 09:41:00-000, 5740, 3380, 2360, 0, 0.00, 0, 0.00, 5740
9, 09:42:00-000, 9810, 4550, 5260, 0, 0.00, 0, 0.00, 9810
9, 09:43:00-000, 3390, 3390, 0, 0, 0.00, 0, 0.00, 3390
9, 09:44:00-000, 10820, 5080, 5740, 0, 0.00, 0, 0.00, 10820
9, 09:45:00-000, 1264, 64, 1200, 33, 1354.33, 33, 1352.00, 1198
9, 09:47:00-000, 1330, 1330, 0, 0, 0.00, 0, 0.00, 1330
9, 09:48:00-000, 4730, 1830, 2900, 0, 0.00, 0, 0.00, 4730
9, 09:49:00-000, 3067, 1177, 1890, 24, 1351.67, 40, 1352.00, 3003
9, 09:50:00-000, 1906, 876, 1030, 16, 1355.37, 0, 0.00, 860
9, 09:51:00-000, 940, 0, 940, 0, 0.00, 0, 0.00, 1970
9, 09:52:00-000, 1269, 59, 1210, 59, 1353.71, 59, 1352.00, 1151
9, 09:54:00-000, 867, 90, 777, 22, 1346.91, 22, 1348.41, 823
9, 09:56:00-000, 4840, 3010, 1830, 0, 0.00, 0, 0.00, 3420
9, 09:57:00-000, 6060, 6060, 0, 0, 0.00, 0, 0.00, 7480
9, 09:59:00-000, 2480, 0, 2480, 0, 0.00, 0, 0.00, 2480
9, 10:00:00-000, 4782, 2402, 2380, 52, 1354.03, 52, 1352.00, 4678
9, 10:01:00-000, 2850, 1800, 1050, 10, 1348.00, 10, 1348.00, 2830
9, 10:02:00-000, 1258, 28, 1230, 5, 1350.00, 28, 1352.00, 1225
9, 10:03:00-000, 26, 26, 0, 23, 1354.08, 0, 0.00, 3
9, 10:06:00-000, 1290, 0, 1290, 0, 0.00, 0, 0.00, 1290
9, 10:07:00-000, 3220, 820, 2400, 0, 0.00, 0, 0.00, 3220
9, 10:10:00-000, 2540, 1140, 1400, 0, 0.00, 0, 0.00, 2540
9, 10:11:00-000, 2780, 1250, 1530, 0, 0.00, 0, 0.00, 2780
9, 10:12:00-000, 2986, 2040, 946, 6, 1348.00, 6, 1348.83, 2974
9, 10:13:00-000, 4820, 3050, 1770, 0, 0.00, 0, 0.00, 4820
9, 10:14:00-000, 2342, 42, 2300, 42, 1351.90, 42, 1353.00, 2258
9, 10:15:00-000, 950, 0, 950, 0, 0.00, 0, 0.00, 0
9, 10:16:00-000, 1020, 260, 760, 75, 1354.71, 75, 1351.00, 1820
9, 10:17:00-000, 2730, 1370, 1360, 0, 0.00, 0, 0.00, 2730
9, 10:18:00-000, 5926, 3546, 2380, 6, 1353.67, 6, 1353.00, 5914
9, 10:19:00-000, 4090, 1370, 2720, 0, 0.00, 0, 0.00, 4090
9, 10:20:00-000, 1580, 850, 730, 0, 0.00, 0, 0.00, 1580
9, 10:21:00-000, 5780, 1690, 4090, 0, 0.00, 0, 0.00, 5780
9, 10:22:00-000, 4000, 0, 4000, 0, 0.00, 5, 1351.00, 3995
9, 10:23:00-000, 5855, 3845, 2010, 5, 1351.20, 0, 0.00, 5850
9, 10:28:00-000, 4260, 3080, 1180, 0, 0.00, 0, 0.00, 4260
9, 10:29:00-000, 7080, 4670, 2410, 0, 0.00, 0, 0.00, 7080
9, 10:30:00-000, 1540, 710, 830, 0, 0.00, 0, 0.00, 1540
9, 10:31:00-000, 14460, 5130, 9330, 0, 0.00, 0, 0.00, 14460
9, 10:33:00-000, 4100, 2050, 2050, 0, 0.00, 0, 0.00, 4100
9, 10:34:00-000, 4360, 1730, 2630, 0, 0.00, 0, 0.00, 4360
9, 10:37:00-000, 1260, 1260, 0, 0, 0.00, 0, 0.00, 1260
9, 10:39:00-000, 5860, 4910, 950, 0, 0.00, 0, 0.00, 5860
9, 10:40:00-000, 5850, 4630, 1220, 23, 1347.00, 23, 1346.74, 5804
9, 10:41:00-000, 7558, 3338, 4220, 8, 1355.00, 8, 1353.00, 7542
9, 10:43:00-000, 3870, 0, 3870, 0, 0.00, 0, 0.00, 3870
9, 10:45:00-000, 5610, 830, 4780, 0, 0.00, 0, 0.00, 5610
9, 10:49:00-000, 821, 11, 810, 11, 1357.00, 11, 1352.00, 799
9, 10:51:00-000, 6530, 3890, 2640, 0, 0.00, 0, 0.00, 6530
9, 10:53:00-000, 926, 16, 910, 16, 1354.37, 16, 1353.00, 894
9, 10:55:00-000, 1760, 900, 860, 0, 0.00, 0, 0.00, 1760
9, 10:56:00-000, 1010, 1010, 0, 0, 0.00, 0, 0.00, 1010
9, 10:57:00-000, 3620, 1260, 2360, 0, 0.00, 0, 0.00, 3620
9, 10:58:00-000, 2546, 2470, 76, 29, 1348.00, 29, 1347.24, 2128
9, 10:59:00-000, 2810, 780, 2030, 0, 0.00, 0, 0.00, 3170
9, 11:00:00-000, 4640, 3120, 1520, 0, 0.00, 0, 0.00, 4640
9, 11:01:00-000, 5470, 2880, 2590, 0, 0.00, 0, 0.00, 5470
9, 11:02:00-000, 6370, 4880, 1490, 0, 0.00, 0, 0.00, 6370
9, 11:05:00-000, 2070, 1090, 980, 0, 0.00, 0, 0.00, 2070
9, 11:06:00-000, 6150, 3360, 2790, 0, 0.00, 0, 0.00, 6150
9, 11:08:00-000, 5250, 2650, 2600, 0, 0.00, 0, 0.00, 5250
9, 11:14:00-000, 910, 0, 910, 0, 0.00, 0, 0.00, 910
9, 11:15:00-000, 2990, 0, 2990, 0, 0.00, 0, 0.00, 2990
9, 11:19:00-000, 990, 0, 990, 0, 0.00, 0, 0.00, 990
9, 11:21:00-000, 4600, 2310, 2290, 0, 0.00, 0, 0.00, 4600
9, 11:22:00-000, 2301, 1, 2300, 1, 1353.00, 1, 1351.00, 2299
9, 11:23:00-000, 5830, 2490, 3340, 0, 0.00, 0, 0.00, 5830
9, 11:24:00-000, 6743, 4083, 2660, 23, 1351.48, 23, 1353.00, 6697
9, 11:25:00-000, 2200, 1130, 1070, 0, 0.00, 0, 0.00, 2200
9, 11:26:00-000, 6081, 4650, 1431, 1, 1348.00, 1, 1354.00, 6079
9, 11:28:00-000, 2800, 2010, 790, 0, 0.00, 0, 0.00, 2800
9, 11:30:00-000, 7100, 3740, 3360, 0, 0.00, 0, 0.00, 7100
9, 11:32:00-000, 6210, 4830, 1380, 0, 0.00, 0, 0.00, 5780
9, 11:33:00-000, 1220, 1220, 0, 0, 0.00, 0, 0.00, 1650
9, 11:34:00-000, 5400, 1460, 3940, 0, 0.00, 0, 0.00, 5400
9, 11:36:00-000, 13762, 5392, 8370, 36, 1352.77, 36, 1352.00, 12220
9, 11:37:00-000, 2180, 790, 1390, 0, 0.00, 0, 0.00, 3650
9, 11:38:00-000, 5780, 1480, 4300, 0, 0.00, 0, 0.00, 5780
9, 11:39:00-000, 5360, 1170, 4190, 0, 0.00, 0, 0.00, 5360
9, 11:40:00-000, 3822, 1251, 2571, 2, 1348.50, 2, 1350.00, 3818
9, 11:41:00-000, 7090, 3240, 3850, 0, 0.00, 0, 0.00, 7090
9, 11:42:00-000, 2699, 39, 2660, 29, 1354.93, 29, 1352.00, 2641
9, 11:45:00-000, 2390, 0, 2390, 0, 0.00, 0, 0.00, 2390
9, 11:46:00-000, 5074, 674, 4400, 5, 1351.00, 34, 1352.00, 5035
9, 11:47:00-000, 781, 781, 0, 29, 1354.86, 0, 0.00, 752
9, 11:49:00-000, 4849, 1209, 3640, 43, 1352.00, 79, 1352.04, 4727
9, 11:50:00-000, 36, 36, 0, 36, 1356.17, 0, 0.00, 0
9, 11:53:00-000, 11375, 5575, 5800, 5, 1350.00, 5, 1352.00, 11365
9, 11:54:00-000, 931, 900, 31, 12, 1348.00, 12, 1346.75, 907
9, 11:55:00-000, 9540, 2670, 6870, 0, 0.00, 0, 0.00, 9540
9, 11:56:00-000, 9939, 2049, 7890, 7, 1355.00, 7, 1351.00, 8935
9, 11:57:00-000, 5274, 3000, 2274, 3, 1349.00, 3, 1346.33, 6258
9, 11:58:00-000, 1320, 1320, 0, 0, 0.00, 0, 0.00, 1320
9, 11:59:00-000, 960, 960, 0, 0, 0.00, 0, 0.00, 960
9, 12:00:00-000, 2063, 770, 1293, 3, 1345.00, 3, 1347.33, 2057
9, 12:01:00-000, 9764, 7240, 2524, 29, 1348.00, 29, 1346.72, 9706
9, 12:02:00-000, 3580, 2460, 1120, 0, 0.00, 0, 0.00, 3580
9, 12:03:00-000, 7690, 6480, 1210, 0, 0.00, 0, 0.00, 7690
9, 12:04:00-000, 4000, 2660, 1340, 0, 0.00, 0, 0.00, 4000
9, 12:05:00-000, 1153, 3, 1150, 3, 1350.00, 3, 1350.00, 1147
9, 12:07:00-000, 1960, 1110, 850, 0, 0.00, 0, 0.00, 1960
9, 12:08:00-000, 5102, 2302, 2800, 15, 1353.07, 15, 1352.00, 5072
9, 12:09:00-000, 1560, 1560, 0, 0, 0.00, 0, 0.00, 1560
9, 12:10:00-000, 9377, 7420, 1957, 17, 1347.71, 17, 1346.88, 9343
9, 12:11:00-000, 6460, 1340, 5120, 0, 0.00, 0, 0.00, 6460
9, 12:12:00-000, 3353, 43, 3310, 24, 1355.58, 24, 1353.92, 3305
9, 12:13:00-000, 6682, 4470, 2212, 33, 1349.39, 33, 1347.30, 5366
9, 12:14:00-000, 1340, 0, 1340, 0, 0.00, 0, 0.00, 2590
9, 12:15:00-000, 5870, 4530, 1340, 0, 0.00, 0, 0.00, 5870
9, 12:16:00-000, 1971, 781, 1190, 1, 1350.00, 1, 1350.00, 1969
9, 12:17:00-000, 5390, 4530, 860, 0, 0.00, 0, 0.00, 5390
9, 12:18:00-000, 2280, 1530, 750, 0, 0.00, 0, 0.00, 2280
9, 12:19:00-000, 2340, 1220, 1120, 0, 0.00, 0, 0.00, 2340
9, 12:22:00-000, 1194, 4, 1190, 4, 1353.00, 4, 1352.00, 1186
9, 12:24:00-000, 969, 9, 960, 9, 1351.00, 9, 1351.00, 951
9, 12:26:00-000, 1057, 7, 1050, 7, 1351.00, 7, 1352.00, 1043
9, 12:29:00-000, 1200, 0, 1200, 0, 0.00, 0, 0.00, 1200
9, 12:31:00-000, 1250, 0, 1250, 0, 0.00, 0, 0.00, 1250
9, 12:32:00-000, 1211, 21, 1190, 11, 1351.36, 11, 1351.00, 1189
9, 12:33:00-000, 1465, 5, 1460, 5, 1353.80, 5, 1353.00, 1455
9, 12:36:00-000, 2550, 1810, 740, 0, 0.00, 0, 0.00, 2550
9, 12:37:00-000, 1330, 0, 1330, 0, 0.00, 0, 0.00, 1330
9, 12:38:00-000, 5593, 3500, 2093, 3, 1348.00, 3, 1349.33, 5587
9, 12:40:00-000, 2870, 1700, 1170, 0, 0.00, 0, 0.00, 2870
9, 12:41:00-000, 4650, 3730, 920, 0, 0.00, 0, 0.00, 4650
9, 12:42:00-000, 1971, 951, 1020, 5, 1350.00, 11, 1352.00, 1955
9, 12:43:00-000, 6, 6, 0, 6, 1351.00, 0, 0.00, 0
9, 12:45:00-000, 1810, 820, 990, 0, 0.00, 0, 0.00, 1810
9, 12:48:00-000, 4422, 1442, 2980, 2, 1352.00, 2, 1352.00, 4418
9, 12:49:00-000, 4790, 2160, 2630, 0, 0.00, 0, 0.00, 4790
9, 12:50:00-000, 7580, 3900, 3680, 0, 0.00, 0, 0.00, 7580
9, 12:51:00-000, 3510, 1500, 2010, 0, 0.00, 0, 0.00, 3510
9, 12:53:00-000, 1860, 770, 1090, 0, 0.00, 0, 0.00, 1860
9, 12:54:00-000, 1301, 11, 1290, 11, 1354.00, 11, 1352.00, 1279
9, 12:57:00-000, 3367, 1147, 2220, 56, 1356.08, 56, 1352.00, 3255
9, 12:59:00-000, 5500, 4590, 910, 0, 0.00, 0, 0.00, 5500
9, 13:00:00-000, 3840, 2790, 1050, 39, 1346.02, 39, 1345.35, 3762
9, 13:01:00-000, 5979, 799, 5180, 29, 1351.79, 29, 1352.00, 5921
9, 13:02:00-000, 3120, 2230, 890, 0, 0.00, 0, 0.00, 3120
9, 13:05:00-000, 2640, 1250, 1390, 0, 0.00, 0, 0.00, 2640
9, 13:06:00-000, 3840, 3840, 0, 0, 0.00, 0, 0.00, 3840
9, 13:07:00-000, 2680, 820, 1860, 0, 0.00, 0, 0.00, 2680
9, 13:08:00-000, 1510, 1510, 0, 0, 0.00, 0, 0.00, 1510
9, 13:09:00-000, 9218, 3341, 5877, 42, 1349.52, 42, 1349.59, 9134
9, 13:10:00-000, 790, 0, 790, 0, 0.00, 0, 0.00, 790
9, 13:11:00-000, 7140, 3380, 3760, 0, 0.00, 0, 0.00, 7140
9, 13:12:00-000, 7180, 1130, 6050, 0, 0.00, 0, 0.00, 7180
9, 13:13:00-000, 5560, 2920, 2640, 0, 0.00, 0, 0.00, 5560
9, 13:14:00-000, 6510, 980, 5530, 0, 0.00, 0, 0.00, 6510
9, 13:15:00-000, 4690, 1140, 3550, 0, 0.00, 0, 0.00, 4690
9, 13:16:00-000, 1550, 1550, 0, 0, 0.00, 0, 0.00, 1550
9, 13:18:00-000, 827, 820, 7, 7, 1348.00, 7, 1350.00, 813
9, 13:19:00-000, 9050, 3710, 5340, 0, 0.00, 0, 0.00, 9050
9, 13:20:00-000, 1190, 1190, 0, 0, 0.00, 0, 0.00, 1190
9, 13:21:00-000, 6490, 3450, 3040, 0, 0.00, 0, 0.00, 6490
9, 13:22:00-000, 8930, 1160, 7770, 0, 0.00, 0, 0.00, 8930
9, 13:23:00-000, 10010, 5190, 4820, 0, 0.00, 0, 0.00, 10010
9, 13:24:00-000, 7250, 2240, 5010, 0, 0.00, 0, 0.00, 7250
9, 13:25:00-000, 5930, 4840, 1090, 0, 0.00, 0, 0.00, 5180
9, 13:26:00-000, 2330, 2330, 0, 0, 0.00, 0, 0.00, 3080
9, 13:27:00-000, 2200, 0, 2200, 0, 0.00, 0, 0.00, 2200
9, 13:28:00-000, 7403, 4647, 2756, 13, 1348.15, 13, 1350.38, 7377
9, 13:29:00-000, 3040, 3040, 0, 0, 0.00, 0, 0.00, 3040
9, 13:30:00-000, 10800, 3490, 7310, 0, 0.00, 0, 0.00, 10800
9, 13:31:00-000, 1780, 1060, 720, 0, 0.00, 0, 0.00, 1780
9, 13:32:00-000, 3335, 2160, 1175, 26, 1348.00, 26, 1348.92, 3283
9, 13:33:00-000, 2430, 0, 2430, 0, 0.00, 0, 0.00, 2430
9, 13:34:00-000, 960, 960, 0, 0, 0.00, 0, 0.00, 960
9, 13:35:00-000, 2400, 0, 2400, 0, 0.00, 0, 0.00, 2400
9, 13:36:00-000, 2350, 1400, 950, 0, 0.00, 0, 0.00, 2350
9, 13:37:00-000, 1590, 1590, 0, 0, 0.00, 0, 0.00, 1590
9, 13:39:00-000, 8360, 4120, 4240, 0, 0.00, 0, 0.00, 8360
9, 13:41:00-000, 6666, 2136, 4530, 29, 1352.31, 29, 1351.00, 6608
9, 13:42:00-000, 7815, 3975, 3840, 5, 1350.40, 5, 1351.00, 7805
9, 13:43:00-000, 6470, 5290, 1180, 0, 0.00, 0, 0.00, 6470
9, 13:44:00-000, 725, 15, 710, 15, 1356.00, 15, 1351.00, 695
9, 13:45:00-000, 1910, 1910, 0, 0, 0.00, 0, 0.00, 1910
9, 13:46:00-000, 4660, 1310, 3350, 0, 0.00, 1, 1351.00, 4659
9, 13:47:00-000, 6261, 3281, 2980, 1, 1351.00, 0, 0.00, 6260
9, 13:48:00-000, 4215, 2910, 1305, 5, 1348.00, 5, 1348.20, 4205
9, 13:49:00-000, 6970, 2810, 4160, 0, 0.00, 0, 0.00, 6970
9, 13:50:00-000, 7805, 4470, 3335, 5, 1349.00, 5, 1347.60, 7795
9, 13:51:00-000, 5750, 0, 5750, 0, 0.00, 0, 0.00, 5750
9, 13:52:00-000, 6628, 891, 5737, 16, 1346.06, 16, 1349.31, 6596
9, 13:53:00-000, 2620, 1190, 1430, 0, 0.00, 0, 0.00, 2620
9, 13:54:00-000, 3505, 1230, 2275, 5, 1346.00, 5, 1348.00, 3495
9, 13:55:00-000, 2540, 1100, 1440, 0, 0.00, 0, 0.00, 2540
9, 13:56:00-000, 1170, 1170, 0, 0, 0.00, 0, 0.00, 1170
9, 13:57:00-000, 4113, 1900, 2213, 3, 1347.00, 3, 1347.33, 4107
9, 13:58:00-000, 10265, 6620, 3645, 15, 1345.00, 15, 1347.20, 8765
9, 13:59:00-000, 3080, 2020, 1060, 0, 0.00, 0, 0.00, 4550
9, 14:00:00-000, 2390, 990, 1400, 0, 0.00, 0, 0.00, 2390
9, 14:01:00-000, 5300, 0, 5300, 0, 0.00, 0, 0.00, 5300
9, 14:03:00-000, 4185, 3080, 1105, 17, 1348.00, 17, 1346.76, 4151
9, 14:06:00-000, 4052, 3310, 742, 2, 1347.00, 2, 1348.00, 4048
9, 14:10:00-000, 3460, 1320, 2140, 0, 0.00, 0, 0.00, 3460
9, 14:11:00-000, 6800, 2610, 4190, 0, 0.00, 3, 1352.00, 6797
9, 14:12:00-000, 5187, 3493, 1694, 43, 1348.35, 40, 1345.47, 5104
9, 14:13:00-000, 10624, 4984, 5640, 4, 1349.75, 4, 1350.25, 10616
9, 14:14:00-000, 3628, 1190, 2438, 58, 1346.86, 1, 1350.00, 3569
9, 14:15:00-000, 534, 0, 534, 0, 0.00, 57, 1347.49, 157
9, 14:16:00-000, 88, 8, 80, 8, 1351.25, 8, 1350.00, 392
9, 14:17:00-000, 2170, 2170, 0, 0, 0.00, 0, 0.00, 2170
9, 14:18:00-000, 4164, 24, 4140, 18, 1353.28, 24, 1352.83, 4122
9, 14:19:00-000, 1237, 1236, 1, 7, 1354.14, 1, 1348.00, 1229
9, 14:21:00-000, 4639, 1105, 3534, 9, 1348.56, 9, 1351.33, 4621
9, 14:22:00-000, 830, 830, 0, 0, 0.00, 0, 0.00, 830
9, 14:23:00-000, 4360, 1780, 2580, 0, 0.00, 0, 0.00, 4360
9, 14:24:00-000, 3992, 1500, 2492, 2, 1348.00, 2, 1351.00, 3988
9, 14:26:00-000, 1930, 0, 1930, 0, 0.00, 0, 0.00, 1930
9, 14:27:00-000, 9650, 5690, 3960, 0, 0.00, 0, 0.00, 9650
9, 14:28:00-000, 5595, 4063, 1532, 54, 1350.77, 54, 1348.29, 5487
9, 14:29:00-000, 1690, 940, 750, 0, 0.00, 0, 0.00, 1690
9, 14:30:00-000, 1300, 0, 1300, 0, 0.00, 0, 0.00, 1300
9, 14:31:00-000, 2144, 1334, 810, 24, 1351.33, 24, 1353.00, 2096
9, 14:33:00-000, 1560, 1560, 0, 0, 0.00, 0, 0.00, 1560
9, 14:36:00-000, 2490, 1200, 1290, 10, 1357.00, 10, 1353.00, 2470
9, 14:37:00-000, 1440, 1440, 0, 0, 0.00, 0, 0.00, 1440
9, 14:38:00-000, 2280, 2280, 0, 0, 0.00, 0, 0.00, 2280
9, 14:39:00-000, 1550, 0, 1550, 0, 0.00, 0, 0.00, 1550
9, 14:40:00-000, 3941, 2091, 1850, 1, 1352.00, 1, 1353.00, 3939
9, 14:41:00-000, 4040, 1180, 2860, 0, 0.00, 0, 0.00, 4040
9, 14:44:00-000, 2298, 890, 1408, 18, 1349.00, 18, 1348.56, 2262
9, 14:45:00-000, 14900, 6500, 8400, 0, 0.00, 0, 0.00, 14900
9, 14:46:00-000, 7770, 6520, 1250, 0, 0.00, 0, 0.00, 7770
9, 14:47:00-000, 9750, 3580, 6170, 0, 0.00, 0, 0.00, 9750
9, 14:49:00-000, 1354, 1350, 4, 3, 1349.00, 3, 1350.67, 1348
9, 14:52:00-000, 1350, 1350, 0, 0, 0.00, 0, 0.00, 1350
9, 14:54:00-000, 1200, 0, 1200, 0, 0.00, 0, 0.00, 1200
9, 14:55:00-000, 2100, 1090, 1010, 0, 0.00, 0, 0.00, 2100
9, 14:59:00-000, 6027, 6020, 7, 7, 1347.14, 7, 1349.71, 6013
9, 15:00:00-000, 1510, 1510, 0, 0, 0.00, 0, 0.00, 1510
9, 15:02:00-000, 8034, 6578, 1456, 25, 1350.00, 25, 1349.56, 7984
9, 15:03:00-000, 2110, 810, 1300, 0, 0.00, 0, 0.00, 2110
9, 15:04:00-000, 3640, 2290, 1350, 0, 0.00, 0, 0.00, 3640
9, 15:07:00-000, 6150, 3820, 2330, 0, 0.00, 0, 0.00, 6150
9, 15:09:00-000, 3331, 1860, 1471, 11, 1348.00, 11, 1345.45, 3309
9, 15:10:00-000, 4080, 3140, 940, 0, 0.00, 0, 0.00, 4080
9, 15:11:00-000, 4840, 2510, 2330, 0, 0.00, 0, 0.00, 4840
9, 15:12:00-000, 8745, 3345, 5400, 4, 1350.00, 4, 1352.00, 8737
9, 15:13:00-000, 2620, 1870, 750, 0, 0.00, 0, 0.00, 2620
9, 15:14:00-000, 3449, 1299, 2150, 21, 1351.38, 57, 1352.00, 3371
9, 15:15:00-000, 2426, 1456, 970, 36, 1353.33, 2, 1352.00, 2388
9, 15:16:00-000, 1221, 21, 1200, 21, 1357.00, 19, 1353.00, 1181
9, 15:17:00-000, 3150, 0, 3150, 0, 0.00, 0, 0.00, 3150
9, 15:18:00-000, 7210, 2560, 4650, 0, 0.00, 0, 0.00, 7210
9, 15:19:00-000, 5340, 1950, 3390, 0, 0.00, 0, 0.00, 5340
9, 15:20:00-000, 1170, 1170, 0, 0, 0.00, 0, 0.00, 1170
9, 15:21:00-000, 4630, 810, 3820, 0, 0.00, 0, 0.00, 4630
9, 15:22:00-000, 7471, 3331, 4140, 1, 1351.00, 1, 1351.00, 6439
9, 15:23:00-000, 6600, 3710, 2890, 0, 0.00, 0, 0.00, 7630
9, 15:24:00-000, 3220, 870, 2350, 0, 0.00, 0, 0.00, 3220
9, 15:25:00-000, 1190, 0, 1190, 0, 0.00, 0, 0.00, 1190
9, 15:26:00-000, 3503, 3500, 3, 3, 1348.00, 3, 1347.00, 3497
9, 15:27:00-000, 6897, 2587, 4310, 3, 1354.00, 14, 1354.00, 6880
9, 15:28:00-000, 24, 24, 0, 11, 1352.64, 0, 0.00, 13
9, 15:29:00-000, 2850, 820, 2030, 0, 0.00, 0, 0.00, 1990
9, 15:30:00-000, 5741, 3051, 2690, 1, 1352.00, 1, 1352.00, 6599
9, 15:31:00-000, 720, 720, 0, 0, 0.00, 0, 0.00, 720
9, 15:32:00-000, 3680, 1270, 2410, 0, 0.00, 0, 0.00, 2430
9, 15:33:00-000, 9262, 2072, 7190, 2, 1355.00, 2, 1352.00, 10508
9, 15:34:00-000, 2380, 1110, 1270, 0, 0.00, 0, 0.00, 2380
9, 15:36:00-000, 7043, 4830, 2213, 42, 1351.97, 42, 1349.83, 6959
9, 15:37:00-000, 3681, 2360, 1321, 1, 1345.00, 1, 1349.00, 3679
9, 15:38:00-000, 11390, 2900, 8490, 0, 0.00, 0, 0.00, 10940
9, 15:39:00-000, 7570, 2420, 5150, 0, 0.00, 0, 0.00, 7260
9, 15:40:00-000, 230, 230, 0, 0, 0.00, 0, 0.00, 990
9, 15:41:00-000, 4230, 2720, 1510, 0, 0.00, 0, 0.00, 4230
9, 15:43:00-000, 2300, 2300, 0, 0, 0.00, 0, 0.00, 2300
9, 15:44:00-000, 2120, 1150, 970, 0, 0.00, 0, 0.00, 2120
9, 15:46:00-000, 3210, 1250, 1960, 0, 0.00, 0, 0.00, 3210
9, 15:50:00-000, 600, 600, 0, 6, 1347.00, 0, 0.00, 594
9, 15:51:00-000, 6, 0, 6, 0, 0.00, 6, 1348.83, 0
9, 15:54:00-000, 1970, 0, 1970, 0, 0.00, 0, 0.00, 1970
9, 15:57:00-000, 1170, 1170, 0, 0, 0.00, 0, 0.00, 1170
9, 15:58:00-000, 2170, 2170, 0, 0, 0.00, 0, 0.00, 2170
9, 15:59:00-000, 3360, 3360, 0, 0, 0.00, 0, 0.00, 3360
9, 16:03:00-000, 3960, 1760, 2200, 0, 0.00, 0, 0.00, 3960
9, 16:06:00-000, 950, 0, 950, 0, 0.00, 0, 0.00, 950
9, 16:07:00-000, 1430, 1430, 0, 0, 0.00, 0, 0.00, 1430
9, 16:08:00-000, 3798, 2540, 1258, 8, 1349.00, 8, 1350.00, 3782
9, 16:09:00-000, 1220, 0, 1220, 0, 0.00, 0, 0.00, 1220
9, 16:10:00-000, 1540, 0, 1540, 0, 0.00, 0, 0.00, 1540
9, 16:12:00-000, 6500, 2550, 3950, 0, 0.00, 0, 0.00, 6500
9, 16:13:00-000, 5590, 4370, 1220, 0, 0.00, 0, 0.00, 5590
9, 16:14:00-000, 2382, 2380, 2, 2, 1348.00, 2, 1350.00, 2378
9, 16:16:00-000, 5030, 2540, 2490, 0, 0.00, 0, 0.00, 5030
9, 16:17:00-000, 4074, 4, 4070, 4, 1350.00, 4, 1351.00, 4066
9, 16:18:00-000, 890, 890, 0, 0, 0.00, 0, 0.00, 890
9, 16:19:00-000, 4130, 0, 4130, 0, 0.00, 0, 0.00, 4130
9, 16:20:00-000, 12058, 7248, 4810, 8, 1351.62, 8, 1352.00, 12042
9, 16:21:00-000, 3886, 2106, 1780, 26, 1354.92, 26, 1352.00, 3834
9, 16:22:00-000, 3775, 2325, 1450, 5, 1349.00, 5, 1352.00, 3765
9, 16:23:00-000, 2420, 0, 2420, 0, 0.00, 0, 0.00, 2420
9, 16:24:00-000, 2220, 1490, 730, 0, 0.00, 0, 0.00, 2220
9, 16:25:00-000, 1930, 1930, 0, 0, 0.00, 0, 0.00, 810
9, 16:26:00-000, 5062, 1222, 3840, 2, 1355.00, 2, 1351.00, 6178
9, 16:28:00-000, 7360, 5330, 2030, 0, 0.00, 0, 0.00, 6930
9, 16:29:00-000, 7670, 1720, 5950, 0, 0.00, 0, 0.00, 8100
