TraderType,Time,EnterQty,BuyEnterQty,SellEnterQty,BuyExecutedQty,BuyExecutedPx,SellExecutedQty,SellExecutedPx,CanceledQty
1, 09:06:00-000, 3189, 3189, 0, 849, 1347.52, 0, 0.00, 0
1, 09:07:00-000, 0, 0, 0, 0, 0.00, 0, 0.00, 2333
1, 09:08:00-000, 0, 0, 0, 0, 0.00, 0, 0.00, 7
1, 09:13:00-000, 3085, 2236, 849, 1125, 1347.88, 849, 1347.34, 0
1, 09:14:00-000, 10, 5, 5, 0, 0.00, 5, 1354.00, 1111
1, 09:15:00-000, 16, 11, 5, 8, 1346.37, 5, 1349.00, 3
1, 09:16:00-000, 165, 114, 51, 25, 1348.00, 51, 1352.62, 30
1, 09:17:00-000, 179, 121, 58, 23, 1350.65, 58, 1358.97, 59
1, 09:18:00-000, 645, 398, 247, 153, 1348.94, 247, 1355.00, 129
1, 09:19:00-000, 452, 278, 174, 80, 1350.24, 171, 1362.21, 170
1, 09:20:00-000, 778, 477, 301, 272, 1350.05, 304, 1351.97, 233
1, 09:21:00-000, 314, 191, 123, 145, 1348.62, 123, 1353.31, 168
1, 09:22:00-000, 560, 412, 148, 168, 1348.81, 148, 1350.48, 120
1, 09:23:00-000, 281, 191, 90, 101, 1348.24, 90, 1350.52, 199
1, 09:24:00-000, 512, 382, 130, 168, 1348.72, 130, 1349.23, 134
1, 09:25:00-000, 303, 222, 81, 112, 1348.96, 81, 1348.14, 181
1, 09:26:00-000, 756, 573, 183, 287, 1348.37, 183, 1348.40, 152
1, 09:27:00-000, 333, 188, 145, 95, 1348.43, 145, 1348.52, 242
1, 09:28:00-000, 545, 373, 172, 214, 1348.46, 172, 1348.74, 121
1, 09:29:00-000, 356, 236, 120, 139, 1347.72, 118, 1348.54, 126
1, 09:30:00-000, 596, 371, 225, 184, 1349.77, 227, 1353.55, 120
1, 09:31:00-000, 275, 186, 89, 41, 1352.16, 89, 1367.66, 170
1, 09:32:00-000, 613, 403, 210, 251, 1348.96, 210, 1348.51, 133
1, 09:33:00-000, 335, 204, 131, 175, 1347.12, 131, 1347.53, 130
1, 09:34:00-000, 666, 433, 233, 227, 1348.77, 233, 1348.95, 121
1, 09:35:00-000, 356, 250, 106, 107, 1349.13, 106, 1348.87, 142
1, 09:36:00-000, 557, 383, 174, 209, 1349.43, 174, 1349.62, 183
1, 09:37:00-000, 382, 223, 159, 167, 1349.05, 158, 1348.90, 121
1, 09:38:00-000, 557, 351, 206, 217, 1348.23, 207, 1348.64, 124
1, 09:39:00-000, 320, 223, 97, 118, 1347.40, 97, 1347.62, 81
1, 09:40:00-000, 651, 424, 227, 257, 1348.95, 227, 1348.02, 166
1, 09:41:00-000, 251, 171, 80, 90, 1349.81, 80, 1349.46, 115
1, 09:42:00-000, 628, 398, 230, 239, 1348.12, 230, 1348.42, 109
1, 09:43:00-000, 388, 234, 154, 169, 1348.17, 154, 1347.65, 118
1, 09:44:00-000, 646, 372, 274, 237, 1347.60, 274, 1347.30, 88
1, 09:45:00-000, 308, 196, 112, 114, 1348.33, 112, 1348.12, 123
1, 09:46:00-000, 611, 384, 227, 229, 1348.50, 227, 1348.31, 110
1, 09:47:00-000, 238, 121, 117, 91, 1347.23, 117, 1347.34, 111
1, 09:48:00-000, 596, 367, 229, 221, 1348.32, 229, 1347.27, 78
1, 09:49:00-000, 282, 174, 108, 121, 1347.82, 108, 1346.46, 99
1, 09:50:00-000, 607, 344, 263, 223, 1347.62, 263, 1347.24, 89
1, 09:51:00-000, 232, 112, 120, 85, 1348.44, 120, 1347.31, 99
1, 09:52:00-000, 568, 351, 217, 276, 1346.86, 217, 1345.84, 35
1, 09:53:00-000, 395, 263, 132, 148, 1348.23, 132, 1347.84, 62
1, 09:54:00-000, 566, 339, 227, 229, 1347.78, 227, 1348.16, 140
1, 09:55:00-000, 271, 146, 125, 113, 1348.15, 125, 1347.81, 88
1, 09:56:00-000, 617, 388, 229, 265, 1347.92, 229, 1348.20, 57
1, 09:57:00-000, 348, 215, 133, 179, 1348.33, 133, 1347.26, 94
1, 09:58:00-000, 615, 406, 209, 205, 1347.37, 209, 1347.27, 90
1, 09:59:00-000, 291, 169, 122, 134, 1347.42, 122, 1347.22, 128
1, 10:00:00-000, 665, 406, 259, 269, 1348.47, 259, 1348.11, 78
1, 10:01:00-000, 270, 150, 120, 103, 1348.07, 120, 1348.18, 108
1, 10:02:00-000, 626, 345, 281, 261, 1347.15, 281, 1346.72, 46
1, 10:03:00-000, 307, 189, 118, 119, 1347.81, 118, 1347.12, 92
1, 10:04:00-000, 594, 376, 218, 237, 1347.99, 218, 1348.00, 104
1, 10:05:00-000, 388, 246, 142, 208, 1347.76, 142, 1346.53, 96
1, 10:06:00-000, 529, 284, 245, 221, 1347.87, 245, 1347.17, 76
1, 10:07:00-000, 305, 190, 115, 121, 1348.96, 115, 1347.68, 40
1, 10:08:00-000, 580, 309, 271, 223, 1347.72, 271, 1347.47, 106
1, 10:09:00-000, 305, 177, 128, 85, 1347.66, 128, 1346.44, 43
1, 10:10:00-000, 535, 310, 225, 211, 1347.67, 225, 1347.06, 97
1, 10:11:00-000, 302, 145, 157, 130, 1347.36, 157, 1346.64, 63
1, 10:12:00-000, 698, 455, 243, 296, 1348.51, 243, 1348.10, 93
1, 10:13:00-000, 298, 175, 123, 110, 1348.24, 123, 1348.08, 120
1, 10:14:00-000, 582, 343, 239, 214, 1347.76, 239, 1347.33, 94
1, 10:15:00-000, 292, 178, 114, 93, 1348.32, 114, 1347.61, 104
1, 10:16:00-000, 575, 345, 230, 229, 1348.08, 230, 1347.70, 94
1, 10:17:00-000, 315, 189, 126, 122, 1347.81, 126, 1347.49, 97
1, 10:18:00-000, 622, 357, 265, 299, 1347.63, 263, 1346.77, 54
1, 10:19:00-000, 320, 196, 124, 139, 1346.82, 126, 1346.01, 59
1, 10:20:00-000, 608, 395, 213, 303, 1347.81, 213, 1347.94, 71
1, 10:21:00-000, 300, 188, 112, 100, 1348.40, 112, 1348.12, 97
1, 10:22:00-000, 547, 303, 244, 237, 1347.54, 244, 1347.68, 69
1, 10:23:00-000, 300, 184, 116, 117, 1347.28, 116, 1347.47, 82
1, 10:24:00-000, 585, 332, 253, 227, 1348.24, 253, 1347.78, 85
1, 10:25:00-000, 327, 159, 168, 113, 1348.68, 168, 1348.62, 84
1, 10:26:00-000, 600, 349, 251, 235, 1347.38, 251, 1346.81, 77
1, 10:27:00-000, 298, 204, 94, 123, 1348.68, 94, 1348.24, 75
1, 10:28:00-000, 560, 345, 215, 188, 1347.98, 215, 1347.24, 108
1, 10:29:00-000, 322, 195, 127, 161, 1348.52, 127, 1347.79, 101
1, 10:30:00-000, 589, 367, 222, 254, 1347.94, 222, 1347.71, 76
1, 10:31:00-000, 311, 212, 99, 129, 1348.59, 99, 1348.03, 101
1, 10:32:00-000, 632, 370, 262, 245, 1348.79, 257, 1348.24, 123
1, 10:33:00-000, 351, 221, 130, 117, 1347.99, 135, 1348.02, 97
1, 10:34:00-000, 585, 321, 264, 239, 1348.73, 264, 1347.83, 108
1, 10:35:00-000, 351, 233, 118, 170, 1348.69, 118, 1347.41, 44
1, 10:36:00-000, 579, 345, 234, 173, 1349.79, 234, 1349.06, 152
1, 10:37:00-000, 331, 203, 128, 161, 1348.17, 127, 1347.96, 87
1, 10:38:00-000, 650, 365, 285, 266, 1347.75, 286, 1347.56, 63
1, 10:39:00-000, 283, 166, 117, 120, 1348.31, 117, 1346.97, 95
1, 10:40:00-000, 615, 383, 232, 226, 1348.69, 232, 1347.80, 102
1, 10:41:00-000, 343, 224, 119, 102, 1350.01, 119, 1349.19, 111
1, 10:42:00-000, 561, 350, 211, 238, 1347.71, 211, 1347.28, 130
1, 10:43:00-000, 263, 140, 123, 134, 1347.48, 123, 1346.68, 78
1, 10:44:00-000, 698, 400, 298, 284, 1347.87, 298, 1346.76, 70
1, 10:45:00-000, 279, 168, 111, 90, 1348.15, 111, 1347.49, 72
1, 10:46:00-000, 626, 393, 233, 249, 1348.71, 233, 1348.49, 96
1, 10:47:00-000, 320, 173, 147, 133, 1348.45, 141, 1348.47, 110
1, 10:48:00-000, 581, 377, 204, 235, 1348.89, 210, 1348.04, 88
1, 10:49:00-000, 285, 168, 117, 105, 1348.46, 117, 1347.78, 107
1, 10:50:00-000, 597, 340, 257, 210, 1348.46, 257, 1347.99, 94
1, 10:51:00-000, 282, 174, 108, 160, 1347.09, 106, 1346.61, 82
1, 10:52:00-000, 679, 420, 259, 249, 1347.64, 261, 1348.00, 83
1, 10:53:00-000, 309, 200, 109, 104, 1347.05, 109, 1347.07, 108
1, 10:54:00-000, 571, 366, 205, 255, 1348.46, 205, 1347.89, 120
1, 10:55:00-000, 258, 146, 112, 114, 1347.66, 112, 1347.12, 95
1, 10:56:00-000, 619, 366, 253, 227, 1347.97, 253, 1347.70, 77
1, 10:57:00-000, 317, 182, 135, 155, 1347.67, 135, 1347.48, 94
1, 10:58:00-000, 649, 345, 304, 248, 1347.60, 304, 1346.92, 70
1, 10:59:00-000, 246, 144, 102, 100, 1347.49, 102, 1347.53, 71
1, 11:00:00-000, 595, 344, 251, 239, 1347.44, 251, 1346.71, 60
1, 11:01:00-000, 316, 204, 112, 136, 1347.96, 112, 1347.20, 71
1, 11:02:00-000, 604, 367, 237, 255, 1347.92, 237, 1347.42, 101
1, 11:03:00-000, 348, 201, 147, 166, 1347.38, 147, 1346.70, 85
1, 11:04:00-000, 558, 340, 218, 238, 1348.25, 218, 1347.64, 67
1, 11:05:00-000, 333, 235, 98, 105, 1348.96, 98, 1348.29, 77
1, 11:06:00-000, 637, 390, 247, 295, 1348.16, 247, 1347.56, 147
1, 11:07:00-000, 279, 176, 103, 113, 1348.21, 103, 1347.01, 85
1, 11:08:00-000, 541, 280, 261, 191, 1347.73, 261, 1346.70, 80
1, 11:09:00-000, 328, 164, 164, 144, 1346.66, 164, 1346.86, 72
1, 11:10:00-000, 727, 435, 292, 327, 1347.84, 292, 1346.42, 45
1, 11:11:00-000, 274, 164, 110, 113, 1348.12, 110, 1347.23, 78
1, 11:12:00-000, 570, 348, 222, 251, 1347.60, 222, 1346.74, 44
1, 11:13:00-000, 304, 187, 117, 110, 1348.66, 117, 1348.76, 99
1, 11:14:00-000, 579, 342, 237, 192, 1348.19, 237, 1348.19, 93
1, 11:15:00-000, 313, 182, 131, 123, 1347.65, 131, 1347.77, 123
1, 11:16:00-000, 637, 331, 306, 277, 1347.62, 306, 1346.17, 89
1, 11:17:00-000, 252, 162, 90, 129, 1347.82, 90, 1347.28, 44
1, 11:18:00-000, 685, 397, 288, 298, 1347.65, 288, 1346.98, 63
1, 11:19:00-000, 268, 162, 106, 128, 1348.53, 106, 1347.58, 60
1, 11:20:00-000, 720, 395, 325, 274, 1348.44, 325, 1347.91, 84
1, 11:21:00-000, 271, 180, 91, 94, 1348.30, 91, 1348.19, 74
1, 11:22:00-000, 613, 358, 255, 232, 1348.46, 252, 1347.97, 110
1, 11:23:00-000, 326, 190, 136, 102, 1347.41, 139, 1347.53, 84
1, 11:24:00-000, 585, 330, 255, 235, 1347.44, 255, 1346.88, 101
1, 11:25:00-000, 266, 145, 121, 122, 1348.10, 121, 1346.11, 95
1, 11:26:00-000, 637, 351, 286, 254, 1347.75, 286, 1346.53, 45
1, 11:27:00-000, 295, 178, 117, 126, 1347.06, 117, 1346.58, 67
1, 11:28:00-000, 586, 347, 239, 239, 1347.04, 239, 1346.66, 66
1, 11:29:00-000, 263, 178, 85, 132, 1348.62, 85, 1348.28, 69
1, 11:30:00-000, 529, 310, 219, 212, 1347.63, 219, 1346.69, 87
1, 11:31:00-000, 265, 159, 106, 112, 1347.91, 106, 1348.51, 98
1, 11:32:00-000, 598, 373, 225, 225, 1348.33, 220, 1347.95, 88
1, 11:33:00-000, 351, 197, 154, 167, 1347.68, 159, 1346.72, 86
1, 11:34:00-000, 621, 360, 261, 242, 1348.18, 261, 1347.35, 69
1, 11:35:00-000, 287, 186, 101, 124, 1348.30, 101, 1347.80, 81
1, 11:36:00-000, 604, 337, 267, 242, 1347.60, 267, 1346.96, 98
1, 11:37:00-000, 262, 157, 105, 103, 1346.65, 105, 1347.08, 78
1, 11:38:00-000, 610, 387, 223, 290, 1347.82, 223, 1347.56, 76
1, 11:39:00-000, 305, 179, 126, 128, 1347.24, 126, 1347.46, 74
1, 11:40:00-000, 554, 326, 228, 259, 1347.04, 228, 1346.55, 61
1, 11:41:00-000, 378, 235, 143, 149, 1348.33, 143, 1347.57, 50
1, 11:42:00-000, 634, 352, 282, 255, 1347.43, 282, 1347.27, 79
1, 11:43:00-000, 265, 146, 119, 112, 1348.25, 119, 1348.00, 72
1, 11:44:00-000, 592, 356, 236, 287, 1347.86, 236, 1347.03, 93
1, 11:45:00-000, 272, 146, 126, 121, 1347.85, 126, 1346.25, 35
1, 11:46:00-000, 720, 409, 311, 303, 1347.19, 311, 1347.18, 68
1, 11:47:00-000, 296, 177, 119, 126, 1347.43, 119, 1346.33, 79
1, 11:48:00-000, 573, 331, 242, 238, 1348.25, 242, 1347.49, 47
1, 11:49:00-000, 329, 195, 134, 138, 1349.02, 134, 1347.96, 63
1, 11:50:00-000, 621, 352, 269, 244, 1347.49, 269, 1347.34, 119
1, 11:51:00-000, 333, 240, 93, 114, 1348.31, 93, 1348.33, 83
1, 11:52:00-000, 553, 329, 224, 223, 1348.78, 224, 1347.99, 133
1, 11:53:00-000, 326, 177, 149, 132, 1347.55, 149, 1347.85, 73
1, 11:54:00-000, 646, 387, 259, 251, 1348.95, 259, 1347.96, 83
1, 11:55:00-000, 335, 235, 100, 116, 1348.90, 100, 1349.14, 102
1, 11:56:00-000, 697, 398, 299, 278, 1348.60, 299, 1348.59, 131
1, 11:57:00-000, 291, 172, 119, 125, 1347.62, 119, 1346.79, 97
1, 11:58:00-000, 660, 365, 295, 225, 1347.28, 295, 1347.40, 79
1, 11:59:00-000, 317, 207, 110, 151, 1348.55, 110, 1347.86, 113
1, 12:00:00-000, 624, 390, 234, 221, 1348.23, 234, 1347.57, 114
1, 12:01:00-000, 308, 184, 124, 125, 1347.83, 123, 1347.62, 111
1, 12:02:00-000, 629, 371, 258, 269, 1348.48, 259, 1347.72, 97
1, 12:03:00-000, 287, 164, 123, 76, 1347.58, 123, 1346.72, 90
1, 12:04:00-000, 636, 359, 277, 266, 1348.26, 277, 1347.68, 105
1, 12:05:00-000, 244, 143, 101, 106, 1349.47, 101, 1348.29, 71
1, 12:06:00-000, 623, 351, 272, 196, 1347.75, 272, 1347.01, 50
1, 12:07:00-000, 341, 189, 152, 158, 1347.90, 152, 1346.70, 123
1, 12:08:00-000, 592, 364, 228, 230, 1348.77, 228, 1348.51, 70
1, 12:09:00-000, 300, 185, 115, 133, 1347.67, 115, 1347.03, 110
1, 12:10:00-000, 592, 364, 228, 261, 1347.80, 228, 1347.53, 82
1, 12:11:00-000, 290, 197, 93, 130, 1348.66, 93, 1348.15, 87
1, 12:12:00-000, 566, 361, 205, 226, 1348.87, 205, 1348.65, 88
1, 12:13:00-000, 326, 198, 128, 164, 1348.46, 128, 1348.38, 91
1, 12:14:00-000, 580, 309, 271, 224, 1347.56, 271, 1347.92, 49
1, 12:15:00-000, 335, 216, 119, 145, 1348.95, 119, 1349.24, 83
1, 12:16:00-000, 590, 367, 223, 259, 1347.56, 223, 1346.55, 89
1, 12:17:00-000, 323, 166, 157, 150, 1348.58, 157, 1347.35, 66
1, 12:18:00-000, 546, 315, 231, 209, 1347.83, 231, 1347.35, 57
1, 12:19:00-000, 309, 183, 126, 162, 1347.70, 126, 1346.95, 70
1, 12:20:00-000, 557, 299, 258, 136, 1348.47, 258, 1347.28, 93
1, 12:21:00-000, 401, 246, 155, 113, 1348.96, 155, 1347.67, 116
1, 12:22:00-000, 547, 330, 217, 201, 1347.96, 217, 1347.38, 154
1, 12:23:00-000, 275, 189, 86, 111, 1349.43, 86, 1347.14, 110
1, 12:24:00-000, 680, 384, 296, 261, 1348.35, 296, 1346.86, 115
1, 12:25:00-000, 281, 198, 83, 125, 1348.46, 83, 1348.53, 82
1, 12:26:00-000, 645, 363, 282, 235, 1347.70, 282, 1346.79, 102
1, 12:27:00-000, 321, 229, 92, 140, 1348.24, 92, 1347.57, 92
1, 12:28:00-000, 613, 402, 211, 303, 1348.48, 211, 1347.20, 110
1, 12:29:00-000, 271, 192, 79, 94, 1348.70, 79, 1348.32, 69
1, 12:30:00-000, 604, 411, 193, 267, 1349.00, 193, 1348.10, 97
1, 12:31:00-000, 323, 211, 112, 127, 1348.93, 112, 1348.54, 123
1, 12:32:00-000, 611, 309, 302, 238, 1347.49, 297, 1346.69, 115
1, 12:33:00-000, 330, 171, 159, 123, 1347.99, 164, 1347.62, 80
1, 12:34:00-000, 574, 298, 276, 194, 1347.13, 276, 1346.68, 97
1, 12:35:00-000, 281, 172, 109, 108, 1348.57, 109, 1348.08, 56
1, 12:36:00-000, 660, 392, 268, 264, 1348.06, 268, 1347.97, 68
1, 12:37:00-000, 285, 164, 121, 154, 1347.32, 121, 1346.32, 102
1, 12:38:00-000, 625, 352, 273, 246, 1347.99, 273, 1346.69, 36
1, 12:39:00-000, 312, 199, 113, 120, 1348.41, 113, 1348.08, 87
1, 12:40:00-000, 549, 360, 189, 215, 1348.92, 189, 1349.12, 115
1, 12:41:00-000, 323, 196, 127, 149, 1348.00, 127, 1347.59, 97
1, 12:42:00-000, 680, 399, 281, 281, 1347.34, 281, 1346.57, 109
1, 12:43:00-000, 263, 141, 122, 113, 1347.02, 122, 1345.77, 71
1, 12:44:00-000, 542, 347, 195, 219, 1348.49, 195, 1347.84, 70
1, 12:45:00-000, 369, 202, 167, 174, 1347.39, 167, 1346.59, 66
1, 12:46:00-000, 637, 385, 252, 266, 1347.15, 252, 1346.68, 69
1, 12:47:00-000, 260, 165, 95, 129, 1348.54, 95, 1346.65, 102
1, 12:48:00-000, 655, 407, 248, 256, 1348.22, 248, 1347.42, 68
1, 12:49:00-000, 298, 173, 125, 149, 1347.19, 125, 1347.40, 103
1, 12:50:00-000, 598, 354, 244, 260, 1347.53, 244, 1347.12, 59
1, 12:51:00-000, 294, 149, 145, 142, 1347.50, 145, 1347.23, 58
1, 12:52:00-000, 635, 342, 293, 267, 1347.69, 293, 1346.92, 43
1, 12:53:00-000, 276, 136, 140, 93, 1346.98, 140, 1346.48, 62
1, 12:54:00-000, 675, 437, 238, 258, 1348.43, 238, 1347.54, 65
1, 12:55:00-000, 291, 184, 107, 108, 1348.18, 107, 1347.81, 132
1, 12:56:00-000, 574, 341, 233, 232, 1347.78, 233, 1347.67, 113
1, 12:57:00-000, 310, 174, 136, 122, 1347.75, 136, 1347.56, 70
1, 12:58:00-000, 614, 366, 248, 228, 1347.49, 248, 1347.15, 109
1, 12:59:00-000, 311, 153, 158, 117, 1346.90, 158, 1346.32, 96
1, 13:00:00-000, 615, 367, 248, 286, 1348.29, 248, 1346.88, 85
1, 13:01:00-000, 267, 146, 121, 106, 1348.12, 121, 1347.21, 48
1, 13:02:00-000, 596, 361, 235, 257, 1348.23, 235, 1347.02, 37
1, 13:03:00-000, 315, 212, 103, 161, 1349.30, 103, 1347.61, 84
1, 13:04:00-000, 542, 304, 238, 264, 1347.77, 238, 1346.71, 71
1, 13:05:00-000, 315, 188, 127, 97, 1347.37, 127, 1347.89, 41
1, 13:06:00-000, 694, 424, 270, 333, 1348.02, 270, 1347.23, 85
1, 13:07:00-000, 342, 197, 145, 130, 1348.00, 145, 1347.70, 93
1, 13:08:00-000, 566, 340, 226, 257, 1347.95, 223, 1347.46, 71
1, 13:09:00-000, 361, 186, 175, 154, 1348.11, 178, 1346.89, 68
1, 13:10:00-000, 522, 289, 233, 220, 1347.45, 233, 1346.99, 47
1, 13:11:00-000, 338, 168, 170, 139, 1347.31, 170, 1346.70, 49
1, 13:12:00-000, 622, 370, 252, 257, 1348.16, 252, 1347.17, 61
1, 13:13:00-000, 323, 206, 117, 127, 1348.40, 117, 1347.68, 83
1, 13:14:00-000, 599, 307, 292, 255, 1347.89, 292, 1347.53, 75
1, 13:15:00-000, 370, 212, 158, 127, 1347.92, 158, 1347.71, 65
1, 13:16:00-000, 617, 354, 263, 251, 1348.17, 263, 1347.68, 126
1, 13:17:00-000, 314, 188, 126, 134, 1348.37, 126, 1348.20, 55
1, 13:18:00-000, 574, 328, 246, 235, 1347.82, 246, 1347.50, 78
1, 13:19:00-000, 256, 138, 118, 101, 1346.87, 118, 1346.37, 73
1, 13:20:00-000, 638, 381, 257, 211, 1349.47, 257, 1348.74, 87
1, 13:21:00-000, 307, 195, 112, 147, 1347.72, 112, 1347.37, 102
1, 13:22:00-000, 600, 341, 259, 222, 1347.85, 259, 1347.24, 96
1, 13:23:00-000, 351, 210, 141, 119, 1347.34, 141, 1347.10, 89
1, 13:24:00-000, 606, 349, 257, 255, 1348.13, 257, 1347.49, 93
1, 13:25:00-000, 219, 115, 104, 74, 1348.54, 104, 1346.60, 83
1, 13:26:00-000, 622, 400, 222, 265, 1348.42, 222, 1347.32, 79
1, 13:27:00-000, 354, 249, 105, 169, 1348.86, 105, 1348.10, 100
1, 13:28:00-000, 592, 365, 227, 303, 1348.40, 227, 1347.52, 89
1, 13:29:00-000, 314, 176, 138, 134, 1348.55, 138, 1347.58, 61
1, 13:30:00-000, 613, 368, 245, 247, 1347.74, 245, 1347.62, 61
1, 13:31:00-000, 305, 176, 129, 143, 1348.08, 129, 1348.46, 79
1, 13:32:00-000, 532, 298, 234, 207, 1347.83, 234, 1346.97, 84
1, 13:33:00-000, 311, 175, 136, 132, 1347.00, 136, 1346.60, 57
1, 13:34:00-000, 626, 345, 281, 290, 1347.09, 281, 1346.77, 61
1, 13:35:00-000, 325, 156, 169, 138, 1346.08, 169, 1345.41, 40
1, 13:36:00-000, 659, 404, 255, 274, 1348.59, 255, 1347.64, 75
1, 13:37:00-000, 260, 164, 96, 103, 1348.60, 96, 1346.54, 83
1, 13:38:00-000, 550, 336, 214, 211, 1348.57, 214, 1347.80, 73
1, 13:39:00-000, 305, 161, 144, 170, 1347.16, 144, 1346.29, 62
1, 13:40:00-000, 650, 365, 285, 283, 1348.56, 285, 1347.62, 57
1, 13:41:00-000, 266, 161, 105, 114, 1347.89, 105, 1347.35, 63
1, 13:42:00-000, 603, 329, 274, 219, 1347.75, 274, 1346.88, 51
1, 13:43:00-000, 317, 204, 113, 151, 1347.43, 113, 1346.78, 82
1, 13:44:00-000, 633, 371, 262, 213, 1348.01, 262, 1348.08, 97
1, 13:45:00-000, 318, 184, 134, 144, 1348.73, 134, 1348.07, 126
1, 13:46:00-000, 558, 328, 230, 178, 1349.34, 230, 1348.73, 69
1, 13:47:00-000, 294, 170, 124, 105, 1349.01, 124, 1349.12, 96
1, 13:48:00-000, 544, 278, 266, 217, 1347.23, 266, 1346.45, 86
1, 13:49:00-000, 306, 167, 139, 131, 1348.91, 139, 1347.64, 77
1, 13:50:00-000, 643, 412, 231, 263, 1347.82, 231, 1347.24, 52
1, 13:51:00-000, 336, 233, 103, 134, 1347.91, 103, 1348.09, 121
1, 13:52:00-000, 712, 453, 259, 318, 1348.14, 259, 1347.59, 120
1, 13:53:00-000, 310, 214, 96, 155, 1348.25, 96, 1347.37, 101
1, 13:54:00-000, 548, 351, 197, 220, 1348.90, 197, 1347.81, 111
1, 13:55:00-000, 311, 168, 143, 113, 1348.35, 143, 1349.05, 76
1, 13:56:00-000, 707, 452, 255, 318, 1348.22, 255, 1347.42, 101
1, 13:57:00-000, 297, 172, 125, 115, 1348.83, 125, 1347.71, 114
1, 13:58:00-000, 649, 385, 264, 246, 1348.30, 260, 1347.94, 80
1, 13:59:00-000, 361, 199, 162, 164, 1347.67, 166, 1347.15, 102
1, 14:00:00-000, 636, 347, 289, 258, 1347.62, 289, 1347.30, 65
1, 14:01:00-000, 273, 170, 103, 111, 1349.21, 103, 1348.69, 79
1, 14:02:00-000, 592, 307, 285, 230, 1348.72, 285, 1348.20, 73
1, 14:03:00-000, 353, 219, 134, 164, 1348.25, 134, 1348.28, 43
1, 14:04:00-000, 597, 363, 234, 298, 1348.48, 234, 1347.84, 60
1, 14:05:00-000, 348, 196, 152, 132, 1348.44, 150, 1347.91, 72
1, 14:06:00-000, 705, 393, 312, 357, 1347.47, 314, 1347.16, 45
1, 14:07:00-000, 318, 193, 125, 143, 1346.95, 123, 1346.19, 48
1, 14:08:00-000, 524, 250, 274, 206, 1347.03, 276, 1346.39, 76
1, 14:09:00-000, 297, 151, 146, 110, 1349.06, 146, 1347.15, 35
1, 14:10:00-000, 659, 380, 279, 295, 1346.91, 279, 1346.23, 54
1, 14:11:00-000, 333, 171, 162, 129, 1347.70, 162, 1347.43, 53
1, 14:12:00-000, 609, 345, 264, 257, 1348.28, 264, 1347.57, 50
1, 14:13:00-000, 290, 170, 120, 152, 1348.41, 120, 1347.47, 61
1, 14:14:00-000, 635, 368, 267, 237, 1347.57, 267, 1346.72, 63
1, 14:15:00-000, 295, 161, 134, 130, 1347.35, 134, 1346.61, 102
1, 14:16:00-000, 558, 326, 232, 235, 1347.92, 232, 1347.12, 71
1, 14:17:00-000, 274, 182, 92, 101, 1348.54, 92, 1347.66, 70
1, 14:18:00-000, 591, 346, 245, 247, 1347.04, 245, 1346.59, 79
1, 14:19:00-000, 314, 175, 139, 137, 1347.19, 139, 1346.66, 83
1, 14:20:00-000, 722, 408, 314, 300, 1346.92, 314, 1346.04, 40
1, 14:21:00-000, 286, 144, 142, 173, 1347.93, 142, 1346.45, 64
1, 14:22:00-000, 516, 292, 224, 186, 1348.14, 224, 1346.70, 57
1, 14:23:00-000, 254, 165, 89, 124, 1348.23, 89, 1347.62, 70
1, 14:24:00-000, 650, 399, 251, 275, 1347.59, 251, 1347.31, 75
1, 14:25:00-000, 317, 174, 143, 122, 1346.98, 143, 1346.64, 72
1, 14:26:00-000, 615, 316, 299, 291, 1346.96, 299, 1346.05, 64
1, 14:27:00-000, 350, 195, 155, 160, 1347.82, 155, 1346.55, 37
1, 14:28:00-000, 557, 338, 219, 221, 1348.61, 219, 1347.72, 70
1, 14:29:00-000, 252, 165, 87, 93, 1348.66, 87, 1347.92, 80
1, 14:30:00-000, 629, 347, 282, 278, 1347.53, 282, 1346.86, 63
1, 14:31:00-000, 354, 195, 159, 174, 1347.12, 159, 1345.75, 55
1, 14:32:00-000, 625, 338, 287, 250, 1347.72, 287, 1346.78, 59
1, 14:33:00-000, 294, 185, 109, 144, 1348.30, 109, 1347.03, 45
1, 14:34:00-000, 611, 378, 233, 244, 1348.25, 233, 1347.62, 106
1, 14:35:00-000, 318, 170, 148, 141, 1347.76, 148, 1347.33, 94
1, 14:36:00-000, 588, 358, 230, 232, 1348.24, 230, 1348.24, 42
1, 14:37:00-000, 351, 194, 157, 147, 1347.40, 157, 1346.92, 106
1, 14:38:00-000, 562, 355, 207, 208, 1347.92, 207, 1347.71, 88
1, 14:39:00-000, 289, 170, 119, 114, 1348.01, 119, 1347.76, 102
1, 14:40:00-000, 666, 379, 287, 307, 1348.13, 287, 1347.26, 82
1, 14:41:00-000, 320, 194, 126, 137, 1348.85, 126, 1347.96, 65
1, 14:42:00-000, 573, 306, 267, 224, 1348.14, 267, 1347.26, 59
1, 14:43:00-000, 376, 221, 155, 157, 1348.61, 153, 1348.18, 72
1, 14:44:00-000, 626, 355, 271, 258, 1347.97, 273, 1346.78, 91
1, 14:45:00-000, 355, 223, 132, 139, 1349.18, 132, 1348.26, 70
1, 14:46:00-000, 509, 333, 176, 221, 1348.03, 176, 1348.18, 111
1, 14:47:00-000, 329, 176, 153, 93, 1347.67, 153, 1347.51, 91
1, 14:48:00-000, 649, 383, 266, 272, 1348.01, 264, 1347.27, 88
1, 14:49:00-000, 339, 214, 125, 132, 1347.68, 127, 1347.66, 99
1, 14:50:00-000, 578, 358, 220, 214, 1348.64, 220, 1347.99, 116
1, 14:51:00-000, 338, 174, 164, 147, 1348.81, 164, 1348.03, 87
1, 14:52:00-000, 585, 311, 274, 255, 1347.58, 274, 1347.00, 63
1, 14:53:00-000, 309, 191, 118, 121, 1348.37, 118, 1347.25, 54
1, 14:54:00-000, 665, 419, 246, 286, 1347.97, 246, 1347.07, 74
1, 14:55:00-000, 251, 146, 105, 120, 1347.61, 105, 1347.52, 112
1, 14:56:00-000, 635, 363, 272, 239, 1348.41, 272, 1347.68, 66
1, 14:57:00-000, 335, 215, 120, 97, 1348.87, 120, 1348.35, 97
1, 14:58:00-000, 635, 403, 232, 282, 1348.32, 232, 1347.71, 116
1, 14:59:00-000, 311, 195, 116, 129, 1348.80, 116, 1347.05, 105
1, 15:00:00-000, 569, 293, 276, 242, 1347.26, 276, 1346.49, 75
1, 15:01:00-000, 311, 169, 142, 108, 1348.28, 142, 1347.63, 58
1, 15:02:00-000, 651, 343, 308, 247, 1347.52, 308, 1346.43, 71
1, 15:03:00-000, 320, 177, 143, 143, 1347.73, 143, 1347.09, 83
1, 15:04:00-000, 692, 444, 248, 306, 1347.97, 248, 1347.59, 45
1, 15:05:00-000, 313, 199, 114, 193, 1348.04, 114, 1346.91, 86
1, 15:06:00-000, 557, 338, 219, 238, 1348.28, 219, 1347.38, 69
1, 15:07:00-000, 343, 203, 140, 178, 1347.45, 140, 1346.72, 62
1, 15:08:00-000, 594, 353, 241, 273, 1348.24, 241, 1347.88, 50
1, 15:09:00-000, 332, 176, 156, 151, 1347.45, 156, 1346.29, 54
1, 15:10:00-000, 571, 332, 239, 269, 1347.88, 239, 1346.92, 50
1, 15:11:00-000, 311, 184, 127, 126, 1347.60, 127, 1346.74, 51
1, 15:12:00-000, 663, 338, 325, 300, 1347.98, 325, 1346.93, 63
1, 15:13:00-000, 307, 164, 143, 136, 1347.85, 143, 1347.01, 42
1, 15:14:00-000, 639, 341, 298, 257, 1348.05, 298, 1347.17, 43
1, 15:15:00-000, 261, 150, 111, 123, 1347.85, 111, 1347.59, 66
1, 15:16:00-000, 558, 290, 268, 226, 1348.64, 268, 1346.85, 46
1, 15:17:00-000, 307, 185, 122, 121, 1348.94, 122, 1347.25, 51
1, 15:18:00-000, 608, 324, 284, 270, 1348.21, 284, 1347.52, 59
1, 15:19:00-000, 312, 174, 138, 146, 1346.95, 138, 1346.68, 60
1, 15:20:00-000, 609, 328, 281, 254, 1346.88, 281, 1345.90, 30
1, 15:21:00-000, 280, 157, 123, 149, 1347.46, 123, 1347.00, 45
1, 15:22:00-000, 647, 374, 273, 300, 1347.75, 273, 1346.83, 49
1, 15:23:00-000, 346, 192, 154, 166, 1346.60, 154, 1346.70, 54
1, 15:24:00-000, 558, 352, 206, 232, 1347.83, 206, 1346.96, 52
1, 15:25:00-000, 274, 146, 128, 136, 1346.63, 128, 1345.77, 78
1, 15:26:00-000, 607, 349, 258, 233, 1348.46, 258, 1347.33, 47
1, 15:27:00-000, 316, 166, 150, 146, 1348.22, 150, 1347.08, 77
1, 15:28:00-000, 667, 375, 292, 254, 1347.35, 292, 1346.56, 65
1, 15:29:00-000, 323, 188, 135, 138, 1348.54, 135, 1346.67, 94
1, 15:30:00-000, 582, 300, 282, 232, 1347.15, 282, 1346.65, 48
1, 15:31:00-000, 332, 179, 153, 184, 1347.16, 153, 1346.06, 43
1, 15:32:00-000, 606, 332, 274, 226, 1348.76, 274, 1347.89, 46
1, 15:33:00-000, 317, 186, 131, 135, 1349.25, 131, 1347.52, 88
1, 15:34:00-000, 624, 342, 282, 249, 1346.93, 282, 1346.46, 69
1, 15:35:00-000, 338, 223, 115, 161, 1347.84, 115, 1347.27, 65
1, 15:36:00-000, 592, 368, 224, 220, 1348.67, 224, 1347.21, 111
1, 15:37:00-000, 338, 199, 139, 154, 1348.87, 136, 1348.14, 71
1, 15:38:00-000, 611, 415, 196, 268, 1348.47, 199, 1347.91, 83
1, 15:39:00-000, 344, 170, 174, 151, 1347.50, 174, 1347.08, 115
1, 15:40:00-000, 694, 436, 258, 257, 1348.17, 258, 1347.60, 97
1, 15:41:00-000, 320, 190, 130, 152, 1349.45, 130, 1348.08, 113
1, 15:42:00-000, 609, 340, 269, 221, 1349.55, 269, 1347.81, 72
1, 15:43:00-000, 258, 149, 109, 88, 1348.01, 109, 1346.85, 82
1, 15:44:00-000, 603, 312, 291, 231, 1348.05, 291, 1347.27, 90
1, 15:45:00-000, 310, 180, 130, 85, 1348.02, 130, 1347.13, 79
1, 15:46:00-000, 698, 387, 311, 261, 1347.57, 311, 1347.18, 112
1, 15:47:00-000, 295, 176, 119, 143, 1348.50, 117, 1347.31, 99
1, 15:48:00-000, 638, 377, 261, 261, 1348.35, 263, 1346.83, 61
1, 15:49:00-000, 262, 168, 94, 98, 1348.94, 94, 1348.24, 85
1, 15:50:00-000, 578, 381, 197, 226, 1348.51, 197, 1347.65, 84
1, 15:51:00-000, 294, 146, 148, 94, 1348.02, 148, 1346.63, 135
1, 15:52:00-000, 587, 389, 198, 243, 1347.70, 198, 1347.43, 102
1, 15:53:00-000, 309, 203, 106, 122, 1348.56, 106, 1347.27, 111
1, 15:54:00-000, 512, 307, 205, 223, 1347.88, 205, 1347.67, 73
1, 15:55:00-000, 293, 146, 147, 121, 1347.92, 147, 1347.90, 71
1, 15:56:00-000, 660, 420, 240, 257, 1348.68, 240, 1348.22, 64
1, 15:57:00-000, 345, 191, 154, 137, 1347.52, 154, 1346.74, 120
1, 15:58:00-000, 600, 352, 248, 255, 1348.04, 248, 1347.06, 79
1, 15:59:00-000, 280, 156, 124, 142, 1347.97, 124, 1347.35, 75
1, 16:00:00-000, 635, 370, 265, 262, 1347.55, 265, 1346.85, 58
1, 16:01:00-000, 317, 222, 95, 130, 1348.41, 95, 1347.89, 77
1, 16:02:00-000, 631, 421, 210, 221, 1348.85, 210, 1348.56, 116
1, 16:03:00-000, 337, 172, 165, 171, 1348.11, 165, 1347.09, 130
1, 16:04:00-000, 570, 324, 246, 231, 1348.11, 246, 1347.49, 76
1, 16:05:00-000, 304, 193, 111, 111, 1348.02, 111, 1347.38, 68
1, 16:06:00-000, 662, 374, 288, 291, 1348.03, 288, 1347.35, 114
1, 16:07:00-000, 327, 196, 131, 128, 1347.61, 131, 1347.12, 51
1, 16:08:00-000, 682, 439, 243, 288, 1348.45, 243, 1347.73, 101
1, 16:09:00-000, 282, 179, 103, 137, 1348.91, 103, 1348.04, 100
1, 16:10:00-000, 662, 386, 276, 256, 1348.48, 276, 1348.29, 78
1, 16:11:00-000, 345, 211, 134, 121, 1348.00, 134, 1347.47, 105
1, 16:12:00-000, 559, 326, 233, 233, 1347.49, 233, 1347.37, 93
1, 16:13:00-000, 358, 228, 130, 173, 1348.14, 130, 1347.37, 87
1, 16:14:00-000, 565, 328, 237, 202, 1348.60, 237, 1348.57, 92
1, 16:15:00-000, 393, 216, 177, 159, 1348.10, 177, 1348.21, 90
1, 16:16:00-000, 621, 343, 278, 239, 1347.79, 278, 1346.94, 90
1, 16:17:00-000, 309, 199, 110, 133, 1347.57, 110, 1347.68, 63
1, 16:18:00-000, 660, 385, 275, 314, 1348.33, 275, 1347.18, 67
1, 16:19:00-000, 311, 183, 128, 139, 1347.97, 128, 1347.24, 83
1, 16:20:00-000, 580, 371, 209, 185, 1347.89, 209, 1347.93, 72
1, 16:21:00-000, 369, 220, 149, 176, 1348.35, 149, 1347.93, 130
1, 16:22:00-000, 562, 309, 253, 252, 1348.38, 253, 1347.33, 65
1, 16:23:00-000, 319, 145, 174, 120, 1346.56, 174, 1346.40, 60
1, 16:24:00-000, 645, 364, 281, 291, 1348.24, 281, 1346.74, 55
1, 16:25:00-000, 258, 145, 113, 79, 1348.87, 113, 1348.31, 58
1, 16:26:00-000, 581, 314, 267, 267, 1348.02, 267, 1347.19, 51
1, 16:27:00-000, 267, 184, 83, 128, 1348.26, 83, 1347.76, 61
1, 16:28:00-000, 626, 378, 248, 234, 1347.88, 248, 1347.40, 87
1, 16:29:00-000, 285, 149, 136, 126, 1347.89, 136, 1346.53, 73
2, 09:06:00-000, 3172, 0, 3172, 0, 0.00, 1128, 1348.23, 0
2, 09:07:00-000, 0, 0, 0, 0, 0.00, 0, 0.00, 2033
2, 09:08:00-000, 0, 0, 0, 0, 0.00, 0, 0.00, 11
2, 09:13:00-000, 3266, 1128, 2138, 1126, 1352.00, 1640, 1350.82, 0
2, 09:14:00-000, 6, 0, 6, 2, 1352.00, 63, 1355.66, 441
2, 09:15:00-000, 33, 20, 13, 20, 1357.00, 12, 1349.75, 0
2, 09:16:00-000, 128, 66, 62, 63, 1354.83, 63, 1354.15, 0
2, 09:17:00-000, 206, 112, 94, 115, 1355.95, 91, 1353.65, 0
2, 09:18:00-000, 683, 395, 288, 387, 1355.97, 291, 1353.33, 0
2, 09:19:00-000, 383, 237, 146, 245, 1361.24, 146, 1353.52, 0
2, 09:20:00-000, 769, 400, 369, 400, 1354.55, 363, 1353.20, 0
2, 09:21:00-000, 397, 187, 210, 187, 1355.82, 205, 1352.25, 0
2, 09:22:00-000, 641, 311, 330, 311, 1354.00, 327, 1352.88, 0
2, 09:23:00-000, 248, 115, 133, 115, 1354.82, 137, 1352.60, 0
2, 09:24:00-000, 572, 257, 315, 257, 1353.21, 301, 1352.32, 0
2, 09:25:00-000, 315, 136, 179, 136, 1353.00, 164, 1352.63, 11
2, 09:26:00-000, 643, 302, 341, 302, 1353.30, 345, 1352.11, 5
2, 09:27:00-000, 319, 163, 156, 163, 1353.24, 114, 1351.61, 13
2, 09:28:00-000, 598, 279, 319, 279, 1353.29, 276, 1351.37, 52
2, 09:29:00-000, 302, 162, 140, 162, 1353.91, 174, 1352.75, 5
2, 09:30:00-000, 633, 344, 289, 344, 1355.16, 281, 1353.04, 0
2, 09:31:00-000, 294, 169, 125, 169, 1361.72, 131, 1353.94, 0
2, 09:32:00-000, 606, 246, 360, 246, 1353.41, 305, 1352.58, 0
2, 09:33:00-000, 325, 149, 176, 149, 1352.99, 170, 1351.29, 18
2, 09:34:00-000, 620, 333, 287, 333, 1353.77, 291, 1352.40, 21
2, 09:35:00-000, 351, 177, 174, 173, 1354.50, 174, 1353.87, 11
2, 09:36:00-000, 668, 300, 368, 304, 1353.19, 298, 1351.75, 22
2, 09:37:00-000, 300, 151, 149, 151, 1353.23, 130, 1351.70, 55
2, 09:38:00-000, 691, 341, 350, 341, 1353.65, 276, 1351.61, 38
2, 09:39:00-000, 334, 140, 194, 140, 1352.51, 162, 1351.03, 52
2, 09:40:00-000, 620, 278, 342, 278, 1352.34, 278, 1351.34, 40
2, 09:41:00-000, 270, 107, 163, 107, 1353.18, 116, 1351.90, 49
2, 09:42:00-000, 614, 264, 350, 264, 1353.19, 278, 1351.21, 69
2, 09:43:00-000, 325, 159, 166, 159, 1354.08, 139, 1352.03, 59
2, 09:44:00-000, 615, 314, 301, 312, 1353.28, 276, 1351.49, 30
2, 09:45:00-000, 296, 158, 138, 160, 1353.53, 111, 1351.44, 20
2, 09:46:00-000, 605, 303, 302, 303, 1353.24, 253, 1351.20, 24
2, 09:47:00-000, 300, 126, 174, 126, 1351.34, 109, 1350.79, 52
2, 09:48:00-000, 669, 285, 384, 285, 1352.14, 345, 1351.27, 43
2, 09:49:00-000, 360, 128, 232, 128, 1352.39, 163, 1351.28, 65
2, 09:50:00-000, 610, 276, 334, 276, 1352.34, 280, 1351.40, 62
2, 09:51:00-000, 323, 151, 172, 151, 1352.03, 125, 1351.40, 46
2, 09:52:00-000, 613, 223, 390, 223, 1351.95, 273, 1350.05, 82
2, 09:53:00-000, 292, 155, 137, 155, 1352.43, 151, 1352.03, 53
2, 09:54:00-000, 651, 354, 297, 354, 1353.20, 252, 1351.08, 39
2, 09:55:00-000, 280, 119, 161, 119, 1352.65, 130, 1351.75, 37
2, 09:56:00-000, 627, 301, 326, 301, 1353.20, 249, 1351.20, 37
2, 09:57:00-000, 301, 124, 177, 124, 1352.41, 136, 1350.26, 71
2, 09:58:00-000, 600, 269, 331, 269, 1352.52, 285, 1351.53, 45
2, 09:59:00-000, 269, 104, 165, 101, 1352.63, 148, 1351.09, 28
2, 10:00:00-000, 643, 316, 327, 319, 1352.87, 283, 1351.69, 33
2, 10:01:00-000, 337, 117, 220, 117, 1351.81, 131, 1350.57, 42
2, 10:02:00-000, 571, 215, 356, 215, 1351.91, 262, 1350.30, 99
2, 10:03:00-000, 269, 121, 148, 121, 1351.56, 123, 1351.22, 68
2, 10:04:00-000, 670, 319, 351, 319, 1352.76, 293, 1351.40, 44
2, 10:05:00-000, 298, 101, 197, 101, 1351.37, 169, 1350.67, 43
2, 10:06:00-000, 626, 302, 324, 302, 1351.98, 232, 1351.18, 47
2, 10:07:00-000, 331, 148, 183, 148, 1352.84, 180, 1352.32, 53
2, 10:08:00-000, 643, 267, 376, 267, 1352.74, 310, 1351.57, 48
2, 10:09:00-000, 288, 123, 165, 123, 1352.65, 122, 1351.53, 43
2, 10:10:00-000, 640, 289, 351, 289, 1352.65, 283, 1350.93, 51
2, 10:11:00-000, 334, 131, 203, 131, 1352.49, 149, 1350.50, 70
2, 10:12:00-000, 651, 298, 353, 298, 1352.77, 291, 1351.17, 56
2, 10:13:00-000, 300, 134, 166, 134, 1353.05, 126, 1351.42, 60
2, 10:14:00-000, 588, 256, 332, 256, 1352.29, 230, 1351.45, 43
2, 10:15:00-000, 336, 162, 174, 162, 1352.30, 156, 1352.71, 59
2, 10:16:00-000, 649, 303, 346, 303, 1352.92, 305, 1351.66, 53
2, 10:17:00-000, 344, 170, 174, 170, 1352.15, 122, 1351.57, 41
2, 10:18:00-000, 621, 219, 402, 219, 1352.57, 304, 1351.01, 78
2, 10:19:00-000, 352, 141, 211, 141, 1351.94, 174, 1351.12, 59
2, 10:20:00-000, 558, 262, 296, 262, 1353.41, 277, 1351.87, 31
2, 10:21:00-000, 340, 157, 183, 157, 1352.79, 126, 1350.61, 43
2, 10:22:00-000, 584, 274, 310, 274, 1353.24, 263, 1352.13, 39
2, 10:23:00-000, 287, 161, 126, 161, 1353.91, 134, 1352.35, 43
2, 10:24:00-000, 685, 347, 338, 347, 1352.91, 299, 1351.70, 24
2, 10:25:00-000, 268, 133, 135, 133, 1353.02, 113, 1350.49, 25
2, 10:26:00-000, 659, 255, 404, 255, 1351.89, 343, 1351.03, 26
2, 10:27:00-000, 282, 128, 154, 128, 1352.78, 117, 1351.54, 58
2, 10:28:00-000, 645, 291, 354, 291, 1351.29, 284, 1350.98, 52
2, 10:29:00-000, 298, 123, 175, 123, 1352.17, 116, 1351.37, 58
2, 10:30:00-000, 649, 314, 335, 314, 1353.61, 293, 1351.60, 57
2, 10:31:00-000, 286, 146, 140, 146, 1354.81, 142, 1353.09, 28
2, 10:32:00-000, 562, 217, 345, 217, 1353.00, 257, 1351.40, 25
2, 10:33:00-000, 316, 148, 168, 148, 1352.83, 136, 1351.75, 44
2, 10:34:00-000, 615, 276, 339, 276, 1352.91, 258, 1351.97, 62
2, 10:35:00-000, 340, 125, 215, 125, 1352.52, 198, 1351.25, 62
2, 10:36:00-000, 616, 313, 303, 313, 1353.62, 258, 1351.73, 35
2, 10:37:00-000, 333, 151, 182, 151, 1352.34, 156, 1351.50, 36
2, 10:38:00-000, 644, 268, 376, 268, 1351.30, 295, 1350.39, 52
2, 10:39:00-000, 323, 142, 181, 142, 1352.15, 140, 1351.39, 60
2, 10:40:00-000, 609, 264, 345, 264, 1352.56, 268, 1351.63, 58
2, 10:41:00-000, 362, 182, 180, 182, 1353.35, 170, 1352.35, 38
2, 10:42:00-000, 621, 276, 345, 276, 1353.00, 264, 1350.94, 43
2, 10:43:00-000, 266, 120, 146, 120, 1352.03, 148, 1351.61, 39
2, 10:44:00-000, 646, 262, 384, 262, 1351.78, 280, 1350.95, 66
2, 10:45:00-000, 288, 162, 126, 162, 1353.27, 125, 1352.50, 41
2, 10:46:00-000, 581, 280, 301, 280, 1353.54, 252, 1352.52, 32
2, 10:47:00-000, 304, 155, 149, 155, 1353.59, 142, 1352.00, 38
2, 10:48:00-000, 586, 290, 296, 290, 1353.06, 252, 1352.09, 27
2, 10:49:00-000, 311, 145, 166, 145, 1352.37, 106, 1351.69, 33
2, 10:50:00-000, 661, 263, 398, 263, 1352.52, 298, 1351.44, 87
2, 10:51:00-000, 262, 88, 174, 88, 1353.31, 131, 1351.19, 66
2, 10:52:00-000, 713, 342, 371, 342, 1353.02, 337, 1351.76, 42
2, 10:53:00-000, 299, 106, 193, 106, 1351.70, 115, 1350.31, 42
2, 10:54:00-000, 625, 274, 351, 274, 1352.70, 282, 1351.59, 81
2, 10:55:00-000, 260, 98, 162, 98, 1352.24, 96, 1350.87, 64
2, 10:56:00-000, 671, 338, 333, 338, 1352.35, 294, 1351.61, 58
2, 10:57:00-000, 280, 108, 172, 108, 1351.68, 101, 1350.60, 42
2, 10:58:00-000, 561, 255, 306, 255, 1351.96, 216, 1350.54, 122
2, 10:59:00-000, 343, 147, 196, 147, 1352.60, 128, 1350.60, 51
2, 11:00:00-000, 593, 234, 359, 234, 1351.68, 235, 1350.79, 77
2, 11:01:00-000, 332, 116, 216, 116, 1351.97, 140, 1351.12, 84
2, 11:02:00-000, 639, 269, 370, 265, 1352.07, 259, 1350.97, 123
2, 11:03:00-000, 372, 154, 218, 158, 1351.68, 199, 1351.05, 69
2, 11:04:00-000, 588, 279, 309, 279, 1352.34, 228, 1351.78, 68
2, 11:05:00-000, 310, 139, 171, 139, 1352.99, 127, 1351.09, 45
2, 11:06:00-000, 704, 289, 415, 289, 1352.81, 304, 1351.14, 69
2, 11:07:00-000, 285, 129, 156, 129, 1352.23, 134, 1351.89, 78
2, 11:08:00-000, 567, 221, 346, 221, 1350.93, 238, 1350.78, 72
2, 11:09:00-000, 344, 143, 201, 143, 1351.95, 136, 1350.50, 69
2, 11:10:00-000, 644, 273, 371, 273, 1352.28, 305, 1351.65, 78
2, 11:11:00-000, 272, 105, 167, 105, 1352.52, 153, 1351.70, 29
2, 11:12:00-000, 680, 247, 433, 247, 1351.54, 270, 1350.66, 83
2, 11:13:00-000, 306, 178, 128, 178, 1353.97, 142, 1352.65, 82
2, 11:14:00-000, 679, 318, 361, 318, 1353.02, 309, 1352.00, 29
2, 11:15:00-000, 338, 157, 181, 157, 1352.63, 151, 1351.32, 54
2, 11:16:00-000, 591, 229, 362, 229, 1352.19, 245, 1351.14, 51
2, 11:17:00-000, 315, 145, 170, 145, 1351.81, 159, 1351.94, 55
2, 11:18:00-000, 607, 268, 339, 268, 1352.49, 259, 1351.38, 69
2, 11:19:00-000, 304, 108, 196, 108, 1352.69, 149, 1351.28, 51
2, 11:20:00-000, 588, 292, 296, 292, 1352.36, 264, 1351.50, 48
2, 11:21:00-000, 354, 163, 191, 163, 1352.32, 151, 1351.15, 37
2, 11:22:00-000, 696, 334, 362, 334, 1352.76, 311, 1351.24, 46
2, 11:23:00-000, 291, 135, 156, 135, 1352.32, 121, 1351.68, 40
2, 11:24:00-000, 630, 259, 371, 259, 1351.94, 266, 1350.85, 50
2, 11:25:00-000, 316, 101, 215, 101, 1350.53, 141, 1350.34, 80
2, 11:26:00-000, 625, 284, 341, 284, 1351.76, 247, 1350.63, 106
2, 11:27:00-000, 307, 136, 171, 136, 1352.93, 121, 1349.98, 71
2, 11:28:00-000, 676, 313, 363, 313, 1351.97, 283, 1351.01, 66
2, 11:29:00-000, 294, 148, 146, 148, 1353.35, 143, 1351.97, 47
2, 11:30:00-000, 603, 277, 326, 277, 1353.09, 271, 1351.47, 30
2, 11:31:00-000, 287, 117, 170, 117, 1352.34, 140, 1351.28, 46
2, 11:32:00-000, 654, 305, 349, 305, 1352.34, 277, 1351.28, 44
2, 11:33:00-000, 230, 66, 164, 66, 1351.64, 114, 1349.83, 59
2, 11:34:00-000, 637, 294, 343, 294, 1352.26, 268, 1351.70, 66
2, 11:35:00-000, 325, 135, 190, 135, 1352.24, 159, 1351.67, 54
2, 11:36:00-000, 563, 263, 300, 263, 1352.15, 225, 1351.26, 63
2, 11:37:00-000, 309, 85, 224, 85, 1351.21, 119, 1349.56, 58
2, 11:38:00-000, 680, 311, 369, 311, 1351.68, 303, 1350.58, 97
2, 11:39:00-000, 297, 126, 171, 126, 1352.44, 112, 1350.37, 69
2, 11:40:00-000, 590, 252, 338, 252, 1352.50, 262, 1350.66, 68
2, 11:41:00-000, 338, 124, 214, 124, 1351.55, 160, 1351.52, 59
2, 11:42:00-000, 626, 269, 357, 269, 1351.65, 261, 1350.92, 81
2, 11:43:00-000, 362, 163, 199, 163, 1353.17, 134, 1351.87, 65
2, 11:44:00-000, 710, 295, 415, 295, 1352.28, 344, 1351.49, 80
2, 11:45:00-000, 337, 148, 189, 148, 1351.34, 152, 1350.80, 56
2, 11:46:00-000, 595, 231, 364, 231, 1351.69, 229, 1350.65, 58
2, 11:47:00-000, 275, 119, 156, 119, 1352.34, 132, 1351.56, 85
2, 11:48:00-000, 635, 229, 406, 229, 1351.78, 257, 1350.64, 75
2, 11:49:00-000, 330, 151, 179, 151, 1352.36, 158, 1351.51, 94
2, 11:50:00-000, 670, 294, 376, 294, 1351.54, 260, 1351.17, 104
2, 11:51:00-000, 320, 166, 154, 166, 1352.40, 143, 1351.61, 60
2, 11:52:00-000, 639, 275, 364, 275, 1353.39, 298, 1351.84, 38
2, 11:53:00-000, 323, 146, 177, 145, 1352.65, 149, 1351.37, 48
2, 11:54:00-000, 544, 248, 296, 249, 1352.97, 242, 1351.91, 32
2, 11:55:00-000, 310, 164, 146, 164, 1353.41, 141, 1351.70, 43
2, 11:56:00-000, 597, 245, 352, 245, 1352.64, 247, 1350.99, 38
2, 11:57:00-000, 297, 137, 160, 137, 1352.02, 122, 1350.87, 64
2, 11:58:00-000, 712, 318, 394, 318, 1351.97, 308, 1351.00, 73
2, 11:59:00-000, 329, 151, 178, 151, 1352.84, 150, 1351.21, 60
2, 12:00:00-000, 528, 231, 297, 231, 1352.05, 229, 1351.01, 58
2, 12:01:00-000, 307, 126, 181, 126, 1352.31, 146, 1350.97, 47
2, 12:02:00-000, 587, 251, 336, 251, 1353.02, 283, 1352.07, 43
2, 12:03:00-000, 256, 132, 124, 132, 1351.80, 125, 1352.15, 46
2, 12:04:00-000, 635, 277, 358, 277, 1353.13, 289, 1351.55, 18
2, 12:05:00-000, 313, 149, 164, 149, 1352.58, 129, 1351.62, 53
2, 12:06:00-000, 623, 237, 386, 237, 1351.45, 289, 1350.91, 49
2, 12:07:00-000, 289, 126, 163, 126, 1351.81, 142, 1350.95, 55
2, 12:08:00-000, 639, 297, 342, 297, 1351.84, 277, 1351.69, 49
2, 12:09:00-000, 281, 151, 130, 151, 1352.65, 104, 1350.49, 55
2, 12:10:00-000, 624, 312, 312, 312, 1352.21, 282, 1350.86, 29
2, 12:11:00-000, 327, 131, 196, 131, 1353.01, 149, 1351.94, 25
2, 12:12:00-000, 597, 275, 322, 275, 1353.36, 276, 1351.76, 46
2, 12:13:00-000, 284, 119, 165, 119, 1352.69, 122, 1351.07, 45
2, 12:14:00-000, 576, 278, 298, 278, 1352.90, 225, 1350.91, 60
2, 12:15:00-000, 304, 149, 155, 149, 1354.03, 143, 1351.54, 45
2, 12:16:00-000, 620, 243, 377, 243, 1351.24, 290, 1350.80, 66
2, 12:17:00-000, 340, 167, 173, 167, 1352.54, 155, 1351.52, 52
2, 12:18:00-000, 678, 324, 354, 324, 1352.58, 273, 1351.29, 45
2, 12:19:00-000, 311, 106, 205, 106, 1351.91, 151, 1351.19, 68
2, 12:20:00-000, 589, 257, 332, 257, 1351.99, 154, 1350.22, 96
2, 12:21:00-000, 344, 137, 207, 137, 1351.91, 130, 1350.78, 116
2, 12:22:00-000, 613, 242, 371, 242, 1351.89, 220, 1350.36, 119
2, 12:23:00-000, 289, 169, 120, 169, 1352.65, 97, 1350.71, 122
2, 12:24:00-000, 584, 223, 361, 223, 1352.00, 232, 1350.50, 47
2, 12:25:00-000, 307, 103, 204, 103, 1352.23, 110, 1350.14, 98
2, 12:26:00-000, 701, 295, 406, 295, 1351.99, 298, 1350.66, 89
2, 12:27:00-000, 268, 81, 187, 81, 1351.58, 139, 1350.33, 103
2, 12:28:00-000, 657, 188, 469, 188, 1351.95, 289, 1350.49, 109
2, 12:29:00-000, 313, 149, 164, 149, 1352.20, 140, 1351.82, 117
2, 12:30:00-000, 627, 211, 416, 211, 1351.82, 278, 1350.67, 73
2, 12:31:00-000, 286, 135, 151, 135, 1352.39, 112, 1351.12, 94
2, 12:32:00-000, 642, 269, 373, 269, 1351.59, 240, 1351.22, 100
2, 12:33:00-000, 299, 110, 189, 110, 1350.50, 122, 1350.73, 79
2, 12:34:00-000, 682, 269, 413, 269, 1351.58, 300, 1350.90, 95
2, 12:35:00-000, 261, 114, 147, 114, 1352.71, 99, 1352.43, 76
2, 12:36:00-000, 672, 328, 344, 328, 1352.65, 236, 1350.33, 77
2, 12:37:00-000, 352, 132, 220, 132, 1350.77, 132, 1350.43, 93
2, 12:38:00-000, 590, 279, 311, 279, 1352.22, 270, 1351.57, 100
2, 12:39:00-000, 269, 133, 136, 133, 1353.90, 98, 1351.25, 36
2, 12:40:00-000, 568, 256, 312, 256, 1352.71, 235, 1351.40, 50
2, 12:41:00-000, 376, 180, 196, 180, 1352.95, 158, 1351.72, 53
2, 12:42:00-000, 616, 222, 394, 222, 1351.65, 254, 1350.19, 68
2, 12:43:00-000, 278, 81, 197, 81, 1350.71, 111, 1350.03, 117
2, 12:44:00-000, 680, 280, 400, 280, 1351.96, 330, 1351.31, 91
2, 12:45:00-000, 249, 93, 156, 93, 1350.89, 58, 1349.92, 69
2, 12:46:00-000, 597, 246, 351, 246, 1351.72, 246, 1350.64, 119
2, 12:47:00-000, 296, 123, 173, 123, 1352.16, 166, 1350.95, 69
2, 12:48:00-000, 601, 254, 347, 254, 1351.68, 256, 1350.94, 30
2, 12:49:00-000, 354, 131, 223, 131, 1352.05, 161, 1350.65, 70
2, 12:50:00-000, 628, 271, 357, 271, 1351.69, 240, 1350.15, 85
2, 12:51:00-000, 292, 114, 178, 114, 1352.01, 121, 1350.37, 94
2, 12:52:00-000, 629, 267, 362, 267, 1352.07, 277, 1350.63, 72
2, 12:53:00-000, 338, 133, 205, 133, 1350.74, 130, 1350.95, 57
2, 12:54:00-000, 564, 262, 302, 262, 1352.43, 228, 1351.45, 91
2, 12:55:00-000, 301, 115, 186, 115, 1351.87, 117, 1350.57, 83
2, 12:56:00-000, 631, 259, 372, 259, 1351.89, 276, 1351.06, 96
2, 12:57:00-000, 244, 120, 124, 120, 1352.34, 90, 1351.47, 60
2, 12:58:00-000, 603, 241, 362, 241, 1351.93, 242, 1350.59, 56
2, 12:59:00-000, 292, 116, 176, 116, 1351.97, 116, 1350.31, 73
2, 13:00:00-000, 576, 235, 341, 235, 1352.16, 261, 1350.81, 96
2, 13:01:00-000, 350, 145, 205, 145, 1351.58, 134, 1350.60, 61
2, 13:02:00-000, 684, 256, 428, 256, 1352.13, 304, 1351.01, 97
2, 13:03:00-000, 324, 130, 194, 130, 1352.37, 197, 1351.84, 62
2, 13:04:00-000, 598, 251, 347, 251, 1352.50, 240, 1350.50, 76
2, 13:05:00-000, 314, 156, 158, 156, 1353.41, 163, 1351.77, 57
2, 13:06:00-000, 579, 255, 324, 255, 1352.45, 256, 1351.48, 33
2, 13:07:00-000, 263, 117, 146, 117, 1352.44, 98, 1351.14, 53
2, 13:08:00-000, 614, 279, 335, 279, 1353.25, 276, 1351.58, 63
2, 13:09:00-000, 323, 147, 176, 147, 1352.31, 145, 1349.98, 39
2, 13:10:00-000, 702, 297, 405, 297, 1351.67, 279, 1350.65, 69
2, 13:11:00-000, 359, 151, 208, 151, 1352.35, 157, 1351.86, 60
2, 13:12:00-000, 702, 301, 401, 301, 1352.25, 322, 1350.79, 86
2, 13:13:00-000, 265, 109, 156, 109, 1352.27, 144, 1351.58, 62
2, 13:14:00-000, 608, 252, 356, 252, 1352.42, 276, 1351.10, 32
2, 13:15:00-000, 266, 156, 110, 156, 1353.55, 98, 1351.84, 56
2, 13:16:00-000, 668, 269, 399, 269, 1351.78, 261, 1350.85, 57
2, 13:17:00-000, 341, 146, 195, 146, 1351.74, 126, 1350.99, 94
2, 13:18:00-000, 687, 280, 407, 280, 1351.45, 296, 1351.05, 95
2, 13:19:00-000, 260, 117, 143, 117, 1352.10, 88, 1349.85, 104
2, 13:20:00-000, 596, 284, 312, 284, 1353.29, 250, 1351.89, 58
2, 13:21:00-000, 333, 116, 217, 116, 1351.20, 135, 1350.69, 52
2, 13:22:00-000, 567, 261, 306, 261, 1352.36, 261, 1351.16, 67
2, 13:23:00-000, 342, 157, 185, 157, 1352.42, 111, 1350.97, 58
2, 13:24:00-000, 641, 259, 382, 259, 1351.71, 291, 1350.94, 71
2, 13:25:00-000, 310, 121, 189, 121, 1352.04, 128, 1351.10, 77
2, 13:26:00-000, 615, 227, 388, 227, 1351.84, 269, 1350.52, 100
2, 13:27:00-000, 240, 109, 131, 109, 1353.60, 107, 1351.20, 90
2, 13:28:00-000, 620, 270, 350, 270, 1352.53, 302, 1351.24, 53
2, 13:29:00-000, 387, 164, 223, 164, 1352.44, 145, 1350.60, 38
2, 13:30:00-000, 574, 216, 358, 216, 1351.78, 253, 1351.47, 77
2, 13:31:00-000, 358, 134, 224, 134, 1352.70, 144, 1351.25, 88
2, 13:32:00-000, 671, 314, 357, 314, 1352.06, 289, 1351.62, 88
2, 13:33:00-000, 321, 127, 194, 127, 1351.71, 119, 1349.85, 70
2, 13:34:00-000, 583, 260, 323, 260, 1351.51, 222, 1350.43, 97
2, 13:35:00-000, 318, 134, 184, 134, 1351.14, 107, 1350.84, 78
2, 13:36:00-000, 620, 280, 340, 280, 1352.61, 264, 1351.36, 86
2, 13:37:00-000, 308, 132, 176, 132, 1352.73, 123, 1351.66, 63
2, 13:38:00-000, 680, 299, 381, 299, 1352.81, 295, 1351.23, 67
2, 13:39:00-000, 379, 156, 223, 156, 1352.28, 181, 1350.80, 67
2, 13:40:00-000, 641, 220, 421, 220, 1352.12, 294, 1350.92, 68
2, 13:41:00-000, 318, 95, 223, 95, 1351.51, 146, 1350.00, 90
2, 13:42:00-000, 641, 265, 376, 265, 1351.49, 275, 1351.19, 107
2, 13:43:00-000, 327, 173, 154, 173, 1353.16, 143, 1351.41, 65
2, 13:44:00-000, 633, 274, 359, 274, 1352.40, 246, 1351.28, 53
2, 13:45:00-000, 370, 163, 207, 163, 1352.19, 177, 1351.75, 78
2, 13:46:00-000, 512, 277, 235, 277, 1353.76, 202, 1351.91, 60
2, 13:47:00-000, 329, 154, 175, 154, 1352.74, 153, 1351.18, 25
2, 13:48:00-000, 606, 284, 322, 284, 1352.10, 263, 1351.42, 28
2, 13:49:00-000, 311, 151, 160, 151, 1352.74, 144, 1351.90, 35
2, 13:50:00-000, 692, 297, 395, 297, 1352.26, 310, 1351.33, 46
2, 13:51:00-000, 295, 116, 179, 112, 1352.27, 141, 1350.60, 72
2, 13:52:00-000, 628, 247, 381, 251, 1352.35, 286, 1350.98, 58
2, 13:53:00-000, 230, 113, 117, 113, 1352.73, 81, 1350.41, 80
2, 13:54:00-000, 617, 266, 351, 266, 1352.13, 295, 1351.60, 32
2, 13:55:00-000, 315, 186, 129, 186, 1353.37, 139, 1352.80, 40
2, 13:56:00-000, 636, 232, 404, 232, 1351.58, 281, 1350.40, 41
2, 13:57:00-000, 307, 152, 155, 152, 1352.19, 137, 1351.56, 71
2, 13:58:00-000, 610, 248, 362, 248, 1352.61, 241, 1351.50, 51
2, 13:59:00-000, 297, 137, 160, 137, 1352.36, 136, 1351.63, 70
2, 14:00:00-000, 573, 243, 330, 243, 1351.60, 229, 1350.46, 86
2, 14:01:00-000, 325, 169, 156, 169, 1352.56, 122, 1351.21, 66
2, 14:02:00-000, 604, 291, 313, 291, 1353.28, 226, 1351.89, 51
2, 14:03:00-000, 299, 150, 149, 150, 1353.38, 132, 1349.93, 74
2, 14:04:00-000, 582, 266, 316, 266, 1352.45, 279, 1351.00, 29
2, 14:05:00-000, 304, 138, 166, 138, 1352.03, 138, 1351.56, 28
2, 14:06:00-000, 589, 235, 354, 235, 1352.31, 249, 1350.83, 44
2, 14:07:00-000, 292, 88, 204, 88, 1350.70, 150, 1349.55, 77
2, 14:08:00-000, 601, 235, 366, 235, 1350.91, 202, 1350.17, 117
2, 14:09:00-000, 280, 120, 160, 120, 1352.07, 126, 1351.55, 91
2, 14:10:00-000, 567, 265, 302, 265, 1352.16, 240, 1350.80, 71
2, 14:11:00-000, 274, 136, 138, 136, 1351.55, 102, 1351.32, 50
2, 14:12:00-000, 627, 283, 344, 283, 1352.57, 264, 1351.64, 44
2, 14:13:00-000, 270, 94, 176, 94, 1351.44, 110, 1350.51, 66
2, 14:14:00-000, 591, 238, 353, 238, 1351.93, 242, 1350.70, 86
2, 14:15:00-000, 365, 128, 237, 128, 1351.29, 141, 1350.54, 100
2, 14:16:00-000, 629, 283, 346, 283, 1351.96, 275, 1350.89, 110
2, 14:17:00-000, 317, 139, 178, 139, 1352.64, 140, 1350.56, 50
2, 14:18:00-000, 525, 198, 327, 198, 1351.59, 225, 1350.68, 59
2, 14:19:00-000, 332, 136, 196, 136, 1351.01, 139, 1350.95, 86
2, 14:20:00-000, 678, 214, 464, 214, 1351.06, 270, 1350.52, 65
2, 14:21:00-000, 325, 133, 192, 133, 1352.08, 166, 1350.53, 150
2, 14:22:00-000, 568, 256, 312, 256, 1352.11, 246, 1350.99, 60
2, 14:23:00-000, 287, 87, 200, 87, 1351.41, 130, 1350.74, 48
2, 14:24:00-000, 670, 319, 351, 319, 1352.07, 269, 1351.41, 108
2, 14:25:00-000, 292, 121, 171, 121, 1351.89, 109, 1351.54, 45
2, 14:26:00-000, 641, 260, 381, 260, 1350.90, 297, 1350.23, 84
2, 14:27:00-000, 315, 160, 155, 160, 1351.76, 153, 1351.63, 60
2, 14:28:00-000, 638, 233, 405, 233, 1351.50, 252, 1351.04, 69
2, 14:29:00-000, 298, 133, 165, 133, 1351.95, 130, 1351.93, 83
2, 14:30:00-000, 700, 293, 407, 293, 1352.70, 331, 1351.15, 63
2, 14:31:00-000, 248, 91, 157, 91, 1352.05, 114, 1349.84, 62
2, 14:32:00-000, 704, 322, 382, 322, 1351.60, 299, 1350.91, 51
2, 14:33:00-000, 340, 146, 194, 146, 1351.90, 155, 1350.66, 84
2, 14:34:00-000, 532, 256, 276, 256, 1352.31, 218, 1351.33, 51
2, 14:35:00-000, 279, 135, 144, 135, 1352.78, 119, 1351.92, 36
2, 14:36:00-000, 687, 338, 349, 338, 1352.76, 306, 1351.68, 38
2, 14:37:00-000, 334, 114, 220, 114, 1351.69, 136, 1350.58, 39
2, 14:38:00-000, 629, 241, 388, 241, 1351.35, 259, 1350.81, 98
2, 14:39:00-000, 319, 161, 158, 161, 1352.71, 129, 1351.41, 73
2, 14:40:00-000, 527, 201, 326, 201, 1351.94, 236, 1351.50, 74
2, 14:41:00-000, 344, 174, 170, 174, 1352.40, 157, 1352.42, 68
2, 14:42:00-000, 640, 278, 362, 278, 1352.44, 283, 1351.63, 46
2, 14:43:00-000, 341, 121, 220, 121, 1352.29, 131, 1350.99, 53
2, 14:44:00-000, 669, 290, 379, 285, 1352.20, 332, 1351.99, 74
2, 14:45:00-000, 270, 118, 152, 123, 1352.57, 106, 1351.12, 73
2, 14:46:00-000, 636, 265, 371, 265, 1352.27, 259, 1350.84, 67
2, 14:47:00-000, 289, 150, 139, 150, 1352.46, 119, 1352.34, 71
2, 14:48:00-000, 658, 295, 363, 295, 1352.44, 265, 1351.46, 60
2, 14:49:00-000, 333, 160, 173, 160, 1353.36, 158, 1350.90, 60
2, 14:50:00-000, 530, 266, 264, 266, 1353.33, 198, 1352.23, 36
2, 14:51:00-000, 350, 130, 220, 130, 1352.65, 147, 1351.85, 58
2, 14:52:00-000, 594, 243, 351, 243, 1352.12, 238, 1350.98, 93
2, 14:53:00-000, 312, 132, 180, 132, 1352.32, 137, 1351.49, 82
2, 14:54:00-000, 667, 273, 394, 273, 1352.57, 297, 1351.31, 77
2, 14:55:00-000, 287, 117, 170, 117, 1352.27, 153, 1351.11, 81
2, 14:56:00-000, 563, 251, 312, 251, 1351.96, 217, 1351.61, 35
2, 14:57:00-000, 261, 101, 160, 101, 1351.67, 102, 1350.86, 80
2, 14:58:00-000, 663, 232, 431, 232, 1352.01, 292, 1351.25, 85
2, 14:59:00-000, 409, 192, 217, 192, 1352.23, 187, 1351.69, 71
2, 15:00:00-000, 533, 198, 335, 198, 1351.58, 246, 1350.64, 84
2, 15:01:00-000, 379, 175, 204, 175, 1352.03, 186, 1351.86, 35
2, 15:02:00-000, 653, 284, 369, 284, 1352.11, 274, 1350.43, 81
2, 15:03:00-000, 311, 141, 170, 141, 1353.00, 128, 1351.54, 63
2, 15:04:00-000, 558, 270, 288, 270, 1352.97, 234, 1351.18, 36
2, 15:05:00-000, 295, 132, 163, 132, 1352.92, 134, 1351.53, 43
2, 15:06:00-000, 659, 287, 372, 287, 1352.51, 305, 1351.35, 48
2, 15:07:00-000, 293, 131, 162, 131, 1352.35, 158, 1351.41, 39
2, 15:08:00-000, 673, 316, 357, 316, 1352.81, 308, 1351.28, 50
2, 15:09:00-000, 271, 110, 161, 110, 1350.86, 116, 1350.71, 36
2, 15:10:00-000, 585, 263, 322, 263, 1352.39, 254, 1350.51, 60
2, 15:11:00-000, 308, 128, 180, 128, 1351.40, 132, 1351.31, 40
2, 15:12:00-000, 582, 242, 340, 242, 1351.87, 243, 1351.44, 78
2, 15:13:00-000, 343, 177, 166, 177, 1352.41, 140, 1351.13, 57
2, 15:14:00-000, 677, 332, 345, 332, 1352.59, 325, 1352.02, 48
2, 15:15:00-000, 278, 111, 167, 111, 1352.51, 121, 1350.98, 22
2, 15:16:00-000, 572, 221, 351, 221, 1352.05, 279, 1351.05, 60
2, 15:17:00-000, 317, 149, 168, 149, 1352.53, 130, 1351.74, 56
2, 15:18:00-000, 640, 280, 360, 280, 1352.32, 267, 1350.50, 48
2, 15:19:00-000, 347, 131, 216, 131, 1352.08, 154, 1350.87, 79
2, 15:20:00-000, 596, 277, 319, 277, 1351.20, 201, 1350.61, 80
2, 15:21:00-000, 329, 165, 164, 165, 1351.84, 133, 1351.16, 84
2, 15:22:00-000, 561, 260, 301, 260, 1351.78, 236, 1350.49, 58
2, 15:23:00-000, 290, 123, 167, 123, 1353.29, 128, 1350.75, 51
2, 15:24:00-000, 674, 322, 352, 318, 1353.19, 305, 1351.38, 28
2, 15:25:00-000, 262, 61, 201, 65, 1349.76, 91, 1348.93, 61
2, 15:26:00-000, 596, 259, 337, 259, 1351.68, 260, 1350.98, 118
2, 15:27:00-000, 323, 139, 184, 139, 1352.09, 155, 1351.00, 59
2, 15:28:00-000, 638, 267, 371, 267, 1351.88, 278, 1350.78, 54
2, 15:29:00-000, 289, 137, 152, 137, 1352.06, 104, 1351.06, 67
2, 15:30:00-000, 558, 242, 316, 242, 1351.49, 218, 1350.76, 94
2, 15:31:00-000, 343, 121, 222, 121, 1350.92, 155, 1349.75, 73
2, 15:32:00-000, 624, 274, 350, 274, 1352.94, 284, 1351.85, 45
2, 15:33:00-000, 268, 106, 162, 106, 1351.78, 91, 1350.57, 83
2, 15:34:00-000, 646, 252, 394, 250, 1351.04, 293, 1350.45, 73
2, 15:35:00-000, 303, 116, 187, 118, 1352.45, 136, 1351.10, 56
2, 15:36:00-000, 635, 311, 324, 311, 1352.13, 275, 1351.04, 80
2, 15:37:00-000, 252, 86, 166, 86, 1353.09, 122, 1351.68, 50
2, 15:38:00-000, 593, 273, 320, 273, 1352.74, 245, 1351.61, 43
2, 15:39:00-000, 285, 136, 149, 136, 1352.20, 131, 1351.53, 64
2, 15:40:00-000, 642, 285, 357, 285, 1352.17, 235, 1350.48, 62
2, 15:41:00-000, 349, 160, 189, 160, 1352.66, 117, 1350.43, 91
2, 15:42:00-000, 513, 254, 259, 254, 1352.39, 172, 1351.19, 93
2, 15:43:00-000, 327, 115, 212, 115, 1352.02, 139, 1350.36, 75
2, 15:44:00-000, 696, 269, 427, 269, 1351.79, 303, 1350.57, 103
2, 15:45:00-000, 340, 150, 190, 150, 1351.81, 138, 1350.03, 95
2, 15:46:00-000, 643, 205, 438, 205, 1351.80, 255, 1350.84, 101
2, 15:47:00-000, 288, 123, 165, 123, 1352.04, 143, 1351.39, 95
2, 15:48:00-000, 623, 221, 402, 221, 1351.88, 300, 1351.16, 61
2, 15:49:00-000, 300, 119, 181, 119, 1352.33, 130, 1351.33, 80
2, 15:50:00-000, 661, 272, 389, 272, 1351.97, 276, 1350.86, 92
2, 15:51:00-000, 303, 116, 187, 116, 1351.83, 140, 1351.50, 58
2, 15:52:00-000, 700, 281, 419, 281, 1352.00, 296, 1350.47, 90
2, 15:53:00-000, 369, 141, 228, 141, 1352.44, 188, 1351.52, 82
2, 15:54:00-000, 598, 243, 355, 243, 1351.82, 276, 1351.49, 87
2, 15:55:00-000, 306, 144, 162, 144, 1353.63, 120, 1350.47, 71
2, 15:56:00-000, 648, 258, 390, 258, 1352.00, 290, 1351.64, 57
2, 15:57:00-000, 310, 162, 148, 162, 1351.47, 121, 1350.98, 71
2, 15:58:00-000, 725, 309, 416, 309, 1352.26, 317, 1350.73, 74
2, 15:59:00-000, 321, 170, 151, 170, 1353.92, 119, 1351.31, 54
2, 16:00:00-000, 653, 275, 378, 275, 1352.16, 296, 1350.82, 37
2, 16:01:00-000, 320, 132, 188, 132, 1351.72, 115, 1350.40, 79
2, 16:02:00-000, 588, 311, 277, 311, 1353.32, 210, 1351.79, 68
2, 16:03:00-000, 258, 92, 166, 92, 1352.38, 121, 1350.89, 55
2, 16:04:00-000, 613, 283, 330, 283, 1352.85, 264, 1351.37, 62
2, 16:05:00-000, 358, 148, 210, 148, 1352.14, 146, 1350.07, 69
2, 16:06:00-000, 666, 300, 366, 300, 1352.42, 264, 1351.00, 73
2, 16:07:00-000, 292, 126, 166, 126, 1351.18, 107, 1350.57, 88
2, 16:08:00-000, 478, 229, 249, 229, 1353.11, 239, 1351.53, 53
2, 16:09:00-000, 323, 135, 188, 135, 1352.98, 119, 1351.62, 15
2, 16:10:00-000, 612, 268, 344, 268, 1352.53, 238, 1351.76, 75
2, 16:11:00-000, 269, 108, 161, 108, 1351.08, 101, 1350.79, 106
2, 16:12:00-000, 659, 284, 375, 284, 1351.89, 299, 1351.63, 45
2, 16:13:00-000, 273, 127, 146, 127, 1352.54, 110, 1351.64, 96
2, 16:14:00-000, 621, 262, 359, 262, 1352.62, 282, 1351.54, 46
2, 16:15:00-000, 317, 133, 184, 133, 1352.64, 155, 1351.48, 43
2, 16:16:00-000, 601, 204, 397, 204, 1352.32, 245, 1351.33, 39
2, 16:17:00-000, 298, 94, 204, 94, 1351.23, 114, 1350.91, 122
2, 16:18:00-000, 619, 250, 369, 250, 1351.49, 258, 1350.87, 132
2, 16:19:00-000, 263, 114, 149, 110, 1351.54, 120, 1351.09, 99
2, 16:20:00-000, 587, 250, 337, 254, 1351.92, 239, 1351.08, 58
2, 16:21:00-000, 372, 180, 192, 180, 1352.10, 170, 1351.31, 74
2, 16:22:00-000, 668, 259, 409, 259, 1351.93, 309, 1350.60, 41
2, 16:23:00-000, 256, 127, 129, 127, 1350.69, 105, 1351.02, 70
2, 16:24:00-000, 676, 253, 423, 253, 1351.47, 312, 1350.98, 55
2, 16:25:00-000, 333, 138, 195, 138, 1351.31, 155, 1351.40, 67
2, 16:26:00-000, 674, 264, 410, 264, 1352.31, 267, 1351.10, 84
2, 16:27:00-000, 316, 107, 209, 107, 1351.72, 141, 1351.04, 96
2, 16:28:00-000, 566, 268, 298, 268, 1352.00, 277, 1351.09, 76
2, 16:29:00-000, 400, 180, 220, 180, 1352.45, 156, 1351.32, 48
3, 09:00:00-000, 196, 190, 6, 1, 1351.00, 1, 1351.00, 194
3, 09:01:00-000, 176, 176, 0, 0, 0.00, 0, 0.00, 176
3, 09:02:00-000, 258, 258, 0, 0, 0.00, 0, 0.00, 251
3, 09:03:00-000, 183, 183, 0, 0, 0.00, 0, 0.00, 184
3, 09:04:00-000, 212, 212, 0, 0, 0.00, 0, 0.00, 209
3, 09:05:00-000, 200, 200, 0, 0, 0.00, 0, 0.00, 209
3, 09:06:00-000, 217, 217, 0, 1, 1345.50, 0, 0.00, 212
3, 09:07:00-000, 206, 206, 0, 0, 0.00, 0, 0.00, 209
3, 09:08:00-000, 209, 209, 0, 0, 0.00, 0, 0.00, 208
3, 09:09:00-000, 179, 179, 0, 3, 1365.67, 0, 0.00, 169
3, 09:10:00-000, 194, 194, 0, 1, 1424.00, 0, 0.00, 193
3, 09:11:00-000, 189, 189, 0, 0, 0.00, 0, 0.00, 196
3, 09:12:00-000, 219, 219, 0, 1, 1518.00, 0, 0.00, 215
3, 09:13:00-000, 205, 199, 6, 7, 1375.71, 1, 1355.00, 200
3, 09:14:00-000, 206, 203, 3, 6, 1353.17, 3, 1354.67, 196
3, 09:15:00-000, 199, 199, 0, 1, 1354.00, 0, 0.00, 199
3, 09:16:00-000, 206, 202, 4, 10, 1355.80, 0, 0.00, 194
3, 09:17:00-000, 188, 184, 4, 3, 1357.00, 4, 1367.50, 183
3, 09:18:00-000, 191, 191, 0, 0, 0.00, 0, 0.00, 192
3, 09:19:00-000, 212, 206, 6, 4, 1383.00, 1, 1354.00, 200
3, 09:20:00-000, 202, 169, 33, 13, 1354.31, 14, 1357.28, 171
3, 09:21:00-000, 200, 166, 34, 10, 1348.70, 5, 1350.60, 194
3, 09:22:00-000, 197, 185, 12, 2, 1351.50, 6, 1353.00, 178
3, 09:23:00-000, 195, 189, 6, 7, 1351.57, 6, 1355.00, 192
3, 09:24:00-000, 195, 165, 30, 10, 1353.00, 9, 1352.33, 168
3, 09:25:00-000, 212, 197, 15, 0, 0.00, 1, 1351.00, 219
3, 09:26:00-000, 204, 174, 30, 10, 1354.80, 2, 1351.00, 194
3, 09:27:00-000, 216, 202, 14, 4, 1353.00, 8, 1353.37, 194
3, 09:28:00-000, 227, 214, 13, 1, 1355.00, 0, 0.00, 225
3, 09:29:00-000, 221, 193, 28, 7, 1353.43, 16, 1354.25, 194
3, 09:30:00-000, 194, 177, 17, 8, 1348.00, 1, 1350.00, 196
3, 09:31:00-000, 178, 170, 8, 2, 1354.00, 6, 1352.17, 171
3, 09:32:00-000, 212, 189, 23, 14, 1350.93, 0, 0.00, 203
3, 09:33:00-000, 184, 161, 23, 1, 1346.00, 5, 1351.00, 178
3, 09:34:00-000, 210, 200, 10, 1, 1348.00, 8, 1354.50, 198
3, 09:35:00-000, 213, 206, 7, 3, 1356.00, 3, 1355.00, 207
3, 09:36:00-000, 221, 202, 19, 5, 1352.00, 7, 1350.28, 202
3, 09:37:00-000, 210, 189, 21, 10, 1348.30, 7, 1351.86, 200
3, 09:38:00-000, 224, 196, 28, 8, 1347.50, 14, 1351.64, 191
3, 09:39:00-000, 192, 165, 27, 1, 1348.00, 0, 0.00, 202
3, 09:40:00-000, 193, 167, 26, 10, 1348.60, 5, 1351.40, 176
3, 09:41:00-000, 220, 206, 14, 1, 1349.00, 10, 1350.30, 203
3, 09:42:00-000, 143, 124, 19, 12, 1349.92, 3, 1352.67, 138
3, 09:43:00-000, 213, 188, 25, 4, 1351.50, 4, 1352.25, 206
3, 09:44:00-000, 193, 158, 35, 11, 1348.73, 10, 1352.10, 165
3, 09:45:00-000, 187, 173, 14, 4, 1350.25, 8, 1353.00, 175
3, 09:46:00-000, 200, 190, 10, 16, 1348.18, 6, 1351.83, 181
3, 09:47:00-000, 185, 162, 23, 10, 1347.70, 1, 1351.00, 177
3, 09:48:00-000, 206, 158, 48, 15, 1351.27, 12, 1352.67, 170
3, 09:49:00-000, 176, 126, 50, 6, 1348.50, 7, 1350.43, 166
3, 09:50:00-000, 229, 175, 54, 1, 1350.00, 12, 1350.33, 219
3, 09:51:00-000, 203, 173, 30, 14, 1349.07, 13, 1352.30, 177
3, 09:52:00-000, 223, 180, 43, 9, 1348.67, 2, 1351.00, 214
3, 09:53:00-000, 201, 145, 56, 12, 1349.92, 19, 1352.21, 169
3, 09:54:00-000, 248, 187, 61, 22, 1350.59, 26, 1350.58, 201
3, 09:55:00-000, 246, 222, 24, 4, 1350.00, 7, 1351.71, 232
3, 09:56:00-000, 177, 154, 23, 13, 1348.61, 5, 1351.80, 163
3, 09:57:00-000, 194, 149, 45, 8, 1347.87, 7, 1351.29, 178
3, 09:58:00-000, 228, 181, 47, 7, 1348.43, 6, 1351.67, 216
3, 09:59:00-000, 202, 167, 35, 10, 1352.30, 20, 1353.40, 169
3, 10:00:00-000, 189, 173, 16, 4, 1350.75, 1, 1350.00, 181
3, 10:01:00-000, 185, 151, 34, 13, 1347.92, 8, 1352.87, 165
3, 10:02:00-000, 170, 122, 48, 3, 1346.00, 1, 1350.00, 169
3, 10:03:00-000, 183, 130, 53, 6, 1348.17, 9, 1351.00, 168
3, 10:04:00-000, 176, 162, 14, 9, 1350.00, 7, 1353.43, 159
3, 10:05:00-000, 207, 159, 48, 5, 1348.40, 6, 1349.83, 197
3, 10:06:00-000, 191, 120, 71, 9, 1349.00, 8, 1351.25, 169
3, 10:07:00-000, 185, 151, 34, 2, 1350.50, 11, 1350.73, 176
3, 10:08:00-000, 185, 141, 44, 9, 1350.78, 10, 1350.80, 155
3, 10:09:00-000, 194, 169, 25, 10, 1346.80, 2, 1351.50, 194
3, 10:10:00-000, 175, 122, 53, 10, 1349.30, 10, 1352.10, 156
3, 10:11:00-000, 188, 146, 42, 2, 1348.00, 1, 1351.00, 183
3, 10:12:00-000, 157, 129, 28, 5, 1348.40, 5, 1351.20, 145
3, 10:13:00-000, 189, 168, 21, 1, 1349.00, 2, 1351.00, 180
3, 10:14:00-000, 220, 195, 25, 12, 1348.00, 3, 1350.00, 212
3, 10:15:00-000, 233, 192, 41, 13, 1351.46, 14, 1352.78, 208
3, 10:16:00-000, 203, 168, 35, 14, 1349.14, 9, 1353.11, 174
3, 10:17:00-000, 222, 154, 68, 4, 1350.00, 10, 1350.70, 213
3, 10:18:00-000, 242, 181, 61, 17, 1347.47, 7, 1350.43, 219
3, 10:19:00-000, 259, 169, 90, 7, 1346.57, 15, 1352.40, 231
3, 10:20:00-000, 177, 110, 67, 15, 1347.73, 14, 1351.43, 151
3, 10:21:00-000, 209, 159, 50, 2, 1351.50, 17, 1351.41, 187
3, 10:22:00-000, 196, 157, 39, 16, 1348.62, 2, 1350.50, 186
3, 10:23:00-000, 177, 119, 58, 7, 1347.86, 3, 1350.00, 166
3, 10:24:00-000, 237, 161, 76, 10, 1350.80, 5, 1351.80, 208
3, 10:25:00-000, 187, 125, 62, 12, 1348.83, 14, 1351.07, 168
3, 10:26:00-000, 205, 144, 61, 9, 1346.78, 11, 1351.18, 193
3, 10:27:00-000, 187, 129, 58, 2, 1349.50, 4, 1350.75, 177
3, 10:28:00-000, 210, 151, 59, 13, 1349.15, 17, 1351.11, 176
3, 10:29:00-000, 183, 131, 52, 12, 1348.00, 15, 1352.13, 162
3, 10:30:00-000, 214, 182, 32, 19, 1349.89, 13, 1352.00, 172
3, 10:31:00-000, 164, 129, 35, 3, 1348.33, 18, 1352.33, 154
3, 10:32:00-000, 218, 201, 17, 5, 1349.00, 2, 1352.50, 211
3, 10:33:00-000, 189, 163, 26, 10, 1348.20, 3, 1350.33, 170
3, 10:34:00-000, 185, 142, 43, 11, 1347.00, 11, 1350.91, 167
3, 10:35:00-000, 193, 167, 26, 10, 1348.90, 6, 1351.50, 177
3, 10:36:00-000, 197, 130, 67, 9, 1349.11, 2, 1350.50, 180
3, 10:37:00-000, 206, 150, 56, 2, 1348.50, 16, 1350.37, 196
3, 10:38:00-000, 186, 124, 62, 10, 1347.90, 16, 1351.12, 157
3, 10:39:00-000, 216, 150, 66, 7, 1348.71, 7, 1350.57, 194
3, 10:40:00-000, 205, 142, 63, 3, 1348.00, 14, 1352.21, 199
3, 10:41:00-000, 183, 167, 16, 5, 1349.00, 7, 1354.43, 172
3, 10:42:00-000, 199, 170, 29, 10, 1351.40, 6, 1352.50, 180
3, 10:43:00-000, 209, 176, 33, 5, 1349.60, 6, 1351.83, 187
3, 10:44:00-000, 215, 181, 34, 26, 1348.27, 15, 1351.06, 187
3, 10:45:00-000, 216, 174, 42, 12, 1348.25, 12, 1351.08, 192
3, 10:46:00-000, 209, 162, 47, 5, 1349.00, 10, 1351.40, 187
3, 10:47:00-000, 182, 156, 26, 6, 1350.17, 6, 1351.33, 174
3, 10:48:00-000, 204, 164, 40, 7, 1348.86, 8, 1351.00, 193
3, 10:49:00-000, 188, 164, 24, 16, 1346.94, 4, 1352.00, 163
3, 10:50:00-000, 206, 153, 53, 22, 1348.91, 14, 1351.28, 167
3, 10:51:00-000, 218, 134, 84, 3, 1350.33, 6, 1351.33, 205
3, 10:52:00-000, 181, 137, 44, 7, 1351.43, 20, 1352.70, 161
3, 10:53:00-000, 195, 185, 10, 3, 1347.67, 3, 1351.00, 191
3, 10:54:00-000, 189, 152, 37, 19, 1349.16, 12, 1352.58, 160
3, 10:55:00-000, 201, 143, 58, 4, 1348.50, 20, 1351.15, 176
3, 10:56:00-000, 180, 147, 33, 12, 1350.91, 13, 1353.77, 154
3, 10:57:00-000, 216, 208, 8, 16, 1348.62, 2, 1352.00, 198
3, 10:58:00-000, 219, 159, 60, 19, 1347.94, 10, 1351.50, 184
3, 10:59:00-000, 209, 122, 87, 8, 1348.50, 6, 1351.00, 192
3, 11:00:00-000, 213, 134, 79, 12, 1347.83, 12, 1351.00, 191
3, 11:01:00-000, 227, 137, 90, 11, 1348.55, 15, 1350.60, 199
3, 11:02:00-000, 194, 132, 62, 11, 1349.27, 11, 1351.45, 179
3, 11:03:00-000, 198, 133, 65, 4, 1352.75, 9, 1352.56, 189
3, 11:04:00-000, 191, 155, 36, 9, 1351.11, 16, 1352.87, 162
3, 11:05:00-000, 196, 176, 20, 6, 1351.50, 6, 1352.83, 180
3, 11:06:00-000, 200, 165, 35, 7, 1348.14, 1, 1352.00, 195
3, 11:07:00-000, 221, 190, 31, 1, 1347.00, 3, 1353.67, 221
3, 11:08:00-000, 200, 124, 76, 30, 1348.99, 1, 1350.00, 171
3, 11:09:00-000, 215, 112, 103, 0, 0.00, 11, 1349.91, 204
3, 11:10:00-000, 197, 129, 68, 14, 1348.57, 31, 1351.45, 151
3, 11:11:00-000, 208, 180, 28, 6, 1349.67, 13, 1352.00, 189
3, 11:12:00-000, 219, 189, 30, 9, 1346.89, 9, 1350.55, 194
3, 11:13:00-000, 215, 159, 56, 22, 1347.73, 2, 1350.50, 197
3, 11:14:00-000, 166, 111, 55, 19, 1349.47, 17, 1352.00, 124
3, 11:15:00-000, 202, 154, 48, 0, 0.00, 12, 1351.50, 194
3, 11:16:00-000, 208, 154, 54, 14, 1346.71, 9, 1350.11, 184
3, 11:17:00-000, 227, 132, 95, 13, 1346.77, 14, 1350.57, 197
3, 11:18:00-000, 218, 143, 75, 5, 1348.80, 13, 1350.69, 207
3, 11:19:00-000, 211, 179, 32, 5, 1346.00, 11, 1351.64, 194
3, 11:20:00-000, 201, 173, 28, 22, 1348.63, 4, 1351.00, 177
3, 11:21:00-000, 196, 139, 57, 3, 1347.00, 14, 1350.57, 178
3, 11:22:00-000, 206, 176, 30, 5, 1349.40, 15, 1352.00, 182
3, 11:23:00-000, 171, 154, 17, 3, 1347.00, 0, 0.00, 166
3, 11:24:00-000, 194, 137, 57, 21, 1347.09, 3, 1349.67, 172
3, 11:25:00-000, 208, 129, 79, 14, 1347.36, 3, 1350.33, 189
3, 11:26:00-000, 224, 95, 129, 13, 1348.08, 12, 1350.25, 196
3, 11:27:00-000, 177, 76, 101, 1, 1347.00, 11, 1351.18, 174
3, 11:28:00-000, 214, 139, 75, 5, 1350.00, 11, 1351.63, 197
3, 11:29:00-000, 188, 137, 51, 14, 1350.07, 14, 1350.85, 161
3, 11:30:00-000, 213, 123, 90, 13, 1347.46, 7, 1351.71, 185
3, 11:31:00-000, 190, 145, 45, 9, 1347.89, 16, 1351.75, 174
3, 11:32:00-000, 192, 147, 45, 14, 1348.14, 11, 1351.91, 163
3, 11:33:00-000, 181, 131, 50, 7, 1347.43, 16, 1351.43, 160
3, 11:34:00-000, 215, 177, 38, 17, 1350.29, 16, 1352.06, 179
3, 11:35:00-000, 170, 130, 40, 7, 1348.57, 5, 1350.80, 162
3, 11:36:00-000, 200, 139, 61, 13, 1346.38, 7, 1350.71, 177
3, 11:37:00-000, 196, 143, 53, 3, 1348.00, 11, 1351.91, 186
3, 11:38:00-000, 197, 153, 44, 11, 1348.82, 14, 1351.07, 170
3, 11:39:00-000, 216, 176, 40, 4, 1348.00, 2, 1350.00, 211
3, 11:40:00-000, 203, 153, 50, 10, 1346.80, 6, 1350.33, 187
3, 11:41:00-000, 190, 120, 70, 7, 1347.57, 7, 1351.71, 176
3, 11:42:00-000, 235, 173, 62, 20, 1347.55, 10, 1353.30, 201
3, 11:43:00-000, 242, 152, 90, 9, 1349.33, 24, 1351.33, 210
3, 11:44:00-000, 194, 134, 60, 17, 1348.70, 6, 1350.00, 174
3, 11:45:00-000, 192, 140, 52, 7, 1346.71, 8, 1351.37, 174
3, 11:46:00-000, 185, 140, 45, 18, 1347.33, 4, 1351.50, 166
3, 11:47:00-000, 225, 141, 84, 7, 1349.86, 8, 1351.25, 209
3, 11:48:00-000, 209, 108, 101, 5, 1348.80, 19, 1351.42, 175
3, 11:49:00-000, 200, 110, 90, 17, 1347.70, 14, 1351.07, 174
3, 11:50:00-000, 222, 114, 108, 18, 1348.39, 44, 1350.95, 155
3, 11:51:00-000, 163, 119, 44, 8, 1349.50, 8, 1352.75, 158
3, 11:52:00-000, 201, 151, 50, 10, 1348.50, 16, 1351.62, 173
3, 11:53:00-000, 239, 209, 30, 8, 1348.37, 3, 1350.00, 228
3, 11:54:00-000, 218, 192, 26, 11, 1350.64, 9, 1352.89, 198
3, 11:55:00-000, 214, 200, 14, 7, 1349.86, 2, 1352.00, 204
3, 11:56:00-000, 212, 200, 12, 5, 1349.00, 3, 1353.33, 196
3, 11:57:00-000, 204, 188, 16, 6, 1347.33, 3, 1352.00, 201
3, 11:58:00-000, 212, 175, 37, 19, 1348.47, 8, 1352.37, 190
3, 11:59:00-000, 221, 162, 59, 8, 1347.62, 7, 1351.14, 198
3, 12:00:00-000, 164, 131, 33, 9, 1348.00, 3, 1351.33, 159
3, 12:01:00-000, 205, 122, 83, 14, 1347.64, 15, 1351.80, 171
3, 12:02:00-000, 194, 118, 76, 8, 1346.62, 9, 1353.44, 181
3, 12:03:00-000, 189, 115, 74, 12, 1350.33, 24, 1352.21, 155
3, 12:04:00-000, 227, 157, 70, 28, 1349.57, 9, 1351.33, 191
3, 12:05:00-000, 191, 130, 61, 1, 1349.00, 18, 1350.89, 164
3, 12:06:00-000, 217, 179, 38, 2, 1347.00, 1, 1350.00, 221
3, 12:07:00-000, 191, 157, 34, 6, 1349.67, 4, 1351.25, 175
3, 12:08:00-000, 209, 170, 39, 10, 1349.40, 9, 1350.55, 187
3, 12:09:00-000, 174, 120, 54, 6, 1347.17, 10, 1350.60, 167
3, 12:10:00-000, 204, 169, 35, 16, 1348.62, 15, 1351.80, 171
3, 12:11:00-000, 230, 181, 49, 9, 1348.55, 9, 1350.89, 209
3, 12:12:00-000, 167, 128, 39, 9, 1350.78, 4, 1352.25, 158
3, 12:13:00-000, 193, 155, 38, 5, 1347.00, 12, 1351.75, 172
3, 12:14:00-000, 195, 147, 48, 20, 1350.75, 6, 1350.83, 174
3, 12:15:00-000, 210, 144, 66, 8, 1348.12, 3, 1351.00, 196
3, 12:16:00-000, 195, 128, 67, 11, 1348.54, 10, 1351.70, 171
3, 12:17:00-000, 225, 109, 116, 12, 1348.92, 15, 1350.86, 204
3, 12:18:00-000, 213, 130, 83, 9, 1347.78, 16, 1351.50, 185
3, 12:19:00-000, 182, 147, 35, 2, 1348.50, 9, 1350.22, 155
3, 12:20:00-000, 242, 177, 65, 24, 1349.04, 6, 1350.50, 228
3, 12:21:00-000, 229, 142, 87, 5, 1348.00, 21, 1351.00, 194
3, 12:22:00-000, 223, 167, 56, 30, 1348.09, 17, 1350.29, 187
3, 12:23:00-000, 208, 133, 75, 3, 1349.33, 7, 1351.14, 198
3, 12:24:00-000, 165, 91, 74, 9, 1348.11, 8, 1351.00, 146
3, 12:25:00-000, 174, 102, 72, 7, 1349.29, 8, 1351.12, 160
3, 12:26:00-000, 200, 125, 75, 0, 0.00, 8, 1349.25, 194
3, 12:27:00-000, 201, 126, 75, 7, 1349.00, 16, 1351.31, 173
3, 12:28:00-000, 221, 192, 29, 11, 1350.45, 6, 1351.33, 198
3, 12:29:00-000, 212, 154, 58, 10, 1349.40, 13, 1350.92, 195
3, 12:30:00-000, 177, 135, 42, 9, 1348.44, 8, 1349.87, 162
3, 12:31:00-000, 195, 151, 44, 4, 1352.00, 8, 1351.62, 185
3, 12:32:00-000, 213, 155, 58, 5, 1347.40, 11, 1349.73, 199
3, 12:33:00-000, 221, 188, 33, 5, 1346.60, 6, 1350.17, 206
3, 12:34:00-000, 199, 173, 26, 9, 1346.44, 3, 1351.33, 182
3, 12:35:00-000, 188, 171, 17, 7, 1350.28, 2, 1352.50, 185
3, 12:36:00-000, 191, 133, 58, 13, 1348.31, 11, 1351.54, 163
3, 12:37:00-000, 188, 137, 51, 18, 1348.66, 10, 1350.70, 165
3, 12:38:00-000, 207, 178, 29, 5, 1348.20, 10, 1351.60, 191
3, 12:39:00-000, 191, 149, 42, 19, 1349.52, 4, 1350.25, 162
3, 12:40:00-000, 215, 128, 87, 3, 1350.00, 20, 1352.05, 199
3, 12:41:00-000, 199, 135, 64, 8, 1348.87, 8, 1351.87, 183
3, 12:42:00-000, 182, 160, 22, 16, 1347.93, 17, 1351.88, 150
3, 12:43:00-000, 202, 186, 16, 1, 1348.00, 0, 0.00, 201
3, 12:44:00-000, 206, 139, 67, 10, 1348.50, 5, 1350.00, 186
3, 12:45:00-000, 188, 140, 48, 16, 1346.19, 7, 1350.86, 167
3, 12:46:00-000, 194, 132, 62, 12, 1348.58, 14, 1351.43, 166
3, 12:47:00-000, 242, 162, 80, 20, 1348.50, 16, 1351.37, 202
3, 12:48:00-000, 207, 127, 80, 19, 1348.00, 12, 1351.25, 186
3, 12:49:00-000, 198, 98, 100, 5, 1347.00, 2, 1351.00, 188
3, 12:50:00-000, 184, 105, 79, 3, 1348.33, 20, 1351.85, 164
3, 12:51:00-000, 169, 127, 42, 5, 1349.20, 7, 1351.14, 150
3, 12:52:00-000, 180, 99, 81, 18, 1348.28, 14, 1350.78, 152
3, 12:53:00-000, 186, 112, 74, 10, 1347.30, 12, 1350.58, 165
3, 12:54:00-000, 244, 151, 93, 6, 1346.67, 17, 1351.35, 223
3, 12:55:00-000, 184, 142, 42, 8, 1350.00, 22, 1352.36, 153
3, 12:56:00-000, 203, 181, 22, 11, 1348.09, 5, 1352.20, 187
3, 12:57:00-000, 189, 142, 47, 5, 1348.40, 9, 1353.22, 176
3, 12:58:00-000, 200, 160, 40, 20, 1348.20, 4, 1351.00, 170
3, 12:59:00-000, 201, 124, 77, 5, 1347.80, 2, 1350.00, 190
3, 13:00:00-000, 225, 171, 54, 5, 1347.60, 15, 1350.27, 212
3, 13:01:00-000, 188, 140, 48, 8, 1347.62, 5, 1351.80, 175
3, 13:02:00-000, 196, 145, 51, 11, 1348.18, 7, 1352.00, 181
3, 13:03:00-000, 204, 132, 72, 1, 1348.00, 14, 1352.50, 173
3, 13:04:00-000, 227, 160, 67, 20, 1349.20, 16, 1351.44, 203
3, 13:05:00-000, 218, 174, 44, 15, 1347.13, 7, 1352.86, 198
3, 13:06:00-000, 175, 132, 43, 14, 1347.43, 21, 1350.66, 132
3, 13:07:00-000, 245, 213, 32, 5, 1348.20, 2, 1350.00, 236
3, 13:08:00-000, 218, 165, 53, 12, 1347.00, 9, 1351.55, 208
3, 13:09:00-000, 197, 136, 61, 20, 1350.10, 22, 1352.50, 154
3, 13:10:00-000, 198, 141, 57, 12, 1347.16, 15, 1351.26, 162
3, 13:11:00-000, 252, 206, 46, 22, 1348.36, 10, 1351.20, 225
3, 13:12:00-000, 230, 186, 44, 10, 1348.10, 18, 1351.28, 200
3, 13:13:00-000, 230, 174, 56, 13, 1349.61, 8, 1351.12, 203
3, 13:14:00-000, 238, 164, 74, 18, 1348.44, 25, 1351.68, 208
3, 13:15:00-000, 163, 115, 48, 13, 1347.46, 5, 1350.00, 136
3, 13:16:00-000, 216, 150, 66, 16, 1348.12, 19, 1351.00, 181
3, 13:17:00-000, 211, 137, 74, 12, 1348.00, 15, 1351.00, 194
3, 13:18:00-000, 220, 138, 82, 7, 1347.43, 21, 1350.66, 191
3, 13:19:00-000, 180, 127, 53, 2, 1347.00, 6, 1349.50, 173
3, 13:20:00-000, 201, 172, 29, 14, 1349.21, 12, 1351.41, 168
3, 13:21:00-000, 162, 138, 24, 12, 1348.50, 2, 1353.00, 150
3, 13:22:00-000, 247, 172, 75, 30, 1348.03, 17, 1351.23, 195
3, 13:23:00-000, 192, 142, 50, 9, 1346.00, 5, 1352.80, 181
3, 13:24:00-000, 196, 135, 61, 20, 1348.05, 15, 1351.80, 161
3, 13:25:00-000, 195, 108, 87, 0, 0.00, 9, 1349.00, 186
3, 13:26:00-000, 182, 95, 87, 11, 1349.27, 13, 1350.69, 162
3, 13:27:00-000, 219, 126, 93, 7, 1351.71, 9, 1350.44, 201
3, 13:28:00-000, 193, 131, 62, 8, 1348.37, 11, 1351.18, 173
3, 13:29:00-000, 211, 158, 53, 9, 1349.00, 4, 1350.75, 202
3, 13:30:00-000, 173, 105, 68, 5, 1348.60, 13, 1351.08, 148
3, 13:31:00-000, 179, 127, 52, 18, 1352.66, 10, 1352.90, 158
3, 13:32:00-000, 193, 72, 121, 16, 1347.44, 11, 1351.18, 167
3, 13:33:00-000, 200, 115, 85, 21, 1348.81, 19, 1350.63, 161
3, 13:34:00-000, 194, 79, 115, 28, 1346.82, 8, 1351.37, 156
3, 13:35:00-000, 189, 42, 147, 3, 1350.33, 20, 1352.05, 167
3, 13:36:00-000, 223, 93, 130, 5, 1347.80, 18, 1351.05, 188
3, 13:37:00-000, 162, 102, 60, 1, 1351.00, 7, 1351.14, 167
3, 13:38:00-000, 186, 161, 25, 19, 1349.58, 9, 1352.11, 154
3, 13:39:00-000, 171, 138, 33, 8, 1348.37, 8, 1351.50, 156
3, 13:40:00-000, 221, 145, 76, 11, 1348.64, 16, 1351.06, 192
3, 13:41:00-000, 199, 174, 25, 3, 1347.33, 12, 1350.33, 188
3, 13:42:00-000, 224, 173, 51, 32, 1348.81, 16, 1351.31, 167
3, 13:43:00-000, 172, 109, 63, 5, 1350.40, 11, 1352.36, 165
3, 13:44:00-000, 195, 142, 53, 13, 1350.69, 28, 1351.89, 153
3, 13:45:00-000, 214, 174, 40, 22, 1347.36, 6, 1352.33, 184
3, 13:46:00-000, 226, 185, 41, 9, 1351.22, 16, 1351.93, 197
3, 13:47:00-000, 215, 154, 61, 5, 1349.20, 9, 1351.11, 203
3, 13:48:00-000, 232, 172, 60, 5, 1347.80, 8, 1347.50, 220
3, 13:49:00-000, 187, 109, 78, 10, 1346.70, 2, 1349.50, 175
3, 13:50:00-000, 195, 141, 54, 13, 1347.46, 19, 1351.31, 145
3, 13:51:00-000, 221, 179, 42, 4, 1348.25, 7, 1351.43, 226
3, 13:52:00-000, 196, 158, 38, 19, 1348.31, 10, 1352.30, 170
3, 13:53:00-000, 216, 182, 34, 9, 1347.78, 3, 1350.00, 208
3, 13:54:00-000, 199, 148, 51, 9, 1350.00, 15, 1350.86, 165
3, 13:55:00-000, 211, 163, 48, 8, 1353.12, 17, 1353.00, 192
3, 13:56:00-000, 214, 173, 41, 15, 1348.13, 5, 1350.00, 191
3, 13:57:00-000, 192, 152, 40, 7, 1347.71, 4, 1351.00, 180
3, 13:58:00-000, 192, 163, 29, 9, 1354.00, 9, 1351.33, 167
3, 13:59:00-000, 204, 155, 49, 6, 1348.33, 15, 1351.00, 188
3, 14:00:00-000, 215, 133, 82, 29, 1349.20, 10, 1350.80, 180
3, 14:01:00-000, 199, 107, 92, 5, 1348.40, 15, 1350.87, 176
3, 14:02:00-000, 173, 71, 102, 10, 1347.40, 9, 1351.11, 161
3, 14:03:00-000, 191, 110, 81, 9, 1345.67, 8, 1352.37, 174
3, 14:04:00-000, 209, 123, 86, 7, 1348.28, 8, 1351.75, 187
3, 14:05:00-000, 175, 128, 47, 7, 1348.43, 12, 1351.67, 163
3, 14:06:00-000, 200, 165, 35, 13, 1347.84, 15, 1351.33, 172
3, 14:07:00-000, 205, 168, 37, 10, 1349.80, 5, 1351.00, 186
3, 14:08:00-000, 203, 138, 65, 12, 1348.00, 5, 1349.20, 191
3, 14:09:00-000, 182, 95, 87, 6, 1347.50, 11, 1352.36, 162
3, 14:10:00-000, 187, 143, 44, 4, 1347.75, 14, 1351.43, 171
3, 14:11:00-000, 193, 162, 31, 5, 1346.60, 7, 1351.00, 180
3, 14:12:00-000, 227, 200, 27, 12, 1347.58, 10, 1351.60, 198
3, 14:13:00-000, 188, 148, 40, 13, 1347.38, 4, 1350.75, 178
3, 14:14:00-000, 202, 134, 68, 6, 1348.83, 12, 1350.75, 175
3, 14:15:00-000, 198, 156, 42, 2, 1347.50, 2, 1351.00, 191
3, 14:16:00-000, 208, 159, 49, 16, 1347.19, 3, 1350.67, 204
3, 14:17:00-000, 191, 118, 73, 5, 1345.60, 7, 1350.43, 178
3, 14:18:00-000, 232, 164, 68, 21, 1347.24, 16, 1351.75, 193
3, 14:19:00-000, 192, 123, 69, 7, 1350.14, 8, 1350.87, 175
3, 14:20:00-000, 223, 148, 75, 6, 1346.83, 10, 1349.80, 199
3, 14:21:00-000, 197, 142, 55, 7, 1345.14, 3, 1351.00, 197
3, 14:22:00-000, 230, 135, 95, 17, 1346.47, 10, 1353.60, 198
3, 14:23:00-000, 206, 119, 87, 5, 1348.80, 16, 1352.00, 184
3, 14:24:00-000, 162, 69, 93, 9, 1348.00, 9, 1350.44, 141
3, 14:25:00-000, 217, 132, 85, 4, 1347.00, 13, 1351.23, 209
3, 14:26:00-000, 201, 156, 45, 6, 1348.00, 8, 1353.37, 183
3, 14:27:00-000, 193, 139, 54, 2, 1345.50, 3, 1352.33, 189
3, 14:28:00-000, 231, 173, 58, 10, 1348.90, 6, 1350.83, 219
3, 14:29:00-000, 190, 126, 64, 18, 1349.28, 18, 1351.67, 155
3, 14:30:00-000, 210, 156, 54, 12, 1348.50, 16, 1352.25, 174
3, 14:31:00-000, 220, 159, 61, 12, 1346.75, 6, 1350.00, 202
3, 14:32:00-000, 187, 151, 36, 7, 1346.14, 14, 1351.85, 173
3, 14:33:00-000, 184, 147, 37, 11, 1350.18, 9, 1351.00, 163
3, 14:34:00-000, 248, 194, 54, 18, 1348.22, 19, 1351.16, 194
3, 14:35:00-000, 198, 127, 71, 10, 1348.50, 7, 1349.29, 196
3, 14:36:00-000, 216, 152, 64, 18, 1350.55, 11, 1350.91, 186
3, 14:37:00-000, 238, 166, 72, 14, 1348.71, 11, 1352.00, 210
3, 14:38:00-000, 195, 144, 51, 12, 1348.58, 14, 1350.71, 171
3, 14:39:00-000, 184, 129, 55, 8, 1349.00, 6, 1351.00, 170
3, 14:40:00-000, 202, 116, 86, 9, 1347.78, 21, 1350.43, 175
3, 14:41:00-000, 220, 158, 62, 7, 1349.14, 7, 1350.57, 208
3, 14:42:00-000, 187, 142, 45, 25, 1348.20, 4, 1351.00, 150
3, 14:43:00-000, 194, 109, 85, 8, 1348.75, 6, 1350.17, 189
3, 14:44:00-000, 196, 100, 96, 11, 1347.45, 21, 1351.95, 163
3, 14:45:00-000, 213, 171, 42, 15, 1350.47, 8, 1352.87, 192
3, 14:46:00-000, 200, 145, 55, 15, 1347.60, 16, 1350.81, 166
3, 14:47:00-000, 227, 157, 70, 3, 1346.67, 10, 1351.40, 212
3, 14:48:00-000, 176, 149, 27, 5, 1348.20, 11, 1351.36, 163
3, 14:49:00-000, 205, 175, 30, 6, 1346.17, 7, 1350.86, 193
3, 14:50:00-000, 174, 110, 64, 15, 1348.53, 15, 1350.20, 138
3, 14:51:00-000, 202, 134, 68, 8, 1347.37, 4, 1351.50, 191
3, 14:52:00-000, 194, 128, 66, 9, 1347.33, 5, 1352.00, 177
3, 14:53:00-000, 215, 157, 58, 0, 0.00, 10, 1351.80, 206
3, 14:54:00-000, 192, 149, 43, 13, 1346.38, 6, 1351.00, 167
3, 14:55:00-000, 202, 152, 50, 12, 1349.58, 10, 1353.10, 188
3, 14:56:00-000, 225, 150, 75, 20, 1348.65, 22, 1351.09, 188
3, 14:57:00-000, 181, 139, 42, 9, 1348.00, 11, 1351.45, 155
3, 14:58:00-000, 197, 121, 76, 13, 1349.46, 10, 1351.70, 174
3, 14:59:00-000, 184, 112, 72, 7, 1347.43, 3, 1350.33, 175
3, 15:00:00-000, 215, 154, 61, 19, 1348.10, 6, 1351.17, 188
3, 15:01:00-000, 206, 101, 105, 12, 1348.67, 19, 1352.89, 182
3, 15:02:00-000, 226, 99, 127, 14, 1347.71, 6, 1350.33, 206
3, 15:03:00-000, 199, 91, 108, 9, 1348.22, 17, 1350.94, 169
3, 15:04:00-000, 208, 91, 117, 9, 1346.11, 17, 1350.82, 183
3, 15:05:00-000, 204, 124, 80, 14, 1348.00, 4, 1350.50, 186
3, 15:06:00-000, 212, 126, 86, 20, 1348.80, 34, 1352.76, 150
3, 15:07:00-000, 201, 126, 75, 8, 1347.12, 3, 1353.67, 198
3, 15:08:00-000, 202, 136, 66, 19, 1348.37, 26, 1351.65, 159
3, 15:09:00-000, 205, 164, 41, 5, 1352.40, 11, 1350.45, 183
3, 15:10:00-000, 233, 154, 79, 30, 1348.00, 9, 1350.78, 194
3, 15:11:00-000, 194, 99, 95, 2, 1350.00, 3, 1349.33, 195
3, 15:12:00-000, 200, 114, 86, 15, 1347.53, 17, 1349.82, 170
3, 15:13:00-000, 161, 102, 59, 14, 1349.14, 11, 1350.63, 134
3, 15:14:00-000, 186, 82, 104, 23, 1349.17, 27, 1351.15, 132
3, 15:15:00-000, 181, 118, 63, 2, 1352.50, 17, 1352.88, 167
3, 15:16:00-000, 203, 172, 31, 8, 1349.50, 9, 1352.00, 182
3, 15:17:00-000, 213, 156, 57, 16, 1347.69, 15, 1351.00, 177
3, 15:18:00-000, 211, 148, 63, 5, 1347.00, 5, 1351.20, 202
3, 15:19:00-000, 258, 210, 48, 6, 1348.33, 3, 1351.00, 248
3, 15:20:00-000, 194, 148, 46, 13, 1347.15, 13, 1351.23, 178
3, 15:21:00-000, 190, 134, 56, 7, 1348.86, 17, 1351.12, 165
3, 15:22:00-000, 180, 151, 29, 13, 1347.85, 10, 1351.60, 156
3, 15:23:00-000, 259, 188, 71, 9, 1351.00, 1, 1351.00, 244
3, 15:24:00-000, 168, 104, 64, 4, 1346.75, 4, 1351.25, 165
3, 15:25:00-000, 204, 133, 71, 11, 1347.54, 5, 1350.40, 190
3, 15:26:00-000, 216, 144, 72, 10, 1348.30, 8, 1351.62, 174
3, 15:27:00-000, 225, 152, 73, 8, 1349.37, 19, 1351.16, 206
3, 15:28:00-000, 196, 150, 46, 17, 1348.59, 17, 1351.35, 175
3, 15:29:00-000, 220, 162, 58, 15, 1347.53, 12, 1351.50, 195
3, 15:30:00-000, 221, 150, 71, 16, 1348.12, 16, 1350.81, 181
3, 15:31:00-000, 199, 108, 91, 3, 1347.00, 4, 1350.75, 187
3, 15:32:00-000, 234, 168, 66, 6, 1351.17, 17, 1353.53, 219
3, 15:33:00-000, 167, 143, 24, 12, 1348.67, 2, 1351.00, 157
3, 15:34:00-000, 214, 149, 65, 10, 1348.10, 17, 1351.41, 177
3, 15:35:00-000, 189, 167, 22, 4, 1348.00, 3, 1351.67, 194
3, 15:36:00-000, 216, 163, 53, 21, 1351.14, 15, 1351.00, 176
3, 15:37:00-000, 197, 164, 33, 3, 1349.67, 11, 1351.91, 186
3, 15:38:00-000, 205, 179, 26, 13, 1348.00, 2, 1350.50, 180
3, 15:39:00-000, 225, 198, 27, 3, 1349.00, 8, 1351.37, 215
3, 15:40:00-000, 213, 192, 21, 5, 1350.00, 5, 1350.60, 206
3, 15:41:00-000, 224, 192, 32, 14, 1348.71, 0, 0.00, 213
3, 15:42:00-000, 185, 106, 79, 10, 1348.40, 16, 1351.37, 160
3, 15:43:00-000, 222, 168, 54, 9, 1347.44, 7, 1350.57, 205
3, 15:44:00-000, 239, 176, 63, 7, 1349.29, 15, 1349.87, 220
3, 15:45:00-000, 164, 140, 24, 10, 1349.10, 13, 1352.23, 141
3, 15:46:00-000, 178, 135, 43, 14, 1350.28, 3, 1350.00, 150
3, 15:47:00-000, 179, 127, 52, 1, 1346.00, 16, 1350.25, 173
3, 15:48:00-000, 199, 167, 32, 7, 1348.43, 3, 1350.67, 182
3, 15:49:00-000, 197, 146, 51, 14, 1348.14, 6, 1350.50, 177
3, 15:50:00-000, 191, 116, 75, 12, 1347.92, 17, 1351.06, 160
3, 15:51:00-000, 224, 154, 70, 20, 1349.75, 14, 1352.43, 189
3, 15:52:00-000, 186, 112, 74, 6, 1349.50, 13, 1350.08, 178
3, 15:53:00-000, 204, 133, 71, 14, 1349.93, 17, 1352.12, 165
3, 15:54:00-000, 235, 169, 66, 9, 1348.33, 13, 1351.31, 214
3, 15:55:00-000, 215, 190, 25, 11, 1350.27, 13, 1352.46, 198
3, 15:56:00-000, 234, 197, 37, 22, 1348.54, 8, 1350.88, 203
3, 15:57:00-000, 178, 112, 66, 9, 1347.55, 11, 1351.27, 157
3, 15:58:00-000, 209, 150, 59, 16, 1346.19, 12, 1351.58, 177
3, 15:59:00-000, 193, 142, 51, 3, 1348.67, 4, 1350.50, 182
3, 16:00:00-000, 164, 96, 68, 13, 1348.08, 12, 1350.83, 148
3, 16:01:00-000, 163, 112, 51, 5, 1349.00, 11, 1351.09, 145
3, 16:02:00-000, 177, 157, 20, 8, 1353.00, 7, 1350.57, 148
3, 16:03:00-000, 214, 163, 51, 13, 1348.23, 17, 1351.12, 194
3, 16:04:00-000, 182, 147, 35, 13, 1347.15, 8, 1351.50, 157
3, 16:05:00-000, 212, 149, 63, 14, 1348.43, 16, 1352.00, 181
3, 16:06:00-000, 197, 128, 69, 9, 1350.11, 10, 1351.50, 186
3, 16:07:00-000, 200, 177, 23, 4, 1350.00, 6, 1351.00, 192
3, 16:08:00-000, 213, 173, 40, 20, 1348.60, 11, 1350.82, 174
3, 16:09:00-000, 235, 155, 80, 13, 1350.31, 9, 1351.66, 222
3, 16:10:00-000, 241, 191, 50, 21, 1348.76, 11, 1351.82, 201
3, 16:11:00-000, 190, 94, 96, 2, 1349.00, 15, 1350.73, 169
3, 16:12:00-000, 198, 117, 81, 6, 1347.17, 21, 1351.85, 178
3, 16:13:00-000, 178, 150, 28, 12, 1348.91, 4, 1352.25, 166
3, 16:14:00-000, 192, 131, 61, 16, 1348.00, 9, 1351.11, 166
3, 16:15:00-000, 191, 150, 41, 8, 1349.12, 15, 1350.87, 163
3, 16:16:00-000, 169, 86, 83, 16, 1348.31, 6, 1349.17, 148
3, 16:17:00-000, 221, 121, 100, 2, 1346.00, 7, 1350.28, 211
3, 16:18:00-000, 214, 142, 72, 9, 1348.00, 14, 1350.43, 197
3, 16:19:00-000, 159, 117, 42, 2, 1348.50, 6, 1351.67, 147
3, 16:20:00-000, 180, 134, 46, 16, 1348.62, 16, 1350.81, 153
3, 16:21:00-000, 210, 182, 28, 8, 1348.37, 5, 1350.40, 196
3, 16:22:00-000, 180, 139, 41, 10, 1347.90, 10, 1350.60, 155
3, 16:23:00-000, 197, 166, 31, 2, 1346.00, 8, 1352.50, 190
3, 16:24:00-000, 206, 169, 37, 14, 1347.71, 6, 1351.67, 188
3, 16:25:00-000, 176, 141, 35, 11, 1351.36, 5, 1350.80, 150
3, 16:26:00-000, 202, 131, 71, 12, 1347.58, 8, 1350.25, 183
3, 16:27:00-000, 208, 113, 95, 2, 1348.00, 6, 1349.00, 208
3, 16:28:00-000, 227, 140, 87, 12, 1348.92, 8, 1350.75, 206
3, 16:29:00-000, 162, 96, 66, 6, 1350.00, 24, 1351.58, 134
3, 16:30:00-000, 1, 1, 0, 0, 0.00, 0, 0.00, 0
4, 09:03:00-000, 264, 264, 0, 0, 0.00, 0, 0.00, 259
4, 09:04:00-000, 0, 0, 0, 0, 0.00, 0, 0.00, 5
4, 09:06:00-000, 278, 278, 0, 278, 1350.99, 0, 0.00, 0
4, 09:07:00-000, 3, 3, 0, 0, 0.00, 0, 0.00, 0
4, 09:08:00-000, 46, 40, 6, 9, 1351.11, 6, 1351.17, 19
4, 09:09:00-000, 60, 45, 15, 11, 1376.82, 15, 1374.73, 36
4, 09:10:00-000, 108, 80, 28, 27, 1413.77, 28, 1414.14, 48
4, 09:11:00-000, 71, 65, 6, 6, 1468.33, 6, 1468.33, 66
4, 09:12:00-000, 98, 86, 12, 9, 1516.44, 12, 1517.00, 71
4, 09:13:00-000, 81, 73, 8, 67, 1412.05, 8, 1399.37, 23
4, 09:14:00-000, 90, 84, 6, 77, 1355.88, 5, 1354.40, 5
4, 09:15:00-000, 65, 59, 6, 53, 1356.16, 6, 1354.50, 5
4, 09:16:00-000, 84, 59, 25, 38, 1357.04, 22, 1358.40, 12
4, 09:17:00-000, 99, 45, 54, 43, 1358.32, 31, 1354.99, 35
4, 09:18:00-000, 64, 46, 18, 22, 1369.36, 24, 1365.66, 6
4, 09:19:00-000, 81, 37, 44, 28, 1364.14, 39, 1367.84, 25
4, 09:20:00-000, 83, 41, 42, 36, 1354.30, 40, 1354.52, 4
4, 09:21:00-000, 96, 44, 52, 44, 1351.08, 53, 1350.99, 0
4, 09:22:00-000, 92, 51, 41, 43, 1353.04, 43, 1353.46, 10
4, 09:23:00-000, 65, 36, 29, 32, 1353.93, 22, 1353.63, 6
4, 09:24:00-000, 85, 48, 37, 49, 1352.18, 44, 1352.79, 0
4, 09:25:00-000, 91, 42, 49, 39, 1351.61, 41, 1351.80, 6
4, 09:26:00-000, 95, 67, 28, 51, 1355.19, 29, 1354.92, 17
4, 09:27:00-000, 92, 40, 52, 39, 1351.56, 37, 1351.56, 7
4, 09:28:00-000, 81, 34, 47, 31, 1349.90, 45, 1350.10, 5
4, 09:29:00-000, 77, 41, 36, 39, 1353.51, 33, 1352.21, 18
4, 09:30:00-000, 84, 31, 53, 31, 1350.61, 41, 1350.89, 5
4, 09:31:00-000, 77, 51, 26, 43, 1352.60, 29, 1353.06, 8
4, 09:32:00-000, 91, 39, 52, 41, 1351.46, 42, 1351.47, 8
4, 09:33:00-000, 86, 34, 52, 31, 1349.25, 41, 1348.99, 10
4, 09:34:00-000, 87, 39, 48, 32, 1355.31, 38, 1354.73, 7
4, 09:35:00-000, 59, 29, 30, 29, 1354.20, 24, 1354.04, 21
4, 09:36:00-000, 117, 54, 63, 54, 1351.84, 52, 1352.24, 3
4, 09:37:00-000, 90, 40, 50, 39, 1350.61, 50, 1350.67, 12
4, 09:38:00-000, 68, 29, 39, 21, 1353.24, 26, 1352.68, 6
4, 09:39:00-000, 83, 31, 52, 29, 1349.55, 46, 1349.82, 18
4, 09:40:00-000, 89, 36, 53, 33, 1351.11, 44, 1351.70, 0
4, 09:41:00-000, 73, 39, 34, 40, 1351.12, 39, 1351.33, 5
4, 09:42:00-000, 82, 41, 41, 41, 1350.50, 44, 1350.63, 1
4, 09:43:00-000, 81, 38, 43, 35, 1351.62, 35, 1351.99, 6
4, 09:44:00-000, 63, 37, 26, 40, 1350.77, 30, 1351.29, 1
4, 09:45:00-000, 85, 39, 46, 37, 1352.91, 37, 1352.97, 3
4, 09:46:00-000, 74, 36, 38, 31, 1351.99, 37, 1352.75, 4
4, 09:47:00-000, 95, 35, 60, 36, 1349.44, 58, 1349.99, 7
4, 09:48:00-000, 82, 50, 32, 45, 1352.08, 24, 1352.54, 6
4, 09:49:00-000, 75, 32, 43, 37, 1350.51, 38, 1349.55, 6
4, 09:50:00-000, 96, 54, 42, 45, 1349.92, 43, 1349.85, 7
4, 09:51:00-000, 72, 34, 38, 32, 1352.37, 33, 1352.11, 11
4, 09:52:00-000, 99, 38, 61, 33, 1350.02, 45, 1349.68, 8
4, 09:53:00-000, 65, 35, 30, 35, 1351.68, 27, 1350.14, 14
4, 09:54:00-000, 61, 36, 25, 36, 1352.13, 29, 1352.79, 0
4, 09:55:00-000, 101, 47, 54, 46, 1352.01, 47, 1351.97, 1
4, 09:56:00-000, 83, 40, 43, 41, 1350.80, 37, 1350.75, 7
4, 09:57:00-000, 74, 29, 45, 29, 1350.17, 48, 1350.84, 2
4, 09:58:00-000, 84, 42, 42, 41, 1351.21, 38, 1351.20, 1
4, 09:59:00-000, 57, 37, 20, 37, 1353.80, 18, 1353.55, 4
4, 10:00:00-000, 92, 39, 53, 38, 1350.94, 45, 1351.50, 2
4, 10:01:00-000, 81, 42, 39, 41, 1351.48, 25, 1350.72, 17
4, 10:02:00-000, 87, 27, 60, 29, 1350.44, 45, 1350.37, 12
4, 10:03:00-000, 98, 56, 42, 50, 1351.39, 38, 1350.55, 11
4, 10:04:00-000, 87, 54, 33, 45, 1353.84, 27, 1353.77, 11
4, 10:05:00-000, 75, 33, 42, 32, 1349.52, 36, 1349.35, 6
4, 10:06:00-000, 105, 48, 57, 51, 1349.76, 65, 1350.42, 1
4, 10:07:00-000, 95, 60, 35, 55, 1352.55, 32, 1351.81, 0
4, 10:08:00-000, 70, 41, 29, 45, 1350.59, 25, 1350.79, 3
4, 10:09:00-000, 78, 28, 50, 29, 1350.86, 32, 1350.49, 4
4, 10:10:00-000, 93, 46, 47, 46, 1351.54, 60, 1351.45, 0
4, 10:11:00-000, 68, 30, 38, 25, 1349.55, 34, 1349.94, 7
4, 10:12:00-000, 79, 30, 49, 29, 1350.82, 31, 1350.48, 13
4, 10:13:00-000, 94, 40, 54, 34, 1349.96, 46, 1350.79, 13
4, 10:14:00-000, 84, 30, 54, 29, 1349.00, 48, 1349.87, 4
4, 10:15:00-000, 87, 58, 29, 56, 1351.56, 37, 1350.80, 8
4, 10:16:00-000, 88, 36, 52, 38, 1351.05, 34, 1350.97, 5
4, 10:17:00-000, 70, 39, 31, 36, 1350.58, 33, 1349.66, 12
4, 10:18:00-000, 85, 33, 52, 34, 1349.76, 44, 1350.47, 3
4, 10:19:00-000, 95, 36, 59, 36, 1351.52, 36, 1349.80, 21
4, 10:20:00-000, 84, 42, 42, 37, 1350.69, 38, 1350.73, 1
4, 10:21:00-000, 59, 31, 28, 32, 1352.18, 33, 1352.17, 11
4, 10:22:00-000, 83, 44, 39, 43, 1350.20, 31, 1350.12, 5
4, 10:23:00-000, 80, 29, 51, 30, 1350.39, 37, 1350.37, 0
4, 10:24:00-000, 80, 22, 58, 20, 1349.60, 46, 1350.86, 15
4, 10:25:00-000, 80, 43, 37, 40, 1349.72, 35, 1349.45, 16
4, 10:26:00-000, 60, 41, 19, 41, 1350.97, 21, 1350.47, 1
4, 10:27:00-000, 76, 29, 47, 29, 1350.24, 40, 1350.54, 3
4, 10:28:00-000, 81, 41, 40, 40, 1350.49, 37, 1351.34, 0
4, 10:29:00-000, 75, 46, 29, 40, 1351.69, 28, 1351.92, 10
4, 10:30:00-000, 92, 41, 51, 45, 1351.24, 37, 1350.97, 4
4, 10:31:00-000, 79, 51, 28, 42, 1353.71, 35, 1353.62, 5
4, 10:32:00-000, 92, 42, 50, 44, 1352.63, 38, 1352.05, 4
4, 10:33:00-000, 83, 41, 42, 39, 1349.45, 48, 1349.64, 10
4, 10:34:00-000, 82, 32, 50, 32, 1349.71, 35, 1349.25, 8
4, 10:35:00-000, 81, 45, 36, 37, 1352.86, 28, 1352.57, 12
4, 10:36:00-000, 69, 25, 44, 18, 1350.22, 33, 1351.90, 7
4, 10:37:00-000, 78, 36, 42, 38, 1350.49, 44, 1350.38, 12
4, 10:38:00-000, 131, 64, 67, 58, 1349.97, 70, 1349.00, 4
4, 10:39:00-000, 75, 28, 47, 34, 1351.55, 39, 1352.22, 1
4, 10:40:00-000, 74, 40, 34, 37, 1351.05, 35, 1351.34, 3
4, 10:41:00-000, 95, 58, 37, 48, 1352.14, 40, 1352.22, 7
4, 10:42:00-000, 64, 30, 34, 29, 1351.27, 32, 1351.03, 3
4, 10:43:00-000, 70, 33, 37, 28, 1350.60, 20, 1350.50, 17
4, 10:44:00-000, 81, 40, 41, 39, 1351.04, 49, 1351.13, 1
4, 10:45:00-000, 68, 33, 35, 34, 1351.85, 31, 1352.06, 2
4, 10:46:00-000, 90, 51, 39, 45, 1350.01, 42, 1350.56, 7
4, 10:47:00-000, 79, 40, 39, 36, 1350.97, 35, 1351.08, 5
4, 10:48:00-000, 90, 39, 51, 38, 1351.04, 42, 1350.71, 0
4, 10:49:00-000, 80, 41, 39, 40, 1352.32, 39, 1351.94, 4
4, 10:50:00-000, 82, 42, 40, 43, 1350.90, 33, 1350.90, 5
4, 10:51:00-000, 94, 56, 38, 49, 1349.65, 35, 1349.54, 15
4, 10:52:00-000, 82, 40, 42, 39, 1352.07, 37, 1351.99, 5
4, 10:53:00-000, 89, 46, 43, 44, 1350.74, 46, 1351.06, 6
4, 10:54:00-000, 91, 45, 46, 44, 1352.11, 34, 1352.17, 0
4, 10:55:00-000, 89, 48, 41, 50, 1350.61, 39, 1350.32, 13
4, 10:56:00-000, 108, 54, 54, 51, 1351.82, 50, 1351.05, 2
4, 10:57:00-000, 87, 32, 55, 30, 1351.89, 36, 1351.88, 9
4, 10:58:00-000, 71, 34, 37, 35, 1351.91, 41, 1351.31, 6
4, 10:59:00-000, 91, 41, 50, 41, 1349.31, 39, 1349.40, 5
4, 11:00:00-000, 65, 24, 41, 24, 1350.50, 40, 1349.84, 1
4, 11:01:00-000, 89, 36, 53, 32, 1349.59, 50, 1349.69, 8
4, 11:02:00-000, 116, 65, 51, 67, 1350.32, 53, 1350.50, 6
4, 11:03:00-000, 70, 27, 43, 19, 1349.00, 33, 1350.57, 10
4, 11:04:00-000, 93, 62, 31, 58, 1352.56, 36, 1352.16, 1
4, 11:05:00-000, 106, 52, 54, 55, 1351.88, 36, 1351.63, 13
4, 11:06:00-000, 62, 26, 36, 25, 1348.87, 31, 1349.48, 2
4, 11:07:00-000, 105, 50, 55, 39, 1351.58, 45, 1350.90, 19
4, 11:08:00-000, 96, 26, 70, 33, 1350.36, 53, 1349.61, 18
4, 11:09:00-000, 79, 38, 41, 35, 1347.88, 42, 1349.16, 6
4, 11:10:00-000, 84, 39, 45, 40, 1351.77, 44, 1351.54, 4
4, 11:11:00-000, 74, 47, 27, 39, 1351.02, 16, 1350.37, 14
4, 11:12:00-000, 76, 27, 49, 27, 1348.92, 47, 1349.23, 3
4, 11:13:00-000, 59, 20, 39, 19, 1350.15, 36, 1350.69, 3
4, 11:14:00-000, 115, 70, 45, 62, 1351.42, 43, 1351.01, 3
4, 11:15:00-000, 55, 31, 24, 31, 1350.93, 17, 1351.29, 12
4, 11:16:00-000, 76, 37, 39, 36, 1348.94, 32, 1349.56, 4
4, 11:17:00-000, 95, 42, 53, 43, 1349.22, 41, 1348.75, 7
4, 11:18:00-000, 101, 38, 63, 36, 1350.27, 76, 1350.62, 2
4, 11:19:00-000, 82, 46, 36, 44, 1351.26, 19, 1350.84, 4
4, 11:20:00-000, 102, 37, 65, 39, 1350.53, 62, 1350.96, 0
4, 11:21:00-000, 78, 44, 34, 36, 1349.77, 40, 1350.29, 10
4, 11:22:00-000, 84, 45, 39, 51, 1351.36, 30, 1352.33, 1
4, 11:23:00-000, 81, 26, 55, 26, 1348.57, 43, 1347.88, 14
4, 11:24:00-000, 71, 31, 40, 25, 1347.99, 43, 1348.13, 3
4, 11:25:00-000, 76, 35, 41, 30, 1349.63, 32, 1349.56, 13
4, 11:26:00-000, 68, 41, 27, 35, 1349.74, 31, 1350.28, 9
4, 11:27:00-000, 100, 46, 54, 40, 1348.87, 53, 1349.03, 2
4, 11:28:00-000, 94, 47, 47, 53, 1352.44, 45, 1351.46, 0
4, 11:29:00-000, 83, 47, 36, 44, 1352.06, 29, 1351.62, 9
4, 11:30:00-000, 95, 46, 49, 49, 1349.30, 51, 1350.09, 1
4, 11:31:00-000, 98, 54, 44, 52, 1352.03, 38, 1352.10, 4
4, 11:32:00-000, 68, 37, 31, 36, 1350.74, 26, 1351.50, 0
4, 11:33:00-000, 96, 44, 52, 39, 1350.92, 46, 1350.88, 12
4, 11:34:00-000, 71, 43, 28, 42, 1352.23, 29, 1352.58, 7
4, 11:35:00-000, 90, 42, 48, 42, 1350.32, 44, 1350.65, 2
4, 11:36:00-000, 91, 43, 48, 36, 1349.63, 47, 1350.18, 4
4, 11:37:00-000, 84, 49, 35, 48, 1351.26, 31, 1351.19, 6
4, 11:38:00-000, 78, 38, 40, 38, 1350.73, 41, 1350.84, 0
4, 11:39:00-000, 69, 34, 35, 32, 1348.28, 29, 1348.30, 2
4, 11:40:00-000, 84, 41, 43, 44, 1350.04, 41, 1350.48, 11
4, 11:41:00-000, 84, 49, 35, 45, 1350.61, 35, 1350.08, 2
4, 11:42:00-000, 88, 29, 59, 29, 1348.48, 50, 1349.75, 4
4, 11:43:00-000, 66, 35, 31, 35, 1350.65, 20, 1350.40, 12
4, 11:44:00-000, 89, 41, 48, 36, 1349.77, 30, 1349.83, 1
4, 11:45:00-000, 68, 32, 36, 35, 1350.54, 41, 1350.67, 12
4, 11:46:00-000, 86, 43, 43, 39, 1350.15, 49, 1350.70, 2
4, 11:47:00-000, 85, 37, 48, 34, 1350.93, 34, 1351.17, 5
4, 11:48:00-000, 104, 39, 65, 42, 1350.25, 54, 1350.14, 7
4, 11:49:00-000, 86, 45, 41, 43, 1350.30, 49, 1350.79, 7
4, 11:50:00-000, 90, 57, 33, 57, 1351.04, 35, 1350.74, 0
4, 11:51:00-000, 73, 26, 47, 28, 1350.74, 39, 1351.35, 0
4, 11:52:00-000, 73, 34, 39, 28, 1349.82, 35, 1350.54, 8
4, 11:53:00-000, 81, 41, 40, 40, 1350.94, 37, 1350.97, 5
4, 11:54:00-000, 73, 38, 35, 35, 1352.91, 29, 1352.68, 3
4, 11:55:00-000, 89, 39, 50, 39, 1351.07, 44, 1350.99, 9
4, 11:56:00-000, 56, 30, 26, 33, 1352.48, 25, 1351.40, 1
4, 11:57:00-000, 91, 50, 41, 46, 1350.19, 44, 1348.97, 2
4, 11:58:00-000, 104, 59, 45, 58, 1350.18, 46, 1350.21, 8
4, 11:59:00-000, 74, 32, 42, 32, 1350.49, 33, 1350.66, 0
4, 12:00:00-000, 104, 46, 58, 46, 1350.32, 58, 1351.46, 0
4, 12:01:00-000, 75, 44, 31, 39, 1349.97, 36, 1350.60, 5
4, 12:02:00-000, 81, 26, 55, 29, 1348.13, 39, 1347.99, 4
4, 12:03:00-000, 99, 61, 38, 59, 1351.70, 46, 1351.19, 4
4, 12:04:00-000, 70, 31, 39, 30, 1350.73, 21, 1350.71, 6
4, 12:05:00-000, 87, 43, 44, 40, 1350.24, 48, 1350.72, 7
4, 12:06:00-000, 85, 31, 54, 30, 1349.23, 56, 1350.15, 1
4, 12:07:00-000, 75, 38, 37, 38, 1349.41, 31, 1348.70, 5
4, 12:08:00-000, 76, 28, 48, 26, 1350.61, 37, 1350.78, 5
4, 12:09:00-000, 104, 46, 58, 47, 1350.65, 49, 1350.15, 17
4, 12:10:00-000, 90, 46, 44, 41, 1351.14, 38, 1351.63, 3
4, 12:11:00-000, 83, 43, 40, 37, 1350.67, 38, 1350.60, 13
4, 12:12:00-000, 87, 45, 42, 46, 1350.51, 38, 1350.52, 0
4, 12:13:00-000, 80, 38, 42, 38, 1350.49, 34, 1350.02, 9
4, 12:14:00-000, 75, 34, 41, 37, 1348.64, 45, 1348.97, 0
4, 12:15:00-000, 77, 38, 39, 33, 1350.78, 24, 1350.37, 5
4, 12:16:00-000, 105, 47, 58, 49, 1348.99, 67, 1348.85, 7
4, 12:17:00-000, 69, 32, 37, 30, 1350.29, 36, 1350.63, 0
4, 12:18:00-000, 85, 49, 36, 46, 1350.58, 35, 1350.71, 7
4, 12:19:00-000, 85, 49, 36, 43, 1350.29, 28, 1350.21, 7
4, 12:20:00-000, 97, 45, 52, 45, 1350.81, 43, 1351.22, 8
4, 12:21:00-000, 80, 43, 37, 39, 1349.89, 35, 1350.28, 7
4, 12:22:00-000, 66, 33, 33, 34, 1350.64, 26, 1350.53, 8
4, 12:23:00-000, 62, 36, 26, 36, 1350.77, 24, 1350.54, 6
4, 12:24:00-000, 83, 36, 47, 30, 1349.36, 39, 1349.58, 7
4, 12:25:00-000, 64, 22, 42, 25, 1349.15, 36, 1349.66, 8
4, 12:26:00-000, 88, 38, 50, 38, 1348.89, 45, 1348.99, 7
4, 12:27:00-000, 86, 49, 37, 49, 1352.11, 31, 1352.12, 2
4, 12:28:00-000, 67, 43, 24, 44, 1352.04, 27, 1351.96, 1
4, 12:29:00-000, 74, 33, 41, 32, 1351.34, 39, 1351.09, 2
4, 12:30:00-000, 103, 46, 57, 46, 1349.80, 52, 1349.14, 6
4, 12:31:00-000, 67, 41, 26, 38, 1352.18, 25, 1351.76, 2
4, 12:32:00-000, 76, 28, 48, 28, 1348.28, 39, 1348.56, 4
4, 12:33:00-000, 72, 42, 30, 35, 1350.22, 25, 1350.68, 8
4, 12:34:00-000, 67, 25, 42, 26, 1350.42, 36, 1350.71, 11
4, 12:35:00-000, 112, 59, 53, 54, 1350.81, 44, 1350.42, 6
4, 12:36:00-000, 88, 41, 47, 41, 1351.33, 44, 1351.83, 2
4, 12:37:00-000, 72, 29, 43, 34, 1352.02, 43, 1351.90, 6
4, 12:38:00-000, 89, 42, 47, 40, 1351.79, 44, 1352.13, 1
4, 12:39:00-000, 83, 38, 45, 39, 1350.53, 40, 1350.87, 3
4, 12:40:00-000, 85, 42, 43, 36, 1350.52, 45, 1350.55, 6
4, 12:41:00-000, 85, 38, 47, 36, 1351.33, 25, 1350.59, 12
4, 12:42:00-000, 96, 50, 46, 49, 1350.81, 54, 1350.60, 6
4, 12:43:00-000, 76, 36, 40, 29, 1349.20, 31, 1349.70, 11
4, 12:44:00-000, 81, 51, 30, 50, 1349.91, 25, 1350.24, 5
4, 12:45:00-000, 90, 47, 43, 46, 1350.56, 44, 1350.70, 10
4, 12:46:00-000, 78, 25, 53, 27, 1347.59, 38, 1348.13, 6
4, 12:47:00-000, 92, 54, 38, 54, 1350.97, 40, 1351.17, 0
4, 12:48:00-000, 76, 47, 29, 39, 1351.14, 28, 1351.39, 1
4, 12:49:00-000, 74, 19, 55, 24, 1350.04, 40, 1350.29, 9
4, 12:50:00-000, 93, 31, 62, 27, 1350.00, 62, 1350.31, 6
4, 12:51:00-000, 83, 49, 34, 38, 1351.26, 35, 1350.77, 16
4, 12:52:00-000, 73, 29, 44, 25, 1348.64, 36, 1350.33, 2
4, 12:53:00-000, 87, 42, 45, 43, 1349.83, 32, 1350.31, 16
4, 12:54:00-000, 71, 32, 39, 32, 1350.93, 44, 1350.54, 2
4, 12:55:00-000, 89, 38, 51, 39, 1351.27, 37, 1351.51, 14
4, 12:56:00-000, 74, 41, 33, 41, 1351.65, 26, 1351.53, 9
4, 12:57:00-000, 66, 30, 36, 27, 1349.66, 33, 1349.99, 4
4, 12:58:00-000, 100, 45, 55, 46, 1351.00, 48, 1350.66, 9
4, 12:59:00-000, 80, 39, 41, 39, 1348.79, 35, 1349.05, 3
4, 13:00:00-000, 110, 36, 74, 31, 1348.86, 72, 1349.66, 1
4, 13:01:00-000, 74, 27, 47, 28, 1350.14, 44, 1349.90, 5
4, 13:02:00-000, 61, 36, 25, 37, 1350.10, 30, 1350.86, 1
4, 13:03:00-000, 83, 56, 27, 51, 1351.73, 23, 1351.30, 6
4, 13:04:00-000, 71, 27, 44, 30, 1350.03, 24, 1352.16, 19
4, 13:05:00-000, 89, 37, 52, 37, 1349.21, 31, 1349.73, 11
4, 13:06:00-000, 101, 57, 44, 53, 1350.54, 57, 1350.23, 0
4, 13:07:00-000, 101, 41, 60, 34, 1349.88, 42, 1350.49, 8
4, 13:08:00-000, 71, 26, 45, 26, 1349.88, 52, 1350.55, 0
4, 13:09:00-000, 81, 40, 41, 45, 1352.86, 40, 1352.52, 7
4, 13:10:00-000, 82, 45, 37, 40, 1349.92, 36, 1350.38, 3
4, 13:11:00-000, 90, 63, 27, 60, 1352.55, 24, 1352.04, 7
4, 13:12:00-000, 71, 38, 33, 40, 1351.32, 34, 1351.29, 0
4, 13:13:00-000, 86, 42, 44, 42, 1350.90, 37, 1350.83, 0
4, 13:14:00-000, 83, 39, 44, 36, 1349.99, 46, 1350.73, 0
4, 13:15:00-000, 72, 42, 30, 39, 1349.43, 26, 1350.38, 1
4, 13:16:00-000, 108, 52, 56, 58, 1350.90, 62, 1351.25, 4
4, 13:17:00-000, 93, 46, 47, 42, 1349.04, 40, 1348.92, 2
4, 13:18:00-000, 68, 30, 38, 30, 1349.23, 43, 1349.87, 4
4, 13:19:00-000, 83, 25, 58, 24, 1347.21, 36, 1348.05, 6
4, 13:20:00-000, 86, 41, 45, 40, 1351.52, 52, 1351.37, 2
4, 13:21:00-000, 79, 37, 42, 35, 1350.19, 40, 1349.92, 3
4, 13:22:00-000, 74, 48, 26, 50, 1350.11, 30, 1351.43, 4
4, 13:23:00-000, 88, 37, 51, 33, 1349.54, 32, 1350.28, 7
4, 13:24:00-000, 83, 41, 42, 43, 1349.52, 52, 1349.78, 1
4, 13:25:00-000, 81, 30, 51, 28, 1349.42, 32, 1349.96, 9
4, 13:26:00-000, 91, 54, 37, 51, 1349.60, 46, 1349.88, 0
4, 13:27:00-000, 85, 31, 54, 35, 1350.45, 49, 1350.15, 3
4, 13:28:00-000, 80, 45, 35, 43, 1351.22, 39, 1351.51, 1
4, 13:29:00-000, 90, 37, 53, 35, 1349.68, 41, 1349.94, 1
4, 13:30:00-000, 86, 54, 32, 59, 1349.13, 42, 1349.97, 2
4, 13:31:00-000, 76, 38, 38, 38, 1352.23, 18, 1350.39, 2
4, 13:32:00-000, 91, 47, 44, 47, 1350.10, 59, 1351.09, 0
4, 13:33:00-000, 88, 52, 36, 51, 1350.40, 37, 1351.10, 0
4, 13:34:00-000, 63, 26, 37, 27, 1347.29, 29, 1348.82, 1
4, 13:35:00-000, 88, 46, 42, 33, 1349.48, 43, 1348.81, 13
4, 13:36:00-000, 68, 27, 41, 32, 1347.77, 38, 1348.34, 2
4, 13:37:00-000, 84, 45, 39, 43, 1348.69, 39, 1349.05, 5
4, 13:38:00-000, 61, 40, 21, 39, 1351.33, 22, 1351.31, 1
4, 13:39:00-000, 106, 51, 55, 43, 1351.81, 50, 1351.17, 8
4, 13:40:00-000, 76, 35, 41, 36, 1350.91, 38, 1350.83, 2
4, 13:41:00-000, 98, 45, 53, 38, 1349.55, 43, 1350.18, 5
4, 13:42:00-000, 78, 34, 44, 42, 1349.35, 52, 1349.36, 1
4, 13:43:00-000, 78, 42, 36, 37, 1351.18, 36, 1350.94, 0
4, 13:44:00-000, 79, 46, 33, 51, 1350.70, 30, 1349.79, 0
4, 13:45:00-000, 61, 30, 31, 30, 1353.76, 23, 1351.39, 3
4, 13:46:00-000, 80, 34, 46, 33, 1349.96, 44, 1351.13, 0
4, 13:47:00-000, 62, 32, 30, 33, 1351.05, 34, 1350.96, 1
4, 13:48:00-000, 83, 33, 50, 29, 1347.13, 49, 1347.56, 5
4, 13:49:00-000, 99, 54, 45, 45, 1348.03, 36, 1348.33, 11
4, 13:50:00-000, 80, 33, 47, 39, 1350.53, 41, 1351.02, 11
4, 13:51:00-000, 83, 48, 35, 48, 1350.80, 28, 1350.78, 3
4, 13:52:00-000, 71, 35, 36, 36, 1351.83, 34, 1351.44, 2
4, 13:53:00-000, 90, 37, 53, 36, 1349.61, 44, 1349.95, 6
4, 13:54:00-000, 100, 41, 59, 42, 1350.68, 54, 1350.75, 12
4, 13:55:00-000, 76, 44, 32, 40, 1353.32, 32, 1352.90, 3
4, 13:56:00-000, 58, 25, 33, 26, 1350.80, 30, 1350.59, 3
4, 13:57:00-000, 86, 36, 50, 32, 1350.15, 39, 1350.89, 5
4, 13:58:00-000, 73, 52, 21, 51, 1352.30, 30, 1352.13, 0
4, 13:59:00-000, 91, 38, 53, 35, 1350.42, 44, 1350.40, 9
4, 14:00:00-000, 90, 48, 42, 42, 1351.14, 44, 1351.31, 1
4, 14:01:00-000, 64, 24, 40, 26, 1349.76, 32, 1350.15, 2
4, 14:02:00-000, 73, 32, 41, 36, 1349.44, 40, 1350.47, 4
4, 14:03:00-000, 85, 33, 52, 33, 1350.06, 47, 1349.84, 5
4, 14:04:00-000, 74, 41, 33, 38, 1349.94, 33, 1350.57, 2
4, 14:05:00-000, 90, 53, 37, 47, 1352.48, 23, 1353.39, 5
4, 14:06:00-000, 74, 32, 42, 41, 1350.55, 44, 1350.77, 6
4, 14:07:00-000, 67, 43, 24, 42, 1350.40, 24, 1350.00, 4
4, 14:08:00-000, 76, 22, 54, 21, 1347.85, 35, 1347.74, 13
4, 14:09:00-000, 85, 38, 47, 36, 1350.35, 43, 1350.29, 0
4, 14:10:00-000, 111, 49, 62, 51, 1350.01, 57, 1350.27, 6
4, 14:11:00-000, 83, 51, 32, 52, 1350.34, 37, 1351.45, 3
4, 14:12:00-000, 100, 60, 40, 52, 1351.36, 35, 1351.05, 0
4, 14:13:00-000, 88, 48, 40, 48, 1351.16, 38, 1351.33, 4
4, 14:14:00-000, 84, 47, 37, 41, 1350.24, 41, 1351.53, 10
4, 14:15:00-000, 64, 33, 31, 26, 1348.57, 22, 1349.77, 6
4, 14:16:00-000, 91, 41, 50, 40, 1348.49, 41, 1349.63, 14
4, 14:17:00-000, 77, 27, 50, 25, 1349.20, 40, 1349.19, 10
4, 14:18:00-000, 64, 36, 28, 27, 1350.51, 31, 1351.25, 1
4, 14:19:00-000, 62, 28, 34, 32, 1350.65, 36, 1350.80, 10
4, 14:20:00-000, 99, 46, 53, 47, 1348.33, 35, 1349.39, 9
4, 14:21:00-000, 77, 45, 32, 39, 1349.61, 28, 1349.35, 4
4, 14:22:00-000, 85, 45, 40, 49, 1349.09, 43, 1349.78, 7
4, 14:23:00-000, 83, 38, 45, 38, 1349.75, 24, 1348.00, 7
4, 14:24:00-000, 72, 31, 41, 30, 1350.19, 45, 1350.30, 2
4, 14:25:00-000, 60, 24, 36, 25, 1349.96, 33, 1350.11, 5
4, 14:26:00-000, 74, 24, 50, 16, 1345.25, 43, 1346.99, 6
4, 14:27:00-000, 85, 44, 41, 32, 1349.27, 39, 1350.04, 17
4, 14:28:00-000, 100, 46, 54, 45, 1349.88, 54, 1350.45, 6
4, 14:29:00-000, 91, 58, 33, 58, 1352.03, 24, 1352.41, 6
4, 14:30:00-000, 90, 52, 38, 55, 1351.83, 41, 1352.31, 3
4, 14:31:00-000, 74, 26, 48, 26, 1349.76, 41, 1349.41, 3
4, 14:32:00-000, 77, 31, 46, 25, 1349.56, 43, 1350.11, 4
4, 14:33:00-000, 78, 30, 48, 34, 1351.34, 42, 1351.85, 6
4, 14:34:00-000, 107, 55, 52, 48, 1349.91, 58, 1350.69, 2
4, 14:35:00-000, 68, 28, 40, 31, 1349.90, 40, 1350.24, 2
4, 14:36:00-000, 75, 37, 38, 37, 1349.56, 32, 1350.40, 2
4, 14:37:00-000, 82, 39, 43, 39, 1350.61, 40, 1351.19, 1
4, 14:38:00-000, 85, 57, 28, 59, 1350.82, 32, 1351.02, 2
4, 14:39:00-000, 75, 30, 45, 29, 1350.20, 37, 1349.61, 0
4, 14:40:00-000, 85, 44, 41, 44, 1349.56, 42, 1349.16, 0
4, 14:41:00-000, 81, 31, 50, 30, 1350.89, 46, 1350.71, 2
4, 14:42:00-000, 72, 41, 31, 39, 1349.12, 38, 1350.07, 0
4, 14:43:00-000, 88, 46, 42, 46, 1349.43, 31, 1349.67, 6
4, 14:44:00-000, 80, 60, 20, 62, 1351.18, 24, 1351.04, 1
4, 14:45:00-000, 107, 53, 54, 51, 1353.60, 39, 1353.51, 1
4, 14:46:00-000, 91, 35, 56, 31, 1349.70, 58, 1350.66, 8
4, 14:47:00-000, 64, 30, 34, 32, 1351.31, 34, 1351.43, 6
4, 14:48:00-000, 66, 31, 35, 31, 1350.28, 34, 1350.88, 4
4, 14:49:00-000, 74, 33, 41, 29, 1350.79, 25, 1350.96, 4
4, 14:50:00-000, 90, 41, 49, 39, 1350.02, 65, 1350.40, 2
4, 14:51:00-000, 69, 34, 35, 33, 1349.45, 26, 1349.65, 0
4, 14:52:00-000, 75, 27, 48, 29, 1349.79, 41, 1350.14, 9
4, 14:53:00-000, 82, 27, 55, 27, 1350.07, 37, 1350.21, 5
4, 14:54:00-000, 88, 45, 43, 42, 1350.56, 62, 1351.04, 1
4, 14:55:00-000, 79, 53, 26, 54, 1352.54, 25, 1352.36, 0
4, 14:56:00-000, 96, 64, 32, 53, 1350.27, 27, 1350.37, 6
4, 14:57:00-000, 91, 30, 61, 40, 1349.64, 51, 1350.48, 4
4, 14:58:00-000, 71, 42, 29, 42, 1350.68, 32, 1350.93, 3
4, 14:59:00-000, 88, 37, 51, 35, 1349.39, 46, 1350.12, 2
4, 15:00:00-000, 75, 31, 44, 35, 1348.77, 40, 1350.59, 8
4, 15:01:00-000, 82, 41, 41, 39, 1350.15, 37, 1350.40, 2
4, 15:02:00-000, 76, 39, 37, 35, 1349.42, 38, 1350.02, 5
4, 15:03:00-000, 99, 51, 48, 49, 1350.36, 41, 1351.63, 3
4, 15:04:00-000, 73, 31, 42, 34, 1349.23, 44, 1349.26, 4
4, 15:05:00-000, 79, 42, 37, 40, 1349.67, 35, 1349.42, 2
4, 15:06:00-000, 70, 33, 37, 34, 1354.05, 30, 1352.56, 2
4, 15:07:00-000, 67, 28, 39, 28, 1352.32, 33, 1350.69, 9
4, 15:08:00-000, 92, 49, 43, 46, 1352.01, 37, 1352.10, 0
4, 15:09:00-000, 94, 40, 54, 43, 1350.93, 48, 1350.68, 10
4, 15:10:00-000, 84, 37, 47, 34, 1350.88, 43, 1350.76, 5
4, 15:11:00-000, 92, 43, 49, 40, 1348.84, 48, 1349.26, 2
4, 15:12:00-000, 79, 38, 41, 41, 1347.85, 43, 1349.90, 2
4, 15:13:00-000, 94, 33, 61, 35, 1348.31, 33, 1347.69, 8
4, 15:14:00-000, 83, 44, 39, 41, 1350.04, 50, 1349.83, 5
4, 15:15:00-000, 97, 64, 33, 45, 1351.86, 24, 1352.16, 9
4, 15:16:00-000, 103, 46, 57, 61, 1351.23, 43, 1351.04, 18
4, 15:17:00-000, 54, 26, 28, 24, 1350.66, 25, 1351.23, 8
4, 15:18:00-000, 74, 39, 35, 41, 1350.31, 34, 1350.29, 2
4, 15:19:00-000, 123, 39, 84, 40, 1349.47, 47, 1349.61, 10
4, 15:20:00-000, 70, 39, 31, 34, 1350.02, 58, 1350.28, 2
4, 15:21:00-000, 113, 48, 65, 50, 1350.85, 42, 1350.70, 4
4, 15:22:00-000, 109, 43, 66, 42, 1348.78, 64, 1349.47, 15
4, 15:23:00-000, 86, 37, 49, 38, 1349.15, 41, 1349.74, 2
4, 15:24:00-000, 85, 38, 47, 33, 1350.42, 51, 1350.60, 6
4, 15:25:00-000, 67, 32, 35, 29, 1348.00, 18, 1347.94, 10
4, 15:26:00-000, 93, 54, 39, 57, 1351.01, 45, 1350.44, 1
4, 15:27:00-000, 78, 47, 31, 40, 1350.59, 31, 1350.57, 4
4, 15:28:00-000, 82, 36, 46, 37, 1350.18, 34, 1351.05, 21
4, 15:29:00-000, 86, 47, 39, 39, 1350.20, 33, 1350.66, 2
4, 15:30:00-000, 81, 33, 48, 41, 1349.82, 37, 1350.59, 9
4, 15:31:00-000, 82, 48, 34, 37, 1349.86, 35, 1351.14, 11
4, 15:32:00-000, 77, 40, 37, 42, 1352.68, 21, 1352.90, 6
4, 15:33:00-000, 96, 37, 59, 37, 1348.32, 53, 1348.82, 7
4, 15:34:00-000, 79, 47, 32, 52, 1350.63, 31, 1350.90, 7
4, 15:35:00-000, 85, 38, 47, 32, 1348.65, 43, 1348.90, 7
4, 15:36:00-000, 85, 27, 58, 28, 1352.03, 49, 1351.71, 1
4, 15:37:00-000, 78, 38, 40, 37, 1350.86, 36, 1350.83, 9
4, 15:38:00-000, 58, 26, 32, 27, 1350.14, 37, 1350.59, 0
4, 15:39:00-000, 84, 50, 34, 43, 1351.99, 30, 1351.76, 5
4, 15:40:00-000, 84, 38, 46, 43, 1350.43, 34, 1349.96, 4
4, 15:41:00-000, 84, 31, 53, 31, 1350.41, 48, 1349.99, 4
4, 15:42:00-000, 94, 39, 55, 40, 1350.34, 61, 1350.36, 4
4, 15:43:00-000, 74, 40, 34, 36, 1351.08, 28, 1350.96, 0
4, 15:44:00-000, 66, 35, 31, 38, 1349.33, 29, 1349.99, 1
4, 15:45:00-000, 90, 53, 37, 51, 1351.58, 28, 1350.99, 4
4, 15:46:00-000, 57, 27, 30, 28, 1348.85, 26, 1349.07, 16
4, 15:47:00-000, 84, 51, 33, 39, 1349.40, 25, 1349.47, 0
4, 15:48:00-000, 79, 28, 51, 40, 1348.02, 47, 1349.33, 2
4, 15:49:00-000, 109, 43, 66, 40, 1350.29, 56, 1350.15, 11
4, 15:50:00-000, 97, 54, 43, 53, 1350.18, 54, 1350.73, 3
4, 15:51:00-000, 84, 51, 33, 54, 1350.32, 30, 1349.46, 0
4, 15:52:00-000, 79, 37, 42, 33, 1349.84, 43, 1350.06, 1
4, 15:53:00-000, 81, 44, 37, 41, 1351.63, 21, 1350.57, 5
4, 15:54:00-000, 89, 41, 48, 36, 1349.83, 58, 1350.13, 4
4, 15:55:00-000, 70, 39, 31, 41, 1352.31, 29, 1352.10, 6
4, 15:56:00-000, 72, 40, 32, 40, 1350.24, 33, 1350.78, 1
4, 15:57:00-000, 90, 40, 50, 39, 1351.25, 24, 1350.25, 2
4, 15:58:00-000, 91, 27, 64, 27, 1348.22, 69, 1349.91, 15
4, 15:59:00-000, 77, 38, 39, 34, 1350.32, 38, 1350.89, 2
4, 16:00:00-000, 83, 45, 38, 44, 1349.86, 29, 1350.06, 4
4, 16:01:00-000, 77, 36, 41, 39, 1351.74, 35, 1352.02, 11
4, 16:02:00-000, 96, 45, 51, 47, 1351.05, 54, 1351.43, 0
4, 16:03:00-000, 111, 59, 52, 55, 1349.94, 45, 1349.99, 2
4, 16:04:00-000, 78, 28, 50, 25, 1349.04, 45, 1349.99, 2
4, 16:05:00-000, 101, 55, 46, 43, 1350.23, 55, 1350.10, 9
4, 16:06:00-000, 80, 50, 30, 54, 1351.51, 30, 1351.86, 0
4, 16:07:00-000, 73, 32, 41, 36, 1350.55, 30, 1350.10, 5
4, 16:08:00-000, 84, 44, 40, 40, 1350.74, 49, 1351.27, 5
4, 16:09:00-000, 72, 21, 51, 17, 1349.53, 36, 1349.77, 1
4, 16:10:00-000, 80, 42, 38, 44, 1351.04, 51, 1350.87, 1
4, 16:11:00-000, 68, 37, 31, 38, 1350.04, 20, 1350.09, 6
4, 16:12:00-000, 81, 47, 34, 41, 1351.70, 39, 1350.86, 0
4, 16:13:00-000, 100, 33, 67, 39, 1353.07, 58, 1351.78, 4
4, 16:14:00-000, 96, 61, 35, 54, 1351.06, 37, 1351.80, 0
4, 16:15:00-000, 75, 50, 25, 49, 1351.48, 27, 1352.48, 4
4, 16:16:00-000, 91, 35, 56, 37, 1348.97, 43, 1348.15, 5
4, 16:17:00-000, 98, 23, 75, 23, 1347.30, 55, 1347.34, 9
4, 16:18:00-000, 86, 38, 48, 38, 1351.47, 63, 1350.27, 8
4, 16:19:00-000, 101, 61, 40, 56, 1351.04, 39, 1350.56, 0
4, 16:20:00-000, 77, 40, 37, 41, 1350.85, 31, 1351.58, 0
4, 16:21:00-000, 81, 38, 43, 42, 1350.54, 38, 1350.73, 2
4, 16:22:00-000, 71, 43, 28, 37, 1349.83, 36, 1349.77, 1
4, 16:23:00-000, 68, 25, 43, 31, 1349.90, 31, 1350.25, 2
4, 16:24:00-000, 83, 42, 41, 41, 1350.60, 43, 1350.99, 6
4, 16:25:00-000, 90, 49, 41, 50, 1351.41, 29, 1350.79, 1
4, 16:26:00-000, 77, 25, 52, 25, 1347.95, 58, 1349.23, 4
4, 16:27:00-000, 117, 53, 64, 46, 1349.41, 58, 1349.68, 3
4, 16:28:00-000, 81, 34, 47, 38, 1349.00, 45, 1350.30, 5
4, 16:29:00-000, 95, 56, 39, 55, 1351.57, 41, 1351.19, 3
5, 09:13:00-000, 10208, 5651, 4557, 3926, 1348.06, 3753, 1349.33, 0
5, 09:14:00-000, 0, 0, 0, 0, 0.00, 9, 1357.00, 625
5, 09:15:00-000, 0, 0, 0, 1, 1347.00, 60, 1357.00, 1829
5, 09:16:00-000, 0, 0, 0, 0, 0.00, 0, 0.00, 5
5, 09:26:00-000, 10287, 5497, 4790, 3676, 1348.35, 3767, 1348.45, 0
5, 09:27:00-000, 0, 0, 0, 52, 1348.00, 49, 1356.00, 0
5, 09:28:00-000, 4, 2, 2, 24, 1348.00, 56, 1356.76, 1996
5, 09:29:00-000, 27, 12, 15, 9, 1348.78, 15, 1351.33, 670
5, 09:30:00-000, 66, 31, 35, 18, 1350.44, 35, 1351.45, 0
5, 09:31:00-000, 0, 0, 0, 0, 0.00, 0, 0.00, 4
5, 09:32:00-000, 230, 138, 92, 97, 1350.67, 92, 1351.95, 13
5, 09:33:00-000, 402, 192, 210, 158, 1348.50, 167, 1348.91, 14
5, 09:34:00-000, 642, 377, 265, 260, 1350.00, 283, 1351.69, 26
5, 09:35:00-000, 0, 0, 0, 10, 1348.00, 15, 1359.40, 34
5, 09:36:00-000, 972, 521, 451, 347, 1349.58, 388, 1350.62, 89
5, 09:37:00-000, 1048, 561, 487, 400, 1348.66, 422, 1349.30, 119
5, 09:38:00-000, 1321, 709, 612, 474, 1348.64, 538, 1350.00, 160
5, 09:39:00-000, 0, 0, 0, 22, 1347.00, 5, 1357.00, 170
5, 09:40:00-000, 1343, 708, 635, 500, 1348.91, 524, 1349.73, 256
5, 09:41:00-000, 1172, 622, 550, 457, 1348.88, 450, 1349.17, 199
5, 09:42:00-000, 1112, 607, 505, 456, 1349.09, 457, 1349.97, 230
5, 09:43:00-000, 0, 0, 0, 12, 1346.00, 47, 1357.61, 143
5, 09:44:00-000, 1058, 553, 505, 447, 1348.11, 457, 1349.78, 166
5, 09:45:00-000, 1001, 522, 479, 365, 1348.10, 412, 1349.27, 122
5, 09:46:00-000, 930, 471, 459, 360, 1348.54, 416, 1350.25, 137
5, 09:47:00-000, 0, 0, 0, 22, 1346.18, 0, 0.00, 122
5, 09:48:00-000, 927, 512, 415, 331, 1349.41, 313, 1350.05, 141
5, 09:49:00-000, 912, 486, 426, 422, 1348.87, 372, 1349.58, 154
5, 09:50:00-000, 955, 516, 439, 411, 1348.50, 358, 1349.53, 124
5, 09:51:00-000, 0, 0, 0, 27, 1346.00, 18, 1356.00, 107
5, 09:52:00-000, 995, 471, 524, 424, 1347.49, 428, 1348.59, 141
5, 09:53:00-000, 1103, 519, 584, 405, 1348.66, 426, 1349.06, 109
5, 09:54:00-000, 1096, 569, 527, 389, 1349.03, 496, 1350.55, 113
5, 09:55:00-000, 1, 1, 0, 31, 1346.42, 4, 1357.00, 192
5, 09:56:00-000, 1072, 537, 535, 378, 1348.54, 478, 1349.87, 160
5, 09:57:00-000, 1029, 538, 491, 414, 1348.70, 395, 1349.32, 169
5, 09:58:00-000, 1102, 575, 527, 415, 1349.26, 434, 1350.39, 159
5, 09:59:00-000, 0, 0, 0, 30, 1346.53, 4, 1356.00, 137
5, 10:00:00-000, 1006, 520, 486, 383, 1348.76, 425, 1350.02, 207
5, 10:01:00-000, 1030, 549, 481, 389, 1349.04, 379, 1349.41, 161
5, 10:02:00-000, 1067, 527, 540, 468, 1347.71, 387, 1348.53, 125
5, 10:03:00-000, 0, 0, 0, 13, 1346.00, 21, 1354.00, 166
5, 10:04:00-000, 999, 535, 464, 386, 1348.72, 451, 1350.02, 140
5, 10:05:00-000, 930, 471, 459, 374, 1348.84, 367, 1348.90, 157
5, 10:06:00-000, 1022, 538, 484, 413, 1348.27, 404, 1348.91, 132
5, 10:07:00-000, 0, 0, 0, 18, 1345.00, 48, 1356.43, 105
5, 10:08:00-000, 1051, 588, 463, 474, 1349.16, 402, 1350.10, 158
5, 10:09:00-000, 1040, 538, 502, 440, 1348.64, 403, 1349.43, 108
5, 10:10:00-000, 1061, 581, 480, 428, 1348.29, 406, 1349.71, 131
5, 10:11:00-000, 1, 1, 0, 70, 1345.44, 17, 1356.00, 131
5, 10:12:00-000, 1169, 602, 567, 441, 1348.80, 499, 1349.88, 141
5, 10:13:00-000, 1102, 604, 498, 415, 1349.17, 397, 1349.72, 131
5, 10:14:00-000, 917, 449, 468, 400, 1348.69, 391, 1349.59, 200
5, 10:15:00-000, 0, 0, 0, 10, 1345.00, 13, 1355.38, 163
5, 10:16:00-000, 986, 535, 451, 394, 1348.79, 400, 1349.89, 124
5, 10:17:00-000, 1135, 580, 555, 412, 1348.90, 453, 1349.62, 131
5, 10:18:00-000, 1049, 585, 464, 444, 1348.72, 395, 1349.66, 140
5, 10:19:00-000, 0, 0, 0, 28, 1345.00, 0, 0.00, 160
5, 10:20:00-000, 975, 499, 476, 359, 1349.36, 434, 1349.67, 163
5, 10:21:00-000, 1168, 676, 492, 428, 1348.98, 431, 1349.95, 164
5, 10:22:00-000, 1150, 584, 566, 465, 1348.46, 495, 1349.13, 176
5, 10:23:00-000, 0, 0, 0, 8, 1346.00, 33, 1357.33, 186
5, 10:24:00-000, 995, 493, 502, 430, 1348.42, 431, 1349.82, 137
5, 10:25:00-000, 1031, 575, 456, 421, 1349.16, 389, 1350.15, 140
5, 10:26:00-000, 1054, 541, 513, 450, 1348.50, 364, 1349.00, 115
5, 10:27:00-000, 0, 0, 0, 0, 0.00, 27, 1356.00, 126
5, 10:28:00-000, 965, 483, 482, 406, 1348.41, 385, 1348.97, 179
5, 10:29:00-000, 981, 497, 484, 313, 1349.53, 363, 1349.77, 146
5, 10:30:00-000, 1010, 515, 495, 425, 1349.04, 492, 1350.47, 139
5, 10:31:00-000, 6, 6, 0, 6, 1346.00, 32, 1357.40, 142
5, 10:32:00-000, 1068, 609, 459, 453, 1349.85, 410, 1351.00, 159
5, 10:33:00-000, 934, 481, 453, 368, 1348.65, 360, 1349.15, 125
5, 10:34:00-000, 1051, 545, 506, 422, 1348.26, 412, 1349.55, 127
5, 10:35:00-000, 0, 0, 0, 22, 1346.04, 14, 1356.00, 143
5, 10:36:00-000, 989, 568, 421, 422, 1349.59, 408, 1351.54, 143
5, 10:37:00-000, 1128, 550, 578, 449, 1348.62, 458, 1348.81, 140
5, 10:38:00-000, 1070, 545, 525, 438, 1349.23, 373, 1349.74, 132
5, 10:39:00-000, 0, 0, 0, 20, 1345.60, 20, 1355.20, 160
5, 10:40:00-000, 1055, 577, 478, 434, 1348.88, 415, 1349.92, 172
5, 10:41:00-000, 977, 534, 443, 386, 1349.73, 387, 1350.47, 158
5, 10:42:00-000, 983, 462, 521, 423, 1347.88, 463, 1349.38, 144
5, 10:43:00-000, 0, 0, 0, 11, 1344.00, 1, 1355.00, 106
5, 10:44:00-000, 1004, 516, 488, 410, 1348.46, 379, 1349.46, 140
5, 10:45:00-000, 1031, 541, 490, 419, 1349.07, 438, 1349.78, 129
5, 10:46:00-000, 1073, 561, 512, 405, 1349.38, 447, 1350.11, 132
5, 10:47:00-000, 0, 0, 0, 23, 1347.52, 29, 1357.41, 115
5, 10:48:00-000, 1104, 598, 506, 381, 1349.12, 439, 1350.37, 166
5, 10:49:00-000, 990, 496, 494, 362, 1348.71, 402, 1349.39, 171
5, 10:50:00-000, 1034, 525, 509, 402, 1350.00, 426, 1349.91, 195
5, 10:51:00-000, 0, 0, 0, 73, 1345.70, 7, 1356.00, 126
5, 10:52:00-000, 1020, 570, 450, 409, 1349.37, 391, 1350.19, 136
5, 10:53:00-000, 994, 501, 493, 382, 1348.04, 366, 1348.31, 133
5, 10:54:00-000, 965, 475, 490, 343, 1349.23, 402, 1350.12, 174
5, 10:55:00-000, 0, 0, 0, 19, 1346.00, 18, 1356.00, 171
5, 10:56:00-000, 909, 464, 445, 352, 1348.38, 370, 1349.65, 180
5, 10:57:00-000, 1043, 487, 556, 329, 1347.94, 364, 1348.51, 132
5, 10:58:00-000, 972, 521, 451, 426, 1348.55, 412, 1350.15, 159
5, 10:59:00-000, 2, 2, 0, 19, 1346.00, 40, 1355.17, 166
5, 11:00:00-000, 1019, 525, 494, 389, 1348.01, 360, 1349.00, 126
5, 11:01:00-000, 973, 490, 483, 376, 1348.38, 354, 1348.53, 195
5, 11:02:00-000, 1080, 568, 512, 429, 1349.29, 422, 1349.50, 202
5, 11:03:00-000, 0, 0, 0, 26, 1345.11, 30, 1355.00, 150
5, 11:04:00-000, 1069, 491, 578, 382, 1347.62, 468, 1348.90, 156
5, 11:05:00-000, 994, 534, 460, 374, 1349.31, 412, 1350.22, 172
5, 11:06:00-000, 1100, 519, 581, 467, 1348.52, 500, 1349.61, 101
5, 11:07:00-000, 1, 0, 1, 15, 1345.00, 12, 1356.00, 115
5, 11:08:00-000, 1004, 524, 480, 450, 1348.23, 372, 1349.21, 149
5, 11:09:00-000, 1006, 523, 483, 400, 1349.00, 369, 1349.47, 139
5, 11:10:00-000, 1014, 542, 472, 422, 1348.87, 355, 1349.52, 136
5, 11:11:00-000, 0, 0, 0, 25, 1345.00, 45, 1356.00, 155
5, 11:12:00-000, 991, 523, 468, 405, 1348.26, 391, 1348.87, 162
5, 11:13:00-000, 1039, 571, 468, 401, 1350.20, 433, 1350.74, 123
5, 11:14:00-000, 942, 526, 416, 366, 1349.02, 351, 1350.17, 127
5, 11:15:00-000, 0, 0, 0, 20, 1346.70, 20, 1357.00, 142
5, 11:16:00-000, 1028, 506, 522, 461, 1348.08, 425, 1349.40, 165
5, 11:17:00-000, 1050, 495, 555, 385, 1348.28, 411, 1348.23, 145
5, 11:18:00-000, 1065, 581, 484, 449, 1348.81, 420, 1349.69, 125
5, 11:19:00-000, 1, 0, 1, 15, 1345.00, 15, 1356.00, 142
5, 11:20:00-000, 1066, 593, 473, 409, 1349.00, 381, 1350.06, 175
5, 11:21:00-000, 1058, 532, 526, 380, 1348.61, 380, 1349.04, 191
5, 11:22:00-000, 1111, 597, 514, 475, 1349.50, 489, 1351.02, 180
5, 11:23:00-000, 0, 0, 0, 47, 1346.53, 10, 1357.00, 160
5, 11:24:00-000, 1040, 529, 511, 415, 1348.25, 388, 1349.22, 111
5, 11:25:00-000, 1002, 457, 545, 381, 1347.73, 351, 1348.09, 176
5, 11:26:00-000, 1045, 508, 537, 429, 1347.74, 439, 1349.42, 154
5, 11:27:00-000, 0, 0, 0, 42, 1345.52, 49, 1355.00, 145
5, 11:28:00-000, 1053, 499, 554, 402, 1348.10, 428, 1349.26, 143
5, 11:29:00-000, 998, 507, 491, 359, 1349.36, 426, 1349.88, 128
5, 11:30:00-000, 1091, 590, 501, 475, 1348.65, 448, 1349.75, 156
5, 11:31:00-000, 3, 0, 3, 5, 1345.00, 25, 1356.20, 155
5, 11:32:00-000, 1038, 553, 485, 410, 1349.15, 456, 1350.65, 140
5, 11:33:00-000, 1070, 556, 514, 441, 1348.64, 385, 1349.04, 134
5, 11:34:00-000, 947, 492, 455, 368, 1348.87, 384, 1350.03, 161
5, 11:35:00-000, 0, 0, 0, 0, 0.00, 4, 1355.00, 138
5, 11:36:00-000, 976, 501, 475, 387, 1348.11, 395, 1349.35, 164
5, 11:37:00-000, 1004, 526, 478, 368, 1349.41, 341, 1349.70, 153
5, 11:38:00-000, 1079, 497, 582, 360, 1348.44, 429, 1349.25, 160
5, 11:39:00-000, 1, 0, 1, 12, 1346.00, 33, 1355.00, 199
5, 11:40:00-000, 1011, 482, 529, 412, 1348.61, 435, 1349.65, 181
5, 11:41:00-000, 976, 521, 455, 383, 1348.67, 368, 1348.81, 174
5, 11:42:00-000, 1088, 549, 539, 440, 1348.88, 410, 1349.42, 146
5, 11:43:00-000, 3, 3, 0, 16, 1346.00, 38, 1355.89, 136
5, 11:44:00-000, 1040, 538, 502, 400, 1348.89, 419, 1349.37, 159
5, 11:45:00-000, 988, 489, 499, 394, 1347.41, 378, 1347.96, 154
5, 11:46:00-000, 978, 491, 487, 349, 1348.42, 332, 1348.91, 142
5, 11:47:00-000, 7, 7, 0, 20, 1347.80, 28, 1354.28, 189
5, 11:48:00-000, 1042, 582, 460, 452, 1348.76, 386, 1349.78, 212
5, 11:49:00-000, 1006, 512, 494, 373, 1348.62, 379, 1349.07, 150
5, 11:50:00-000, 1155, 558, 597, 444, 1348.92, 445, 1349.44, 144
5, 11:51:00-000, 0, 0, 0, 0, 0.00, 33, 1355.57, 166
5, 11:52:00-000, 1021, 569, 452, 461, 1349.39, 424, 1350.51, 170
5, 11:53:00-000, 963, 513, 450, 387, 1348.93, 374, 1349.34, 139
5, 11:54:00-000, 1028, 544, 484, 399, 1348.91, 406, 1350.32, 138
5, 11:55:00-000, 1, 0, 1, 2, 1347.00, 41, 1356.48, 130
5, 11:56:00-000, 1040, 547, 493, 425, 1349.62, 412, 1350.76, 176
5, 11:57:00-000, 1012, 487, 525, 382, 1347.90, 407, 1348.73, 134
5, 11:58:00-000, 1009, 523, 486, 406, 1349.28, 370, 1350.35, 146
5, 11:59:00-000, 0, 0, 0, 4, 1346.00, 46, 1355.62, 132
5, 12:00:00-000, 1123, 561, 562, 425, 1348.85, 421, 1349.55, 183
5, 12:01:00-000, 992, 539, 453, 415, 1349.15, 386, 1349.44, 189
5, 12:02:00-000, 1025, 542, 483, 438, 1348.63, 405, 1349.19, 171
5, 12:03:00-000, 1, 1, 0, 39, 1345.28, 0, 0.00, 134
5, 12:04:00-000, 1007, 532, 475, 401, 1349.04, 406, 1350.47, 126
5, 12:05:00-000, 1111, 599, 512, 399, 1349.27, 399, 1350.28, 132
5, 12:06:00-000, 1099, 585, 514, 507, 1348.63, 354, 1349.20, 174
5, 12:07:00-000, 2, 0, 2, 29, 1345.31, 28, 1354.93, 186
5, 12:08:00-000, 930, 451, 479, 360, 1348.28, 379, 1348.64, 179
5, 12:09:00-000, 941, 461, 480, 328, 1348.37, 380, 1349.60, 171
5, 12:10:00-000, 982, 471, 511, 368, 1348.51, 435, 1349.62, 161
5, 12:11:00-000, 1, 0, 1, 0, 0.00, 18, 1355.39, 143
5, 12:12:00-000, 1009, 534, 475, 380, 1348.90, 413, 1350.12, 147
5, 12:13:00-000, 1159, 576, 583, 421, 1348.51, 451, 1349.02, 148
5, 12:14:00-000, 1170, 596, 574, 483, 1348.82, 495, 1350.14, 140
5, 12:15:00-000, 0, 0, 0, 0, 0.00, 46, 1356.95, 170
5, 12:16:00-000, 959, 465, 494, 392, 1348.24, 365, 1348.75, 175
5, 12:17:00-000, 976, 507, 469, 401, 1349.20, 396, 1350.06, 130
5, 12:18:00-000, 1024, 528, 496, 400, 1348.94, 420, 1350.31, 120
5, 12:19:00-000, 1, 0, 1, 4, 1345.00, 16, 1355.56, 147
5, 12:20:00-000, 1043, 535, 508, 340, 1349.25, 341, 1349.05, 174
5, 12:21:00-000, 1052, 548, 504, 369, 1349.31, 359, 1349.15, 259
5, 12:22:00-000, 980, 526, 454, 403, 1348.91, 340, 1349.01, 210
5, 12:23:00-000, 8, 7, 1, 0, 0.00, 9, 1354.00, 240
5, 12:24:00-000, 956, 512, 444, 351, 1349.20, 329, 1348.92, 176
5, 12:25:00-000, 1085, 510, 575, 356, 1348.44, 420, 1348.54, 193
5, 12:26:00-000, 1015, 476, 539, 406, 1348.14, 418, 1349.25, 248
5, 12:27:00-000, 0, 0, 0, 0, 0.00, 7, 1354.00, 182
5, 12:28:00-000, 1098, 483, 615, 352, 1348.22, 450, 1348.42, 190
5, 12:29:00-000, 974, 531, 443, 327, 1349.34, 315, 1349.30, 198
5, 12:30:00-000, 977, 512, 465, 415, 1349.38, 321, 1348.74, 220
5, 12:31:00-000, 0, 0, 0, 4, 1347.00, 33, 1355.00, 203
5, 12:32:00-000, 926, 439, 487, 356, 1348.57, 376, 1349.01, 193
5, 12:33:00-000, 1050, 537, 513, 427, 1349.14, 399, 1349.04, 158
5, 12:34:00-000, 1094, 576, 518, 434, 1348.68, 381, 1348.83, 157
5, 12:35:00-000, 0, 0, 0, 0, 0.00, 29, 1355.00, 152
5, 12:36:00-000, 1071, 512, 559, 425, 1348.22, 454, 1349.25, 189
5, 12:37:00-000, 1052, 492, 560, 372, 1348.34, 425, 1348.32, 167
5, 12:38:00-000, 995, 530, 465, 392, 1348.79, 368, 1349.37, 147
5, 12:39:00-000, 2, 2, 0, 8, 1347.75, 0, 0.00, 196
5, 12:40:00-000, 1040, 570, 470, 384, 1349.50, 362, 1349.48, 174
5, 12:41:00-000, 991, 497, 494, 367, 1348.56, 408, 1349.17, 225
5, 12:42:00-000, 1111, 539, 572, 446, 1347.97, 407, 1348.95, 159
5, 12:43:00-000, 1, 1, 0, 16, 1345.50, 0, 0.00, 136
5, 12:44:00-000, 999, 526, 473, 414, 1349.04, 409, 1349.36, 186
5, 12:45:00-000, 1102, 465, 637, 395, 1347.93, 454, 1348.39, 174
5, 12:46:00-000, 931, 465, 466, 350, 1347.49, 368, 1348.16, 168
5, 12:47:00-000, 0, 0, 0, 3, 1345.67, 25, 1354.00, 163
5, 12:48:00-000, 1093, 543, 550, 387, 1348.53, 411, 1349.39, 155
5, 12:49:00-000, 951, 515, 436, 367, 1349.23, 348, 1349.51, 227
5, 12:50:00-000, 1159, 603, 556, 450, 1348.60, 445, 1349.52, 156
5, 12:51:00-000, 1, 1, 0, 32, 1346.06, 23, 1354.95, 163
5, 12:52:00-000, 1046, 541, 505, 429, 1348.95, 386, 1350.08, 172
5, 12:53:00-000, 1046, 485, 561, 386, 1348.27, 365, 1348.33, 206
5, 12:54:00-000, 1000, 544, 456, 363, 1349.15, 405, 1350.16, 169
5, 12:55:00-000, 0, 0, 0, 18, 1346.05, 3, 1355.00, 188
5, 12:56:00-000, 1072, 551, 521, 414, 1348.52, 417, 1349.00, 183
5, 12:57:00-000, 1088, 600, 488, 387, 1348.82, 393, 1349.26, 229
5, 12:58:00-000, 943, 463, 480, 362, 1348.51, 355, 1349.65, 183
5, 12:59:00-000, 2, 2, 0, 59, 1344.94, 26, 1353.73, 151
5, 13:00:00-000, 980, 508, 472, 422, 1348.05, 383, 1349.38, 155
5, 13:01:00-000, 1020, 502, 518, 395, 1348.14, 378, 1348.64, 140
5, 13:02:00-000, 1029, 524, 505, 410, 1348.42, 395, 1349.53, 153
5, 13:03:00-000, 0, 0, 0, 7, 1345.00, 13, 1355.00, 158
5, 13:04:00-000, 975, 447, 528, 378, 1348.83, 451, 1350.06, 165
5, 13:05:00-000, 1040, 568, 472, 423, 1349.26, 374, 1349.84, 134
5, 13:06:00-000, 1051, 520, 531, 396, 1348.88, 447, 1349.63, 152
5, 13:07:00-000, 0, 0, 0, 22, 1346.00, 21, 1356.00, 162
5, 13:08:00-000, 940, 480, 460, 376, 1348.89, 390, 1349.90, 121
5, 13:09:00-000, 1004, 515, 489, 421, 1348.51, 402, 1350.01, 145
5, 13:10:00-000, 1040, 496, 544, 418, 1348.19, 424, 1349.13, 93
5, 13:11:00-000, 1, 0, 1, 25, 1344.40, 36, 1354.55, 143
5, 13:12:00-000, 1038, 523, 515, 445, 1348.44, 427, 1349.81, 106
5, 13:13:00-000, 1022, 537, 485, 408, 1349.49, 393, 1349.63, 122
5, 13:14:00-000, 1094, 620, 474, 478, 1349.08, 400, 1349.90, 152
5, 13:15:00-000, 0, 0, 0, 8, 1346.00, 56, 1356.67, 105
5, 13:16:00-000, 1041, 534, 507, 381, 1348.54, 376, 1349.36, 154
5, 13:17:00-000, 945, 452, 493, 336, 1348.47, 357, 1349.00, 216
5, 13:18:00-000, 958, 471, 487, 388, 1349.00, 343, 1348.99, 189
5, 13:19:00-000, 2, 2, 0, 47, 1344.66, 34, 1355.00, 158
5, 13:20:00-000, 1069, 561, 508, 443, 1348.97, 421, 1350.44, 129
5, 13:21:00-000, 1012, 493, 519, 370, 1349.19, 395, 1349.07, 126
5, 13:22:00-000, 1131, 580, 551, 389, 1348.64, 393, 1349.66, 177
5, 13:23:00-000, 0, 0, 0, 26, 1346.00, 43, 1354.76, 174
5, 13:24:00-000, 1066, 568, 498, 429, 1348.80, 391, 1349.29, 228
5, 13:25:00-000, 1077, 539, 538, 435, 1348.18, 385, 1348.85, 207
5, 13:26:00-000, 1062, 536, 526, 436, 1348.88, 436, 1349.86, 181
5, 13:27:00-000, 2, 0, 2, 0, 0.00, 54, 1355.42, 144
5, 13:28:00-000, 972, 477, 495, 342, 1348.56, 387, 1349.64, 166
5, 13:29:00-000, 977, 487, 490, 361, 1348.91, 375, 1349.95, 133
5, 13:30:00-000, 1030, 544, 486, 402, 1349.06, 376, 1348.90, 183
5, 13:31:00-000, 0, 0, 0, 1, 1346.00, 33, 1356.00, 143
5, 13:32:00-000, 1141, 582, 559, 447, 1348.71, 438, 1349.45, 219
5, 13:33:00-000, 1047, 508, 539, 390, 1349.18, 410, 1349.64, 184
5, 13:34:00-000, 1070, 467, 603, 353, 1347.99, 418, 1348.82, 166
5, 13:35:00-000, 3, 3, 0, 42, 1344.12, 11, 1354.00, 175
5, 13:36:00-000, 1040, 565, 475, 453, 1348.83, 469, 1350.07, 181
5, 13:37:00-000, 1099, 572, 527, 370, 1348.99, 384, 1349.68, 130
5, 13:38:00-000, 1034, 512, 522, 426, 1348.84, 454, 1350.39, 147
5, 13:39:00-000, 0, 0, 0, 28, 1345.39, 22, 1355.77, 201
5, 13:40:00-000, 1017, 558, 459, 430, 1349.18, 347, 1350.26, 165
5, 13:41:00-000, 1013, 533, 480, 418, 1349.03, 362, 1349.46, 153
5, 13:42:00-000, 1058, 532, 526, 417, 1348.08, 357, 1348.74, 169
5, 13:43:00-000, 0, 0, 0, 1, 1344.00, 65, 1354.68, 136
5, 13:44:00-000, 979, 541, 438, 372, 1349.31, 357, 1350.47, 187
5, 13:45:00-000, 1082, 547, 535, 417, 1349.06, 436, 1349.45, 165
5, 13:46:00-000, 1003, 589, 414, 399, 1350.01, 404, 1351.89, 155
5, 13:47:00-000, 0, 0, 0, 42, 1347.76, 19, 1357.31, 145
5, 13:48:00-000, 1052, 537, 515, 473, 1348.30, 422, 1349.58, 135
5, 13:49:00-000, 1031, 538, 493, 382, 1349.05, 398, 1349.74, 140
5, 13:50:00-000, 1006, 505, 501, 392, 1348.52, 391, 1349.03, 165
5, 13:51:00-000, 0, 0, 0, 0, 0.00, 31, 1355.64, 173
5, 13:52:00-000, 967, 467, 500, 332, 1348.36, 375, 1349.24, 157
5, 13:53:00-000, 1018, 452, 566, 339, 1348.63, 420, 1349.43, 167
5, 13:54:00-000, 995, 551, 444, 368, 1349.74, 337, 1350.43, 188
5, 13:55:00-000, 4, 4, 0, 16, 1346.81, 39, 1356.26, 173
5, 13:56:00-000, 1093, 539, 554, 388, 1348.54, 403, 1349.41, 214
5, 13:57:00-000, 1021, 532, 489, 403, 1348.94, 409, 1349.65, 192
5, 13:58:00-000, 1027, 547, 480, 412, 1349.93, 426, 1351.06, 196
5, 13:59:00-000, 2, 1, 1, 22, 1345.27, 3, 1356.00, 136
5, 14:00:00-000, 1064, 534, 530, 428, 1348.66, 428, 1349.53, 164
5, 14:01:00-000, 1015, 488, 527, 371, 1348.52, 410, 1349.29, 135
5, 14:02:00-000, 989, 515, 474, 414, 1349.00, 421, 1350.67, 173
5, 14:03:00-000, 4, 0, 4, 10, 1344.90, 45, 1356.46, 112
5, 14:04:00-000, 1077, 540, 537, 398, 1348.77, 453, 1349.90, 140
5, 14:05:00-000, 1101, 580, 521, 440, 1349.49, 441, 1349.90, 151
5, 14:06:00-000, 1033, 489, 544, 419, 1348.43, 443, 1349.13, 141
5, 14:07:00-000, 0, 0, 0, 23, 1344.52, 4, 1355.00, 165
5, 14:08:00-000, 994, 496, 498, 411, 1347.57, 367, 1348.90, 153
5, 14:09:00-000, 1067, 563, 504, 439, 1348.83, 385, 1349.52, 121
5, 14:10:00-000, 956, 447, 509, 395, 1347.55, 408, 1348.82, 164
5, 14:11:00-000, 0, 0, 0, 2, 1343.00, 28, 1355.14, 141
5, 14:12:00-000, 949, 478, 471, 386, 1348.92, 417, 1350.09, 131
5, 14:13:00-000, 992, 489, 503, 346, 1348.39, 381, 1348.86, 140
5, 14:14:00-000, 1042, 483, 559, 452, 1347.87, 412, 1348.93, 99
5, 14:15:00-000, 0, 0, 0, 25, 1344.68, 12, 1354.00, 164
5, 14:16:00-000, 1056, 517, 539, 413, 1348.03, 436, 1349.03, 132
5, 14:17:00-000, 1112, 567, 545, 440, 1348.54, 431, 1349.29, 167
5, 14:18:00-000, 1023, 496, 527, 406, 1348.97, 382, 1349.25, 164
5, 14:19:00-000, 0, 0, 0, 14, 1345.00, 3, 1354.00, 162
5, 14:20:00-000, 1047, 527, 520, 446, 1348.53, 385, 1349.08, 121
5, 14:21:00-000, 1002, 497, 505, 390, 1348.52, 403, 1349.34, 192
5, 14:22:00-000, 1020, 539, 481, 459, 1348.21, 444, 1349.42, 148
5, 14:23:00-000, 0, 0, 0, 5, 1344.00, 0, 0.00, 136
5, 14:24:00-000, 1118, 526, 592, 413, 1347.97, 472, 1348.72, 115
5, 14:25:00-000, 1034, 524, 510, 425, 1349.07, 399, 1349.34, 153
5, 14:26:00-000, 937, 463, 474, 427, 1348.12, 353, 1349.09, 130
5, 14:27:00-000, 2, 1, 1, 17, 1344.29, 21, 1354.52, 161
5, 14:28:00-000, 928, 482, 446, 368, 1349.25, 346, 1349.63, 130
5, 14:29:00-000, 1117, 571, 546, 382, 1349.20, 425, 1349.43, 150
5, 14:30:00-000, 1050, 549, 501, 477, 1348.90, 442, 1350.07, 157
5, 14:31:00-000, 0, 0, 0, 37, 1344.34, 23, 1356.00, 160
5, 14:32:00-000, 980, 498, 482, 414, 1348.32, 375, 1349.47, 137
5, 14:33:00-000, 1023, 509, 514, 379, 1348.93, 399, 1349.54, 146
5, 14:34:00-000, 1012, 485, 527, 393, 1349.00, 431, 1349.83, 139
5, 14:35:00-000, 3, 2, 1, 19, 1345.15, 19, 1355.68, 156
5, 14:36:00-000, 977, 499, 478, 355, 1348.53, 404, 1349.79, 142
5, 14:37:00-000, 1023, 525, 498, 399, 1349.37, 372, 1349.75, 144
5, 14:38:00-000, 1010, 517, 493, 367, 1348.91, 369, 1349.21, 181
5, 14:39:00-000, 0, 0, 0, 23, 1346.34, 48, 1354.49, 153
5, 14:40:00-000, 1118, 575, 543, 446, 1348.97, 419, 1349.39, 194
5, 14:41:00-000, 1008, 489, 519, 390, 1348.74, 403, 1349.18, 166
5, 14:42:00-000, 942, 513, 429, 397, 1348.58, 371, 1349.68, 173
5, 14:43:00-000, 0, 0, 0, 10, 1345.00, 22, 1356.00, 126
5, 14:44:00-000, 1031, 512, 519, 425, 1348.18, 390, 1348.97, 141
5, 14:45:00-000, 996, 500, 496, 325, 1349.29, 368, 1350.24, 135
5, 14:46:00-000, 1027, 515, 512, 369, 1349.52, 392, 1350.00, 197
5, 14:47:00-000, 4, 1, 3, 46, 1345.95, 8, 1355.00, 190
5, 14:48:00-000, 1014, 486, 528, 398, 1348.80, 427, 1349.78, 176
5, 14:49:00-000, 1047, 564, 483, 416, 1349.09, 426, 1349.92, 157
5, 14:50:00-000, 941, 516, 425, 358, 1348.37, 394, 1349.89, 138
5, 14:51:00-000, 1, 0, 1, 32, 1346.00, 9, 1356.00, 160
5, 14:52:00-000, 953, 483, 470, 390, 1348.71, 365, 1349.43, 150
5, 14:53:00-000, 1030, 488, 542, 401, 1348.48, 382, 1348.87, 117
5, 14:54:00-000, 1072, 539, 533, 446, 1349.08, 449, 1349.91, 139
5, 14:55:00-000, 3, 3, 0, 4, 1350.00, 13, 1356.00, 168
5, 14:56:00-000, 998, 510, 488, 379, 1348.60, 405, 1349.58, 148
5, 14:57:00-000, 1022, 549, 473, 385, 1348.75, 348, 1348.86, 194
5, 14:58:00-000, 949, 501, 448, 336, 1349.81, 341, 1350.23, 158
5, 14:59:00-000, 2, 1, 1, 23, 1346.04, 32, 1354.75, 193
5, 15:00:00-000, 979, 524, 455, 426, 1348.12, 352, 1348.83, 160
5, 15:01:00-000, 1077, 587, 490, 450, 1349.78, 400, 1349.93, 157
5, 15:02:00-000, 1137, 583, 554, 501, 1347.92, 455, 1349.71, 165
5, 15:03:00-000, 0, 0, 0, 14, 1344.00, 27, 1355.96, 147
5, 15:04:00-000, 1105, 507, 598, 419, 1348.11, 498, 1349.29, 143
5, 15:05:00-000, 969, 454, 515, 344, 1348.21, 431, 1348.83, 156
5, 15:06:00-000, 1056, 528, 528, 419, 1348.47, 413, 1349.30, 113
5, 15:07:00-000, 1, 1, 0, 5, 1344.80, 15, 1355.00, 126
5, 15:08:00-000, 940, 470, 470, 398, 1348.61, 440, 1349.86, 156
5, 15:09:00-000, 1044, 502, 542, 434, 1347.89, 408, 1348.36, 118
5, 15:10:00-000, 1026, 486, 540, 398, 1348.37, 453, 1349.89, 74
5, 15:11:00-000, 3, 0, 3, 21, 1345.38, 7, 1351.57, 133
5, 15:12:00-000, 1095, 560, 535, 483, 1348.07, 453, 1348.68, 148
5, 15:13:00-000, 955, 468, 487, 362, 1348.26, 397, 1349.66, 116
5, 15:14:00-000, 1041, 553, 488, 457, 1348.48, 415, 1349.70, 125
5, 15:15:00-000, 1, 1, 0, 18, 1345.55, 21, 1357.00, 121
5, 15:16:00-000, 1121, 572, 549, 493, 1348.87, 409, 1350.34, 137
5, 15:17:00-000, 1045, 521, 524, 402, 1348.47, 421, 1349.15, 152
5, 15:18:00-000, 1093, 531, 562, 441, 1348.36, 424, 1349.80, 130
5, 15:19:00-000, 0, 0, 0, 22, 1344.00, 26, 1354.23, 133
5, 15:20:00-000, 973, 449, 524, 372, 1347.00, 397, 1348.46, 169
5, 15:21:00-000, 1000, 482, 518, 364, 1348.63, 420, 1349.10, 162
5, 15:22:00-000, 1097, 538, 559, 455, 1348.10, 487, 1349.24, 163
5, 15:23:00-000, 2, 1, 1, 15, 1344.00, 27, 1355.55, 129
5, 15:24:00-000, 951, 479, 472, 382, 1348.67, 400, 1350.40, 117
5, 15:25:00-000, 1058, 441, 617, 356, 1347.93, 358, 1348.40, 122
5, 15:26:00-000, 987, 575, 412, 439, 1349.36, 427, 1350.55, 127
5, 15:27:00-000, 2, 0, 2, 44, 1345.56, 22, 1354.32, 178
5, 15:28:00-000, 1022, 502, 520, 421, 1348.19, 376, 1349.17, 132
5, 15:29:00-000, 1074, 495, 579, 404, 1348.26, 448, 1349.14, 147
5, 15:30:00-000, 1049, 523, 526, 421, 1348.37, 414, 1349.13, 151
5, 15:31:00-000, 1, 0, 1, 30, 1344.30, 13, 1354.00, 145
5, 15:32:00-000, 993, 564, 429, 424, 1349.30, 382, 1350.67, 145
5, 15:33:00-000, 1071, 575, 496, 377, 1348.95, 384, 1349.93, 145
5, 15:34:00-000, 964, 470, 494, 415, 1348.27, 353, 1348.81, 199
5, 15:35:00-000, 1, 0, 1, 0, 0.00, 18, 1354.89, 184
5, 15:36:00-000, 1005, 533, 472, 412, 1348.79, 429, 1350.42, 160
5, 15:37:00-000, 990, 516, 474, 394, 1349.52, 370, 1349.82, 143
5, 15:38:00-000, 1014, 493, 521, 313, 1348.71, 415, 1349.76, 147
5, 15:39:00-000, 4, 3, 1, 37, 1346.16, 22, 1354.95, 150
5, 15:40:00-000, 1048, 607, 441, 403, 1349.91, 299, 1348.90, 188
5, 15:41:00-000, 1002, 546, 456, 319, 1349.28, 348, 1348.97, 260
5, 15:42:00-000, 919, 514, 405, 421, 1349.62, 307, 1349.59, 197
5, 15:43:00-000, 2, 2, 0, 14, 1347.00, 0, 0.00, 226
5, 15:44:00-000, 1113, 575, 538, 414, 1349.03, 364, 1349.48, 187
5, 15:45:00-000, 1036, 510, 526, 351, 1349.25, 362, 1349.50, 224
5, 15:46:00-000, 1015, 513, 502, 435, 1348.88, 370, 1349.06, 246
5, 15:47:00-000, 8, 0, 8, 18, 1346.00, 28, 1351.32, 191
5, 15:48:00-000, 1065, 545, 520, 419, 1349.11, 355, 1349.17, 164
5, 15:49:00-000, 1039, 556, 483, 385, 1349.36, 326, 1349.03, 182
5, 15:50:00-000, 914, 463, 451, 348, 1349.57, 353, 1350.06, 239
5, 15:51:00-000, 12, 3, 9, 32, 1346.74, 6, 1352.00, 242
5, 15:52:00-000, 1061, 518, 543, 375, 1349.09, 426, 1349.58, 164
5, 15:53:00-000, 959, 524, 435, 346, 1349.25, 343, 1349.26, 124
5, 15:54:00-000, 1116, 622, 494, 430, 1349.87, 389, 1349.87, 242
5, 15:55:00-000, 1, 1, 0, 53, 1346.90, 0, 0.00, 198
5, 15:56:00-000, 1036, 527, 509, 391, 1348.79, 399, 1348.96, 190
5, 15:57:00-000, 924, 432, 492, 321, 1348.95, 360, 1349.78, 193
5, 15:58:00-000, 1097, 573, 524, 446, 1348.93, 478, 1349.36, 162
5, 15:59:00-000, 5, 0, 5, 1, 1348.00, 1, 1350.00, 172
5, 16:00:00-000, 1097, 525, 572, 402, 1348.16, 407, 1349.08, 153
5, 16:01:00-000, 980, 467, 513, 324, 1348.91, 373, 1349.44, 158
5, 16:02:00-000, 996, 515, 481, 394, 1349.25, 420, 1349.84, 236
5, 16:03:00-000, 0, 0, 0, 31, 1346.22, 17, 1356.00, 150
5, 16:04:00-000, 1038, 533, 505, 416, 1349.08, 402, 1350.44, 132
5, 16:05:00-000, 999, 519, 480, 397, 1348.92, 385, 1349.73, 171
5, 16:06:00-000, 991, 460, 531, 382, 1347.61, 425, 1348.71, 161
5, 16:07:00-000, 1, 1, 0, 2, 1347.50, 27, 1355.00, 151
5, 16:08:00-000, 1029, 522, 507, 376, 1349.16, 411, 1350.07, 126
5, 16:09:00-000, 950, 508, 442, 330, 1349.22, 365, 1349.98, 169
5, 16:10:00-000, 1023, 523, 500, 400, 1348.73, 413, 1349.48, 179
5, 16:11:00-000, 2, 0, 2, 15, 1346.00, 14, 1354.28, 156
5, 16:12:00-000, 1121, 600, 521, 448, 1349.15, 420, 1349.30, 158
5, 16:13:00-000, 994, 489, 505, 364, 1348.82, 395, 1349.31, 178
5, 16:14:00-000, 1008, 585, 423, 394, 1349.73, 380, 1350.47, 188
5, 16:15:00-000, 8, 0, 8, 29, 1346.76, 1, 1354.00, 167
5, 16:16:00-000, 1012, 573, 439, 454, 1348.81, 371, 1349.74, 158
5, 16:17:00-000, 1095, 567, 528, 360, 1348.24, 326, 1348.14, 156
5, 16:18:00-000, 1024, 492, 532, 408, 1348.75, 410, 1349.68, 225
5, 16:19:00-000, 2, 2, 0, 13, 1345.69, 26, 1354.00, 219
5, 16:20:00-000, 984, 502, 482, 386, 1349.12, 383, 1349.63, 164
5, 16:21:00-000, 1006, 530, 476, 361, 1349.76, 404, 1350.13, 164
5, 16:22:00-000, 926, 471, 455, 404, 1348.42, 355, 1349.91, 165
5, 16:23:00-000, 6, 5, 1, 39, 1346.04, 0, 0.00, 156
5, 16:24:00-000, 1128, 569, 559, 484, 1348.48, 434, 1348.99, 148
5, 16:25:00-000, 1043, 525, 518, 406, 1349.02, 389, 1349.37, 124
5, 16:26:00-000, 948, 516, 432, 405, 1348.98, 371, 1350.02, 170
5, 16:27:00-000, 0, 0, 0, 3, 1345.00, 0, 0.00, 153
5, 16:28:00-000, 1091, 543, 548, 439, 1348.87, 419, 1349.48, 164
5, 16:29:00-000, 1027, 497, 530, 431, 1349.05, 435, 1350.03, 129
6, 12:20:00-000, 6957, 3550, 3407, 1622, 1347.95, 1622, 1348.50, 0
6, 12:21:00-000, 0, 0, 0, 84, 1347.00, 47, 1354.00, 0
6, 12:22:00-000, 0, 0, 0, 5, 1346.00, 95, 1354.00, 0
6, 12:23:00-000, 0, 0, 0, 19, 1346.00, 115, 1354.00, 0
6, 12:24:00-000, 0, 0, 0, 114, 1346.00, 84, 1355.00, 0
6, 12:25:00-000, 0, 0, 0, 41, 1346.00, 0, 0.00, 0
6, 12:26:00-000, 0, 0, 0, 77, 1345.91, 0, 0.00, 0
6, 12:27:00-000, 0, 0, 0, 8, 1345.00, 0, 0.00, 0
6, 12:28:00-000, 0, 0, 0, 79, 1345.00, 0, 0.00, 0
6, 12:29:00-000, 0, 0, 0, 0, 0.00, 20, 1355.00, 0
6, 12:30:00-000, 0, 0, 0, 0, 0.00, 96, 1355.00, 0
6, 12:31:00-000, 0, 0, 0, 0, 0.00, 18, 1355.00, 0
6, 12:32:00-000, 0, 0, 0, 67, 1345.00, 0, 0.00, 0
6, 12:33:00-000, 0, 0, 0, 18, 1345.00, 2, 1356.00, 0
6, 12:34:00-000, 0, 0, 0, 64, 1345.00, 0, 0.00, 0
6, 12:36:00-000, 0, 0, 0, 0, 0.00, 58, 1356.00, 0
6, 12:37:00-000, 0, 0, 0, 21, 1344.00, 0, 0.00, 0
6, 12:38:00-000, 0, 0, 0, 28, 1344.00, 25, 1356.00, 0
6, 12:39:00-000, 0, 0, 0, 0, 0.00, 64, 1356.00, 0
6, 12:40:00-000, 0, 0, 0, 0, 0.00, 43, 1356.00, 117
6, 12:41:00-000, 0, 0, 0, 0, 0.00, 14, 1356.00, 131
6, 12:42:00-000, 0, 0, 0, 0, 0.00, 1, 1356.00, 111
6, 12:43:00-000, 0, 0, 0, 24, 1344.00, 0, 0.00, 116
6, 12:44:00-000, 0, 0, 0, 0, 0.00, 9, 1356.00, 136
6, 12:45:00-000, 0, 0, 0, 6, 1344.00, 0, 0.00, 120
6, 12:46:00-000, 0, 0, 0, 17, 1344.00, 0, 0.00, 105
6, 12:47:00-000, 0, 0, 0, 13, 1344.00, 0, 0.00, 141
6, 12:48:00-000, 0, 0, 0, 0, 0.00, 0, 0.00, 100
6, 12:49:00-000, 0, 0, 0, 0, 0.00, 0, 0.00, 129
6, 12:50:00-000, 0, 0, 0, 0, 0.00, 0, 0.00, 136
6, 12:51:00-000, 0, 0, 0, 0, 0.00, 0, 0.00, 108
6, 12:52:00-000, 0, 0, 0, 11, 1344.00, 11, 1356.00, 111
6, 12:53:00-000, 0, 0, 0, 14, 1344.00, 0, 0.00, 91
6, 12:54:00-000, 0, 0, 0, 9, 1344.00, 0, 0.00, 114
6, 12:55:00-000, 0, 0, 0, 0, 0.00, 0, 0.00, 94
6, 12:56:00-000, 0, 0, 0, 0, 0.00, 0, 0.00, 107
6, 12:57:00-000, 0, 0, 0, 0, 0.00, 0, 0.00, 118
6, 12:58:00-000, 0, 0, 0, 0, 0.00, 0, 0.00, 106
6, 12:59:00-000, 0, 0, 0, 1, 1344.00, 0, 0.00, 99
6, 13:00:00-000, 0, 0, 0, 0, 0.00, 0, 0.00, 1
6, 15:40:00-000, 6946, 3386, 3560, 1511, 1347.67, 1673, 1348.39, 0
6, 15:41:00-000, 0, 0, 0, 76, 1347.00, 109, 1354.00, 0
6, 15:42:00-000, 0, 0, 0, 44, 1346.65, 165, 1354.13, 0
6, 15:43:00-000, 0, 0, 0, 44, 1346.00, 23, 1355.00, 0
6, 15:44:00-000, 0, 0, 0, 69, 1346.00, 26, 1355.00, 0
6, 15:45:00-000, 0, 0, 0, 61, 1346.00, 37, 1355.00, 0
6, 15:46:00-000, 0, 0, 0, 40, 1346.00, 18, 1355.00, 0
6, 15:47:00-000, 0, 0, 0, 5, 1345.00, 0, 0.00, 0
6, 15:48:00-000, 0, 0, 0, 43, 1345.00, 23, 1355.00, 0
6, 15:49:00-000, 0, 0, 0, 0, 0.00, 44, 1355.00, 0
6, 15:50:00-000, 0, 0, 0, 0, 0.00, 28, 1355.00, 0
6, 15:51:00-000, 0, 0, 0, 36, 1345.00, 0, 0.00, 0
6, 15:52:00-000, 0, 0, 0, 38, 1345.00, 0, 0.00, 0
6, 15:53:00-000, 0, 0, 0, 23, 1345.00, 12, 1356.00, 0
6, 15:55:00-000, 0, 0, 0, 0, 0.00, 61, 1356.00, 0
6, 15:56:00-000, 0, 0, 0, 2, 1345.00, 0, 0.00, 0
6, 15:57:00-000, 0, 0, 0, 2, 1345.00, 0, 0.00, 0
6, 15:58:00-000, 0, 0, 0, 78, 1345.00, 7, 1356.00, 0
6, 15:59:00-000, 0, 0, 0, 12, 1345.00, 76, 1356.00, 0
6, 16:00:00-000, 3, 1, 2, 19, 1345.00, 6, 1355.83, 128
6, 16:01:00-000, 1, 0, 1, 0, 0.00, 1, 1353.00, 116
6, 16:02:00-000, 0, 0, 0, 0, 0.00, 80, 1356.00, 131
6, 16:03:00-000, 0, 0, 0, 0, 0.00, 0, 0.00, 116
6, 16:04:00-000, 0, 0, 0, 0, 0.00, 0, 0.00, 121
6, 16:05:00-000, 0, 0, 0, 0, 0.00, 0, 0.00, 129
6, 16:06:00-000, 1, 1, 0, 12, 1344.00, 31, 1357.00, 116
6, 16:07:00-000, 0, 0, 0, 5, 1344.00, 0, 0.00, 116
6, 16:08:00-000, 0, 0, 0, 0, 0.00, 0, 0.00, 117
6, 16:09:00-000, 0, 0, 0, 0, 0.00, 0, 0.00, 127
6, 16:10:00-000, 0, 0, 0, 0, 0.00, 0, 0.00, 103
6, 16:11:00-000, 0, 0, 0, 0, 0.00, 0, 0.00, 109
6, 16:12:00-000, 0, 0, 0, 0, 0.00, 0, 0.00, 114
6, 16:13:00-000, 0, 0, 0, 0, 0.00, 0, 0.00, 144
6, 16:14:00-000, 0, 0, 0, 0, 0.00, 0, 0.00, 138
6, 16:15:00-000, 0, 0, 0, 0, 0.00, 4, 1357.00, 121
6, 16:16:00-000, 0, 0, 0, 0, 0.00, 7, 1357.00, 110
6, 16:17:00-000, 0, 0, 0, 0, 0.00, 0, 0.00, 121
6, 16:18:00-000, 0, 0, 0, 0, 0.00, 0, 0.00, 105
6, 16:19:00-000, 0, 0, 0, 0, 0.00, 0, 0.00, 115
6, 16:20:00-000, 15, 5, 10, 2, 1351.00, 6, 1353.67, 0
6, 16:21:00-000, 0, 0, 0, 0, 0.00, 1, 1356.00, 0
7, 09:06:00-000, 1511, 11, 1500, 10, 1345.00, 10, 1349.40, 1491
7, 09:07:00-000, 10243, 1965, 8278, 0, 0.00, 0, 0.00, 10226
7, 09:08:00-000, 0, 0, 0, 0, 0.00, 0, 0.00, 17
7, 09:33:00-000, 10012, 6691, 3321, 1, 1349.00, 1, 1351.00, 10010
7, 09:47:00-000, 1933, 32, 1901, 17, 1350.00, 17, 1350.76, 1899
7, 09:48:00-000, 3195, 3130, 65, 32, 1349.00, 32, 1351.00, 3131
7, 09:49:00-000, 4853, 3754, 1099, 16, 1348.75, 16, 1348.25, 4821
7, 09:50:00-000, 4609, 3152, 1457, 6, 1351.33, 6, 1352.00, 4597
7, 09:51:00-000, 4447, 3902, 545, 14, 1347.00, 14, 1352.29, 4419
7, 09:52:00-000, 15164, 11299, 3865, 0, 0.00, 0, 0.00, 15164
7, 09:53:00-000, 10647, 4757, 5890, 0, 0.00, 0, 0.00, 10647
7, 09:54:00-000, 2449, 2419, 30, 30, 1349.53, 30, 1351.03, 2389
7, 09:55:00-000, 1783, 1750, 33, 0, 0.00, 0, 0.00, 1783
7, 09:56:00-000, 5300, 2684, 2616, 0, 0.00, 0, 0.00, 5294
7, 09:57:00-000, 6064, 2832, 3232, 37, 1351.48, 72, 1351.00, 5961
7, 09:58:00-000, 8788, 5180, 3608, 35, 1356.31, 0, 0.00, 8753
7, 10:00:00-000, 2212, 1165, 1047, 0, 0.00, 0, 0.00, 2212
7, 10:02:00-000, 10248, 4803, 5445, 5, 1347.80, 5, 1349.20, 10238
7, 10:03:00-000, 7599, 5923, 1676, 6, 1347.50, 6, 1349.33, 7587
7, 10:04:00-000, 862, 22, 840, 9, 1356.00, 9, 1353.00, 844
7, 10:05:00-000, 10222, 6354, 3868, 10, 1348.70, 10, 1351.00, 8951
7, 10:06:00-000, 19911, 9142, 10769, 29, 1348.79, 36, 1350.77, 21097
7, 10:07:00-000, 1115, 1113, 2, 9, 1354.44, 2, 1351.50, 1104
7, 10:08:00-000, 987, 17, 970, 0, 0.00, 0, 0.00, 987
7, 10:09:00-000, 23431, 13313, 10118, 10, 1350.80, 10, 1350.80, 23411
7, 10:10:00-000, 6217, 3344, 2873, 5, 1348.00, 5, 1351.00, 6207
7, 10:11:00-000, 12101, 5086, 7015, 0, 0.00, 0, 0.00, 12101
7, 10:12:00-000, 547, 500, 47, 27, 1348.00, 27, 1348.93, 493
7, 10:13:00-000, 1328, 8, 1320, 0, 0.00, 0, 0.00, 1328
7, 10:15:00-000, 5890, 3593, 2297, 0, 0.00, 0, 0.00, 5890
7, 10:17:00-000, 1988, 48, 1940, 30, 1353.26, 30, 1352.00, 1928
7, 10:18:00-000, 11361, 6684, 4677, 4, 1350.25, 4, 1349.00, 11353
7, 10:19:00-000, 1562, 1540, 22, 0, 0.00, 0, 0.00, 1562
7, 10:20:00-000, 7546, 3504, 4042, 0, 0.00, 0, 0.00, 7546
7, 10:21:00-000, 888, 873, 15, 15, 1353.40, 15, 1351.67, 858
7, 10:26:00-000, 10898, 7465, 3433, 0, 0.00, 0, 0.00, 10898
7, 10:27:00-000, 20226, 7945, 12281, 9, 1351.00, 9, 1351.00, 20208
7, 10:28:00-000, 13662, 5763, 7899, 13, 1350.00, 13, 1347.92, 13636
7, 10:29:00-000, 4109, 1778, 2331, 41, 1350.75, 41, 1351.85, 4027
7, 10:30:00-000, 4436, 2659, 1777, 0, 0.00, 0, 0.00, 4436
7, 10:33:00-000, 3380, 897, 2483, 7, 1351.86, 7, 1352.00, 3366
7, 10:34:00-000, 804, 802, 2, 2, 1354.00, 2, 1351.00, 800
7, 10:35:00-000, 2028, 8, 2020, 0, 0.00, 0, 0.00, 2028
7, 10:37:00-000, 7766, 3858, 3908, 0, 0.00, 0, 0.00, 6446
7, 10:38:00-000, 5023, 2102, 2921, 48, 1348.10, 48, 1351.96, 6247
7, 10:39:00-000, 15506, 3394, 12112, 13, 1349.92, 13, 1351.77, 15480
7, 10:40:00-000, 744, 64, 680, 44, 1353.04, 44, 1352.00, 656
7, 10:41:00-000, 732, 2, 730, 2, 1353.00, 2, 1352.00, 728
7, 10:43:00-000, 12432, 2332, 10100, 0, 0.00, 0, 0.00, 12432
7, 10:44:00-000, 11165, 7253, 3912, 4, 1349.00, 4, 1347.75, 11157
7, 10:45:00-000, 6122, 3328, 2794, 0, 0.00, 0, 0.00, 6122
7, 10:46:00-000, 2407, 1048, 1359, 11, 1355.54, 11, 1352.00, 2385
7, 10:49:00-000, 2090, 2070, 20, 0, 0.00, 0, 0.00, 2090
7, 10:50:00-000, 11294, 6832, 4462, 131, 1347.15, 43, 1351.02, 11120
7, 10:51:00-000, 15096, 9597, 5499, 6, 1351.67, 94, 1346.54, 14996
7, 10:53:00-000, 1641, 782, 859, 0, 0.00, 0, 0.00, 1641
7, 10:55:00-000, 11328, 8836, 2492, 6, 1351.50, 6, 1351.00, 11316
7, 10:56:00-000, 1785, 806, 979, 0, 0.00, 0, 0.00, 1785
7, 10:57:00-000, 4659, 2350, 2309, 57, 1348.00, 57, 1346.96, 4545
7, 10:58:00-000, 902, 164, 738, 2, 1351.00, 2, 1351.00, 898
7, 10:59:00-000, 4504, 856, 3648, 6, 1349.00, 6, 1349.00, 4492
7, 11:00:00-000, 2741, 1665, 1076, 0, 0.00, 0, 0.00, 2741
7, 11:01:00-000, 2965, 2930, 35, 5, 1348.00, 5, 1347.80, 2955
7, 11:02:00-000, 10452, 5210, 5242, 32, 1346.68, 31, 1350.06, 10389
7, 11:03:00-000, 11788, 10421, 1367, 4, 1352.00, 5, 1348.00, 10255
7, 11:04:00-000, 2406, 1215, 1191, 0, 0.00, 0, 0.00, 3930
7, 11:07:00-000, 2280, 1356, 924, 0, 0.00, 0, 0.00, 2280
7, 11:08:00-000, 13185, 10097, 3088, 18, 1348.22, 18, 1345.55, 13149
7, 11:09:00-000, 7711, 4070, 3641, 11, 1350.00, 11, 1350.64, 7689
7, 11:10:00-000, 10365, 4851, 5514, 6, 1345.00, 6, 1346.00, 10353
7, 11:11:00-000, 15072, 8682, 6390, 0, 0.00, 0, 0.00, 15072
7, 11:12:00-000, 15109, 11534, 3575, 9, 1349.89, 9, 1350.44, 15091
7, 11:13:00-000, 3832, 940, 2892, 10, 1352.20, 10, 1352.00, 3812
7, 11:16:00-000, 27039, 12532, 14507, 15, 1349.20, 15, 1351.47, 26011
7, 11:17:00-000, 7961, 4878, 3083, 37, 1347.38, 37, 1347.86, 8885
7, 11:18:00-000, 4357, 1437, 2920, 0, 0.00, 0, 0.00, 4357
7, 11:19:00-000, 18845, 9152, 9693, 0, 0.00, 0, 0.00, 18845
7, 11:20:00-000, 9744, 7451, 2293, 11, 1348.82, 11, 1351.18, 9722
7, 11:21:00-000, 7576, 3427, 4149, 18, 1351.05, 18, 1352.05, 7540
7, 11:22:00-000, 1500, 10, 1490, 0, 0.00, 0, 0.00, 1500
7, 11:24:00-000, 4154, 1406, 2748, 5, 1348.60, 5, 1352.00, 3219
7, 11:25:00-000, 15057, 12808, 2249, 0, 0.00, 0, 0.00, 15982
7, 11:26:00-000, 1927, 1920, 7, 0, 0.00, 0, 0.00, 1927
7, 11:27:00-000, 12787, 5129, 7658, 10, 1350.50, 10, 1347.20, 12767
7, 11:28:00-000, 4182, 4025, 157, 1, 1348.00, 1, 1349.00, 4180
7, 11:30:00-000, 9413, 7162, 2251, 9, 1350.78, 9, 1351.00, 9395
7, 11:31:00-000, 9964, 6959, 3005, 0, 0.00, 0, 0.00, 9082
7, 11:32:00-000, 2990, 2962, 28, 22, 1351.50, 22, 1351.13, 3828
7, 11:33:00-000, 649, 642, 7, 7, 1351.86, 7, 1351.00, 635
7, 11:34:00-000, 10188, 7078, 3110, 16, 1351.19, 15, 1352.20, 10157
7, 11:35:00-000, 9486, 6984, 2502, 5, 1347.20, 6, 1349.67, 8745
7, 11:36:00-000, 1331, 20, 1311, 10, 1349.00, 10, 1346.60, 2041
7, 11:37:00-000, 13241, 7036, 6205, 0, 0.00, 0, 0.00, 13241
7, 11:38:00-000, 5522, 2242, 3280, 23, 1352.26, 23, 1351.91, 5476
7, 11:39:00-000, 2554, 1320, 1234, 9, 1346.44, 9, 1347.67, 2536
7, 11:40:00-000, 15307, 8513, 6794, 6, 1348.00, 6, 1349.67, 15295
7, 11:41:00-000, 12207, 6793, 5414, 9, 1352.22, 9, 1351.22, 12189
7, 11:42:00-000, 11961, 5013, 6948, 11, 1351.00, 11, 1347.45, 11096
7, 11:43:00-000, 13138, 3752, 9386, 2, 1351.00, 2, 1350.00, 13977
7, 11:44:00-000, 11961, 7472, 4489, 58, 1349.20, 58, 1349.65, 11845
7, 11:45:00-000, 4172, 1223, 2949, 1, 1349.00, 1, 1348.00, 4170
7, 11:46:00-000, 6628, 3373, 3255, 8, 1352.62, 8, 1351.38, 6612
7, 11:47:00-000, 2780, 1106, 1674, 14, 1346.93, 14, 1351.00, 2752
7, 11:48:00-000, 17172, 5941, 11231, 17, 1350.65, 25, 1350.60, 16328
7, 11:49:00-000, 12811, 5945, 6866, 35, 1348.80, 27, 1348.92, 13551
7, 11:50:00-000, 5779, 3123, 2656, 48, 1351.23, 48, 1350.68, 5683
7, 11:51:00-000, 3452, 2629, 823, 0, 0.00, 0, 0.00, 3452
7, 11:52:00-000, 855, 5, 850, 0, 0.00, 0, 0.00, 855
7, 11:53:00-000, 7621, 3980, 3641, 0, 0.00, 0, 0.00, 7621
7, 11:54:00-000, 1076, 1070, 6, 5, 1349.00, 5, 1354.00, 1066
7, 11:55:00-000, 3493, 1236, 2257, 0, 0.00, 0, 0.00, 3493
7, 11:57:00-000, 1314, 1218, 96, 0, 0.00, 1, 1351.00, 1313
7, 11:58:00-000, 9840, 6729, 3111, 14, 1350.50, 13, 1351.15, 9813
7, 11:59:00-000, 10909, 5745, 5164, 6, 1351.00, 6, 1348.00, 10109
7, 12:00:00-000, 12350, 5187, 7163, 33, 1348.54, 20, 1350.45, 13085
7, 12:01:00-000, 8831, 3441, 5390, 0, 0.00, 13, 1346.54, 8810
7, 12:02:00-000, 936, 927, 9, 9, 1347.33, 9, 1353.00, 926
7, 12:03:00-000, 358, 350, 8, 0, 0.00, 0, 0.00, 358
7, 12:05:00-000, 5731, 2472, 3259, 7, 1353.57, 7, 1351.00, 5717
7, 12:06:00-000, 21542, 16594, 4948, 16, 1350.75, 16, 1352.56, 19990
7, 12:07:00-000, 7537, 3982, 3555, 0, 0.00, 0, 0.00, 9057
7, 12:08:00-000, 13107, 8032, 5075, 27, 1350.29, 20, 1350.65, 13060
7, 12:09:00-000, 7415, 4556, 2859, 3, 1348.00, 10, 1347.80, 7402
7, 12:10:00-000, 1265, 5, 1260, 5, 1351.60, 5, 1352.00, 1255
7, 12:11:00-000, 1961, 1876, 85, 8, 1348.50, 8, 1348.62, 1945
7, 12:13:00-000, 3906, 1762, 2144, 0, 0.00, 0, 0.00, 3112
7, 12:14:00-000, 12129, 8072, 4057, 4, 1349.75, 4, 1349.25, 11576
7, 12:15:00-000, 2284, 1164, 1120, 0, 0.00, 0, 0.00, 3623
7, 12:16:00-000, 2006, 1063, 943, 23, 1352.82, 22, 1351.45, 1961
7, 12:17:00-000, 10871, 2637, 8234, 9, 1350.00, 10, 1350.80, 10852
7, 12:18:00-000, 12127, 7166, 4961, 1, 1352.00, 1, 1351.00, 12125
7, 12:19:00-000, 11643, 5815, 5828, 22, 1348.27, 22, 1348.50, 10180
7, 12:20:00-000, 89, 89, 0, 98, 1352.70, 98, 1353.00, 1312
7, 12:21:00-000, 1969, 1920, 49, 36, 1348.00, 36, 1347.13, 1897
7, 12:22:00-000, 13757, 9379, 4378, 11, 1351.09, 11, 1350.91, 12926
7, 12:23:00-000, 8032, 4033, 3999, 0, 0.00, 0, 0.00, 8841
7, 12:25:00-000, 1173, 3, 1170, 3, 1349.00, 3, 1352.00, 1167
7, 12:28:00-000, 1916, 16, 1900, 13, 1349.38, 7, 1352.14, 1896
7, 12:29:00-000, 3584, 2503, 1081, 0, 0.00, 6, 1349.00, 3578
7, 12:30:00-000, 3194, 1347, 1847, 0, 0.00, 0, 0.00, 1847
7, 12:31:00-000, 560, 10, 550, 0, 0.00, 0, 0.00, 1907
7, 12:32:00-000, 8228, 3501, 4727, 18, 1349.00, 18, 1351.00, 8192
7, 12:33:00-000, 2741, 1446, 1295, 6, 1351.33, 6, 1350.67, 2729
7, 12:34:00-000, 9347, 1580, 7767, 0, 0.00, 0, 0.00, 9347
7, 12:37:00-000, 1278, 8, 1270, 0, 0.00, 0, 0.00, 1278
7, 12:38:00-000, 1994, 942, 1052, 1, 1353.00, 1, 1351.00, 1992
7, 12:41:00-000, 2632, 1072, 1560, 0, 0.00, 0, 0.00, 2632
7, 12:42:00-000, 2176, 1336, 840, 16, 1352.31, 16, 1352.00, 2144
7, 12:43:00-000, 2898, 1238, 1660, 0, 0.00, 0, 0.00, 2898
7, 12:45:00-000, 5508, 3645, 1863, 5, 1352.40, 5, 1352.00, 5498
7, 12:46:00-000, 975, 51, 924, 8, 1346.25, 8, 1346.88, 959
7, 12:47:00-000, 4450, 1563, 2887, 0, 0.00, 0, 0.00, 4450
7, 12:48:00-000, 1267, 7, 1260, 0, 0.00, 0, 0.00, 1267
7, 12:49:00-000, 765, 690, 75, 34, 1348.00, 34, 1346.26, 697
7, 12:50:00-000, 8056, 5878, 2178, 0, 0.00, 0, 0.00, 8056
7, 12:51:00-000, 2862, 1469, 1393, 0, 0.00, 0, 0.00, 2849
7, 12:52:00-000, 5247, 3232, 2015, 16, 1349.00, 16, 1346.50, 5228
7, 12:53:00-000, 897, 7, 890, 0, 0.00, 0, 0.00, 897
7, 12:54:00-000, 8886, 4355, 4531, 14, 1349.36, 12, 1351.08, 8860
7, 12:55:00-000, 1536, 4, 1532, 0, 0.00, 2, 1349.00, 1534
7, 12:56:00-000, 4301, 33, 4268, 8, 1348.00, 8, 1350.25, 4285
7, 12:57:00-000, 8626, 3098, 5528, 3, 1349.00, 3, 1349.00, 8620
7, 12:58:00-000, 4584, 2677, 1907, 34, 1347.47, 34, 1347.91, 4516
7, 12:59:00-000, 5587, 4069, 1518, 12, 1347.08, 12, 1345.50, 5563
7, 13:00:00-000, 12046, 3405, 8641, 43, 1351.67, 43, 1351.00, 11960
7, 13:01:00-000, 11876, 5988, 5888, 36, 1348.52, 36, 1349.91, 11804
7, 13:02:00-000, 9863, 5902, 3961, 39, 1347.31, 39, 1346.40, 9785
7, 13:03:00-000, 1684, 821, 863, 0, 0.00, 0, 0.00, 1684
7, 13:04:00-000, 7798, 3142, 4656, 89, 1346.84, 63, 1348.14, 7646
7, 13:05:00-000, 1849, 919, 930, 0, 0.00, 26, 1347.08, 1823
7, 13:06:00-000, 9100, 3096, 6004, 19, 1350.84, 19, 1351.89, 9062
7, 13:07:00-000, 12149, 9246, 2903, 0, 0.00, 0, 0.00, 12145
7, 13:08:00-000, 8605, 4591, 4014, 11, 1349.00, 11, 1349.18, 8587
7, 13:09:00-000, 3842, 1343, 2499, 3, 1354.00, 3, 1351.00, 3836
7, 13:10:00-000, 5020, 2768, 2252, 2, 1350.00, 2, 1350.00, 5016
7, 13:11:00-000, 1573, 13, 1560, 0, 0.00, 0, 0.00, 1573
7, 13:12:00-000, 6007, 2932, 3075, 27, 1351.22, 27, 1351.92, 4613
7, 13:13:00-000, 15100, 7880, 7220, 7, 1352.14, 7, 1351.00, 16426
7, 13:14:00-000, 13001, 5284, 7717, 18, 1351.55, 18, 1350.83, 12965
7, 13:15:00-000, 10529, 2315, 8214, 3, 1349.67, 3, 1350.00, 10523
7, 13:16:00-000, 15791, 8540, 7251, 7, 1353.00, 7, 1352.00, 15777
7, 13:17:00-000, 4514, 38, 4476, 7, 1349.43, 7, 1347.57, 3701
7, 13:18:00-000, 11300, 4027, 7273, 7, 1351.71, 7, 1351.29, 12085
7, 13:19:00-000, 4312, 1903, 2409, 18, 1349.89, 18, 1352.00, 4276
7, 13:20:00-000, 2048, 944, 1104, 3, 1352.00, 3, 1351.00, 2042
7, 13:21:00-000, 7748, 2183, 5565, 19, 1347.89, 15, 1351.00, 7350
7, 13:22:00-000, 3785, 2860, 925, 21, 1347.85, 17, 1349.47, 4111
7, 13:23:00-000, 4176, 2385, 1791, 0, 0.00, 8, 1348.12, 4168
7, 13:24:00-000, 8968, 1861, 7107, 28, 1350.86, 28, 1351.64, 8912
7, 13:25:00-000, 5007, 2326, 2681, 0, 0.00, 0, 0.00, 5007
7, 13:26:00-000, 12720, 6129, 6591, 7, 1348.86, 11, 1349.18, 12702
7, 13:27:00-000, 6538, 1423, 5115, 4, 1352.00, 0, 0.00, 6534
7, 13:28:00-000, 4197, 2701, 1496, 0, 0.00, 0, 0.00, 4197
7, 13:29:00-000, 13928, 7791, 6137, 34, 1347.03, 34, 1348.35, 13860
7, 13:30:00-000, 11214, 6247, 4967, 23, 1350.30, 23, 1350.17, 11168
7, 13:31:00-000, 2551, 2540, 11, 0, 0.00, 0, 0.00, 2551
7, 13:32:00-000, 11657, 4413, 7244, 20, 1349.30, 20, 1348.05, 11617
7, 13:33:00-000, 8459, 4543, 3916, 19, 1349.16, 19, 1351.31, 8421
7, 13:34:00-000, 2793, 37, 2756, 6, 1345.67, 6, 1347.67, 2781
7, 13:35:00-000, 6109, 3259, 2850, 0, 0.00, 0, 0.00, 6109
7, 13:36:00-000, 8247, 3032, 5215, 6, 1349.00, 6, 1348.50, 8235
7, 13:37:00-000, 13089, 7411, 5678, 22, 1348.91, 22, 1352.00, 11817
7, 13:38:00-000, 5069, 1837, 3232, 3, 1346.00, 3, 1349.00, 6291
7, 13:40:00-000, 6566, 3357, 3209, 9, 1351.11, 9, 1352.00, 6548
7, 13:41:00-000, 10769, 5839, 4930, 49, 1348.46, 49, 1347.24, 10671
7, 13:42:00-000, 15706, 7348, 8358, 25, 1347.80, 26, 1350.08, 15655
7, 13:43:00-000, 281, 6, 275, 1, 1350.00, 0, 0.00, 280
7, 13:44:00-000, 1092, 22, 1070, 0, 0.00, 0, 0.00, 1092
7, 13:45:00-000, 3184, 3160, 24, 0, 0.00, 0, 0.00, 3177
7, 13:46:00-000, 8871, 5020, 3851, 0, 0.00, 0, 0.00, 8878
7, 13:49:00-000, 8057, 6092, 1965, 0, 0.00, 0, 0.00, 8057
7, 13:50:00-000, 6548, 2313, 4235, 0, 0.00, 0, 0.00, 6548
7, 13:52:00-000, 10231, 4387, 5844, 18, 1348.67, 10, 1350.00, 10203
7, 13:53:00-000, 9223, 3803, 5420, 5, 1348.80, 13, 1348.46, 9205
7, 13:54:00-000, 3955, 3534, 421, 4, 1352.25, 7, 1351.00, 3944
7, 13:55:00-000, 1817, 1046, 771, 41, 1354.29, 38, 1352.82, 1738
7, 13:56:00-000, 15850, 9409, 6441, 5, 1353.00, 11, 1350.82, 15834
7, 13:57:00-000, 3199, 3183, 16, 19, 1353.10, 13, 1350.46, 3167
7, 13:59:00-000, 8223, 3853, 4370, 4, 1350.50, 4, 1350.75, 8215
7, 14:00:00-000, 12805, 4516, 8289, 16, 1348.19, 16, 1350.25, 11787
7, 14:01:00-000, 16118, 11437, 4681, 13, 1350.54, 13, 1351.23, 17078
7, 14:02:00-000, 5487, 1195, 4292, 9, 1348.00, 9, 1346.11, 5469
7, 14:03:00-000, 9022, 3985, 5037, 0, 0.00, 0, 0.00, 9022
7, 14:04:00-000, 4941, 2454, 2487, 5, 1351.20, 5, 1350.40, 4931
7, 14:05:00-000, 7739, 2942, 4797, 3, 1349.00, 3, 1349.00, 7733
7, 14:06:00-000, 13934, 7480, 6454, 8, 1350.63, 8, 1350.00, 12663
7, 14:07:00-000, 8650, 5058, 3592, 7, 1346.43, 7, 1349.86, 8789
7, 14:08:00-000, 6167, 5285, 882, 38, 1347.00, 38, 1346.55, 7193
7, 14:09:00-000, 11637, 4400, 7237, 0, 0.00, 0, 0.00, 11637
7, 14:10:00-000, 12152, 5083, 7069, 15, 1349.60, 27, 1350.03, 12110
7, 14:11:00-000, 5369, 2396, 2973, 12, 1351.83, 0, 0.00, 5357
7, 14:12:00-000, 5464, 3114, 2350, 27, 1351.22, 27, 1351.22, 5410
7, 14:13:00-000, 2452, 1399, 1053, 3, 1349.00, 3, 1346.00, 2446
7, 14:14:00-000, 9415, 4085, 5330, 10, 1350.80, 10, 1351.20, 9394
7, 14:15:00-000, 12875, 6809, 6066, 27, 1346.07, 27, 1345.22, 12822
7, 14:16:00-000, 786, 782, 4, 2, 1348.00, 2, 1349.00, 782
7, 14:17:00-000, 6704, 3787, 2917, 4, 1349.00, 4, 1350.50, 6696
7, 14:18:00-000, 1042, 1030, 12, 12, 1345.75, 12, 1348.58, 1018
7, 14:19:00-000, 3506, 1086, 2420, 1, 1354.00, 1, 1353.00, 3504
7, 14:20:00-000, 6066, 3710, 2356, 8, 1345.25, 8, 1346.50, 6046
7, 14:21:00-000, 8772, 3165, 5607, 4, 1352.75, 4, 1351.00, 8768
7, 14:22:00-000, 5580, 1577, 4003, 14, 1347.71, 14, 1348.00, 5552
7, 14:23:00-000, 4657, 3456, 1201, 15, 1347.87, 15, 1347.33, 4627
7, 14:24:00-000, 12337, 4909, 7428, 13, 1348.15, 13, 1350.08, 12311
7, 14:25:00-000, 8562, 3946, 4616, 12, 1349.75, 12, 1350.00, 8538
7, 14:27:00-000, 3709, 1822, 1887, 0, 0.00, 0, 0.00, 3709
7, 14:28:00-000, 8452, 7014, 1438, 50, 1349.67, 50, 1351.41, 8352
7, 14:29:00-000, 2482, 22, 2460, 0, 0.00, 0, 0.00, 2482
7, 14:30:00-000, 5691, 3558, 2133, 0, 0.00, 5, 1351.00, 4363
7, 14:31:00-000, 22734, 16512, 6222, 14, 1348.93, 9, 1349.78, 23216
7, 14:32:00-000, 4326, 2218, 2108, 3, 1348.00, 3, 1348.67, 5138
7, 14:33:00-000, 8713, 5215, 3498, 0, 0.00, 0, 0.00, 8713
7, 14:34:00-000, 15493, 4015, 11478, 3, 1349.67, 3, 1349.33, 15122
7, 14:35:00-000, 8484, 4921, 3563, 12, 1352.00, 15, 1351.87, 8822
7, 14:36:00-000, 10388, 6593, 3795, 23, 1352.78, 20, 1349.55, 10345
7, 14:37:00-000, 7287, 544, 6743, 8, 1349.63, 5, 1348.60, 7274
7, 14:38:00-000, 7107, 4071, 3036, 16, 1349.00, 22, 1349.72, 7069
7, 14:39:00-000, 8973, 3915, 5058, 9, 1351.33, 5, 1352.00, 8959
7, 14:40:00-000, 9379, 3511, 5868, 6, 1353.33, 7, 1350.86, 9366
7, 14:41:00-000, 15440, 8326, 7114, 21, 1352.85, 21, 1351.52, 15398
7, 14:42:00-000, 8411, 3363, 5048, 30, 1348.60, 30, 1349.03, 8351
7, 14:43:00-000, 6996, 4103, 2893, 0, 0.00, 0, 0.00, 6996
7, 14:44:00-000, 5686, 3495, 2191, 45, 1350.33, 45, 1348.77, 5596
7, 14:45:00-000, 2904, 24, 2880, 5, 1349.00, 5, 1353.00, 2889
7, 14:46:00-000, 4386, 2938, 1448, 0, 0.00, 0, 0.00, 4391
7, 14:47:00-000, 17389, 9410, 7979, 1, 1352.00, 1, 1353.00, 17387
7, 14:48:00-000, 3106, 3090, 16, 14, 1345.28, 14, 1351.07, 3078
7, 14:49:00-000, 12286, 6523, 5763, 5, 1349.40, 5, 1350.80, 12276
7, 14:50:00-000, 2128, 2123, 5, 3, 1348.00, 3, 1350.00, 2122
7, 14:51:00-000, 9537, 3285, 6252, 36, 1348.78, 36, 1348.83, 9465
7, 14:52:00-000, 18142, 9810, 8332, 48, 1349.58, 52, 1352.40, 18042
7, 14:53:00-000, 5164, 3077, 2087, 13, 1348.46, 9, 1352.00, 5142
7, 14:54:00-000, 10366, 4527, 5839, 16, 1349.50, 16, 1350.62, 10334
7, 14:55:00-000, 4686, 2455, 2231, 0, 0.00, 1, 1350.00, 4685
7, 14:56:00-000, 2763, 47, 2716, 21, 1350.76, 20, 1350.85, 2722
7, 14:57:00-000, 1506, 1500, 6, 0, 0.00, 0, 0.00, 1506
7, 14:58:00-000, 11330, 4954, 6376, 20, 1350.00, 18, 1349.94, 11292
7, 14:59:00-000, 907, 15, 892, 0, 0.00, 2, 1348.50, 905
7, 15:00:00-000, 11022, 4590, 6432, 28, 1347.57, 28, 1347.18, 10966
7, 15:01:00-000, 11548, 8657, 2891, 10, 1351.70, 10, 1351.80, 11518
7, 15:02:00-000, 5380, 1311, 4069, 1, 1352.00, 1, 1351.00, 5388
7, 15:03:00-000, 9177, 7740, 1437, 4, 1352.00, 4, 1350.00, 9169
7, 15:04:00-000, 19978, 8078, 11900, 7, 1348.29, 4, 1350.00, 18854
7, 15:05:00-000, 13261, 6028, 7233, 8, 1349.00, 13, 1350.38, 14353
7, 15:06:00-000, 10070, 6889, 3181, 59, 1349.83, 56, 1350.46, 9955
7, 15:07:00-000, 4968, 4087, 881, 1, 1350.00, 2, 1349.00, 4965
7, 15:08:00-000, 1792, 863, 929, 9, 1354.55, 9, 1351.00, 1774
7, 15:09:00-000, 16968, 10532, 6436, 24, 1351.08, 28, 1350.96, 15670
7, 15:10:00-000, 2281, 789, 1492, 4, 1351.00, 0, 0.00, 2746
7, 15:11:00-000, 13802, 6719, 7083, 1, 1350.00, 1, 1350.00, 14577
7, 15:12:00-000, 13824, 2418, 11406, 27, 1349.41, 27, 1350.89, 13069
7, 15:13:00-000, 6898, 3763, 3135, 6, 1347.50, 6, 1344.00, 7587
7, 15:14:00-000, 6492, 3953, 2539, 21, 1347.33, 16, 1350.37, 6455
7, 15:15:00-000, 730, 11, 719, 5, 1355.00, 10, 1350.30, 715
7, 15:16:00-000, 5008, 1459, 3549, 0, 0.00, 0, 0.00, 5008
7, 15:17:00-000, 6612, 3243, 3369, 12, 1348.50, 12, 1350.58, 6588
7, 15:18:00-000, 9393, 4179, 5214, 7, 1347.14, 30, 1351.97, 9356
7, 15:19:00-000, 1988, 58, 1930, 23, 1354.00, 0, 0.00, 1965
7, 15:20:00-000, 2154, 2130, 24, 0, 0.00, 0, 0.00, 2154
7, 15:21:00-000, 3537, 2626, 911, 0, 0.00, 0, 0.00, 3537
7, 15:22:00-000, 2756, 1441, 1315, 0, 0.00, 0, 0.00, 2756
7, 15:24:00-000, 6848, 6753, 95, 3, 1351.00, 3, 1350.67, 6842
7, 15:25:00-000, 3299, 1048, 2251, 20, 1350.00, 20, 1347.25, 3259
7, 15:27:00-000, 12036, 8171, 3865, 0, 0.00, 0, 0.00, 12036
7, 15:28:00-000, 10220, 5277, 4943, 42, 1347.52, 41, 1349.58, 10137
7, 15:29:00-000, 2928, 1941, 987, 0, 0.00, 1, 1347.00, 2927
7, 15:30:00-000, 5138, 2817, 2321, 29, 1348.31, 14, 1351.29, 5095
7, 15:31:00-000, 4200, 2802, 1398, 12, 1348.00, 27, 1347.29, 4054
7, 15:32:00-000, 2480, 1640, 840, 20, 1349.75, 14, 1351.57, 2553
7, 15:33:00-000, 3414, 2119, 1295, 14, 1349.50, 20, 1348.35, 2483
7, 15:34:00-000, 5699, 3196, 2503, 6, 1350.17, 6, 1349.33, 6584
7, 15:35:00-000, 19019, 12318, 6701, 2, 1348.00, 2, 1353.00, 19006
7, 15:36:00-000, 7766, 2478, 5288, 4, 1349.00, 4, 1347.00, 6294
7, 15:37:00-000, 4811, 1964, 2847, 1, 1350.00, 0, 0.00, 6283
7, 15:38:00-000, 410, 9, 401, 5, 1349.00, 1, 1349.00, 404
7, 15:39:00-000, 7927, 3441, 4486, 3, 1351.00, 8, 1350.00, 7916
7, 15:41:00-000, 5410, 2710, 2700, 4, 1349.00, 4, 1349.25, 5402
7, 15:42:00-000, 2149, 1240, 909, 0, 0.00, 0, 0.00, 2149
7, 15:44:00-000, 2871, 1454, 1417, 4, 1350.00, 4, 1347.00, 1430
7, 15:45:00-000, 752, 750, 2, 0, 0.00, 0, 0.00, 2185
7, 15:50:00-000, 7666, 3835, 3831, 36, 1349.00, 22, 1350.91, 7608
7, 15:51:00-000, 25, 0, 25, 0, 0.00, 14, 1350.79, 11
7, 15:54:00-000, 2738, 1354, 1384, 11, 1355.00, 11, 1352.00, 2716
7, 15:56:00-000, 4165, 2841, 1324, 3, 1351.00, 3, 1352.00, 4159
7, 15:57:00-000, 2390, 1432, 958, 7, 1349.86, 7, 1352.00, 2376
7, 15:58:00-000, 1875, 20, 1855, 5, 1350.00, 5, 1343.80, 1865
7, 15:59:00-000, 1442, 2, 1440, 2, 1348.50, 2, 1352.00, 1438
7, 16:00:00-000, 2111, 697, 1414, 8, 1350.00, 8, 1350.00, 2095
7, 16:02:00-000, 761, 1, 760, 0, 0.00, 0, 0.00, 761
7, 16:03:00-000, 9741, 7423, 2318, 3, 1349.00, 0, 0.00, 9738
7, 16:04:00-000, 3, 0, 3, 0, 0.00, 3, 1348.00, 0
7, 16:06:00-000, 1385, 1366, 19, 6, 1351.33, 6, 1352.00, 1373
7, 16:07:00-000, 10705, 6748, 3957, 0, 0.00, 0, 0.00, 10545
7, 16:08:00-000, 4664, 2359, 2305, 21, 1348.24, 21, 1349.76, 4782
7, 16:09:00-000, 6896, 86, 6810, 0, 0.00, 0, 0.00, 5819
7, 16:10:00-000, 7128, 5792, 1336, 0, 0.00, 0, 0.00, 8205
7, 16:11:00-000, 5422, 3107, 2315, 0, 0.00, 0, 0.00, 5422
7, 16:12:00-000, 5387, 3469, 1918, 6, 1351.00, 6, 1350.33, 5375
7, 16:13:00-000, 3145, 1901, 1244, 30, 1351.13, 48, 1350.62, 3067
7, 16:14:00-000, 1217, 1202, 15, 33, 1351.24, 15, 1350.53, 1169
7, 16:15:00-000, 12295, 3380, 8915, 0, 0.00, 0, 0.00, 12295
7, 16:16:00-000, 1331, 1330, 1, 1, 1348.00, 1, 1346.00, 1329
7, 16:17:00-000, 1356, 1350, 6, 6, 1347.00, 6, 1346.00, 1344
7, 16:18:00-000, 3871, 64, 3807, 17, 1348.82, 18, 1351.66, 3836
7, 16:19:00-000, 4369, 3315, 1054, 11, 1353.09, 10, 1351.40, 4348
7, 16:20:00-000, 6548, 2502, 4046, 9, 1349.44, 9, 1349.44, 6530
7, 16:21:00-000, 2638, 34, 2604, 14, 1349.86, 14, 1350.07, 2610
7, 16:22:00-000, 7883, 2845, 5038, 21, 1350.71, 20, 1348.80, 7842
7, 16:23:00-000, 10422, 5161, 5261, 6, 1349.83, 7, 1349.71, 8801
7, 16:24:00-000, 10614, 8252, 2362, 34, 1346.88, 41, 1350.14, 12147
7, 16:25:00-000, 1343, 23, 1320, 10, 1351.90, 3, 1351.00, 1330
7, 16:26:00-000, 8171, 4801, 3370, 9, 1346.55, 15, 1350.60, 8147
7, 16:27:00-000, 13494, 6453, 7041, 18, 1349.39, 12, 1347.25, 13464
7, 16:28:00-000, 8122, 6927, 1195, 2, 1348.00, 2, 1347.50, 8118
7, 16:29:00-000, 7783, 4833, 2950, 2, 1348.00, 2, 1354.50, 7779
8, 09:07:00-000, 2817, 2730, 87, 0, 0.00, 0, 0.00, 2612
8, 09:08:00-000, 18, 18, 0, 0, 0.00, 3, 1351.00, 220
8, 09:09:00-000, 13, 13, 0, 1, 1379.00, 0, 0.00, 12
8, 09:10:00-000, 10, 10, 0, 0, 0.00, 0, 0.00, 10
8, 09:11:00-000, 16, 16, 0, 0, 0.00, 0, 0.00, 14
8, 09:12:00-000, 4, 4, 0, 2, 1519.00, 0, 0.00, 4
8, 09:33:00-000, 823, 664, 159, 0, 0.00, 0, 0.00, 823
8, 09:42:00-000, 21, 20, 1, 0, 0.00, 0, 0.00, 21
8, 09:47:00-000, 22, 1, 21, 1, 1349.00, 1, 1348.00, 20
8, 09:48:00-000, 55, 50, 5, 0, 0.00, 0, 0.00, 55
8, 09:49:00-000, 1320, 1310, 10, 0, 0.00, 0, 0.00, 1320
8, 09:51:00-000, 235, 125, 110, 3, 1353.33, 3, 1351.67, 229
8, 09:52:00-000, 244, 111, 133, 0, 0.00, 0, 0.00, 244
8, 09:53:00-000, 2328, 851, 1477, 8, 1355.62, 8, 1350.00, 2312
8, 09:56:00-000, 183, 170, 13, 0, 0.00, 0, 0.00, 183
8, 09:57:00-000, 1504, 1497, 7, 7, 1352.43, 7, 1351.00, 1490
8, 09:58:00-000, 1801, 630, 1171, 2, 1351.00, 2, 1350.00, 1797
8, 10:02:00-000, 595, 326, 269, 0, 0.00, 0, 0.00, 276
8, 10:03:00-000, 984, 970, 14, 0, 0.00, 0, 0.00, 1303
8, 10:05:00-000, 206, 200, 6, 0, 0.00, 0, 0.00, 206
8, 10:06:00-000, 1337, 238, 1099, 48, 1350.50, 48, 1353.00, 1241
8, 10:09:00-000, 1048, 168, 880, 2, 1351.00, 2, 1352.00, 1044
8, 10:11:00-000, 2150, 1984, 166, 2, 1350.00, 2, 1350.00, 2146
8, 10:15:00-000, 2524, 155, 2369, 38, 1351.86, 38, 1351.42, 2448
8, 10:17:00-000, 885, 880, 5, 0, 0.00, 0, 0.00, 885
8, 10:18:00-000, 1740, 81, 1659, 0, 0.00, 0, 0.00, 1740
8, 10:24:00-000, 97, 70, 27, 27, 1348.00, 27, 1348.44, 43
8, 10:25:00-000, 59, 51, 8, 1, 1350.00, 1, 1350.00, 57
8, 10:26:00-000, 1696, 119, 1577, 6, 1353.17, 6, 1353.33, 1684
8, 10:27:00-000, 1785, 1289, 496, 0, 0.00, 0, 0.00, 1785
8, 10:28:00-000, 3248, 3082, 166, 8, 1346.25, 8, 1350.00, 3232
8, 10:29:00-000, 307, 17, 290, 14, 1349.29, 14, 1349.14, 279
8, 10:30:00-000, 861, 71, 790, 0, 0.00, 0, 0.00, 861
8, 10:33:00-000, 187, 16, 171, 1, 1349.00, 1, 1348.00, 185
8, 10:35:00-000, 66, 62, 4, 2, 1356.00, 2, 1352.00, 62
8, 10:37:00-000, 3194, 1534, 1660, 1, 1349.00, 1, 1350.00, 3192
8, 10:38:00-000, 105, 87, 18, 8, 1350.13, 8, 1351.00, 89
8, 10:39:00-000, 2674, 1160, 1514, 0, 0.00, 0, 0.00, 2674
8, 10:40:00-000, 151, 71, 80, 1, 1345.00, 1, 1349.00, 149
8, 10:43:00-000, 1237, 1157, 80, 0, 0.00, 0, 0.00, 1237
8, 10:44:00-000, 432, 177, 255, 10, 1347.10, 10, 1350.00, 412
8, 10:45:00-000, 273, 22, 251, 0, 0.00, 0, 0.00, 273
8, 10:46:00-000, 92, 42, 50, 27, 1351.15, 27, 1354.00, 38
8, 10:49:00-000, 158, 150, 8, 0, 0.00, 0, 0.00, 158
8, 10:50:00-000, 3131, 880, 2251, 0, 0.00, 0, 0.00, 3131
8, 10:51:00-000, 3984, 2562, 1422, 1, 1348.00, 1, 1349.00, 3931
8, 10:52:00-000, 1, 1, 0, 1, 1357.00, 1, 1351.00, 50
8, 10:53:00-000, 843, 8, 835, 0, 0.00, 0, 0.00, 843
8, 10:54:00-000, 82, 81, 1, 1, 1356.00, 1, 1351.00, 80
8, 10:55:00-000, 1429, 745, 684, 4, 1351.00, 4, 1351.00, 1421
8, 10:56:00-000, 22, 1, 21, 1, 1345.00, 1, 1349.00, 20
8, 10:57:00-000, 1087, 84, 1003, 8, 1350.00, 8, 1348.00, 1071
8, 10:58:00-000, 21, 1, 20, 0, 0.00, 0, 0.00, 21
8, 10:59:00-000, 503, 303, 200, 5, 1350.00, 5, 1350.00, 493
8, 11:00:00-000, 1777, 1541, 236, 7, 1352.43, 7, 1351.00, 1763
8, 11:02:00-000, 21, 20, 1, 0, 0.00, 0, 0.00, 21
8, 11:03:00-000, 2167, 114, 2053, 0, 0.00, 0, 0.00, 2167
8, 11:07:00-000, 3109, 3100, 9, 0, 0.00, 0, 0.00, 3109
8, 11:08:00-000, 3160, 1364, 1796, 0, 0.00, 0, 0.00, 3160
8, 11:09:00-000, 966, 16, 950, 0, 0.00, 0, 0.00, 966
8, 11:10:00-000, 2368, 101, 2267, 10, 1349.00, 9, 1347.33, 2349
8, 11:11:00-000, 3456, 1723, 1733, 0, 0.00, 1, 1353.00, 3442
8, 11:12:00-000, 1684, 1555, 129, 33, 1345.00, 33, 1345.88, 1631
8, 11:13:00-000, 2825, 2706, 119, 5, 1348.00, 5, 1349.40, 2815
8, 11:15:00-000, 66, 60, 6, 0, 0.00, 0, 0.00, 66
8, 11:16:00-000, 824, 526, 298, 0, 0.00, 0, 0.00, 824
8, 11:17:00-000, 1198, 900, 298, 1, 1348.00, 1, 1346.00, 1196
8, 11:18:00-000, 1640, 127, 1513, 18, 1351.22, 18, 1353.00, 1604
8, 11:19:00-000, 3920, 2980, 940, 3, 1350.33, 3, 1351.33, 3914
8, 11:20:00-000, 359, 202, 157, 0, 0.00, 0, 0.00, 359
8, 11:21:00-000, 905, 61, 844, 3, 1353.00, 3, 1350.00, 899
8, 11:22:00-000, 892, 875, 17, 5, 1354.80, 5, 1352.00, 882
8, 11:24:00-000, 21, 20, 1, 0, 0.00, 0, 0.00, 21
8, 11:25:00-000, 2619, 1692, 927, 0, 0.00, 0, 0.00, 2619
8, 11:26:00-000, 110, 100, 10, 0, 0.00, 0, 0.00, 100
8, 11:27:00-000, 5964, 2326, 3638, 6, 1348.00, 0, 0.00, 5968
8, 11:28:00-000, 199, 42, 157, 0, 0.00, 6, 1351.83, 193
8, 11:29:00-000, 108, 9, 99, 9, 1345.78, 9, 1348.78, 90
8, 11:30:00-000, 394, 62, 332, 2, 1349.00, 31, 1352.00, 361
8, 11:31:00-000, 3118, 1578, 1540, 29, 1356.31, 0, 0.00, 3089
8, 11:34:00-000, 347, 294, 53, 0, 0.00, 6, 1351.00, 336
8, 11:35:00-000, 812, 354, 458, 6, 1352.00, 0, 0.00, 811
8, 11:37:00-000, 1473, 440, 1033, 0, 0.00, 0, 0.00, 1473
8, 11:38:00-000, 2000, 492, 1508, 12, 1351.92, 12, 1350.25, 1976
8, 11:39:00-000, 714, 693, 21, 3, 1348.67, 3, 1347.33, 708
8, 11:40:00-000, 3001, 1385, 1616, 7, 1351.86, 12, 1351.00, 2982
8, 11:41:00-000, 1428, 1400, 28, 10, 1352.90, 5, 1351.00, 1413
8, 11:42:00-000, 2299, 148, 2151, 2, 1349.00, 2, 1348.00, 2295
8, 11:43:00-000, 3189, 132, 3057, 0, 0.00, 0, 0.00, 3189
8, 11:44:00-000, 2582, 1628, 954, 4, 1348.00, 4, 1351.50, 2574
8, 11:45:00-000, 103, 100, 3, 0, 0.00, 0, 0.00, 103
8, 11:46:00-000, 1503, 823, 680, 0, 0.00, 0, 0.00, 1503
8, 11:48:00-000, 1539, 1530, 9, 0, 0.00, 0, 0.00, 1539
8, 11:49:00-000, 915, 137, 778, 13, 1351.08, 9, 1351.00, 893
8, 11:50:00-000, 1317, 1202, 115, 10, 1350.40, 14, 1351.07, 1293
8, 11:51:00-000, 1493, 22, 1471, 0, 0.00, 0, 0.00, 1493
8, 11:52:00-000, 3088, 4, 3084, 4, 1349.00, 4, 1349.25, 3080
8, 11:53:00-000, 2428, 1908, 520, 0, 0.00, 0, 0.00, 2231
8, 11:54:00-000, 110, 100, 10, 10, 1357.00, 10, 1353.00, 287
8, 11:55:00-000, 1760, 1520, 240, 0, 0.00, 0, 0.00, 1760
8, 11:57:00-000, 1612, 1, 1611, 1, 1351.00, 1, 1347.00, 1610
8, 11:58:00-000, 2981, 2824, 157, 2, 1352.00, 2, 1350.00, 2977
8, 11:59:00-000, 2190, 2042, 148, 9, 1353.89, 9, 1351.33, 2151
8, 12:00:00-000, 3201, 2378, 823, 16, 1353.12, 16, 1350.94, 3190
8, 12:01:00-000, 1274, 1034, 240, 0, 0.00, 0, 0.00, 1184
8, 12:02:00-000, 0, 0, 0, 0, 0.00, 0, 0.00, 90
8, 12:05:00-000, 1565, 91, 1474, 1, 1355.00, 1, 1352.00, 1563
8, 12:06:00-000, 3630, 120, 3510, 4, 1349.00, 4, 1347.00, 3622
8, 12:07:00-000, 1729, 1644, 85, 0, 0.00, 0, 0.00, 1729
8, 12:08:00-000, 1707, 1455, 252, 0, 0.00, 0, 0.00, 1487
8, 12:09:00-000, 1359, 797, 562, 6, 1348.00, 6, 1349.67, 1567
8, 12:10:00-000, 228, 38, 190, 30, 1352.80, 30, 1352.10, 168
8, 12:11:00-000, 3383, 2142, 1241, 0, 0.00, 0, 0.00, 3383
8, 12:13:00-000, 3456, 2444, 1012, 1, 1350.00, 1, 1351.00, 3454
8, 12:14:00-000, 1095, 153, 942, 3, 1352.00, 3, 1350.00, 1089
8, 12:15:00-000, 109, 100, 9, 0, 0.00, 0, 0.00, 109
8, 12:17:00-000, 916, 893, 23, 2, 1351.00, 2, 1350.00, 912
8, 12:18:00-000, 1646, 1630, 16, 0, 0.00, 0, 0.00, 1646
8, 12:19:00-000, 1622, 1511, 111, 0, 0.00, 0, 0.00, 1601
8, 12:20:00-000, 1, 0, 1, 1, 1350.00, 1, 1351.00, 20
8, 12:22:00-000, 2067, 1606, 461, 0, 0.00, 0, 0.00, 2067
8, 12:29:00-000, 766, 41, 725, 16, 1353.31, 16, 1352.00, 734
8, 12:30:00-000, 173, 86, 87, 2, 1349.00, 2, 1349.50, 169
8, 12:31:00-000, 852, 12, 840, 3, 1352.67, 3, 1351.00, 846
8, 12:32:00-000, 490, 365, 125, 0, 0.00, 0, 0.00, 490
8, 12:34:00-000, 1312, 205, 1107, 0, 0.00, 0, 0.00, 1312
8, 12:41:00-000, 21, 20, 1, 0, 0.00, 0, 0.00, 21
8, 12:43:00-000, 118, 60, 58, 0, 0.00, 0, 0.00, 118
8, 12:45:00-000, 858, 836, 22, 6, 1352.00, 6, 1353.00, 846
8, 12:50:00-000, 1619, 1371, 248, 6, 1348.67, 6, 1351.67, 1607
8, 12:52:00-000, 1349, 1340, 9, 0, 0.00, 0, 0.00, 1349
8, 12:54:00-000, 144, 140, 4, 0, 0.00, 0, 0.00, 144
8, 12:55:00-000, 1185, 1163, 22, 18, 1348.83, 18, 1351.22, 1149
8, 12:57:00-000, 5464, 2672, 2792, 4, 1349.75, 4, 1350.00, 5456
8, 12:58:00-000, 1170, 324, 846, 0, 0.00, 0, 0.00, 1170
8, 12:59:00-000, 977, 970, 7, 0, 0.00, 0, 0.00, 977
8, 13:00:00-000, 1997, 74, 1923, 0, 0.00, 0, 0.00, 1997
8, 13:01:00-000, 129, 70, 59, 0, 0.00, 0, 0.00, 129
8, 13:02:00-000, 847, 176, 671, 0, 0.00, 0, 0.00, 847
8, 13:04:00-000, 1012, 92, 920, 0, 0.00, 0, 0.00, 1012
8, 13:06:00-000, 1216, 1146, 70, 0, 0.00, 0, 0.00, 1216
8, 13:07:00-000, 6379, 3974, 2405, 0, 0.00, 0, 0.00, 6303
8, 13:08:00-000, 193, 139, 54, 33, 1350.48, 33, 1352.00, 200
8, 13:09:00-000, 1818, 198, 1620, 8, 1349.37, 8, 1345.00, 1805
8, 13:10:00-000, 1152, 99, 1053, 2, 1351.00, 2, 1349.00, 1148
8, 13:11:00-000, 42, 7, 35, 0, 0.00, 0, 0.00, 42
8, 13:12:00-000, 2445, 2392, 53, 2, 1354.00, 2, 1352.00, 2441
8, 13:13:00-000, 1652, 668, 984, 16, 1348.88, 16, 1350.75, 1620
8, 13:14:00-000, 1217, 60, 1157, 0, 0.00, 0, 0.00, 1217
8, 13:15:00-000, 60, 60, 0, 0, 0.00, 0, 0.00, 60
8, 13:16:00-000, 538, 128, 410, 0, 0.00, 0, 0.00, 538
8, 13:17:00-000, 81, 6, 75, 5, 1348.00, 5, 1347.00, 71
8, 13:18:00-000, 899, 65, 834, 7, 1350.14, 7, 1352.00, 885
8, 13:19:00-000, 925, 98, 827, 1, 1348.00, 1, 1345.00, 923
8, 13:20:00-000, 111, 11, 100, 10, 1350.40, 10, 1350.00, 91
8, 13:21:00-000, 271, 95, 176, 0, 0.00, 0, 0.00, 271
8, 13:22:00-000, 267, 242, 25, 10, 1352.20, 10, 1351.00, 247
8, 13:23:00-000, 190, 97, 93, 1, 1352.00, 1, 1351.00, 188
8, 13:24:00-000, 1506, 692, 814, 5, 1349.60, 5, 1350.40, 1496
8, 13:25:00-000, 3143, 43, 3100, 0, 0.00, 0, 0.00, 3143
8, 13:26:00-000, 2991, 2960, 31, 3, 1348.00, 3, 1351.00, 2985
8, 13:27:00-000, 579, 45, 534, 2, 1349.50, 2, 1352.00, 575
8, 13:28:00-000, 130, 20, 110, 0, 0.00, 0, 0.00, 130
8, 13:29:00-000, 81, 11, 70, 0, 0.00, 0, 0.00, 81
8, 13:30:00-000, 328, 251, 77, 3, 1349.00, 3, 1350.00, 322
8, 13:31:00-000, 670, 93, 577, 0, 0.00, 0, 0.00, 670
8, 13:32:00-000, 1651, 829, 822, 0, 0.00, 0, 0.00, 1651
8, 13:33:00-000, 209, 190, 19, 0, 0.00, 0, 0.00, 209
8, 13:34:00-000, 817, 23, 794, 3, 1348.00, 3, 1345.00, 811
8, 13:35:00-000, 203, 103, 100, 0, 0.00, 0, 0.00, 103
8, 13:36:00-000, 953, 165, 788, 5, 1348.40, 5, 1350.00, 1043
8, 13:37:00-000, 1695, 1690, 5, 0, 0.00, 0, 0.00, 1695
8, 13:38:00-000, 293, 135, 158, 7, 1354.00, 7, 1351.00, 279
8, 13:40:00-000, 678, 11, 667, 7, 1350.00, 7, 1348.43, 664
8, 13:41:00-000, 2023, 1047, 976, 7, 1351.00, 7, 1351.86, 2009
8, 13:42:00-000, 1696, 1463, 233, 13, 1351.15, 13, 1349.23, 1670
8, 13:43:00-000, 53, 3, 50, 0, 0.00, 0, 0.00, 53
8, 13:45:00-000, 1287, 22, 1265, 0, 0.00, 0, 0.00, 1287
8, 13:46:00-000, 1509, 1497, 12, 0, 0.00, 0, 0.00, 1509
8, 13:49:00-000, 206, 16, 190, 0, 0.00, 0, 0.00, 206
8, 13:50:00-000, 661, 185, 476, 4, 1351.00, 7, 1351.00, 650
8, 13:51:00-000, 929, 837, 92, 3, 1355.00, 0, 0.00, 926
8, 13:52:00-000, 1075, 248, 827, 1, 1351.00, 1, 1352.00, 1073
8, 13:53:00-000, 2565, 1063, 1502, 28, 1346.93, 28, 1347.86, 2509
8, 13:56:00-000, 1442, 1112, 330, 2, 1352.00, 1, 1350.00, 1439
8, 13:57:00-000, 1702, 268, 1434, 2, 1349.00, 3, 1346.67, 1697
8, 13:59:00-000, 318, 107, 211, 14, 1351.07, 14, 1354.00, 269
8, 14:00:00-000, 1888, 970, 918, 3, 1350.00, 3, 1350.00, 1903
8, 14:01:00-000, 3813, 2889, 924, 3, 1350.67, 3, 1350.67, 3807
8, 14:02:00-000, 1653, 1480, 173, 10, 1349.00, 10, 1348.00, 1633
8, 14:03:00-000, 2396, 315, 2081, 21, 1346.14, 21, 1349.47, 2354
8, 14:04:00-000, 100, 5, 95, 5, 1347.40, 5, 1349.20, 90
8, 14:05:00-000, 1858, 110, 1748, 0, 0.00, 0, 0.00, 1787
8, 14:06:00-000, 2901, 2773, 128, 4, 1352.50, 4, 1352.00, 2964
8, 14:07:00-000, 1867, 927, 940, 0, 0.00, 0, 0.00, 1867
8, 14:08:00-000, 3181, 3171, 10, 1, 1350.00, 1, 1350.00, 1589
8, 14:09:00-000, 1395, 827, 568, 2, 1351.00, 2, 1350.00, 2979
8, 14:10:00-000, 376, 185, 191, 8, 1351.00, 8, 1349.00, 362
8, 14:11:00-000, 404, 96, 308, 0, 0.00, 0, 0.00, 404
8, 14:12:00-000, 91, 85, 6, 5, 1346.00, 5, 1350.00, 81
8, 14:13:00-000, 876, 9, 867, 7, 1346.29, 7, 1348.00, 862
8, 14:14:00-000, 610, 220, 390, 0, 0.00, 0, 0.00, 610
8, 14:15:00-000, 2496, 2442, 54, 2, 1350.50, 2, 1349.00, 2492
8, 14:17:00-000, 3134, 2997, 137, 3, 1349.67, 3, 1349.33, 3128
8, 14:19:00-000, 809, 249, 560, 0, 0.00, 1, 1350.00, 808
8, 14:20:00-000, 781, 623, 158, 4, 1349.50, 3, 1347.00, 472
8, 14:21:00-000, 1591, 1496, 95, 0, 0.00, 0, 0.00, 1893
8, 14:22:00-000, 784, 774, 10, 4, 1351.00, 4, 1350.00, 776
8, 14:23:00-000, 255, 251, 4, 1, 1350.00, 1, 1350.00, 253
8, 14:24:00-000, 2104, 2034, 70, 0, 0.00, 0, 0.00, 2104
8, 14:25:00-000, 2481, 1508, 973, 0, 0.00, 0, 0.00, 2481
8, 14:26:00-000, 21, 1, 20, 0, 0.00, 0, 0.00, 21
8, 14:27:00-000, 116, 101, 15, 5, 1351.80, 5, 1349.00, 106
8, 14:28:00-000, 785, 670, 115, 1, 1352.00, 1, 1351.00, 574
8, 14:29:00-000, 1106, 119, 987, 3, 1349.00, 3, 1353.00, 1309
8, 14:30:00-000, 1862, 373, 1489, 3, 1348.00, 1, 1350.00, 1858
8, 14:31:00-000, 1724, 253, 1471, 1, 1349.00, 3, 1349.00, 1712
8, 14:32:00-000, 2466, 25, 2441, 1, 1349.00, 1, 1350.00, 2472
8, 14:33:00-000, 1554, 145, 1409, 0, 0.00, 0, 0.00, 1554
8, 14:34:00-000, 3500, 257, 3243, 3, 1350.00, 3, 1352.00, 3494
8, 14:35:00-000, 1584, 969, 615, 0, 0.00, 0, 0.00, 1584
8, 14:36:00-000, 1597, 1396, 201, 15, 1348.07, 15, 1349.27, 1567
8, 14:37:00-000, 1646, 1448, 198, 0, 0.00, 0, 0.00, 1646
8, 14:38:00-000, 1002, 767, 235, 12, 1347.16, 12, 1350.17, 978
8, 14:39:00-000, 287, 37, 250, 1, 1348.00, 1, 1352.00, 285
8, 14:40:00-000, 3336, 1647, 1689, 16, 1349.25, 17, 1352.00, 3303
8, 14:41:00-000, 3738, 734, 3004, 10, 1353.40, 9, 1352.00, 3719
8, 14:42:00-000, 1380, 825, 555, 15, 1347.27, 15, 1345.00, 1350
8, 14:43:00-000, 538, 360, 178, 1, 1349.00, 0, 0.00, 537
8, 14:44:00-000, 1, 0, 1, 0, 0.00, 1, 1348.00, 0
8, 14:45:00-000, 101, 11, 90, 0, 0.00, 0, 0.00, 101
8, 14:46:00-000, 3097, 1561, 1536, 10, 1351.00, 10, 1351.00, 3077
8, 14:47:00-000, 1794, 932, 862, 1, 1353.00, 1, 1351.00, 1034
8, 14:48:00-000, 553, 550, 3, 0, 0.00, 0, 0.00, 1311
8, 14:49:00-000, 154, 131, 23, 0, 0.00, 0, 0.00, 154
8, 14:52:00-000, 2051, 954, 1097, 2, 1348.50, 1, 1349.00, 2048
8, 14:53:00-000, 455, 284, 171, 10, 1349.80, 11, 1348.91, 434
8, 14:54:00-000, 2855, 1040, 1815, 11, 1354.00, 11, 1350.27, 2833
8, 14:55:00-000, 48, 40, 8, 0, 0.00, 0, 0.00, 48
8, 14:57:00-000, 1806, 746, 1060, 0, 0.00, 0, 0.00, 1806
8, 14:58:00-000, 169, 9, 160, 0, 0.00, 0, 0.00, 169
8, 14:59:00-000, 255, 163, 92, 9, 1350.89, 9, 1351.78, 237
8, 15:00:00-000, 3092, 2150, 942, 11, 1349.82, 11, 1348.45, 3070
8, 15:01:00-000, 2449, 1597, 852, 5, 1351.60, 5, 1353.00, 2439
8, 15:03:00-000, 2014, 546, 1468, 0, 0.00, 0, 0.00, 2014
8, 15:04:00-000, 2667, 455, 2212, 4, 1348.00, 4, 1349.00, 2649
8, 15:05:00-000, 2094, 346, 1748, 1, 1349.00, 1, 1350.00, 2102
8, 15:06:00-000, 1360, 991, 369, 8, 1348.00, 8, 1350.88, 1344
8, 15:07:00-000, 1573, 211, 1362, 0, 0.00, 0, 0.00, 1573
8, 15:08:00-000, 106, 90, 16, 0, 0.00, 0, 0.00, 106
8, 15:09:00-000, 2188, 993, 1195, 2, 1354.00, 2, 1353.00, 2184
8, 15:10:00-000, 729, 456, 273, 10, 1349.50, 10, 1348.70, 709
8, 15:11:00-000, 3957, 2576, 1381, 1, 1348.00, 1, 1349.00, 3949
8, 15:12:00-000, 512, 380, 132, 0, 0.00, 0, 0.00, 518
8, 15:13:00-000, 451, 356, 95, 1, 1352.00, 1, 1350.00, 449
8, 15:14:00-000, 322, 310, 12, 0, 0.00, 0, 0.00, 322
8, 15:15:00-000, 202, 148, 54, 8, 1355.50, 8, 1348.88, 186
8, 15:16:00-000, 4159, 3248, 911, 1, 1345.00, 2, 1351.50, 3403
8, 15:17:00-000, 82, 20, 62, 3, 1351.33, 2, 1354.00, 830
8, 15:18:00-000, 3324, 1652, 1672, 1, 1349.00, 1, 1348.00, 3322
8, 15:21:00-000, 1512, 1510, 2, 0, 0.00, 0, 0.00, 1512
8, 15:22:00-000, 1348, 17, 1331, 6, 1350.00, 6, 1347.00, 1336
8, 15:24:00-000, 1567, 1522, 45, 11, 1350.45, 14, 1351.21, 1542
8, 15:25:00-000, 4361, 4343, 18, 3, 1350.00, 0, 0.00, 4358
8, 15:26:00-000, 1492, 1491, 1, 1, 1351.00, 1, 1351.00, 1490
8, 15:27:00-000, 197, 103, 94, 0, 0.00, 0, 0.00, 197
8, 15:28:00-000, 1571, 1544, 27, 2, 1350.50, 2, 1352.00, 1567
8, 15:29:00-000, 1445, 460, 985, 21, 1347.19, 21, 1348.38, 1403
8, 15:30:00-000, 428, 309, 119, 10, 1349.30, 10, 1350.20, 408
8, 15:32:00-000, 717, 710, 7, 0, 0.00, 0, 0.00, 717
8, 15:33:00-000, 1056, 16, 1040, 0, 0.00, 0, 0.00, 1056
8, 15:34:00-000, 1710, 926, 784, 12, 1348.25, 12, 1351.00, 1686
8, 15:35:00-000, 3331, 1691, 1640, 0, 0.00, 0, 0.00, 3331
8, 15:36:00-000, 1504, 408, 1096, 7, 1349.71, 7, 1353.71, 1490
8, 15:37:00-000, 105, 5, 100, 0, 0.00, 0, 0.00, 105
8, 15:39:00-000, 141, 11, 130, 0, 0.00, 0, 0.00, 141
8, 15:41:00-000, 63, 3, 60, 0, 0.00, 0, 0.00, 63
8, 15:42:00-000, 2434, 2274, 160, 0, 0.00, 0, 0.00, 2434
8, 15:44:00-000, 1577, 265, 1312, 10, 1350.20, 10, 1352.00, 1552
8, 15:45:00-000, 120, 112, 8, 8, 1354.50, 8, 1351.00, 109
8, 15:50:00-000, 4975, 3074, 1901, 9, 1353.78, 9, 1352.00, 4957
8, 15:57:00-000, 155, 81, 74, 0, 0.00, 0, 0.00, 151
8, 15:58:00-000, 0, 0, 0, 0, 0.00, 0, 0.00, 4
8, 16:00:00-000, 21, 20, 1, 0, 0.00, 0, 0.00, 21
8, 16:02:00-000, 621, 11, 610, 0, 0.00, 0, 0.00, 621
8, 16:03:00-000, 1166, 107, 1059, 0, 0.00, 0, 0.00, 1166
8, 16:07:00-000, 518, 204, 314, 0, 0.00, 0, 0.00, 518
8, 16:08:00-000, 607, 4, 603, 3, 1349.67, 3, 1346.67, 601
8, 16:09:00-000, 374, 106, 268, 5, 1351.00, 5, 1351.00, 364
8, 16:10:00-000, 2527, 127, 2400, 1, 1350.00, 1, 1353.00, 2525
8, 16:11:00-000, 1681, 798, 883, 1, 1349.00, 1, 1349.00, 1679
8, 16:14:00-000, 21, 20, 1, 0, 0.00, 1, 1351.00, 20
8, 16:15:00-000, 1587, 1566, 21, 6, 1351.83, 5, 1351.00, 1576
8, 16:19:00-000, 69, 9, 60, 0, 0.00, 0, 0.00, 69
8, 16:20:00-000, 2335, 765, 1570, 0, 0.00, 0, 0.00, 2335
8, 16:21:00-000, 67, 60, 7, 0, 0.00, 0, 0.00, 67
8, 16:22:00-000, 253, 250, 3, 0, 0.00, 0, 0.00, 253
8, 16:23:00-000, 1686, 741, 945, 0, 0.00, 0, 0.00, 1686
8, 16:24:00-000, 1930, 866, 1064, 20, 1348.10, 20, 1348.25, 1890
8, 16:25:00-000, 132, 61, 71, 1, 1351.00, 1, 1351.00, 130
8, 16:26:00-000, 3408, 2206, 1202, 5, 1349.40, 1, 1350.00, 3402
8, 16:27:00-000, 964, 884, 80, 6, 1347.00, 10, 1348.30, 948
8, 16:28:00-000, 3062, 855, 2207, 12, 1347.00, 6, 1351.00, 3044
8, 16:29:00-000, 1547, 1084, 463, 1, 1349.00, 7, 1349.14, 1539
9, 09:07:00-000, 4110, 1420, 2690, 0, 0.00, 0, 0.00, 4110
9, 09:33:00-000, 5360, 1170, 4190, 0, 0.00, 0, 0.00, 5360
9, 09:48:00-000, 796, 760, 36, 36, 1345.47, 10, 1350.60, 750
9, 09:49:00-000, 61, 0, 61, 0, 0.00, 26, 1347.38, 35
9, 09:51:00-000, 3660, 2230, 1430, 0, 0.00, 0, 0.00, 3660
9, 09:52:00-000, 6891, 4531, 2360, 1, 1350.00, 1, 1350.00, 6889
9, 09:53:00-000, 2900, 2900, 0, 0, 0.00, 0, 0.00, 2900
9, 09:54:00-000, 935, 900, 35, 23, 1348.00, 23, 1350.69, 889
9, 09:55:00-000, 700, 700, 0, 0, 0.00, 0, 0.00, 700
9, 09:56:00-000, 950, 950, 0, 0, 0.00, 0, 0.00, 950
9, 09:57:00-000, 2712, 2272, 440, 2, 1356.00, 2, 1354.00, 2708
9, 09:58:00-000, 3070, 2250, 820, 0, 0.00, 0, 0.00, 3070
9, 10:00:00-000, 2100, 1190, 910, 0, 0.00, 0, 0.00, 2100
9, 10:01:00-000, 1053, 1050, 3, 3, 1349.00, 3, 1349.00, 1047
9, 10:02:00-000, 2170, 980, 1190, 0, 0.00, 0, 0.00, 2170
9, 10:03:00-000, 5860, 2690, 3170, 0, 0.00, 0, 0.00, 5860
9, 10:05:00-000, 2250, 1250, 1000, 0, 0.00, 0, 0.00, 2250
9, 10:06:00-000, 8130, 2160, 5970, 0, 0.00, 35, 1351.00, 8095
9, 10:07:00-000, 61, 61, 0, 35, 1354.14, 0, 0.00, 26
9, 10:08:00-000, 1660, 1660, 0, 0, 0.00, 0, 0.00, 1660
9, 10:09:00-000, 12370, 7010, 5360, 0, 0.00, 0, 0.00, 12370
9, 10:10:00-000, 2979, 1100, 1879, 39, 1346.94, 39, 1347.00, 2901
9, 10:11:00-000, 5590, 3550, 2040, 0, 0.00, 0, 0.00, 5590
9, 10:15:00-000, 5740, 2730, 3010, 0, 0.00, 0, 0.00, 5740
9, 10:17:00-000, 1340, 0, 1340, 0, 0.00, 0, 0.00, 1340
9, 10:18:00-000, 7829, 2930, 4899, 39, 1348.00, 39, 1345.23, 7751
9, 10:20:00-000, 2582, 2, 2580, 2, 1352.00, 2, 1352.00, 2578
9, 10:26:00-000, 1350, 1350, 0, 0, 0.00, 0, 0.00, 1350
9, 10:27:00-000, 10790, 5030, 5760, 0, 0.00, 0, 0.00, 10790
9, 10:28:00-000, 8144, 1584, 6560, 4, 1354.00, 4, 1353.00, 8136
9, 10:30:00-000, 2730, 2730, 0, 0, 0.00, 0, 0.00, 2730
9, 10:33:00-000, 1330, 0, 1330, 0, 0.00, 0, 0.00, 1330
9, 10:34:00-000, 920, 920, 0, 0, 0.00, 0, 0.00, 920
9, 10:35:00-000, 810, 0, 810, 0, 0.00, 0, 0.00, 810
9, 10:37:00-000, 2850, 1650, 1200, 0, 0.00, 0, 0.00, 2850
9, 10:38:00-000, 2079, 29, 2050, 29, 1354.24, 29, 1352.14, 2021
9, 10:39:00-000, 1180, 1180, 0, 0, 0.00, 0, 0.00, 1180
9, 10:43:00-000, 10620, 7050, 3570, 0, 0.00, 0, 0.00, 9340
9, 10:44:00-000, 2922, 1982, 940, 12, 1351.00, 12, 1354.00, 4178
9, 10:45:00-000, 2640, 0, 2640, 0, 0.00, 0, 0.00, 2640
9, 10:46:00-000, 1390, 0, 1390, 0, 0.00, 0, 0.00, 1390
9, 10:49:00-000, 940, 0, 940, 0, 0.00, 0, 0.00, 940
9, 10:50:00-000, 6366, 3472, 2894, 6, 1349.33, 6, 1351.17, 6354
9, 10:51:00-000, 9250, 2220, 7030, 0, 0.00, 0, 0.00, 8850
9, 10:52:00-000, 579, 570, 9, 9, 1347.00, 9, 1349.00, 961
9, 10:53:00-000, 1107, 7, 1100, 7, 1352.00, 7, 1352.00, 1093
9, 10:54:00-000, 73, 23, 50, 23, 1354.39, 23, 1354.00, 27
9, 10:55:00-000, 6200, 3310, 2890, 0, 0.00, 0, 0.00, 5440
9, 10:56:00-000, 840, 0, 840, 0, 0.00, 0, 0.00, 1600
9, 10:57:00-000, 2430, 1490, 940, 0, 0.00, 0, 0.00, 2430
9, 10:58:00-000, 3627, 3620, 7, 7, 1347.00, 7, 1346.86, 3613
9, 10:59:00-000, 6650, 1700, 4950, 0, 0.00, 0, 0.00, 6650
9, 11:00:00-000, 3070, 2050, 1020, 0, 0.00, 0, 0.00, 3070
9, 11:02:00-000, 4782, 1452, 3330, 6, 1351.00, 52, 1353.00, 4724
9, 11:03:00-000, 6518, 1028, 5490, 69, 1353.60, 23, 1352.00, 6426
9, 11:04:00-000, 738, 8, 730, 8, 1354.00, 8, 1351.00, 722
9, 11:05:00-000, 1012, 950, 62, 22, 1348.00, 22, 1348.86, 968
9, 11:08:00-000, 6390, 1980, 4410, 0, 0.00, 0, 0.00, 6390
9, 11:09:00-000, 3120, 3120, 0, 0, 0.00, 0, 0.00, 3120
9, 11:10:00-000, 6772, 4111, 2661, 29, 1350.55, 79, 1351.55, 6664
9, 11:11:00-000, 6270, 4820, 1450, 50, 1355.93, 0, 0.00, 6220
9, 11:12:00-000, 11355, 6170, 5185, 3, 1345.00, 3, 1346.00, 10479
9, 11:13:00-000, 6588, 3890, 2698, 8, 1348.00, 8, 1349.00, 7442
9, 11:15:00-000, 780, 0, 780, 0, 0.00, 0, 0.00, 780
9, 11:16:00-000, 9320, 2820, 6500, 0, 0.00, 0, 0.00, 9320
9, 11:17:00-000, 9667, 5976, 3691, 45, 1351.26, 45, 1349.73, 9577
9, 11:19:00-000, 16030, 10770, 5260, 0, 0.00, 0, 0.00, 15510
9, 11:20:00-000, 6524, 5574, 950, 4, 1348.50, 4, 1352.00, 7036
9, 11:21:00-000, 7887, 2790, 5097, 26, 1348.00, 26, 1347.88, 7835
9, 11:22:00-000, 2276, 16, 2260, 16, 1356.00, 16, 1352.00, 2244
9, 11:24:00-000, 2890, 680, 2210, 0, 0.00, 0, 0.00, 2890
9, 11:25:00-000, 3595, 1085, 2510, 15, 1350.40, 15, 1352.00, 3565
9, 11:26:00-000, 1470, 1470, 0, 0, 0.00, 0, 0.00, 1470
9, 11:27:00-000, 6536, 3416, 3120, 8, 1349.87, 8, 1351.00, 6520
9, 11:28:00-000, 3160, 1890, 1270, 0, 0.00, 0, 0.00, 3160
9, 11:30:00-000, 8943, 3723, 5220, 2, 1352.00, 3, 1353.00, 8938
9, 11:31:00-000, 6421, 3911, 2510, 1, 1351.00, 0, 0.00, 6420
9, 11:32:00-000, 1282, 192, 1090, 65, 1356.93, 65, 1353.00, 1152
9, 11:33:00-000, 2390, 1430, 960, 0, 0.00, 0, 0.00, 2390
9, 11:34:00-000, 3030, 0, 3030, 0, 0.00, 0, 0.00, 3030
9, 11:35:00-000, 8730, 1720, 7010, 0, 0.00, 0, 0.00, 8000
9, 11:36:00-000, 2627, 1465, 1162, 7, 1352.29, 7, 1350.71, 3343
9, 11:37:00-000, 6171, 2391, 3780, 1, 1351.00, 1, 1353.00, 6169
9, 11:38:00-000, 4831, 881, 3950, 21, 1351.62, 21, 1351.95, 4789
9, 11:40:00-000, 15180, 4860, 10320, 0, 0.00, 0, 0.00, 15180
9, 11:41:00-000, 5179, 1419, 3760, 9, 1351.67, 9, 1352.00, 5161
9, 11:42:00-000, 9300, 6110, 3190, 0, 0.00, 0, 0.00, 9300
9, 11:43:00-000, 7110, 5640, 1470, 0, 0.00, 0, 0.00, 7110
9, 11:44:00-000, 4870, 1270, 3600, 0, 0.00, 0, 0.00, 4870
9, 11:45:00-000, 1380, 1380, 0, 0, 0.00, 0, 0.00, 1380
9, 11:46:00-000, 8721, 3511, 5210, 16, 1351.56, 31, 1351.00, 8674
9, 11:47:00-000, 15, 15, 0, 15, 1353.60, 0, 0.00, 0
9, 11:48:00-000, 5514, 2419, 3095, 44, 1347.82, 44, 1346.36, 5426
9, 11:49:00-000, 9450, 7030, 2420, 6, 1347.00, 6, 1348.17, 9438
9, 11:50:00-000, 3390, 2180, 1210, 0, 0.00, 0, 0.00, 3390
9, 11:51:00-000, 4883, 1953, 2930, 33, 1355.33, 33, 1352.00, 4817
9, 11:53:00-000, 2730, 1180, 1550, 0, 0.00, 0, 0.00, 2730
9, 11:55:00-000, 4000, 1290, 2710, 0, 0.00, 0, 0.00, 4000
9, 11:57:00-000, 920, 920, 0, 0, 0.00, 0, 0.00, 920
9, 11:58:00-000, 5800, 3690, 2110, 0, 0.00, 0, 0.00, 5800
9, 11:59:00-000, 4380, 2900, 1480, 0, 0.00, 0, 0.00, 4380
9, 12:00:00-000, 3945, 1360, 2585, 5, 1348.00, 5, 1349.20, 3935
9, 12:01:00-000, 6550, 2770, 3780, 0, 0.00, 0, 0.00, 6550
9, 12:03:00-000, 810, 810, 0, 0, 0.00, 0, 0.00, 810
9, 12:05:00-000, 4649, 1489, 3160, 50, 1354.19, 50, 1351.71, 4549
9, 12:06:00-000, 5730, 1160, 4570, 0, 0.00, 0, 0.00, 5730
9, 12:07:00-000, 4880, 3670, 1210, 0, 0.00, 0, 0.00, 4880
9, 12:08:00-000, 9140, 3380, 5760, 0, 0.00, 0, 0.00, 9140
9, 12:09:00-000, 5480, 5480, 0, 0, 0.00, 0, 0.00, 5480
9, 12:11:00-000, 3447, 2487, 960, 27, 1353.44, 27, 1353.00, 3393
9, 12:12:00-000, 1363, 1360, 3, 3, 1349.00, 3, 1348.00, 1357
9, 12:13:00-000, 9446, 2912, 6534, 36, 1349.06, 36, 1347.13, 9374
9, 12:14:00-000, 2310, 890, 1420, 0, 0.00, 0, 0.00, 2310
9, 12:15:00-000, 1260, 1260, 0, 0, 0.00, 0, 0.00, 1260
9, 12:17:00-000, 4040, 1970, 2070, 0, 0.00, 0, 0.00, 4040
9, 12:18:00-000, 7216, 3796, 3420, 3, 1350.00, 16, 1353.00, 7197
9, 12:19:00-000, 4633, 1363, 3270, 13, 1356.00, 0, 0.00, 4620
9, 12:21:00-000, 1722, 782, 940, 2, 1351.50, 2, 1352.00, 1718
9, 12:22:00-000, 5730, 4630, 1100, 0, 0.00, 0, 0.00, 5730
9, 12:23:00-000, 4880, 1180, 3700, 0, 0.00, 0, 0.00, 4880
9, 12:24:00-000, 1520, 1520, 0, 0, 0.00, 0, 0.00, 1520
9, 12:28:00-000, 1229, 1210, 19, 19, 1348.00, 19, 1349.68, 1191
9, 12:29:00-000, 3940, 1470, 2470, 0, 0.00, 0, 0.00, 3940
9, 12:30:00-000, 2450, 950, 1500, 0, 0.00, 0, 0.00, 2450
9, 12:32:00-000, 1080, 1080, 0, 0, 0.00, 0, 0.00, 1080
9, 12:34:00-000, 5608, 8, 5600, 6, 1350.17, 6, 1353.00, 5596
9, 12:36:00-000, 1210, 1210, 0, 0, 0.00, 0, 0.00, 1210
9, 12:42:00-000, 1290, 1290, 0, 0, 0.00, 0, 0.00, 1290
9, 12:43:00-000, 2400, 1080, 1320, 0, 0.00, 0, 0.00, 2400
9, 12:45:00-000, 6374, 1554, 4820, 4, 1353.00, 4, 1352.00, 6366
9, 12:46:00-000, 1490, 1490, 0, 0, 0.00, 0, 0.00, 1490
9, 12:47:00-000, 3440, 1390, 2050, 0, 0.00, 0, 0.00, 3440
9, 12:48:00-000, 2190, 1130, 1060, 0, 0.00, 0, 0.00, 2190
9, 12:49:00-000, 1336, 1330, 6, 6, 1348.00, 6, 1346.00, 1324
9, 12:50:00-000, 6220, 880, 5340, 0, 0.00, 0, 0.00, 6220
9, 12:51:00-000, 810, 810, 0, 0, 0.00, 0, 0.00, 810
9, 12:52:00-000, 810, 810, 0, 0, 0.00, 0, 0.00, 810
9, 12:54:00-000, 2050, 980, 1070, 0, 0.00, 0, 0.00, 2050
9, 12:55:00-000, 1510, 0, 1510, 0, 0.00, 0, 0.00, 1510
9, 12:57:00-000, 3230, 1810, 1420, 0, 0.00, 0, 0.00, 3230
9, 12:58:00-000, 5490, 3230, 2260, 0, 0.00, 0, 0.00, 5490
9, 12:59:00-000, 8439, 4610, 3829, 20, 1345.65, 20, 1345.85, 8399
9, 13:00:00-000, 4970, 0, 4970, 0, 0.00, 0, 0.00, 4970
9, 13:01:00-000, 1390, 0, 1390, 0, 0.00, 0, 0.00, 1390
9, 13:02:00-000, 1010, 0, 1010, 0, 0.00, 0, 0.00, 1010
9, 13:04:00-000, 5075, 1528, 3547, 25, 1352.52, 25, 1351.32, 5025
9, 13:05:00-000, 1130, 0, 1130, 0, 0.00, 0, 0.00, 1130
9, 13:06:00-000, 7140, 3680, 3460, 0, 0.00, 0, 0.00, 7140
9, 13:07:00-000, 7850, 4630, 3220, 0, 0.00, 0, 0.00, 7850
9, 13:08:00-000, 2110, 1320, 790, 0, 0.00, 0, 0.00, 1320
9, 13:09:00-000, 4900, 2430, 2470, 10, 1345.80, 10, 1345.00, 5670
9, 13:10:00-000, 6331, 3960, 2371, 1, 1348.00, 1, 1348.00, 6329
9, 13:11:00-000, 1200, 1200, 0, 0, 0.00, 0, 0.00, 0
9, 13:12:00-000, 4883, 2490, 2393, 3, 1348.00, 3, 1349.33, 6077
9, 13:13:00-000, 9690, 6160, 3530, 0, 0.00, 0, 0.00, 9690
9, 13:14:00-000, 4340, 1120, 3220, 0, 0.00, 0, 0.00, 2940
9, 13:15:00-000, 4351, 3650, 701, 1, 1349.00, 1, 1349.00, 5749
9, 13:16:00-000, 6854, 3490, 3364, 14, 1348.00, 8, 1349.13, 6832
9, 13:17:00-000, 1408, 1380, 28, 22, 1347.00, 28, 1346.32, 1358
9, 13:18:00-000, 9719, 4006, 5713, 45, 1347.02, 36, 1349.19, 9638
9, 13:19:00-000, 4168, 823, 3345, 6, 1351.00, 15, 1344.80, 3067
9, 13:20:00-000, 1740, 820, 920, 0, 0.00, 0, 0.00, 2820
9, 13:21:00-000, 2020, 1230, 790, 0, 0.00, 0, 0.00, 2020
9, 13:22:00-000, 1225, 1220, 5, 5, 1348.00, 1, 1350.00, 1219
9, 13:23:00-000, 6001, 3590, 2411, 6, 1347.50, 10, 1348.30, 4655
9, 13:24:00-000, 0, 0, 0, 0, 0.00, 0, 0.00, 1330
9, 13:25:00-000, 6434, 1074, 5360, 4, 1350.25, 4, 1351.00, 5356
9, 13:26:00-000, 5587, 2000, 3587, 17, 1346.94, 17, 1346.12, 6623
9, 13:27:00-000, 4500, 830, 3670, 0, 0.00, 0, 0.00, 4500
9, 13:28:00-000, 8100, 2890, 5210, 0, 0.00, 0, 0.00, 8100
9, 13:29:00-000, 10466, 6930, 3536, 16, 1348.00, 16, 1348.81, 9134
9, 13:30:00-000, 3880, 1390, 2490, 0, 0.00, 0, 0.00, 5180
9, 13:32:00-000, 6749, 4139, 2610, 9, 1350.33, 9, 1352.00, 6731
9, 13:33:00-000, 2341, 1470, 871, 11, 1346.36, 11, 1348.64, 2319
9, 13:34:00-000, 4720, 3590, 1130, 10, 1346.80, 10, 1346.00, 4700
9, 13:35:00-000, 1470, 0, 1470, 0, 0.00, 0, 0.00, 1470
9, 13:36:00-000, 7774, 4080, 3694, 4, 1348.00, 4, 1345.25, 7766
9, 13:37:00-000, 1570, 0, 1570, 0, 0.00, 0, 0.00, 1570
9, 13:38:00-000, 1626, 250, 1376, 16, 1349.00, 16, 1347.87, 1594
9, 13:40:00-000, 7190, 4620, 2570, 0, 0.00, 0, 0.00, 7190
9, 13:41:00-000, 5807, 4390, 1417, 5, 1348.00, 5, 1346.80, 5797
9, 13:42:00-000, 9250, 6970, 2280, 0, 0.00, 0, 0.00, 9250
9, 13:43:00-000, 1030, 0, 1030, 0, 0.00, 0, 0.00, 1030
9, 13:45:00-000, 2119, 9, 2110, 9, 1355.00, 9, 1352.00, 2101
9, 13:46:00-000, 3720, 1400, 2320, 0, 0.00, 0, 0.00, 3720
9, 13:49:00-000, 4457, 3150, 1307, 7, 1348.00, 7, 1348.43, 4443
9, 13:50:00-000, 8694, 3507, 5187, 11, 1349.18, 20, 1351.60, 8663
9, 13:51:00-000, 17, 13, 4, 13, 1355.00, 4, 1348.00, 0
9, 13:52:00-000, 3050, 2169, 881, 10, 1350.70, 10, 1352.70, 3030
9, 13:53:00-000, 5911, 2810, 3101, 11, 1348.73, 11, 1347.09, 5889
9, 13:54:00-000, 2298, 1017, 1281, 4, 1349.50, 8, 1352.50, 2286
9, 13:55:00-000, 1264, 1264, 0, 4, 1356.00, 0, 0.00, 1260
9, 13:56:00-000, 5070, 3340, 1730, 0, 0.00, 0, 0.00, 5070
9, 13:57:00-000, 800, 0, 800, 0, 0.00, 0, 0.00, 800
9, 13:58:00-000, 760, 760, 0, 0, 0.00, 0, 0.00, 760
9, 13:59:00-000, 7350, 4810, 2540, 0, 0.00, 0, 0.00, 5970
9, 14:00:00-000, 1730, 870, 860, 0, 0.00, 0, 0.00, 3110
9, 14:01:00-000, 4378, 720, 3658, 8, 1345.00, 8, 1347.87, 4362
9, 14:02:00-000, 7441, 4051, 3390, 1, 1353.00, 1, 1350.00, 7439
9, 14:03:00-000, 13690, 9080, 4610, 0, 0.00, 0, 0.00, 13690
9, 14:04:00-000, 1594, 1520, 74, 74, 1347.79, 74, 1346.75, 1446
9, 14:05:00-000, 6850, 1270, 5580, 0, 0.00, 0, 0.00, 6850
9, 14:06:00-000, 10760, 3960, 6800, 0, 0.00, 0, 0.00, 10760
9, 14:07:00-000, 7640, 3560, 4080, 0, 0.00, 0, 0.00, 7640
9, 14:08:00-000, 1120, 0, 1120, 0, 0.00, 0, 0.00, 1120
9, 14:09:00-000, 11470, 8770, 2700, 0, 0.00, 0, 0.00, 11470
9, 14:10:00-000, 7490, 4020, 3470, 0, 0.00, 0, 0.00, 7490
9, 14:11:00-000, 1350, 1350, 0, 0, 0.00, 0, 0.00, 1350
9, 14:12:00-000, 2090, 690, 1400, 0, 0.00, 0, 0.00, 2090
9, 14:13:00-000, 2393, 33, 2360, 19, 1353.05, 19, 1352.00, 2355
9, 14:14:00-000, 3290, 940, 2350, 0, 0.00, 0, 0.00, 2340
9, 14:15:00-000, 4235, 2390, 1845, 5, 1348.00, 5, 1349.00, 5175
9, 14:17:00-000, 6870, 4660, 2210, 0, 0.00, 0, 0.00, 6870
9, 14:18:00-000, 2005, 15, 1990, 15, 1352.60, 15, 1352.00, 1975
9, 14:19:00-000, 5533, 883, 4650, 35, 1352.60, 35, 1352.28, 5463
9, 14:20:00-000, 2706, 16, 2690, 10, 1349.20, 10, 1352.00, 2686
9, 14:21:00-000, 8740, 1960, 6780, 0, 0.00, 0, 0.00, 8740
9, 14:22:00-000, 3560, 2150, 1410, 0, 0.00, 0, 0.00, 3560
9, 14:23:00-000, 3273, 2490, 783, 3, 1349.00, 3, 1348.67, 3267
9, 14:24:00-000, 7480, 5200, 2280, 0, 0.00, 0, 0.00, 7480
9, 14:25:00-000, 4570, 2980, 1590, 0, 0.00, 0, 0.00, 4570
9, 14:26:00-000, 1430, 1430, 0, 0, 0.00, 0, 0.00, 1430
9, 14:27:00-000, 2286, 1466, 820, 6, 1352.17, 6, 1352.00, 2274
9, 14:28:00-000, 5230, 3500, 1730, 0, 0.00, 0, 0.00, 5230
9, 14:29:00-000, 1240, 1240, 0, 0, 0.00, 0, 0.00, 1240
9, 14:30:00-000, 780, 780, 0, 0, 0.00, 0, 0.00, 780
9, 14:31:00-000, 15660, 7130, 8530, 0, 0.00, 0, 0.00, 15660
9, 14:32:00-000, 5271, 1501, 3770, 20, 1350.75, 20, 1352.20, 5231
9, 14:33:00-000, 2159, 2079, 80, 9, 1353.78, 9, 1353.00, 2141
9, 14:34:00-000, 8960, 3240, 5720, 0, 0.00, 0, 0.00, 8960
9, 14:35:00-000, 3970, 0, 3970, 0, 0.00, 0, 0.00, 3970
9, 14:36:00-000, 1665, 1640, 25, 25, 1348.00, 25, 1348.16, 1615
9, 14:37:00-000, 2890, 710, 2180, 0, 0.00, 0, 0.00, 2890
9, 14:38:00-000, 6460, 1391, 5069, 10, 1350.20, 10, 1348.80, 6440
9, 14:39:00-000, 3980, 3980, 0, 0, 0.00, 0, 0.00, 3980
9, 14:40:00-000, 10150, 6780, 3370, 0, 0.00, 0, 0.00, 10150
9, 14:41:00-000, 7628, 2078, 5550, 8, 1351.00, 8, 1352.00, 7612
9, 14:42:00-000, 3940, 2610, 1330, 10, 1345.50, 10, 1347.80, 3920
9, 14:43:00-000, 6890, 2530, 4360, 0, 0.00, 0, 0.00, 6890
9, 14:45:00-000, 1160, 0, 1160, 0, 0.00, 0, 0.00, 1160
9, 14:46:00-000, 4276, 2357, 1919, 16, 1349.94, 16, 1349.87, 4244
9, 14:47:00-000, 7110, 1590, 5520, 0, 0.00, 0, 0.00, 7110
9, 14:48:00-000, 960, 0, 960, 0, 0.00, 0, 0.00, 960
9, 14:49:00-000, 3270, 2390, 880, 0, 0.00, 0, 0.00, 3270
9, 14:50:00-000, 4050, 1500, 2550, 0, 0.00, 0, 0.00, 4050
9, 14:51:00-000, 1880, 860, 1020, 0, 0.00, 0, 0.00, 860
9, 14:52:00-000, 7220, 1380, 5840, 0, 0.00, 0, 0.00, 6580
9, 14:53:00-000, 2290, 1060, 1230, 0, 0.00, 0, 0.00, 2890
9, 14:54:00-000, 2523, 1510, 1013, 3, 1346.00, 3, 1347.00, 3577
9, 14:55:00-000, 2543, 1490, 1053, 13, 1348.00, 13, 1350.61, 2517
9, 14:56:00-000, 3857, 7, 3850, 7, 1355.57, 7, 1353.00, 3843
9, 14:57:00-000, 2723, 13, 2710, 10, 1350.60, 10, 1352.00, 2703
9, 14:58:00-000, 6129, 6120, 9, 9, 1348.00, 9, 1347.00, 6111
9, 14:59:00-000, 2215, 2210, 5, 5, 1347.00, 5, 1348.20, 2205
9, 15:00:00-000, 11321, 7901, 3420, 11, 1352.54, 11, 1352.00, 11299
9, 15:01:00-000, 850, 0, 850, 0, 0.00, 0, 0.00, 0
9, 15:02:00-000, 981, 980, 1, 1, 1347.00, 1, 1347.00, 1829
9, 15:03:00-000, 3780, 1780, 2000, 0, 0.00, 0, 0.00, 3780
9, 15:04:00-000, 12490, 6960, 5530, 0, 0.00, 0, 0.00, 12490
9, 15:05:00-000, 4180, 910, 3270, 0, 0.00, 0, 0.00, 4180
9, 15:06:00-000, 1502, 2, 1500, 2, 1350.50, 2, 1352.00, 1498
9, 15:07:00-000, 7910, 4400, 3510, 0, 0.00, 0, 0.00, 7230
9, 15:08:00-000, 1610, 250, 1360, 0, 0.00, 0, 0.00, 2290
9, 15:09:00-000, 8309, 3829, 4480, 9, 1354.00, 9, 1352.00, 8291
9, 15:10:00-000, 6460, 2310, 4150, 0, 0.00, 0, 0.00, 6460
9, 15:11:00-000, 4670, 880, 3790, 0, 0.00, 0, 0.00, 3380
9, 15:12:00-000, 14490, 8870, 5620, 0, 0.00, 0, 0.00, 15780
9, 15:13:00-000, 10686, 6890, 3796, 26, 1348.04, 26, 1345.19, 10634
9, 15:14:00-000, 4675, 2545, 2130, 25, 1356.96, 25, 1352.00, 4625
9, 15:15:00-000, 880, 0, 880, 0, 0.00, 0, 0.00, 880
9, 15:16:00-000, 5050, 3090, 1960, 0, 0.00, 0, 0.00, 5050
9, 15:17:00-000, 1110, 1110, 0, 0, 0.00, 0, 0.00, 1110
9, 15:18:00-000, 1160, 0, 1160, 0, 0.00, 0, 0.00, 1160
9, 15:19:00-000, 763, 750, 13, 8, 1347.00, 8, 1345.13, 747
9, 15:20:00-000, 3620, 2520, 1100, 0, 0.00, 0, 0.00, 3620
9, 15:21:00-000, 2370, 1100, 1270, 0, 0.00, 0, 0.00, 2370
9, 15:22:00-000, 3170, 1690, 1480, 0, 0.00, 0, 0.00, 3170
9, 15:24:00-000, 2620, 2620, 0, 0, 0.00, 0, 0.00, 1040
9, 15:25:00-000, 2110, 980, 1130, 0, 0.00, 0, 0.00, 3690
9, 15:27:00-000, 1960, 0, 1960, 0, 0.00, 0, 0.00, 1370
9, 15:28:00-000, 6890, 1990, 4900, 0, 0.00, 0, 0.00, 7480
9, 15:29:00-000, 3730, 2140, 1590, 0, 0.00, 0, 0.00, 3730
9, 15:30:00-000, 5120, 3760, 1360, 0, 0.00, 0, 0.00, 5120
9, 15:32:00-000, 2410, 1600, 810, 0, 0.00, 0, 0.00, 2410
9, 15:33:00-000, 1780, 750, 1030, 0, 0.00, 0, 0.00, 1780
9, 15:34:00-000, 2612, 2, 2610, 2, 1351.00, 2, 1352.00, 2608
9, 15:35:00-000, 2400, 1300, 1100, 0, 0.00, 0, 0.00, 2400
9, 15:36:00-000, 4060, 4060, 0, 0, 0.00, 0, 0.00, 4060
9, 15:37:00-000, 2170, 1180, 990, 0, 0.00, 0, 0.00, 2170
9, 15:38:00-000, 1070, 1070, 0, 0, 0.00, 0, 0.00, 1070
9, 15:41:00-000, 4810, 3540, 1270, 0, 0.00, 0, 0.00, 4810
9, 15:42:00-000, 2260, 930, 1330, 0, 0.00, 0, 0.00, 2260
9, 15:44:00-000, 1100, 0, 1100, 0, 0.00, 0, 0.00, 1100
9, 15:50:00-000, 9551, 5351, 4200, 1, 1353.00, 1, 1353.00, 9549
9, 15:54:00-000, 1216, 6, 1210, 5, 1347.60, 5, 1352.00, 1206
9, 15:56:00-000, 4200, 4200, 0, 0, 0.00, 0, 0.00, 4200
9, 15:57:00-000, 4060, 2760, 1300, 0, 0.00, 0, 0.00, 4060
9, 15:59:00-000, 1010, 0, 1010, 0, 0.00, 0, 0.00, 1010
9, 16:00:00-000, 1470, 1470, 0, 0, 0.00, 0, 0.00, 1470
9, 16:02:00-000, 870, 0, 870, 0, 0.00, 0, 0.00, 870
9, 16:03:00-000, 4470, 3290, 1180, 0, 0.00, 0, 0.00, 4470
9, 16:06:00-000, 1240, 1240, 0, 0, 0.00, 0, 0.00, 1240
9, 16:07:00-000, 5370, 2850, 2520, 0, 0.00, 0, 0.00, 5370
9, 16:08:00-000, 888, 8, 880, 6, 1348.67, 6, 1352.00, 876
9, 16:09:00-000, 2490, 1540, 950, 0, 0.00, 0, 0.00, 2490
9, 16:10:00-000, 9533, 3553, 5980, 3, 1353.00, 3, 1352.00, 9527
9, 16:11:00-000, 7850, 2940, 4910, 0, 0.00, 0, 0.00, 6720
9, 16:12:00-000, 2393, 2323, 70, 23, 1355.09, 23, 1354.00, 3477
9, 16:13:00-000, 940, 940, 0, 0, 0.00, 0, 0.00, 940
9, 16:15:00-000, 4270, 2730, 1540, 0, 0.00, 0, 0.00, 4270
9, 16:18:00-000, 3726, 1716, 2010, 8, 1350.25, 6, 1349.00, 3712
9, 16:19:00-000, 3282, 3280, 2, 0, 0.00, 2, 1347.00, 3280
9, 16:20:00-000, 3836, 2541, 1295, 6, 1347.83, 6, 1349.67, 3824
9, 16:21:00-000, 1710, 0, 1710, 0, 0.00, 0, 0.00, 1710
9, 16:22:00-000, 4143, 2263, 1880, 3, 1354.00, 3, 1351.00, 4137
9, 16:23:00-000, 1320, 1320, 0, 0, 0.00, 0, 0.00, 1320
9, 16:24:00-000, 7741, 5490, 2251, 1, 1348.00, 1, 1349.00, 7739
9, 16:25:00-000, 1587, 7, 1580, 7, 1353.86, 7, 1352.00, 1573
9, 16:26:00-000, 6314, 2002, 4312, 28, 1350.03, 28, 1351.64, 6258
9, 16:27:00-000, 8760, 4120, 4640, 0, 0.00, 0, 0.00, 8600
9, 16:28:00-000, 7013, 6210, 803, 33, 1347.00, 33, 1346.72, 7107
9, 16:29:00-000, 2619, 1880, 739, 5, 1349.00, 5, 1351.00, 2609
