TraderType,Time,EnterQty,BuyEnterQty,SellEnterQty,BuyExecutedQty,BuyExecutedPx,SellExecutedQty,SellExecutedPx,CanceledQty
1, 09:06:00-000, 3039, 3039, 0, 826, 1347.65, 0, 0.00, 0
1, 09:07:00-000, 0, 0, 0, 0, 0.00, 0, 0.00, 2193
1, 09:08:00-000, 0, 0, 0, 0, 0.00, 0, 0.00, 20
1, 09:13:00-000, 3056, 2230, 826, 1150, 1347.86, 826, 1347.16, 0
1, 09:14:00-000, 8, 7, 1, 0, 0.00, 1, 1347.00, 1080
1, 09:15:00-000, 31, 16, 15, 2, 1346.00, 15, 1348.93, 7
1, 09:16:00-000, 180, 126, 54, 44, 1348.83, 54, 1350.10, 34
1, 09:17:00-000, 175, 129, 46, 60, 1347.76, 46, 1349.82, 49
1, 09:18:00-000, 647, 417, 230, 241, 1347.72, 229, 1349.69, 50
1, 09:19:00-000, 395, 261, 134, 88, 1348.75, 135, 1352.23, 179
1, 09:20:00-000, 769, 461, 308, 327, 1348.46, 308, 1350.58, 152
1, 09:21:00-000, 333, 180, 153, 102, 1348.94, 153, 1351.11, 145
1, 09:22:00-000, 554, 360, 194, 214, 1348.20, 193, 1351.23, 140
1, 09:23:00-000, 232, 136, 96, 93, 1348.41, 96, 1348.90, 98
1, 09:24:00-000, 591, 372, 219, 268, 1347.96, 219, 1348.06, 73
1, 09:25:00-000, 282, 173, 109, 127, 1347.92, 105, 1347.49, 80
1, 09:26:00-000, 639, 397, 242, 244, 1347.34, 246, 1347.55, 76
1, 09:27:00-000, 334, 216, 118, 91, 1348.74, 118, 1348.60, 137
1, 09:28:00-000, 612, 359, 253, 217, 1348.35, 253, 1348.63, 168
1, 09:29:00-000, 265, 179, 86, 77, 1348.12, 84, 1349.20, 95
1, 09:30:00-000, 686, 444, 242, 311, 1348.86, 244, 1348.92, 113
1, 09:31:00-000, 322, 174, 148, 132, 1347.02, 148, 1347.45, 95
1, 09:32:00-000, 548, 318, 230, 184, 1347.87, 230, 1350.70, 105
1, 09:33:00-000, 319, 207, 112, 135, 1348.06, 112, 1347.87, 89
1, 09:34:00-000, 700, 472, 228, 286, 1348.43, 223, 1349.37, 122
1, 09:35:00-000, 295, 226, 69, 103, 1349.42, 71, 1349.69, 157
1, 09:36:00-000, 655, 389, 266, 252, 1347.80, 266, 1347.82, 118
1, 09:37:00-000, 321, 194, 127, 142, 1346.85, 127, 1346.42, 72
1, 09:38:00-000, 600, 359, 241, 264, 1348.05, 241, 1347.30, 114
1, 09:39:00-000, 322, 178, 144, 99, 1348.19, 142, 1346.38, 97
1, 09:40:00-000, 559, 348, 211, 237, 1348.22, 213, 1348.04, 100
1, 09:41:00-000, 301, 182, 119, 105, 1349.48, 119, 1348.67, 91
1, 09:42:00-000, 602, 351, 251, 216, 1348.06, 251, 1348.45, 90
1, 09:43:00-000, 325, 208, 117, 123, 1348.89, 117, 1349.10, 117
1, 09:44:00-000, 675, 448, 227, 220, 1349.13, 227, 1349.02, 171
1, 09:45:00-000, 303, 135, 168, 126, 1348.11, 168, 1347.51, 109
1, 09:46:00-000, 548, 312, 236, 178, 1348.00, 236, 1347.56, 73
1, 09:47:00-000, 257, 165, 92, 84, 1347.77, 92, 1347.40, 100
1, 09:48:00-000, 622, 371, 251, 257, 1348.60, 251, 1347.97, 103
1, 09:49:00-000, 297, 176, 121, 128, 1347.80, 121, 1348.10, 86
1, 09:50:00-000, 644, 465, 179, 245, 1348.81, 179, 1348.60, 123
1, 09:51:00-000, 340, 200, 140, 140, 1348.74, 140, 1348.89, 126
1, 09:52:00-000, 662, 415, 247, 246, 1348.10, 247, 1348.16, 113
1, 09:53:00-000, 249, 156, 93, 98, 1348.00, 93, 1346.89, 128
1, 09:54:00-000, 571, 338, 233, 240, 1347.71, 233, 1347.53, 116
1, 09:55:00-000, 304, 231, 73, 109, 1348.70, 73, 1347.98, 65
1, 09:56:00-000, 689, 434, 255, 274, 1348.31, 255, 1348.03, 136
1, 09:57:00-000, 282, 168, 114, 93, 1347.30, 114, 1346.49, 133
1, 09:58:00-000, 596, 381, 215, 231, 1347.59, 215, 1346.73, 116
1, 09:59:00-000, 294, 163, 131, 133, 1346.67, 131, 1346.38, 96
1, 10:00:00-000, 551, 359, 192, 195, 1347.80, 192, 1347.73, 80
1, 10:01:00-000, 299, 175, 124, 88, 1349.19, 124, 1348.48, 121
1, 10:02:00-000, 672, 397, 275, 286, 1347.48, 275, 1347.21, 120
1, 10:03:00-000, 288, 154, 134, 121, 1346.74, 134, 1346.56, 90
1, 10:04:00-000, 552, 345, 207, 235, 1347.99, 207, 1346.94, 63
1, 10:05:00-000, 332, 213, 119, 187, 1347.32, 119, 1346.99, 63
1, 10:06:00-000, 548, 325, 223, 241, 1348.55, 223, 1347.86, 75
1, 10:07:00-000, 296, 168, 128, 129, 1348.80, 128, 1348.23, 58
1, 10:08:00-000, 658, 363, 295, 304, 1347.34, 295, 1346.00, 36
1, 10:09:00-000, 272, 172, 100, 118, 1348.19, 100, 1347.82, 60
1, 10:10:00-000, 622, 373, 249, 249, 1347.11, 247, 1346.86, 58
1, 10:11:00-000, 259, 135, 124, 123, 1347.78, 126, 1347.57, 94
1, 10:12:00-000, 676, 411, 265, 269, 1348.31, 265, 1347.50, 59
1, 10:13:00-000, 336, 180, 156, 164, 1348.03, 156, 1347.05, 90
1, 10:14:00-000, 607, 353, 254, 218, 1348.93, 254, 1347.86, 69
1, 10:15:00-000, 296, 138, 158, 121, 1347.13, 158, 1347.23, 79
1, 10:16:00-000, 558, 309, 249, 220, 1348.44, 249, 1348.73, 76
1, 10:17:00-000, 279, 163, 116, 90, 1348.65, 116, 1347.34, 51
1, 10:18:00-000, 612, 354, 258, 238, 1347.66, 258, 1347.63, 105
1, 10:19:00-000, 330, 191, 139, 139, 1347.84, 139, 1347.00, 76
1, 10:20:00-000, 698, 454, 244, 310, 1348.73, 244, 1347.72, 108
1, 10:21:00-000, 284, 159, 125, 104, 1348.15, 125, 1347.59, 98
1, 10:22:00-000, 573, 353, 220, 224, 1347.62, 220, 1347.47, 77
1, 10:23:00-000, 285, 150, 135, 130, 1348.83, 135, 1349.13, 85
1, 10:24:00-000, 544, 320, 224, 241, 1348.20, 224, 1348.12, 82
1, 10:25:00-000, 294, 153, 141, 100, 1347.07, 141, 1347.46, 55
1, 10:26:00-000, 671, 418, 253, 280, 1347.72, 253, 1347.06, 79
1, 10:27:00-000, 261, 170, 91, 119, 1347.38, 91, 1346.96, 86
1, 10:28:00-000, 645, 397, 248, 246, 1348.68, 248, 1349.04, 97
1, 10:29:00-000, 305, 193, 112, 100, 1347.95, 112, 1348.92, 103
1, 10:30:00-000, 543, 337, 206, 225, 1348.48, 206, 1348.35, 134
1, 10:31:00-000, 282, 164, 118, 112, 1348.18, 118, 1347.32, 77
1, 10:32:00-000, 699, 405, 294, 295, 1347.06, 294, 1347.19, 74
1, 10:33:00-000, 316, 201, 115, 154, 1347.72, 115, 1346.95, 91
1, 10:34:00-000, 566, 326, 240, 241, 1347.59, 240, 1347.15, 68
1, 10:35:00-000, 325, 186, 139, 136, 1347.91, 139, 1347.53, 72
1, 10:36:00-000, 671, 418, 253, 260, 1348.22, 253, 1347.57, 85
1, 10:37:00-000, 358, 215, 143, 149, 1347.94, 143, 1347.09, 109
1, 10:38:00-000, 659, 395, 264, 288, 1347.54, 264, 1347.06, 89
1, 10:39:00-000, 311, 199, 112, 144, 1347.87, 112, 1347.38, 94
1, 10:40:00-000, 595, 348, 247, 265, 1346.62, 247, 1345.89, 80
1, 10:41:00-000, 338, 194, 144, 132, 1348.14, 144, 1347.07, 60
1, 10:42:00-000, 612, 334, 278, 255, 1348.10, 278, 1347.39, 110
1, 10:43:00-000, 307, 153, 154, 130, 1347.99, 154, 1347.04, 39
1, 10:44:00-000, 607, 374, 233, 283, 1348.15, 233, 1347.34, 48
1, 10:45:00-000, 359, 215, 144, 142, 1348.82, 144, 1347.59, 65
1, 10:46:00-000, 617, 318, 299, 259, 1346.93, 299, 1346.89, 55
1, 10:47:00-000, 294, 147, 147, 114, 1347.66, 143, 1348.24, 80
1, 10:48:00-000, 567, 355, 212, 266, 1347.83, 216, 1347.33, 56
1, 10:49:00-000, 360, 185, 175, 142, 1347.24, 175, 1347.18, 58
1, 10:50:00-000, 638, 317, 321, 222, 1346.84, 321, 1346.23, 83
1, 10:51:00-000, 253, 151, 102, 105, 1347.22, 102, 1347.04, 57
1, 10:52:00-000, 655, 350, 305, 300, 1347.24, 305, 1346.66, 48
1, 10:53:00-000, 313, 213, 100, 117, 1348.13, 100, 1347.86, 57
1, 10:54:00-000, 577, 356, 221, 274, 1347.64, 221, 1347.62, 77
1, 10:55:00-000, 288, 154, 134, 110, 1346.83, 134, 1347.16, 73
1, 10:56:00-000, 565, 341, 224, 192, 1349.40, 222, 1349.01, 80
1, 10:57:00-000, 266, 146, 120, 107, 1347.40, 122, 1347.42, 123
1, 10:58:00-000, 716, 412, 304, 295, 1347.94, 304, 1346.80, 80
1, 10:59:00-000, 308, 162, 146, 131, 1346.97, 146, 1347.45, 77
1, 11:00:00-000, 549, 349, 200, 238, 1348.43, 200, 1347.11, 68
1, 11:01:00-000, 298, 152, 146, 156, 1347.03, 146, 1346.23, 60
1, 11:02:00-000, 584, 327, 257, 219, 1347.65, 257, 1347.49, 45
1, 11:03:00-000, 358, 254, 104, 136, 1348.40, 104, 1347.49, 90
1, 11:04:00-000, 586, 360, 226, 213, 1348.02, 226, 1348.10, 141
1, 11:05:00-000, 354, 232, 122, 146, 1348.53, 122, 1348.36, 107
1, 11:06:00-000, 624, 350, 274, 216, 1348.50, 274, 1347.87, 140
1, 11:07:00-000, 292, 177, 115, 88, 1347.67, 115, 1348.09, 93
1, 11:08:00-000, 590, 340, 250, 219, 1348.09, 249, 1347.46, 120
1, 11:09:00-000, 320, 192, 128, 118, 1348.84, 129, 1348.11, 61
1, 11:10:00-000, 617, 383, 234, 242, 1348.73, 234, 1348.64, 114
1, 11:11:00-000, 264, 173, 91, 114, 1348.93, 91, 1347.58, 117
1, 11:12:00-000, 574, 400, 174, 206, 1348.45, 174, 1347.83, 99
1, 11:13:00-000, 280, 184, 96, 171, 1348.17, 96, 1346.62, 122
1, 11:14:00-000, 631, 379, 252, 239, 1347.76, 252, 1347.17, 65
1, 11:15:00-000, 378, 229, 149, 143, 1347.99, 149, 1347.58, 131
1, 11:16:00-000, 613, 350, 263, 268, 1347.34, 263, 1346.92, 84
1, 11:17:00-000, 295, 159, 136, 132, 1346.60, 136, 1346.39, 63
1, 11:18:00-000, 519, 289, 230, 222, 1347.69, 230, 1346.25, 72
1, 11:19:00-000, 334, 221, 113, 131, 1348.30, 113, 1347.30, 43
1, 11:20:00-000, 648, 394, 254, 303, 1347.58, 254, 1347.16, 102
1, 11:21:00-000, 310, 194, 116, 130, 1347.73, 116, 1346.92, 75
1, 11:22:00-000, 648, 383, 265, 234, 1347.65, 265, 1347.30, 79
1, 11:23:00-000, 362, 222, 140, 148, 1347.48, 140, 1346.76, 111
1, 11:24:00-000, 559, 360, 199, 210, 1347.36, 199, 1347.67, 139
1, 11:25:00-000, 352, 203, 149, 114, 1347.87, 149, 1347.28, 94
1, 11:26:00-000, 587, 287, 300, 254, 1347.28, 300, 1346.45, 107
1, 11:27:00-000, 349, 218, 131, 132, 1348.10, 131, 1347.53, 39
1, 11:28:00-000, 562, 360, 202, 264, 1348.60, 200, 1347.83, 91
1, 11:29:00-000, 336, 187, 149, 137, 1347.01, 151, 1346.93, 76
1, 11:30:00-000, 589, 365, 224, 232, 1348.29, 224, 1347.21, 95
1, 11:31:00-000, 315, 207, 108, 127, 1348.38, 104, 1347.77, 90
1, 11:32:00-000, 608, 320, 288, 231, 1347.68, 292, 1347.47, 99
1, 11:33:00-000, 291, 159, 132, 121, 1348.09, 132, 1347.30, 66
1, 11:34:00-000, 598, 303, 295, 257, 1346.98, 295, 1346.72, 43
1, 11:35:00-000, 276, 153, 123, 103, 1347.36, 123, 1346.86, 48
1, 11:36:00-000, 636, 402, 234, 277, 1347.95, 234, 1347.24, 74
1, 11:37:00-000, 303, 190, 113, 122, 1349.00, 113, 1349.03, 92
1, 11:38:00-000, 586, 353, 233, 235, 1348.40, 233, 1347.64, 96
1, 11:39:00-000, 292, 158, 134, 96, 1349.09, 132, 1348.75, 90
1, 11:40:00-000, 517, 333, 184, 221, 1347.63, 186, 1347.09, 75
1, 11:41:00-000, 360, 197, 163, 184, 1348.22, 163, 1347.22, 82
1, 11:42:00-000, 654, 393, 261, 250, 1348.27, 261, 1347.65, 70
1, 11:43:00-000, 377, 251, 126, 140, 1348.69, 126, 1348.25, 115
1, 11:44:00-000, 670, 378, 292, 275, 1347.77, 292, 1346.61, 106
1, 11:45:00-000, 284, 196, 88, 116, 1349.20, 88, 1348.75, 109
1, 11:46:00-000, 611, 359, 252, 261, 1347.87, 252, 1347.89, 94
1, 11:47:00-000, 296, 187, 109, 115, 1347.50, 109, 1347.18, 79
1, 11:48:00-000, 549, 338, 211, 206, 1347.87, 211, 1348.01, 118
1, 11:49:00-000, 293, 166, 127, 103, 1347.18, 127, 1347.79, 90
1, 11:50:00-000, 671, 372, 299, 265, 1347.66, 299, 1346.80, 73
1, 11:51:00-000, 276, 191, 85, 142, 1347.94, 85, 1347.75, 87
1, 11:52:00-000, 701, 422, 279, 314, 1347.74, 279, 1347.19, 62
1, 11:53:00-000, 259, 140, 119, 117, 1347.85, 119, 1345.71, 94
1, 11:54:00-000, 598, 326, 272, 209, 1347.98, 272, 1348.59, 61
1, 11:55:00-000, 282, 170, 112, 113, 1349.37, 112, 1348.93, 89
1, 11:56:00-000, 608, 365, 243, 274, 1348.05, 243, 1347.05, 82
1, 11:57:00-000, 334, 181, 153, 104, 1347.40, 153, 1347.32, 53
1, 11:58:00-000, 641, 404, 237, 257, 1348.14, 237, 1347.21, 112
1, 11:59:00-000, 292, 200, 92, 128, 1348.63, 92, 1346.95, 119
1, 12:00:00-000, 579, 317, 262, 256, 1347.99, 262, 1347.16, 80
1, 12:01:00-000, 306, 188, 118, 134, 1347.93, 118, 1346.36, 60
1, 12:02:00-000, 640, 367, 273, 247, 1347.31, 273, 1346.39, 83
1, 12:03:00-000, 292, 172, 120, 140, 1347.40, 120, 1346.99, 69
1, 12:04:00-000, 563, 294, 269, 196, 1348.07, 269, 1347.94, 81
1, 12:05:00-000, 359, 196, 163, 142, 1348.12, 163, 1347.55, 65
1, 12:06:00-000, 551, 364, 187, 236, 1347.95, 187, 1347.61, 84
1, 12:07:00-000, 320, 206, 114, 137, 1348.51, 114, 1347.09, 96
1, 12:08:00-000, 620, 347, 273, 273, 1347.55, 273, 1346.54, 81
1, 12:09:00-000, 347, 208, 139, 106, 1348.15, 139, 1348.94, 70
1, 12:10:00-000, 562, 350, 212, 230, 1348.08, 212, 1347.99, 110
1, 12:11:00-000, 331, 207, 124, 137, 1347.56, 124, 1347.49, 101
1, 12:12:00-000, 601, 354, 247, 247, 1347.97, 247, 1347.17, 76
1, 12:13:00-000, 312, 182, 130, 129, 1348.16, 130, 1347.83, 102
1, 12:14:00-000, 668, 425, 243, 287, 1347.82, 243, 1347.67, 101
1, 12:15:00-000, 290, 183, 107, 117, 1348.63, 107, 1347.24, 97
1, 12:16:00-000, 618, 357, 261, 252, 1348.10, 261, 1346.96, 81
1, 12:17:00-000, 315, 186, 129, 111, 1349.03, 129, 1348.60, 94
1, 12:18:00-000, 514, 295, 219, 226, 1347.99, 219, 1347.53, 65
1, 12:19:00-000, 351, 207, 144, 142, 1347.83, 144, 1346.37, 69
1, 12:20:00-000, 658, 370, 288, 224, 1349.26, 288, 1348.26, 116
1, 12:21:00-000, 280, 164, 116, 96, 1347.84, 116, 1347.20, 109
1, 12:22:00-000, 585, 334, 251, 210, 1348.50, 251, 1347.13, 81
1, 12:23:00-000, 292, 129, 163, 95, 1347.73, 163, 1347.06, 107
1, 12:24:00-000, 611, 387, 224, 209, 1348.25, 224, 1347.43, 75
1, 12:25:00-000, 267, 186, 81, 120, 1348.22, 81, 1347.49, 134
1, 12:26:00-000, 552, 318, 234, 176, 1348.19, 234, 1347.65, 82
1, 12:27:00-000, 264, 175, 89, 107, 1348.10, 89, 1347.91, 115
1, 12:28:00-000, 644, 408, 236, 287, 1347.94, 236, 1347.08, 102
1, 12:29:00-000, 378, 244, 134, 134, 1348.18, 134, 1347.62, 103
1, 12:30:00-000, 548, 342, 206, 254, 1348.23, 206, 1346.98, 87
1, 12:31:00-000, 264, 164, 100, 108, 1347.59, 100, 1346.81, 94
1, 12:32:00-000, 544, 339, 205, 218, 1348.07, 205, 1348.05, 87
1, 12:33:00-000, 286, 180, 106, 114, 1348.65, 106, 1347.67, 100
1, 12:34:00-000, 523, 295, 228, 189, 1348.01, 228, 1346.90, 105
1, 12:35:00-000, 281, 165, 116, 76, 1347.66, 116, 1346.61, 75
1, 12:36:00-000, 654, 405, 249, 272, 1348.16, 249, 1347.61, 124
1, 12:37:00-000, 297, 173, 124, 130, 1347.12, 124, 1346.57, 80
1, 12:38:00-000, 570, 354, 216, 235, 1348.41, 216, 1347.67, 83
1, 12:39:00-000, 284, 192, 92, 127, 1348.70, 92, 1348.00, 86
1, 12:40:00-000, 556, 342, 214, 221, 1349.01, 213, 1347.67, 100
1, 12:41:00-000, 311, 192, 119, 163, 1348.60, 120, 1347.34, 65
1, 12:42:00-000, 660, 407, 253, 313, 1348.33, 253, 1347.69, 70
1, 12:43:00-000, 304, 208, 96, 116, 1348.73, 96, 1348.27, 87
1, 12:44:00-000, 546, 301, 245, 211, 1347.52, 245, 1347.11, 91
1, 12:45:00-000, 323, 206, 117, 140, 1348.89, 117, 1348.37, 82
1, 12:46:00-000, 653, 376, 277, 254, 1348.15, 277, 1347.44, 69
1, 12:47:00-000, 355, 159, 196, 153, 1347.22, 196, 1346.27, 86
1, 12:48:00-000, 655, 384, 271, 249, 1348.32, 271, 1347.30, 80
1, 12:49:00-000, 318, 193, 125, 125, 1348.92, 125, 1347.91, 95
1, 12:50:00-000, 637, 399, 238, 280, 1347.97, 238, 1347.39, 83
1, 12:51:00-000, 312, 174, 138, 141, 1348.13, 138, 1347.00, 77
1, 12:52:00-000, 650, 378, 272, 261, 1347.78, 272, 1347.29, 87
1, 12:53:00-000, 317, 209, 108, 155, 1348.85, 108, 1348.06, 66
1, 12:54:00-000, 616, 367, 249, 270, 1347.96, 249, 1348.07, 75
1, 12:55:00-000, 333, 201, 132, 127, 1348.20, 132, 1347.67, 101
1, 12:56:00-000, 645, 362, 283, 280, 1348.04, 283, 1347.10, 79
1, 12:57:00-000, 325, 196, 129, 103, 1349.32, 129, 1348.79, 81
1, 12:58:00-000, 639, 345, 294, 256, 1348.58, 294, 1348.15, 106
1, 12:59:00-000, 364, 221, 143, 152, 1348.31, 143, 1348.11, 69
1, 13:00:00-000, 614, 364, 250, 237, 1347.75, 250, 1346.70, 77
1, 13:01:00-000, 313, 213, 100, 155, 1348.85, 100, 1348.69, 87
1, 13:02:00-000, 559, 364, 195, 257, 1349.15, 195, 1348.40, 121
1, 13:03:00-000, 327, 158, 169, 148, 1347.20, 169, 1346.36, 58
1, 13:04:00-000, 620, 345, 275, 253, 1348.69, 275, 1347.59, 52
1, 13:05:00-000, 334, 178, 156, 113, 1347.13, 156, 1346.52, 75
1, 13:06:00-000, 670, 396, 274, 258, 1348.54, 274, 1348.63, 98
1, 13:07:00-000, 286, 169, 117, 115, 1347.88, 117, 1347.43, 86
1, 13:08:00-000, 587, 306, 281, 236, 1348.32, 278, 1347.05, 84
1, 13:09:00-000, 264, 144, 120, 101, 1349.07, 123, 1347.69, 62
1, 13:10:00-000, 628, 353, 275, 253, 1347.94, 275, 1347.37, 59
1, 13:11:00-000, 316, 200, 116, 166, 1348.19, 116, 1347.40, 71
1, 13:12:00-000, 649, 383, 266, 280, 1348.43, 266, 1347.42, 60
1, 13:13:00-000, 285, 186, 99, 71, 1347.61, 99, 1347.74, 85
1, 13:14:00-000, 572, 344, 228, 249, 1347.72, 228, 1347.05, 104
1, 13:15:00-000, 327, 169, 158, 178, 1346.83, 158, 1346.29, 70
1, 13:16:00-000, 535, 327, 208, 206, 1347.64, 208, 1347.44, 46
1, 13:17:00-000, 268, 163, 105, 102, 1348.81, 105, 1347.97, 91
1, 13:18:00-000, 667, 389, 278, 309, 1347.90, 278, 1347.11, 58
1, 13:19:00-000, 269, 142, 127, 130, 1347.61, 127, 1345.93, 80
1, 13:20:00-000, 641, 348, 293, 271, 1347.67, 293, 1347.10, 27
1, 13:21:00-000, 287, 139, 148, 110, 1347.25, 148, 1347.42, 68
1, 13:22:00-000, 517, 308, 209, 221, 1348.62, 209, 1347.28, 54
1, 13:23:00-000, 326, 204, 122, 160, 1347.73, 122, 1347.04, 59
1, 13:24:00-000, 697, 427, 270, 309, 1348.01, 270, 1346.98, 72
1, 13:25:00-000, 313, 178, 135, 134, 1347.93, 135, 1347.54, 85
1, 13:26:00-000, 653, 401, 252, 329, 1347.34, 252, 1346.50, 80
1, 13:27:00-000, 297, 192, 105, 120, 1347.72, 105, 1347.23, 54
1, 13:28:00-000, 575, 318, 257, 267, 1348.73, 255, 1348.64, 68
1, 13:29:00-000, 294, 146, 148, 118, 1347.05, 150, 1346.71, 40
1, 13:30:00-000, 591, 317, 274, 271, 1347.02, 274, 1346.36, 47
1, 13:31:00-000, 346, 193, 153, 169, 1347.27, 153, 1345.98, 24
1, 13:32:00-000, 584, 339, 245, 246, 1347.89, 245, 1346.93, 42
1, 13:33:00-000, 258, 143, 115, 89, 1349.55, 115, 1348.45, 75
1, 13:34:00-000, 657, 342, 315, 262, 1347.39, 315, 1347.32, 70
1, 13:35:00-000, 289, 173, 116, 117, 1347.81, 116, 1347.06, 75
1, 13:36:00-000, 715, 418, 297, 305, 1347.82, 297, 1347.10, 83
1, 13:37:00-000, 279, 135, 144, 104, 1348.72, 144, 1347.68, 89
1, 13:38:00-000, 572, 314, 258, 200, 1347.57, 258, 1347.21, 67
1, 13:39:00-000, 292, 143, 149, 118, 1347.28, 148, 1345.97, 57
1, 13:40:00-000, 637, 383, 254, 251, 1347.84, 255, 1347.00, 79
1, 13:41:00-000, 329, 175, 154, 123, 1348.08, 154, 1348.00, 97
1, 13:42:00-000, 551, 329, 222, 226, 1348.20, 222, 1347.71, 68
1, 13:43:00-000, 330, 217, 113, 154, 1349.09, 113, 1347.83, 78
1, 13:44:00-000, 677, 410, 267, 213, 1348.74, 267, 1348.26, 116
1, 13:45:00-000, 336, 178, 158, 182, 1347.68, 158, 1347.25, 96
1, 13:46:00-000, 552, 365, 187, 242, 1347.93, 187, 1347.49, 86
1, 13:47:00-000, 308, 188, 120, 142, 1347.66, 120, 1346.41, 77
1, 13:48:00-000, 550, 325, 225, 254, 1348.25, 225, 1347.80, 80
1, 13:49:00-000, 287, 136, 151, 100, 1347.39, 151, 1347.24, 56
1, 13:50:00-000, 596, 324, 272, 222, 1347.71, 272, 1347.32, 44
1, 13:51:00-000, 260, 167, 93, 108, 1348.55, 93, 1347.31, 82
1, 13:52:00-000, 684, 370, 314, 277, 1347.50, 314, 1346.56, 88
1, 13:53:00-000, 271, 163, 108, 114, 1347.46, 108, 1347.42, 61
1, 13:54:00-000, 589, 376, 213, 277, 1348.03, 213, 1347.26, 74
1, 13:55:00-000, 311, 179, 132, 139, 1348.13, 132, 1347.61, 68
1, 13:56:00-000, 586, 342, 244, 188, 1348.54, 244, 1347.48, 99
1, 13:57:00-000, 319, 175, 144, 127, 1348.08, 144, 1347.58, 105
1, 13:58:00-000, 577, 378, 199, 209, 1348.36, 199, 1347.94, 73
1, 13:59:00-000, 286, 177, 109, 97, 1347.83, 109, 1347.91, 144
1, 14:00:00-000, 590, 321, 269, 260, 1347.80, 269, 1347.49, 87
1, 14:01:00-000, 317, 195, 122, 129, 1347.72, 122, 1348.28, 65
1, 14:02:00-000, 610, 343, 267, 249, 1347.44, 267, 1346.96, 87
1, 14:03:00-000, 325, 201, 124, 134, 1347.05, 124, 1347.12, 55
1, 14:04:00-000, 548, 371, 177, 225, 1348.84, 177, 1348.57, 109
1, 14:05:00-000, 319, 175, 144, 112, 1347.77, 144, 1346.82, 102
1, 14:06:00-000, 626, 373, 253, 276, 1347.78, 253, 1347.27, 91
1, 14:07:00-000, 289, 182, 107, 112, 1347.66, 107, 1347.77, 86
1, 14:08:00-000, 677, 432, 245, 285, 1348.40, 245, 1347.71, 101
1, 14:09:00-000, 255, 143, 112, 98, 1347.39, 110, 1347.43, 116
1, 14:10:00-000, 641, 388, 253, 281, 1348.46, 255, 1347.97, 78
1, 14:11:00-000, 284, 149, 135, 121, 1348.81, 135, 1346.92, 72
1, 14:12:00-000, 611, 337, 274, 240, 1347.51, 274, 1346.90, 41
1, 14:13:00-000, 303, 213, 90, 96, 1348.37, 90, 1347.93, 86
1, 14:14:00-000, 650, 370, 280, 261, 1348.09, 280, 1347.60, 126
1, 14:15:00-000, 307, 182, 125, 137, 1348.44, 125, 1348.18, 92
1, 14:16:00-000, 700, 447, 253, 278, 1348.30, 253, 1347.08, 65
1, 14:17:00-000, 294, 168, 126, 129, 1347.67, 126, 1346.64, 128
1, 14:18:00-000, 533, 324, 209, 226, 1347.39, 209, 1347.50, 70
1, 14:19:00-000, 282, 179, 103, 105, 1348.14, 103, 1348.32, 76
1, 14:20:00-000, 699, 388, 311, 281, 1347.79, 311, 1347.14, 89
1, 14:21:00-000, 297, 158, 139, 143, 1347.10, 139, 1346.31, 72
1, 14:22:00-000, 655, 393, 262, 266, 1347.97, 262, 1347.72, 64
1, 14:23:00-000, 351, 197, 154, 143, 1348.36, 154, 1348.35, 96
1, 14:24:00-000, 578, 335, 243, 195, 1347.52, 243, 1347.25, 98
1, 14:25:00-000, 272, 171, 101, 130, 1348.20, 101, 1348.07, 95
1, 14:26:00-000, 585, 356, 229, 275, 1347.66, 229, 1347.66, 54
1, 14:27:00-000, 301, 169, 132, 155, 1347.05, 132, 1346.85, 78
1, 14:28:00-000, 575, 368, 207, 241, 1348.37, 207, 1347.39, 56
1, 14:29:00-000, 366, 212, 154, 184, 1347.76, 154, 1347.19, 69
1, 14:30:00-000, 642, 386, 256, 249, 1348.77, 256, 1348.70, 78
1, 14:31:00-000, 244, 106, 138, 87, 1348.62, 138, 1349.14, 73
1, 14:32:00-000, 610, 362, 248, 236, 1348.63, 247, 1348.13, 102
1, 14:33:00-000, 309, 134, 175, 120, 1346.62, 176, 1345.87, 65
1, 14:34:00-000, 651, 342, 309, 255, 1347.99, 309, 1347.04, 62
1, 14:35:00-000, 318, 197, 121, 131, 1347.54, 121, 1347.14, 45
1, 14:36:00-000, 516, 323, 193, 221, 1349.08, 193, 1348.23, 96
1, 14:37:00-000, 338, 205, 133, 132, 1348.54, 133, 1347.26, 70
1, 14:38:00-000, 594, 372, 222, 244, 1348.14, 222, 1347.71, 103
1, 14:39:00-000, 384, 212, 172, 149, 1347.94, 172, 1346.99, 114
1, 14:40:00-000, 609, 353, 256, 264, 1348.09, 256, 1347.73, 81
1, 14:41:00-000, 265, 169, 96, 120, 1348.08, 96, 1348.16, 54
1, 14:42:00-000, 501, 336, 165, 213, 1348.37, 165, 1347.44, 83
1, 14:43:00-000, 272, 172, 100, 125, 1348.33, 100, 1347.66, 98
1, 14:44:00-000, 645, 345, 300, 267, 1347.65, 300, 1346.92, 61
1, 14:45:00-000, 380, 243, 137, 143, 1348.30, 137, 1347.90, 79
1, 14:46:00-000, 599, 332, 267, 247, 1348.02, 267, 1347.05, 107
1, 14:47:00-000, 271, 136, 135, 118, 1347.22, 135, 1346.54, 60
1, 14:48:00-000, 546, 336, 210, 217, 1348.51, 210, 1347.58, 64
1, 14:49:00-000, 319, 168, 151, 167, 1347.47, 151, 1346.67, 43
1, 14:50:00-000, 560, 317, 243, 238, 1347.17, 243, 1346.50, 54
1, 14:51:00-000, 377, 202, 175, 178, 1347.21, 175, 1346.06, 50
1, 14:52:00-000, 645, 446, 199, 207, 1349.64, 199, 1348.59, 64
1, 14:53:00-000, 333, 184, 149, 164, 1348.01, 149, 1347.90, 143
1, 14:54:00-000, 574, 298, 276, 239, 1347.49, 276, 1347.49, 98
1, 14:55:00-000, 322, 197, 125, 122, 1347.28, 125, 1347.05, 61
1, 14:56:00-000, 649, 385, 264, 295, 1347.77, 264, 1346.64, 64
1, 14:57:00-000, 333, 175, 158, 135, 1348.80, 158, 1347.48, 78
1, 14:58:00-000, 619, 373, 246, 273, 1347.36, 246, 1346.42, 81
1, 14:59:00-000, 272, 172, 100, 140, 1347.89, 100, 1346.76, 71
1, 15:00:00-000, 629, 402, 227, 308, 1347.97, 227, 1346.82, 42
1, 15:01:00-000, 307, 155, 152, 119, 1346.56, 152, 1345.97, 92
1, 15:02:00-000, 639, 375, 264, 254, 1347.69, 264, 1346.57, 56
1, 15:03:00-000, 348, 187, 161, 146, 1347.48, 161, 1346.61, 68
1, 15:04:00-000, 641, 357, 284, 275, 1348.13, 284, 1347.45, 90
1, 15:05:00-000, 301, 191, 110, 124, 1348.75, 110, 1347.98, 57
1, 15:06:00-000, 687, 426, 261, 300, 1347.95, 261, 1347.67, 91
1, 15:07:00-000, 293, 141, 152, 118, 1347.29, 152, 1347.08, 81
1, 15:08:00-000, 625, 362, 263, 243, 1347.53, 263, 1346.79, 39
1, 15:09:00-000, 305, 173, 132, 151, 1347.39, 132, 1347.41, 88
1, 15:10:00-000, 574, 288, 286, 235, 1347.72, 286, 1346.94, 49
1, 15:11:00-000, 340, 195, 145, 143, 1347.83, 145, 1346.69, 58
1, 15:12:00-000, 587, 317, 270, 257, 1347.68, 270, 1346.91, 81
1, 15:13:00-000, 388, 210, 178, 153, 1349.30, 178, 1348.85, 46
1, 15:14:00-000, 640, 352, 288, 284, 1347.88, 288, 1347.53, 54
1, 15:15:00-000, 339, 238, 101, 133, 1349.14, 101, 1348.00, 66
1, 15:16:00-000, 573, 332, 241, 230, 1348.84, 241, 1348.33, 125
1, 15:17:00-000, 311, 215, 96, 100, 1348.88, 96, 1348.60, 83
1, 15:18:00-000, 668, 375, 293, 293, 1347.86, 293, 1347.91, 124
1, 15:19:00-000, 287, 174, 113, 136, 1348.68, 113, 1347.00, 61
1, 15:20:00-000, 612, 332, 280, 251, 1347.85, 280, 1346.82, 59
1, 15:21:00-000, 294, 188, 106, 104, 1348.02, 106, 1347.55, 69
1, 15:22:00-000, 632, 388, 244, 281, 1348.42, 244, 1347.99, 94
1, 15:23:00-000, 331, 178, 153, 123, 1348.40, 153, 1346.71, 82
1, 15:24:00-000, 666, 400, 266, 315, 1347.67, 266, 1346.84, 72
1, 15:25:00-000, 350, 215, 135, 155, 1347.81, 135, 1347.10, 61
1, 15:26:00-000, 586, 324, 262, 262, 1347.28, 262, 1346.29, 78
1, 15:27:00-000, 304, 189, 115, 123, 1347.97, 115, 1347.86, 68
1, 15:28:00-000, 519, 277, 242, 192, 1348.02, 242, 1347.37, 86
1, 15:29:00-000, 296, 165, 131, 120, 1348.56, 131, 1347.58, 71
1, 15:30:00-000, 619, 372, 247, 223, 1348.05, 247, 1347.26, 51
1, 15:31:00-000, 338, 177, 161, 141, 1347.54, 161, 1346.80, 116
1, 15:32:00-000, 660, 408, 252, 227, 1348.77, 252, 1348.29, 105
1, 15:33:00-000, 364, 194, 170, 126, 1348.06, 170, 1348.69, 114
1, 15:34:00-000, 600, 335, 265, 207, 1348.03, 265, 1346.99, 94
1, 15:35:00-000, 236, 129, 107, 91, 1348.21, 107, 1348.48, 101
1, 15:36:00-000, 565, 323, 242, 241, 1347.19, 242, 1346.95, 52
1, 15:37:00-000, 290, 189, 101, 103, 1349.08, 101, 1349.25, 85
1, 15:38:00-000, 700, 435, 265, 305, 1348.15, 265, 1348.17, 102
1, 15:39:00-000, 318, 200, 118, 110, 1348.64, 118, 1348.44, 116
1, 15:40:00-000, 524, 321, 203, 153, 1349.05, 203, 1347.47, 128
1, 15:41:00-000, 347, 213, 134, 117, 1347.77, 134, 1347.29, 112
1, 15:42:00-000, 615, 366, 249, 221, 1348.36, 249, 1347.21, 151
1, 15:43:00-000, 284, 161, 123, 88, 1348.19, 123, 1347.58, 106
1, 15:44:00-000, 578, 380, 198, 217, 1348.92, 198, 1347.46, 106
1, 15:45:00-000, 295, 200, 95, 144, 1348.68, 95, 1348.45, 102
1, 15:46:00-000, 540, 339, 201, 215, 1348.79, 201, 1347.62, 90
1, 15:47:00-000, 338, 235, 103, 131, 1349.17, 99, 1348.57, 115
1, 15:48:00-000, 671, 427, 244, 291, 1348.79, 248, 1347.47, 141
1, 15:49:00-000, 309, 204, 105, 127, 1348.32, 105, 1347.85, 103
1, 15:50:00-000, 627, 431, 196, 254, 1347.80, 196, 1347.43, 106
1, 15:51:00-000, 355, 233, 122, 163, 1348.20, 122, 1347.35, 126
1, 15:52:00-000, 550, 325, 225, 224, 1348.50, 225, 1347.89, 99
1, 15:53:00-000, 307, 192, 115, 133, 1348.53, 115, 1347.84, 73
1, 15:54:00-000, 635, 389, 246, 252, 1348.25, 244, 1347.22, 86
1, 15:55:00-000, 320, 205, 115, 115, 1348.28, 117, 1346.86, 125
1, 15:56:00-000, 627, 348, 279, 258, 1347.71, 279, 1347.30, 105
1, 15:57:00-000, 293, 145, 148, 110, 1348.59, 148, 1347.90, 69
1, 15:58:00-000, 607, 373, 234, 248, 1348.31, 234, 1347.15, 70
1, 15:59:00-000, 360, 200, 160, 166, 1347.62, 160, 1347.58, 77
1, 16:00:00-000, 609, 357, 252, 246, 1348.48, 251, 1348.02, 68
1, 16:01:00-000, 307, 197, 110, 144, 1348.03, 111, 1347.65, 79
1, 16:02:00-000, 658, 382, 276, 275, 1347.14, 276, 1346.70, 93
1, 16:03:00-000, 344, 215, 129, 162, 1348.20, 129, 1348.13, 65
1, 16:04:00-000, 589, 359, 230, 265, 1348.14, 230, 1347.86, 80
1, 16:05:00-000, 303, 172, 131, 138, 1346.45, 131, 1346.22, 75
1, 16:06:00-000, 662, 365, 297, 281, 1347.66, 297, 1347.17, 64
1, 16:07:00-000, 370, 209, 161, 167, 1347.79, 161, 1347.32, 74
1, 16:08:00-000, 637, 365, 272, 257, 1348.19, 272, 1347.81, 56
1, 16:09:00-000, 319, 156, 163, 118, 1348.35, 163, 1346.83, 64
1, 16:10:00-000, 613, 374, 239, 243, 1347.94, 239, 1346.78, 76
1, 16:11:00-000, 266, 174, 92, 149, 1348.66, 92, 1348.18, 85
1, 16:12:00-000, 587, 337, 250, 249, 1348.52, 250, 1346.84, 80
1, 16:13:00-000, 353, 177, 176, 139, 1347.36, 176, 1347.52, 65
1, 16:14:00-000, 637, 348, 289, 244, 1348.11, 289, 1347.12, 50
1, 16:15:00-000, 331, 181, 150, 139, 1347.65, 150, 1347.14, 87
1, 16:16:00-000, 585, 317, 268, 236, 1348.18, 268, 1347.00, 68
1, 16:17:00-000, 264, 160, 104, 115, 1347.68, 104, 1347.20, 61
1, 16:18:00-000, 576, 340, 236, 226, 1347.71, 236, 1347.21, 56
1, 16:19:00-000, 320, 214, 106, 94, 1348.68, 106, 1348.50, 101
1, 16:20:00-000, 623, 335, 288, 273, 1347.78, 288, 1346.93, 129
1, 16:21:00-000, 328, 181, 147, 127, 1348.23, 147, 1347.97, 62
1, 16:22:00-000, 599, 375, 224, 260, 1348.66, 224, 1347.85, 75
1, 16:23:00-000, 306, 177, 129, 132, 1348.54, 129, 1347.58, 86
1, 16:24:00-000, 591, 359, 232, 234, 1348.27, 232, 1348.07, 81
1, 16:25:00-000, 285, 143, 142, 121, 1347.48, 142, 1347.08, 69
1, 16:26:00-000, 620, 395, 225, 265, 1349.16, 225, 1348.04, 64
1, 16:27:00-000, 303, 218, 85, 126, 1348.80, 85, 1348.00, 87
1, 16:28:00-000, 618, 355, 263, 243, 1347.96, 263, 1347.71, 108
1, 16:29:00-000, 365, 203, 162, 140, 1347.88, 162, 1347.57, 96
2, 09:06:00-000, 3218, 0, 3218, 0, 0.00, 1088, 1348.36, 0
2, 09:07:00-000, 0, 0, 0, 0, 0.00, 4, 1351.00, 2124
2, 09:08:00-000, 0, 0, 0, 0, 0.00, 0, 0.00, 2
2, 09:13:00-000, 3247, 1092, 2155, 1092, 1351.81, 1558, 1350.74, 0
2, 09:14:00-000, 9, 9, 0, 9, 1356.00, 0, 0.00, 597
2, 09:15:00-000, 27, 15, 12, 12, 1351.00, 12, 1351.00, 0
2, 09:16:00-000, 199, 102, 97, 100, 1352.85, 97, 1352.56, 0
2, 09:17:00-000, 230, 89, 141, 94, 1354.23, 100, 1351.49, 0
2, 09:18:00-000, 606, 311, 295, 311, 1354.02, 325, 1352.30, 10
2, 09:19:00-000, 457, 247, 210, 240, 1354.31, 211, 1353.15, 0
2, 09:20:00-000, 782, 389, 393, 383, 1354.79, 393, 1352.63, 0
2, 09:21:00-000, 334, 175, 159, 188, 1353.43, 144, 1352.86, 0
2, 09:22:00-000, 647, 309, 338, 309, 1354.61, 313, 1352.55, 4
2, 09:23:00-000, 313, 182, 131, 180, 1354.92, 167, 1354.86, 0
2, 09:24:00-000, 608, 269, 339, 271, 1353.09, 324, 1352.12, 0
2, 09:25:00-000, 280, 129, 151, 129, 1352.74, 147, 1352.42, 2
2, 09:26:00-000, 674, 277, 397, 277, 1351.89, 328, 1351.00, 20
2, 09:27:00-000, 359, 193, 166, 193, 1353.31, 140, 1351.23, 64
2, 09:28:00-000, 677, 357, 320, 357, 1353.35, 262, 1351.30, 41
2, 09:29:00-000, 339, 175, 164, 175, 1354.47, 178, 1354.01, 17
2, 09:30:00-000, 617, 272, 345, 272, 1353.26, 322, 1352.31, 0
2, 09:31:00-000, 293, 148, 145, 148, 1353.23, 142, 1353.27, 12
2, 09:32:00-000, 639, 347, 292, 345, 1354.91, 309, 1353.10, 0
2, 09:33:00-000, 347, 187, 160, 189, 1354.33, 170, 1352.66, 0
2, 09:34:00-000, 597, 246, 351, 246, 1353.00, 307, 1351.12, 6
2, 09:35:00-000, 334, 159, 175, 159, 1354.32, 163, 1352.02, 23
2, 09:36:00-000, 571, 273, 298, 273, 1352.79, 258, 1351.44, 23
2, 09:37:00-000, 267, 126, 141, 126, 1352.62, 96, 1351.77, 34
2, 09:38:00-000, 699, 324, 375, 324, 1352.45, 319, 1351.22, 56
2, 09:39:00-000, 274, 119, 155, 119, 1351.92, 135, 1351.25, 50
2, 09:40:00-000, 614, 274, 340, 274, 1353.35, 218, 1350.88, 52
2, 09:41:00-000, 334, 147, 187, 147, 1353.32, 163, 1352.02, 70
2, 09:42:00-000, 663, 293, 370, 293, 1353.04, 282, 1351.92, 49
2, 09:43:00-000, 312, 173, 139, 173, 1354.59, 138, 1352.04, 67
2, 09:44:00-000, 667, 326, 341, 322, 1353.86, 317, 1352.09, 22
2, 09:45:00-000, 270, 102, 168, 106, 1351.46, 97, 1350.63, 25
2, 09:46:00-000, 693, 288, 405, 288, 1352.47, 297, 1351.76, 73
2, 09:47:00-000, 320, 148, 172, 148, 1352.40, 146, 1352.24, 91
2, 09:48:00-000, 548, 243, 305, 243, 1353.56, 261, 1351.99, 46
2, 09:49:00-000, 365, 198, 167, 198, 1354.17, 146, 1352.27, 34
2, 09:50:00-000, 597, 263, 334, 263, 1352.68, 290, 1351.41, 21
2, 09:51:00-000, 300, 145, 155, 145, 1353.03, 151, 1351.69, 29
2, 09:52:00-000, 584, 281, 303, 281, 1352.86, 265, 1351.73, 34
2, 09:53:00-000, 287, 151, 136, 151, 1352.87, 117, 1350.67, 16
2, 09:54:00-000, 678, 299, 379, 299, 1352.56, 310, 1351.15, 47
2, 09:55:00-000, 326, 121, 205, 121, 1351.88, 140, 1351.30, 53
2, 09:56:00-000, 537, 243, 294, 243, 1352.64, 231, 1351.41, 55
2, 09:57:00-000, 340, 177, 163, 177, 1352.22, 126, 1350.57, 69
2, 09:58:00-000, 598, 255, 343, 255, 1351.98, 283, 1351.05, 60
2, 09:59:00-000, 304, 133, 171, 133, 1352.64, 129, 1350.08, 34
2, 10:00:00-000, 626, 282, 344, 282, 1352.23, 250, 1351.18, 65
2, 10:01:00-000, 323, 158, 165, 158, 1351.94, 144, 1351.78, 77
2, 10:02:00-000, 621, 245, 376, 245, 1351.86, 293, 1350.77, 31
2, 10:03:00-000, 323, 128, 195, 128, 1351.46, 128, 1351.09, 56
2, 10:04:00-000, 694, 305, 389, 305, 1351.80, 327, 1351.43, 62
2, 10:05:00-000, 303, 107, 196, 107, 1352.47, 173, 1351.19, 80
2, 10:06:00-000, 634, 270, 364, 270, 1352.27, 285, 1351.45, 31
2, 10:07:00-000, 380, 167, 213, 167, 1352.46, 173, 1351.27, 76
2, 10:08:00-000, 662, 281, 381, 281, 1350.78, 275, 1351.03, 41
2, 10:09:00-000, 350, 167, 183, 167, 1352.87, 168, 1351.57, 74
2, 10:10:00-000, 544, 240, 304, 240, 1352.81, 271, 1351.86, 45
2, 10:11:00-000, 306, 150, 156, 150, 1352.77, 136, 1350.76, 23
2, 10:12:00-000, 621, 306, 315, 306, 1353.11, 268, 1351.73, 40
2, 10:13:00-000, 302, 144, 158, 144, 1352.89, 120, 1352.28, 28
2, 10:14:00-000, 750, 373, 377, 373, 1352.90, 341, 1352.69, 23
2, 10:15:00-000, 309, 128, 181, 128, 1352.36, 156, 1351.20, 41
2, 10:16:00-000, 643, 295, 348, 295, 1353.56, 312, 1352.06, 31
2, 10:17:00-000, 311, 116, 195, 114, 1351.93, 143, 1352.12, 32
2, 10:18:00-000, 605, 247, 358, 249, 1352.61, 267, 1351.25, 75
2, 10:19:00-000, 382, 163, 219, 163, 1351.63, 161, 1350.71, 73
2, 10:20:00-000, 616, 273, 343, 273, 1353.01, 277, 1351.95, 63
2, 10:21:00-000, 284, 154, 130, 154, 1353.11, 121, 1351.57, 53
2, 10:22:00-000, 641, 313, 328, 313, 1352.55, 289, 1350.93, 36
2, 10:23:00-000, 331, 163, 168, 163, 1353.42, 137, 1351.61, 27
2, 10:24:00-000, 692, 288, 404, 288, 1352.59, 342, 1351.66, 35
2, 10:25:00-000, 305, 155, 150, 155, 1353.11, 160, 1351.95, 30
2, 10:26:00-000, 597, 224, 373, 224, 1351.58, 277, 1350.93, 51
2, 10:27:00-000, 275, 107, 168, 107, 1351.62, 120, 1350.65, 64
2, 10:28:00-000, 621, 354, 267, 354, 1353.69, 266, 1351.92, 34
2, 10:29:00-000, 333, 200, 133, 200, 1354.19, 136, 1352.33, 6
2, 10:30:00-000, 632, 308, 324, 308, 1353.73, 269, 1351.70, 6
2, 10:31:00-000, 333, 131, 202, 131, 1351.89, 145, 1351.74, 54
2, 10:32:00-000, 633, 286, 347, 286, 1352.15, 250, 1350.69, 78
2, 10:33:00-000, 282, 119, 163, 119, 1352.03, 127, 1350.80, 73
2, 10:34:00-000, 495, 237, 258, 237, 1352.57, 207, 1351.52, 30
2, 10:35:00-000, 350, 158, 192, 158, 1352.52, 153, 1351.04, 52
2, 10:36:00-000, 587, 254, 333, 254, 1352.56, 245, 1351.33, 60
2, 10:37:00-000, 351, 136, 215, 136, 1352.63, 172, 1351.24, 71
2, 10:38:00-000, 533, 205, 328, 205, 1352.20, 261, 1351.65, 47
2, 10:39:00-000, 327, 154, 173, 154, 1352.39, 163, 1351.33, 49
2, 10:40:00-000, 684, 244, 440, 244, 1351.37, 296, 1350.33, 53
2, 10:41:00-000, 343, 194, 149, 194, 1353.47, 156, 1351.75, 71
2, 10:42:00-000, 588, 254, 334, 254, 1352.04, 261, 1351.71, 74
2, 10:43:00-000, 358, 170, 188, 170, 1353.35, 154, 1351.01, 35
2, 10:44:00-000, 627, 249, 378, 249, 1351.60, 285, 1350.92, 56
2, 10:45:00-000, 297, 114, 183, 114, 1352.50, 152, 1352.00, 56
2, 10:46:00-000, 648, 304, 344, 304, 1352.53, 277, 1350.88, 49
2, 10:47:00-000, 378, 143, 235, 143, 1352.31, 137, 1351.52, 60
2, 10:48:00-000, 698, 283, 415, 283, 1351.88, 319, 1351.00, 110
2, 10:49:00-000, 294, 132, 162, 132, 1352.97, 138, 1351.19, 92
2, 10:50:00-000, 600, 289, 311, 289, 1352.57, 229, 1351.45, 41
2, 10:51:00-000, 238, 120, 118, 120, 1352.89, 92, 1351.10, 67
2, 10:52:00-000, 618, 292, 326, 287, 1352.34, 283, 1351.51, 35
2, 10:53:00-000, 346, 162, 184, 167, 1352.69, 120, 1351.20, 39
2, 10:54:00-000, 653, 259, 394, 259, 1352.40, 275, 1350.28, 97
2, 10:55:00-000, 343, 157, 186, 157, 1351.89, 153, 1351.39, 62
2, 10:56:00-000, 663, 311, 352, 311, 1353.11, 304, 1352.50, 47
2, 10:57:00-000, 258, 95, 163, 95, 1351.69, 104, 1350.84, 49
2, 10:58:00-000, 640, 286, 354, 286, 1352.48, 304, 1351.02, 47
2, 10:59:00-000, 247, 125, 122, 125, 1352.71, 105, 1351.76, 57
2, 11:00:00-000, 577, 210, 367, 210, 1351.95, 264, 1351.03, 45
2, 11:01:00-000, 390, 163, 227, 163, 1351.62, 162, 1350.24, 74
2, 11:02:00-000, 685, 328, 357, 328, 1352.32, 266, 1351.22, 94
2, 11:03:00-000, 305, 141, 164, 141, 1351.70, 146, 1351.84, 75
2, 11:04:00-000, 543, 260, 283, 260, 1352.20, 227, 1351.45, 18
2, 11:05:00-000, 340, 147, 193, 147, 1351.99, 126, 1350.39, 56
2, 11:06:00-000, 577, 239, 338, 239, 1352.28, 257, 1351.86, 70
2, 11:07:00-000, 276, 126, 150, 126, 1351.66, 112, 1351.33, 71
2, 11:08:00-000, 627, 276, 351, 276, 1352.58, 304, 1351.30, 28
2, 11:09:00-000, 315, 123, 192, 123, 1352.21, 130, 1352.01, 56
2, 11:10:00-000, 634, 255, 379, 255, 1352.18, 248, 1351.67, 82
2, 11:11:00-000, 298, 132, 166, 132, 1351.52, 149, 1351.89, 100
2, 11:12:00-000, 544, 246, 298, 246, 1352.79, 212, 1350.74, 44
2, 11:13:00-000, 315, 111, 204, 111, 1351.59, 125, 1350.75, 74
2, 11:14:00-000, 545, 210, 335, 210, 1351.88, 228, 1350.62, 91
2, 11:15:00-000, 336, 181, 155, 181, 1352.90, 125, 1351.63, 79
2, 11:16:00-000, 625, 268, 357, 268, 1353.13, 287, 1350.99, 57
2, 11:17:00-000, 327, 100, 227, 100, 1350.72, 116, 1348.94, 58
2, 11:18:00-000, 651, 285, 366, 285, 1351.54, 307, 1350.86, 83
2, 11:19:00-000, 293, 139, 154, 139, 1352.26, 130, 1351.05, 68
2, 11:20:00-000, 633, 248, 385, 248, 1352.25, 311, 1350.87, 64
2, 11:21:00-000, 274, 113, 161, 113, 1352.15, 109, 1351.46, 54
2, 11:22:00-000, 636, 296, 340, 296, 1352.40, 248, 1350.79, 60
2, 11:23:00-000, 346, 140, 206, 140, 1352.24, 165, 1350.89, 80
2, 11:24:00-000, 569, 267, 302, 267, 1352.58, 257, 1351.30, 40
2, 11:25:00-000, 307, 143, 164, 143, 1351.84, 93, 1350.87, 44
2, 11:26:00-000, 687, 231, 456, 231, 1351.91, 274, 1350.47, 126
2, 11:27:00-000, 279, 123, 156, 123, 1352.22, 111, 1351.71, 113
2, 11:28:00-000, 663, 270, 393, 270, 1352.41, 325, 1350.88, 63
2, 11:29:00-000, 338, 130, 208, 130, 1352.18, 154, 1349.75, 60
2, 11:30:00-000, 606, 277, 329, 277, 1352.11, 257, 1351.42, 79
2, 11:31:00-000, 291, 105, 186, 105, 1352.18, 140, 1350.61, 47
2, 11:32:00-000, 564, 269, 295, 269, 1353.17, 252, 1351.85, 66
2, 11:33:00-000, 434, 191, 243, 191, 1352.06, 172, 1351.02, 35
2, 11:34:00-000, 608, 283, 325, 283, 1351.88, 237, 1350.46, 78
2, 11:35:00-000, 321, 174, 147, 174, 1352.79, 130, 1351.46, 65
2, 11:36:00-000, 666, 283, 383, 283, 1352.27, 313, 1351.86, 29
2, 11:37:00-000, 294, 125, 169, 125, 1353.17, 130, 1351.22, 64
2, 11:38:00-000, 565, 243, 322, 243, 1352.99, 301, 1351.62, 32
2, 11:39:00-000, 320, 158, 162, 157, 1353.59, 131, 1352.08, 27
2, 11:40:00-000, 511, 228, 283, 229, 1352.00, 205, 1350.32, 75
2, 11:41:00-000, 270, 108, 162, 108, 1352.02, 143, 1351.08, 41
2, 11:42:00-000, 645, 295, 350, 295, 1353.00, 272, 1351.32, 29
2, 11:43:00-000, 350, 136, 214, 136, 1352.19, 155, 1351.34, 74
2, 11:44:00-000, 643, 259, 384, 259, 1351.79, 266, 1350.97, 87
2, 11:45:00-000, 332, 157, 175, 157, 1352.57, 149, 1350.86, 70
2, 11:46:00-000, 536, 250, 286, 250, 1352.91, 233, 1351.69, 45
2, 11:47:00-000, 279, 133, 146, 133, 1352.20, 132, 1351.74, 41
2, 11:48:00-000, 624, 317, 307, 317, 1352.97, 270, 1351.51, 25
2, 11:49:00-000, 339, 141, 198, 141, 1352.57, 124, 1351.06, 24
2, 11:50:00-000, 554, 231, 323, 231, 1352.27, 265, 1351.97, 58
2, 11:51:00-000, 309, 135, 174, 135, 1352.43, 145, 1350.53, 84
2, 11:52:00-000, 596, 237, 359, 237, 1352.52, 253, 1351.16, 40
2, 11:53:00-000, 315, 138, 177, 137, 1352.52, 105, 1350.94, 90
2, 11:54:00-000, 636, 296, 340, 296, 1352.19, 258, 1351.49, 85
2, 11:55:00-000, 268, 145, 123, 145, 1353.60, 133, 1352.48, 44
2, 11:56:00-000, 641, 245, 396, 245, 1352.12, 272, 1351.07, 58
2, 11:57:00-000, 266, 126, 140, 126, 1351.85, 101, 1351.57, 77
2, 11:58:00-000, 601, 218, 383, 218, 1351.64, 257, 1351.18, 71
2, 11:59:00-000, 349, 152, 197, 152, 1351.88, 160, 1351.30, 94
2, 12:00:00-000, 653, 301, 352, 301, 1352.38, 310, 1350.85, 49
2, 12:01:00-000, 318, 121, 197, 121, 1351.49, 118, 1350.10, 38
2, 12:02:00-000, 523, 195, 328, 195, 1350.65, 249, 1350.56, 86
2, 12:03:00-000, 337, 137, 200, 137, 1352.87, 154, 1350.56, 61
2, 12:04:00-000, 669, 299, 370, 299, 1352.56, 286, 1351.30, 63
2, 12:05:00-000, 296, 144, 152, 144, 1352.48, 126, 1351.53, 75
2, 12:06:00-000, 643, 285, 358, 285, 1352.51, 279, 1350.44, 34
2, 12:07:00-000, 313, 123, 190, 120, 1351.84, 143, 1350.95, 70
2, 12:08:00-000, 631, 265, 366, 268, 1351.56, 308, 1351.06, 68
2, 12:09:00-000, 314, 143, 171, 143, 1352.60, 143, 1351.76, 34
2, 12:10:00-000, 644, 279, 365, 279, 1352.56, 281, 1351.88, 37
2, 12:11:00-000, 272, 99, 173, 99, 1351.91, 137, 1351.06, 89
2, 12:12:00-000, 613, 261, 352, 261, 1351.97, 240, 1351.21, 67
2, 12:13:00-000, 331, 162, 169, 162, 1353.19, 141, 1352.50, 47
2, 12:14:00-000, 630, 286, 344, 286, 1352.12, 274, 1351.13, 58
2, 12:15:00-000, 386, 151, 235, 151, 1352.02, 168, 1351.62, 74
2, 12:16:00-000, 625, 265, 360, 265, 1351.67, 285, 1350.49, 59
2, 12:17:00-000, 310, 163, 147, 163, 1354.02, 136, 1352.86, 57
2, 12:18:00-000, 683, 269, 414, 269, 1351.76, 274, 1350.91, 55
2, 12:19:00-000, 308, 135, 173, 135, 1352.46, 140, 1351.74, 85
2, 12:20:00-000, 632, 306, 326, 306, 1351.60, 217, 1350.55, 87
2, 12:21:00-000, 377, 146, 231, 146, 1351.84, 152, 1349.83, 93
2, 12:22:00-000, 617, 284, 333, 284, 1352.47, 219, 1350.47, 114
2, 12:23:00-000, 279, 135, 144, 135, 1352.05, 90, 1351.06, 75
2, 12:24:00-000, 592, 268, 324, 268, 1352.72, 197, 1350.83, 76
2, 12:25:00-000, 333, 115, 218, 115, 1351.83, 151, 1350.80, 88
2, 12:26:00-000, 629, 267, 362, 267, 1352.32, 243, 1351.47, 107
2, 12:27:00-000, 311, 117, 194, 117, 1352.07, 153, 1351.66, 79
2, 12:28:00-000, 621, 238, 383, 238, 1351.75, 272, 1350.95, 64
2, 12:29:00-000, 333, 105, 228, 105, 1351.00, 141, 1350.44, 101
2, 12:30:00-000, 555, 209, 346, 209, 1352.12, 268, 1351.44, 73
2, 12:31:00-000, 267, 83, 184, 83, 1351.95, 124, 1350.10, 100
2, 12:32:00-000, 634, 299, 335, 299, 1352.74, 261, 1351.19, 55
2, 12:33:00-000, 316, 140, 176, 140, 1352.60, 114, 1350.94, 69
2, 12:34:00-000, 628, 276, 352, 276, 1352.51, 241, 1351.18, 80
2, 12:35:00-000, 320, 142, 178, 142, 1352.28, 159, 1351.85, 63
2, 12:36:00-000, 671, 288, 383, 288, 1352.30, 263, 1351.30, 77
2, 12:37:00-000, 353, 156, 197, 156, 1352.44, 141, 1350.89, 84
2, 12:38:00-000, 577, 244, 333, 244, 1352.68, 266, 1351.59, 57
2, 12:39:00-000, 309, 107, 202, 107, 1352.15, 133, 1351.46, 79
2, 12:40:00-000, 700, 263, 437, 263, 1352.23, 392, 1351.40, 58
2, 12:41:00-000, 277, 105, 172, 105, 1352.00, 118, 1351.08, 45
2, 12:42:00-000, 529, 193, 336, 193, 1351.77, 267, 1350.97, 81
2, 12:43:00-000, 289, 128, 161, 128, 1353.17, 129, 1351.58, 46
2, 12:44:00-000, 649, 289, 360, 289, 1352.10, 277, 1350.99, 53
2, 12:45:00-000, 338, 158, 180, 158, 1353.34, 118, 1350.92, 74
2, 12:46:00-000, 729, 344, 385, 344, 1353.03, 306, 1351.32, 82
2, 12:47:00-000, 252, 123, 129, 123, 1353.18, 107, 1352.09, 49
2, 12:48:00-000, 653, 313, 340, 313, 1351.99, 254, 1351.10, 48
2, 12:49:00-000, 354, 168, 186, 168, 1352.52, 133, 1350.76, 51
2, 12:50:00-000, 564, 250, 314, 250, 1352.90, 284, 1351.30, 61
2, 12:51:00-000, 270, 109, 161, 109, 1351.49, 130, 1351.44, 38
2, 12:52:00-000, 651, 254, 397, 254, 1352.16, 252, 1351.26, 83
2, 12:53:00-000, 304, 148, 156, 146, 1353.48, 156, 1352.15, 55
2, 12:54:00-000, 664, 301, 363, 303, 1352.63, 310, 1350.83, 50
2, 12:55:00-000, 307, 118, 189, 118, 1351.61, 124, 1351.36, 34
2, 12:56:00-000, 586, 245, 341, 245, 1352.44, 305, 1351.07, 59
2, 12:57:00-000, 268, 144, 124, 144, 1352.62, 120, 1351.82, 44
2, 12:58:00-000, 590, 287, 303, 287, 1352.99, 242, 1351.63, 28
2, 12:59:00-000, 265, 122, 143, 122, 1354.08, 136, 1352.40, 21
2, 13:00:00-000, 622, 282, 340, 282, 1352.25, 272, 1351.31, 42
2, 13:01:00-000, 300, 134, 166, 134, 1353.49, 102, 1351.12, 45
2, 13:02:00-000, 667, 298, 369, 298, 1352.96, 286, 1351.20, 77
2, 13:03:00-000, 293, 128, 165, 128, 1352.13, 170, 1351.06, 59
2, 13:04:00-000, 700, 304, 396, 304, 1352.26, 322, 1351.51, 27
2, 13:05:00-000, 313, 159, 154, 159, 1352.42, 101, 1350.44, 55
2, 13:06:00-000, 597, 258, 339, 258, 1352.97, 279, 1351.66, 52
2, 13:07:00-000, 209, 87, 122, 87, 1351.59, 97, 1350.89, 60
2, 13:08:00-000, 622, 307, 315, 307, 1352.17, 242, 1351.09, 38
2, 13:09:00-000, 308, 124, 184, 124, 1351.88, 133, 1351.49, 71
2, 13:10:00-000, 673, 292, 381, 292, 1352.09, 270, 1351.34, 48
2, 13:11:00-000, 291, 110, 181, 110, 1351.68, 150, 1350.96, 96
2, 13:12:00-000, 614, 254, 360, 254, 1352.18, 280, 1351.29, 50
2, 13:13:00-000, 336, 157, 179, 157, 1351.89, 117, 1350.60, 73
2, 13:14:00-000, 609, 264, 345, 264, 1351.96, 235, 1351.29, 53
2, 13:15:00-000, 305, 153, 152, 153, 1352.39, 138, 1350.86, 103
2, 13:16:00-000, 631, 257, 374, 257, 1351.98, 248, 1350.65, 65
2, 13:17:00-000, 334, 110, 224, 110, 1352.19, 146, 1352.09, 75
2, 13:18:00-000, 580, 268, 312, 268, 1352.87, 246, 1351.53, 91
2, 13:19:00-000, 283, 104, 179, 104, 1352.44, 136, 1351.00, 55
2, 13:20:00-000, 582, 260, 322, 260, 1351.60, 239, 1350.67, 65
2, 13:21:00-000, 325, 115, 210, 115, 1351.14, 124, 1350.24, 82
2, 13:22:00-000, 644, 298, 346, 298, 1352.59, 276, 1351.81, 70
2, 13:23:00-000, 334, 123, 211, 123, 1352.00, 165, 1350.89, 66
2, 13:24:00-000, 598, 262, 336, 262, 1352.47, 240, 1351.32, 86
2, 13:25:00-000, 334, 128, 206, 128, 1351.31, 119, 1351.15, 76
2, 13:26:00-000, 706, 292, 414, 292, 1351.48, 313, 1350.34, 79
2, 13:27:00-000, 325, 126, 199, 126, 1351.88, 146, 1351.03, 83
2, 13:28:00-000, 550, 250, 300, 250, 1352.87, 263, 1351.80, 71
2, 13:29:00-000, 320, 139, 181, 139, 1351.28, 142, 1350.53, 38
2, 13:30:00-000, 700, 280, 420, 280, 1351.28, 268, 1350.47, 64
2, 13:31:00-000, 293, 115, 178, 115, 1351.44, 144, 1350.29, 107
2, 13:32:00-000, 625, 257, 368, 257, 1351.67, 252, 1351.17, 52
2, 13:33:00-000, 302, 156, 146, 156, 1353.49, 149, 1352.77, 77
2, 13:34:00-000, 622, 291, 331, 291, 1352.73, 271, 1351.72, 35
2, 13:35:00-000, 324, 114, 210, 114, 1350.76, 124, 1349.97, 66
2, 13:36:00-000, 585, 293, 292, 293, 1352.44, 241, 1351.46, 72
2, 13:37:00-000, 342, 122, 220, 122, 1351.66, 156, 1351.33, 68
2, 13:38:00-000, 555, 235, 320, 235, 1351.98, 239, 1350.56, 76
2, 13:39:00-000, 313, 126, 187, 126, 1352.03, 126, 1351.51, 59
2, 13:40:00-000, 611, 292, 319, 292, 1352.26, 283, 1351.29, 66
2, 13:41:00-000, 326, 142, 184, 142, 1352.49, 129, 1350.96, 27
2, 13:42:00-000, 681, 293, 388, 293, 1352.34, 278, 1351.30, 68
2, 13:43:00-000, 263, 116, 147, 116, 1352.08, 163, 1351.56, 79
2, 13:44:00-000, 499, 229, 270, 229, 1352.41, 209, 1352.12, 25
2, 13:45:00-000, 369, 172, 197, 172, 1352.33, 130, 1350.66, 49
2, 13:46:00-000, 555, 198, 357, 198, 1352.23, 234, 1350.73, 63
2, 13:47:00-000, 309, 131, 178, 131, 1352.28, 165, 1351.09, 90
2, 13:48:00-000, 619, 299, 320, 299, 1352.55, 273, 1351.05, 57
2, 13:49:00-000, 277, 109, 168, 109, 1350.90, 96, 1350.63, 44
2, 13:50:00-000, 733, 330, 403, 330, 1352.27, 303, 1351.84, 60
2, 13:51:00-000, 250, 98, 152, 98, 1351.92, 110, 1351.61, 106
2, 13:52:00-000, 556, 215, 341, 215, 1351.21, 243, 1350.68, 63
2, 13:53:00-000, 325, 134, 191, 134, 1351.90, 116, 1350.13, 63
2, 13:54:00-000, 645, 269, 376, 269, 1352.12, 295, 1351.29, 96
2, 13:55:00-000, 326, 147, 179, 147, 1352.80, 159, 1351.50, 42
2, 13:56:00-000, 677, 280, 397, 280, 1351.93, 306, 1351.28, 67
2, 13:57:00-000, 309, 141, 168, 141, 1352.53, 159, 1352.06, 56
2, 13:58:00-000, 604, 252, 352, 252, 1352.35, 259, 1351.68, 46
2, 13:59:00-000, 337, 146, 191, 146, 1351.76, 158, 1351.39, 77
2, 14:00:00-000, 593, 275, 318, 275, 1352.06, 209, 1351.82, 59
2, 14:01:00-000, 307, 143, 164, 143, 1353.01, 124, 1350.63, 74
2, 14:02:00-000, 666, 303, 363, 303, 1352.38, 304, 1351.24, 37
2, 14:03:00-000, 319, 107, 212, 103, 1351.31, 117, 1349.93, 75
2, 14:04:00-000, 658, 301, 357, 305, 1352.91, 292, 1351.26, 76
2, 14:05:00-000, 268, 108, 160, 108, 1350.97, 79, 1350.97, 71
2, 14:06:00-000, 617, 243, 374, 243, 1352.44, 275, 1350.73, 111
2, 14:07:00-000, 275, 134, 141, 134, 1352.75, 114, 1350.62, 72
2, 14:08:00-000, 597, 256, 341, 256, 1353.26, 275, 1351.57, 38
2, 14:09:00-000, 308, 137, 171, 137, 1352.63, 145, 1350.71, 43
2, 14:10:00-000, 670, 281, 389, 281, 1352.64, 295, 1351.35, 53
2, 14:11:00-000, 277, 121, 156, 118, 1352.05, 149, 1351.68, 69
2, 14:12:00-000, 673, 259, 414, 262, 1351.40, 296, 1350.23, 41
2, 14:13:00-000, 329, 159, 170, 159, 1352.36, 143, 1351.95, 75
2, 14:14:00-000, 669, 276, 393, 276, 1351.91, 279, 1350.91, 80
2, 14:15:00-000, 262, 85, 177, 85, 1351.49, 99, 1350.98, 74
2, 14:16:00-000, 619, 285, 334, 285, 1352.65, 270, 1351.84, 79
2, 14:17:00-000, 334, 153, 181, 153, 1351.72, 154, 1351.09, 64
2, 14:18:00-000, 655, 293, 362, 293, 1352.61, 257, 1351.44, 59
2, 14:19:00-000, 345, 159, 186, 159, 1352.40, 147, 1351.26, 75
2, 14:20:00-000, 614, 237, 377, 237, 1352.36, 256, 1351.23, 56
2, 14:21:00-000, 306, 124, 182, 124, 1352.29, 131, 1351.41, 97
2, 14:22:00-000, 625, 291, 334, 291, 1352.24, 318, 1351.72, 38
2, 14:23:00-000, 349, 163, 186, 163, 1353.14, 159, 1351.41, 37
2, 14:24:00-000, 633, 260, 373, 260, 1352.95, 287, 1351.17, 30
2, 14:25:00-000, 334, 183, 151, 183, 1353.21, 160, 1352.48, 47
2, 14:26:00-000, 604, 235, 369, 235, 1351.76, 262, 1350.65, 52
2, 14:27:00-000, 374, 152, 222, 152, 1351.65, 186, 1350.49, 62
2, 14:28:00-000, 587, 257, 330, 257, 1352.59, 289, 1351.28, 52
2, 14:29:00-000, 281, 124, 157, 124, 1352.07, 133, 1350.81, 44
2, 14:30:00-000, 566, 302, 264, 302, 1353.15, 195, 1351.62, 31
2, 14:31:00-000, 368, 219, 149, 219, 1353.57, 152, 1353.38, 38
2, 14:32:00-000, 613, 267, 346, 267, 1352.72, 283, 1351.16, 55
2, 14:33:00-000, 322, 137, 185, 137, 1351.16, 103, 1350.57, 35
2, 14:34:00-000, 596, 280, 316, 280, 1352.45, 252, 1351.25, 90
2, 14:35:00-000, 369, 180, 189, 180, 1352.87, 188, 1351.53, 38
2, 14:36:00-000, 618, 245, 373, 245, 1352.23, 289, 1351.28, 32
2, 14:37:00-000, 303, 123, 180, 123, 1352.72, 124, 1351.18, 71
2, 14:38:00-000, 556, 242, 314, 242, 1353.12, 236, 1351.10, 59
2, 14:39:00-000, 252, 116, 136, 116, 1351.08, 121, 1351.19, 57
2, 14:40:00-000, 671, 300, 371, 300, 1353.40, 312, 1351.50, 26
2, 14:41:00-000, 339, 167, 172, 167, 1352.60, 118, 1350.66, 54
2, 14:42:00-000, 569, 209, 360, 209, 1351.92, 243, 1350.82, 73
2, 14:43:00-000, 305, 117, 188, 117, 1351.64, 135, 1350.90, 100
2, 14:44:00-000, 627, 321, 306, 321, 1352.94, 263, 1351.34, 67
2, 14:45:00-000, 312, 147, 165, 147, 1352.55, 126, 1351.60, 45
2, 14:46:00-000, 628, 236, 392, 236, 1352.00, 321, 1350.82, 44
2, 14:47:00-000, 287, 133, 154, 133, 1351.34, 128, 1351.20, 48
2, 14:48:00-000, 584, 273, 311, 273, 1352.14, 235, 1351.40, 38
2, 14:49:00-000, 329, 117, 212, 117, 1351.71, 146, 1350.31, 68
2, 14:50:00-000, 662, 285, 377, 285, 1351.73, 259, 1350.53, 104
2, 14:51:00-000, 310, 124, 186, 124, 1351.96, 169, 1351.18, 56
2, 14:52:00-000, 599, 268, 331, 268, 1353.02, 262, 1351.88, 66
2, 14:53:00-000, 312, 126, 186, 126, 1351.69, 129, 1350.50, 50
2, 14:54:00-000, 631, 292, 339, 292, 1351.81, 243, 1350.76, 58
2, 14:55:00-000, 323, 129, 194, 129, 1351.03, 134, 1350.71, 88
2, 14:56:00-000, 639, 284, 355, 284, 1352.08, 286, 1350.72, 80
2, 14:57:00-000, 359, 168, 191, 168, 1352.90, 136, 1351.24, 51
2, 14:58:00-000, 676, 239, 437, 239, 1352.25, 272, 1350.83, 92
2, 14:59:00-000, 273, 104, 169, 104, 1351.71, 160, 1350.81, 104
2, 15:00:00-000, 625, 286, 339, 286, 1352.12, 293, 1351.24, 37
2, 15:01:00-000, 305, 111, 194, 111, 1350.08, 98, 1350.70, 49
2, 15:02:00-000, 672, 300, 372, 300, 1351.55, 303, 1350.72, 82
2, 15:03:00-000, 298, 125, 173, 125, 1351.82, 114, 1350.97, 81
2, 15:04:00-000, 618, 255, 363, 255, 1351.59, 278, 1350.86, 70
2, 15:05:00-000, 324, 151, 173, 151, 1352.57, 127, 1351.32, 65
2, 15:06:00-000, 609, 235, 374, 235, 1352.24, 281, 1350.86, 63
2, 15:07:00-000, 353, 163, 190, 161, 1351.85, 161, 1351.39, 66
2, 15:08:00-000, 622, 273, 349, 275, 1351.64, 260, 1350.83, 57
2, 15:09:00-000, 301, 131, 170, 131, 1352.45, 136, 1350.99, 81
2, 15:10:00-000, 694, 339, 355, 339, 1352.19, 320, 1351.30, 44
2, 15:11:00-000, 306, 126, 180, 126, 1351.86, 160, 1351.09, 29
2, 15:12:00-000, 605, 257, 348, 257, 1352.44, 264, 1350.39, 48
2, 15:13:00-000, 277, 152, 125, 152, 1353.14, 121, 1352.59, 25
2, 15:14:00-000, 612, 261, 351, 261, 1352.27, 277, 1351.38, 35
2, 15:15:00-000, 335, 132, 203, 132, 1352.40, 161, 1351.91, 43
2, 15:16:00-000, 618, 292, 326, 292, 1352.66, 270, 1351.78, 86
2, 15:17:00-000, 294, 112, 182, 112, 1351.71, 127, 1350.32, 41
2, 15:18:00-000, 656, 306, 350, 306, 1352.38, 230, 1351.27, 61
2, 15:19:00-000, 296, 137, 159, 137, 1353.53, 141, 1352.02, 84
2, 15:20:00-000, 630, 300, 330, 300, 1352.66, 275, 1351.47, 49
2, 15:21:00-000, 356, 148, 208, 148, 1351.61, 154, 1350.27, 54
2, 15:22:00-000, 620, 272, 348, 272, 1353.01, 283, 1351.71, 74
2, 15:23:00-000, 325, 136, 189, 136, 1352.55, 153, 1351.20, 33
2, 15:24:00-000, 645, 253, 392, 253, 1352.33, 275, 1350.98, 76
2, 15:25:00-000, 332, 145, 187, 145, 1351.51, 137, 1351.06, 70
2, 15:26:00-000, 596, 261, 335, 261, 1351.94, 251, 1350.81, 80
2, 15:27:00-000, 306, 114, 192, 114, 1351.33, 135, 1351.01, 41
2, 15:28:00-000, 603, 279, 324, 279, 1352.70, 285, 1352.06, 63
2, 15:29:00-000, 278, 144, 134, 144, 1353.15, 129, 1352.04, 42
2, 15:30:00-000, 640, 287, 353, 287, 1351.82, 279, 1351.83, 36
2, 15:31:00-000, 276, 104, 172, 104, 1351.05, 132, 1351.07, 64
2, 15:32:00-000, 649, 302, 347, 302, 1352.49, 303, 1351.99, 36
2, 15:33:00-000, 349, 164, 185, 164, 1352.94, 122, 1351.32, 54
2, 15:34:00-000, 554, 288, 266, 288, 1352.66, 250, 1351.82, 35
2, 15:35:00-000, 273, 137, 136, 137, 1353.26, 111, 1351.14, 38
2, 15:36:00-000, 598, 264, 334, 264, 1352.55, 267, 1350.67, 42
2, 15:37:00-000, 263, 123, 140, 123, 1353.65, 123, 1352.00, 52
2, 15:38:00-000, 561, 252, 309, 252, 1352.60, 261, 1351.03, 35
2, 15:39:00-000, 293, 106, 187, 106, 1352.65, 115, 1351.10, 23
2, 15:40:00-000, 574, 264, 310, 264, 1352.18, 166, 1350.15, 111
2, 15:41:00-000, 336, 130, 206, 130, 1351.84, 145, 1350.09, 102
2, 15:42:00-000, 667, 282, 385, 282, 1352.22, 247, 1350.38, 97
2, 15:43:00-000, 310, 144, 166, 144, 1352.33, 91, 1350.92, 104
2, 15:44:00-000, 530, 218, 312, 218, 1351.91, 202, 1350.53, 119
2, 15:45:00-000, 308, 120, 188, 120, 1352.25, 122, 1350.81, 71
2, 15:46:00-000, 678, 285, 393, 285, 1352.24, 293, 1350.73, 93
2, 15:47:00-000, 311, 120, 191, 120, 1352.51, 125, 1351.04, 71
2, 15:48:00-000, 573, 231, 342, 231, 1352.71, 245, 1350.87, 72
2, 15:49:00-000, 312, 112, 200, 112, 1351.61, 123, 1351.31, 78
2, 15:50:00-000, 632, 208, 424, 208, 1352.05, 267, 1350.79, 97
2, 15:51:00-000, 321, 105, 216, 105, 1351.25, 135, 1351.14, 129
2, 15:52:00-000, 570, 228, 342, 228, 1351.72, 228, 1351.12, 105
2, 15:53:00-000, 319, 118, 201, 118, 1352.02, 140, 1351.27, 102
2, 15:54:00-000, 661, 291, 370, 291, 1352.19, 291, 1350.99, 61
2, 15:55:00-000, 312, 116, 196, 116, 1351.93, 137, 1351.59, 70
2, 15:56:00-000, 616, 225, 391, 225, 1351.51, 284, 1350.95, 95
2, 15:57:00-000, 339, 149, 190, 149, 1351.50, 125, 1350.74, 77
2, 15:58:00-000, 640, 264, 376, 264, 1351.77, 306, 1351.24, 98
2, 15:59:00-000, 315, 109, 206, 109, 1351.71, 132, 1351.06, 57
2, 16:00:00-000, 655, 302, 353, 302, 1352.47, 292, 1351.33, 70
2, 16:01:00-000, 323, 131, 192, 131, 1352.38, 119, 1351.06, 58
2, 16:02:00-000, 611, 241, 370, 241, 1351.83, 232, 1351.03, 88
2, 16:03:00-000, 384, 166, 218, 166, 1352.52, 181, 1351.37, 109
2, 16:04:00-000, 639, 279, 360, 279, 1352.64, 280, 1351.49, 67
2, 16:05:00-000, 371, 151, 220, 151, 1351.45, 126, 1349.63, 67
2, 16:06:00-000, 597, 248, 349, 248, 1352.17, 231, 1350.44, 87
2, 16:07:00-000, 356, 148, 208, 148, 1352.64, 150, 1351.19, 116
2, 16:08:00-000, 628, 285, 343, 285, 1352.42, 252, 1351.18, 84
2, 16:09:00-000, 275, 118, 157, 118, 1351.97, 103, 1350.90, 67
2, 16:10:00-000, 578, 229, 349, 229, 1352.34, 260, 1351.04, 52
2, 16:11:00-000, 341, 137, 204, 137, 1353.43, 172, 1351.55, 66
2, 16:12:00-000, 680, 294, 386, 294, 1351.47, 307, 1350.92, 77
2, 16:13:00-000, 312, 139, 173, 139, 1352.50, 128, 1349.97, 67
2, 16:14:00-000, 621, 254, 367, 254, 1352.03, 240, 1351.81, 72
2, 16:15:00-000, 264, 125, 139, 125, 1352.95, 127, 1351.30, 59
2, 16:16:00-000, 619, 282, 337, 282, 1352.62, 292, 1351.43, 56
2, 16:17:00-000, 287, 121, 166, 121, 1352.17, 113, 1350.51, 42
2, 16:18:00-000, 612, 269, 343, 269, 1352.29, 283, 1351.22, 59
2, 16:19:00-000, 369, 157, 212, 157, 1351.60, 153, 1351.33, 54
2, 16:20:00-000, 626, 257, 369, 257, 1351.74, 308, 1351.15, 60
2, 16:21:00-000, 383, 171, 212, 171, 1352.32, 123, 1350.46, 52
2, 16:22:00-000, 646, 280, 366, 280, 1352.27, 282, 1351.73, 116
2, 16:23:00-000, 310, 132, 178, 130, 1351.45, 140, 1351.75, 49
2, 16:24:00-000, 508, 232, 276, 234, 1352.00, 186, 1351.28, 64
2, 16:25:00-000, 332, 132, 200, 132, 1351.85, 144, 1351.06, 64
2, 16:26:00-000, 601, 289, 312, 289, 1352.93, 274, 1351.40, 76
2, 16:27:00-000, 349, 147, 202, 147, 1353.04, 189, 1352.08, 19
2, 16:28:00-000, 636, 278, 358, 278, 1352.57, 268, 1351.64, 48
2, 16:29:00-000, 292, 125, 167, 125, 1352.38, 121, 1351.89, 53
3, 09:00:00-000, 219, 196, 23, 7, 1350.00, 7, 1350.00, 196
3, 09:01:00-000, 184, 174, 10, 0, 0.00, 0, 0.00, 190
3, 09:02:00-000, 221, 205, 16, 0, 0.00, 0, 0.00, 219
3, 09:03:00-000, 187, 170, 17, 0, 0.00, 7, 1353.00, 182
3, 09:04:00-000, 209, 209, 0, 0, 0.00, 0, 0.00, 206
3, 09:05:00-000, 198, 198, 0, 0, 0.00, 0, 0.00, 201
3, 09:06:00-000, 218, 218, 0, 0, 0.00, 0, 0.00, 221
3, 09:07:00-000, 258, 258, 0, 0, 0.00, 0, 0.00, 249
3, 09:08:00-000, 180, 180, 0, 0, 0.00, 0, 0.00, 184
3, 09:09:00-000, 171, 171, 0, 0, 0.00, 0, 0.00, 175
3, 09:10:00-000, 182, 182, 0, 0, 0.00, 0, 0.00, 179
3, 09:11:00-000, 202, 202, 0, 0, 0.00, 0, 0.00, 205
3, 09:12:00-000, 216, 216, 0, 0, 0.00, 0, 0.00, 206
3, 09:13:00-000, 241, 237, 4, 12, 1388.58, 2, 1353.50, 230
3, 09:14:00-000, 190, 181, 9, 0, 0.00, 2, 1354.00, 192
3, 09:15:00-000, 229, 229, 0, 3, 1353.00, 0, 0.00, 225
3, 09:16:00-000, 207, 202, 5, 4, 1355.00, 0, 0.00, 206
3, 09:17:00-000, 181, 169, 12, 2, 1351.50, 4, 1352.75, 171
3, 09:18:00-000, 227, 209, 18, 11, 1350.36, 8, 1352.12, 213
3, 09:19:00-000, 217, 203, 14, 13, 1351.77, 8, 1356.75, 196
3, 09:20:00-000, 185, 182, 3, 2, 1359.50, 1, 1365.00, 181
3, 09:21:00-000, 249, 227, 22, 20, 1356.10, 10, 1350.20, 211
3, 09:22:00-000, 179, 154, 25, 9, 1348.67, 8, 1353.37, 170
3, 09:23:00-000, 170, 153, 17, 4, 1349.75, 2, 1352.00, 163
3, 09:24:00-000, 227, 208, 19, 8, 1348.00, 4, 1352.50, 217
3, 09:25:00-000, 196, 178, 18, 3, 1348.00, 0, 0.00, 194
3, 09:26:00-000, 186, 154, 32, 1, 1346.00, 4, 1351.25, 178
3, 09:27:00-000, 213, 192, 21, 2, 1351.00, 1, 1350.00, 206
3, 09:28:00-000, 208, 178, 30, 20, 1350.90, 9, 1352.66, 182
3, 09:29:00-000, 195, 151, 44, 7, 1350.86, 13, 1351.00, 170
3, 09:30:00-000, 187, 169, 18, 2, 1348.50, 13, 1351.77, 178
3, 09:31:00-000, 199, 192, 7, 3, 1352.00, 4, 1352.00, 193
3, 09:32:00-000, 206, 198, 8, 6, 1349.17, 1, 1352.00, 197
3, 09:33:00-000, 198, 193, 5, 9, 1353.55, 4, 1355.75, 180
3, 09:34:00-000, 185, 128, 57, 24, 1350.70, 7, 1352.29, 152
3, 09:35:00-000, 198, 170, 28, 1, 1349.00, 8, 1352.00, 191
3, 09:36:00-000, 183, 142, 41, 13, 1349.61, 1, 1352.00, 169
3, 09:37:00-000, 158, 96, 62, 7, 1348.57, 2, 1351.00, 154
3, 09:38:00-000, 203, 101, 102, 5, 1348.40, 11, 1351.09, 179
3, 09:39:00-000, 190, 120, 70, 0, 0.00, 4, 1349.50, 194
3, 09:40:00-000, 210, 130, 80, 2, 1349.50, 9, 1351.11, 202
3, 09:41:00-000, 242, 161, 81, 12, 1348.50, 7, 1350.43, 222
3, 09:42:00-000, 219, 169, 50, 7, 1349.43, 15, 1351.26, 194
3, 09:43:00-000, 201, 168, 33, 7, 1349.57, 7, 1351.57, 191
3, 09:44:00-000, 189, 174, 15, 6, 1350.83, 14, 1355.43, 169
3, 09:45:00-000, 234, 204, 30, 13, 1348.54, 6, 1350.83, 215
3, 09:46:00-000, 204, 174, 30, 7, 1349.14, 5, 1350.00, 190
3, 09:47:00-000, 187, 150, 37, 1, 1348.00, 0, 0.00, 185
3, 09:48:00-000, 193, 154, 39, 19, 1348.26, 8, 1351.87, 162
3, 09:49:00-000, 214, 144, 70, 6, 1348.67, 6, 1350.00, 206
3, 09:50:00-000, 223, 135, 88, 5, 1348.00, 2, 1352.00, 210
3, 09:51:00-000, 179, 113, 66, 1, 1348.00, 12, 1351.17, 172
3, 09:52:00-000, 227, 157, 70, 8, 1349.50, 8, 1350.12, 204
3, 09:53:00-000, 211, 147, 64, 4, 1347.00, 5, 1348.80, 198
3, 09:54:00-000, 211, 125, 86, 15, 1348.46, 18, 1351.66, 190
3, 09:55:00-000, 204, 132, 72, 3, 1348.33, 6, 1350.83, 196
3, 09:56:00-000, 188, 164, 24, 4, 1349.25, 9, 1351.89, 174
3, 09:57:00-000, 194, 161, 33, 2, 1349.50, 7, 1351.14, 186
3, 09:58:00-000, 191, 156, 35, 7, 1348.29, 1, 1352.00, 180
3, 09:59:00-000, 246, 215, 31, 5, 1348.80, 14, 1352.43, 215
3, 10:00:00-000, 177, 114, 63, 37, 1348.94, 17, 1352.41, 131
3, 10:01:00-000, 207, 160, 47, 1, 1352.00, 14, 1352.28, 199
3, 10:02:00-000, 197, 188, 9, 6, 1352.00, 1, 1351.00, 188
3, 10:03:00-000, 192, 149, 43, 4, 1347.00, 0, 0.00, 189
3, 10:04:00-000, 210, 132, 78, 10, 1347.80, 13, 1352.15, 187
3, 10:05:00-000, 225, 190, 35, 8, 1350.38, 8, 1351.00, 211
3, 10:06:00-000, 182, 137, 45, 15, 1349.60, 14, 1351.71, 154
3, 10:07:00-000, 213, 162, 51, 2, 1349.00, 2, 1350.50, 199
3, 10:08:00-000, 205, 151, 54, 10, 1345.90, 8, 1350.00, 176
3, 10:09:00-000, 170, 133, 37, 1, 1348.00, 2, 1351.00, 185
3, 10:10:00-000, 199, 138, 61, 15, 1346.53, 10, 1351.10, 174
3, 10:11:00-000, 188, 132, 56, 0, 0.00, 2, 1352.00, 182
3, 10:12:00-000, 232, 152, 80, 11, 1349.63, 12, 1353.17, 215
3, 10:13:00-000, 180, 104, 76, 9, 1347.89, 18, 1352.00, 153
3, 10:14:00-000, 247, 176, 71, 5, 1349.60, 11, 1352.27, 212
3, 10:15:00-000, 198, 172, 26, 10, 1351.00, 7, 1352.14, 195
3, 10:16:00-000, 222, 201, 21, 4, 1349.75, 8, 1351.37, 214
3, 10:17:00-000, 202, 179, 23, 5, 1351.80, 13, 1353.61, 184
3, 10:18:00-000, 225, 215, 10, 8, 1347.62, 1, 1352.00, 210
3, 10:19:00-000, 201, 160, 41, 12, 1348.58, 10, 1351.10, 178
3, 10:20:00-000, 195, 158, 37, 17, 1348.82, 5, 1351.40, 169
3, 10:21:00-000, 230, 191, 39, 17, 1347.76, 16, 1351.75, 204
3, 10:22:00-000, 175, 135, 40, 10, 1347.60, 4, 1350.75, 163
3, 10:23:00-000, 188, 140, 48, 14, 1350.14, 6, 1350.50, 168
3, 10:24:00-000, 217, 108, 109, 16, 1349.25, 13, 1351.23, 184
3, 10:25:00-000, 188, 84, 104, 9, 1348.67, 6, 1350.33, 177
3, 10:26:00-000, 207, 72, 135, 21, 1347.90, 19, 1350.63, 168
3, 10:27:00-000, 188, 93, 95, 0, 0.00, 12, 1350.91, 174
3, 10:28:00-000, 176, 102, 74, 0, 0.00, 0, 0.00, 180
3, 10:29:00-000, 216, 151, 65, 5, 1351.80, 30, 1353.89, 168
3, 10:30:00-000, 184, 161, 23, 17, 1351.82, 6, 1351.67, 174
3, 10:31:00-000, 167, 113, 54, 6, 1349.67, 3, 1353.33, 157
3, 10:32:00-000, 191, 119, 72, 3, 1348.00, 10, 1349.30, 172
3, 10:33:00-000, 239, 188, 51, 10, 1347.20, 1, 1354.00, 229
3, 10:34:00-000, 205, 160, 45, 9, 1348.11, 8, 1352.00, 192
3, 10:35:00-000, 217, 175, 42, 6, 1348.33, 2, 1352.00, 211
3, 10:36:00-000, 200, 122, 78, 12, 1348.83, 11, 1350.54, 174
3, 10:37:00-000, 192, 111, 81, 7, 1351.00, 10, 1351.60, 175
3, 10:38:00-000, 204, 116, 88, 6, 1346.33, 12, 1351.58, 183
3, 10:39:00-000, 203, 148, 55, 4, 1349.00, 12, 1349.17, 189
3, 10:40:00-000, 154, 122, 32, 8, 1346.87, 2, 1350.50, 146
3, 10:41:00-000, 230, 171, 59, 15, 1346.86, 5, 1350.80, 213
3, 10:42:00-000, 198, 130, 68, 15, 1346.13, 8, 1352.00, 162
3, 10:43:00-000, 180, 98, 82, 1, 1349.00, 2, 1353.00, 183
3, 10:44:00-000, 227, 113, 114, 11, 1347.54, 4, 1350.75, 215
3, 10:45:00-000, 225, 139, 86, 0, 0.00, 19, 1351.16, 204
3, 10:46:00-000, 193, 116, 77, 16, 1346.75, 9, 1351.44, 170
3, 10:47:00-000, 220, 148, 72, 10, 1347.50, 10, 1350.20, 203
3, 10:48:00-000, 220, 134, 86, 5, 1348.60, 16, 1350.81, 192
3, 10:49:00-000, 213, 140, 73, 7, 1348.14, 2, 1351.00, 207
3, 10:50:00-000, 177, 120, 57, 2, 1346.50, 15, 1350.93, 159
3, 10:51:00-000, 204, 188, 16, 1, 1345.00, 1, 1350.00, 204
3, 10:52:00-000, 216, 199, 17, 11, 1346.45, 6, 1352.00, 195
3, 10:53:00-000, 195, 161, 34, 9, 1351.11, 13, 1352.54, 170
3, 10:54:00-000, 201, 186, 15, 10, 1348.40, 4, 1351.50, 196
3, 10:55:00-000, 211, 180, 31, 15, 1350.87, 4, 1351.00, 192
3, 10:56:00-000, 194, 146, 48, 11, 1351.00, 4, 1351.50, 174
3, 10:57:00-000, 229, 154, 75, 1, 1351.00, 13, 1352.23, 220
3, 10:58:00-000, 183, 131, 52, 12, 1348.33, 6, 1350.83, 164
3, 10:59:00-000, 223, 138, 85, 7, 1347.14, 13, 1351.61, 202
3, 11:00:00-000, 189, 130, 59, 9, 1348.33, 6, 1351.00, 177
3, 11:01:00-000, 199, 138, 61, 2, 1348.50, 1, 1350.00, 191
3, 11:02:00-000, 206, 148, 58, 13, 1348.69, 10, 1350.90, 189
3, 11:03:00-000, 221, 137, 84, 14, 1350.28, 27, 1350.89, 173
3, 11:04:00-000, 230, 169, 61, 15, 1347.87, 8, 1351.75, 214
3, 11:05:00-000, 203, 170, 33, 3, 1349.00, 4, 1352.50, 192
3, 11:06:00-000, 198, 164, 34, 16, 1349.62, 15, 1350.86, 169
3, 11:07:00-000, 220, 194, 26, 4, 1349.50, 11, 1351.73, 187
3, 11:08:00-000, 186, 139, 47, 15, 1352.26, 5, 1349.80, 182
3, 11:09:00-000, 183, 147, 36, 4, 1351.00, 11, 1353.09, 168
3, 11:10:00-000, 195, 150, 45, 25, 1348.96, 10, 1351.90, 159
3, 11:11:00-000, 209, 133, 76, 3, 1349.00, 5, 1351.00, 192
3, 11:12:00-000, 201, 115, 86, 6, 1348.83, 18, 1351.94, 191
3, 11:13:00-000, 199, 147, 52, 5, 1347.00, 1, 1350.00, 190
3, 11:14:00-000, 215, 107, 108, 14, 1347.14, 6, 1351.17, 196
3, 11:15:00-000, 189, 112, 77, 2, 1349.50, 6, 1349.17, 180
3, 11:16:00-000, 194, 111, 83, 8, 1346.37, 14, 1351.64, 164
3, 11:17:00-000, 194, 149, 45, 5, 1348.60, 3, 1352.00, 185
3, 11:18:00-000, 185, 143, 42, 3, 1346.00, 7, 1352.43, 175
3, 11:19:00-000, 201, 149, 52, 3, 1350.00, 0, 0.00, 208
3, 11:20:00-000, 185, 141, 44, 8, 1348.12, 12, 1352.16, 164
3, 11:21:00-000, 229, 190, 39, 14, 1347.71, 3, 1351.00, 206
3, 11:22:00-000, 218, 141, 77, 10, 1347.10, 16, 1351.37, 198
3, 11:23:00-000, 212, 162, 50, 12, 1349.58, 6, 1353.00, 190
3, 11:24:00-000, 195, 124, 71, 25, 1348.48, 19, 1350.84, 150
3, 11:25:00-000, 164, 99, 65, 1, 1347.00, 13, 1350.46, 157
3, 11:26:00-000, 204, 144, 60, 19, 1347.47, 8, 1351.50, 176
3, 11:27:00-000, 187, 107, 80, 7, 1346.86, 2, 1351.50, 177
3, 11:28:00-000, 194, 137, 57, 13, 1351.23, 38, 1351.50, 139
3, 11:29:00-000, 191, 159, 32, 5, 1346.80, 1, 1353.00, 185
3, 11:30:00-000, 195, 168, 27, 8, 1349.62, 7, 1350.43, 179
3, 11:31:00-000, 178, 170, 8, 6, 1350.00, 1, 1351.00, 179
3, 11:32:00-000, 200, 132, 68, 24, 1347.16, 17, 1351.29, 150
3, 11:33:00-000, 200, 109, 91, 15, 1347.40, 11, 1351.36, 181
3, 11:34:00-000, 192, 124, 68, 15, 1347.73, 18, 1350.39, 155
3, 11:35:00-000, 191, 122, 69, 0, 0.00, 4, 1350.25, 191
3, 11:36:00-000, 180, 115, 65, 3, 1348.67, 6, 1352.67, 168
3, 11:37:00-000, 175, 142, 33, 3, 1349.33, 9, 1350.44, 162
3, 11:38:00-000, 168, 146, 22, 7, 1350.14, 14, 1354.00, 146
3, 11:39:00-000, 174, 160, 14, 10, 1348.40, 1, 1352.00, 167
3, 11:40:00-000, 202, 162, 40, 3, 1348.33, 10, 1351.10, 188
3, 11:41:00-000, 236, 195, 41, 18, 1346.67, 2, 1353.00, 210
3, 11:42:00-000, 208, 122, 86, 14, 1349.71, 7, 1351.00, 188
3, 11:43:00-000, 187, 107, 80, 0, 0.00, 8, 1350.25, 181
3, 11:44:00-000, 209, 154, 55, 8, 1348.25, 8, 1351.62, 200
3, 11:45:00-000, 222, 129, 93, 6, 1348.00, 20, 1351.95, 191
3, 11:46:00-000, 238, 175, 63, 8, 1348.75, 5, 1351.60, 228
3, 11:47:00-000, 199, 145, 54, 2, 1345.00, 7, 1350.29, 189
3, 11:48:00-000, 205, 162, 43, 5, 1349.60, 4, 1351.00, 195
3, 11:49:00-000, 189, 175, 14, 1, 1347.00, 3, 1350.33, 173
3, 11:50:00-000, 195, 180, 15, 14, 1347.43, 0, 0.00, 192
3, 11:51:00-000, 226, 167, 59, 9, 1350.44, 29, 1352.51, 190
3, 11:52:00-000, 192, 170, 22, 15, 1348.53, 4, 1351.75, 174
3, 11:53:00-000, 220, 195, 25, 1, 1352.00, 7, 1352.00, 212
3, 11:54:00-000, 254, 226, 28, 18, 1350.33, 10, 1352.20, 218
3, 11:55:00-000, 193, 163, 30, 2, 1351.00, 8, 1349.87, 193
3, 11:56:00-000, 196, 160, 36, 17, 1347.59, 26, 1351.42, 151
3, 11:57:00-000, 221, 190, 31, 6, 1347.67, 4, 1352.25, 210
3, 11:58:00-000, 170, 130, 40, 13, 1348.00, 1, 1351.00, 157
3, 11:59:00-000, 186, 125, 61, 8, 1348.37, 15, 1352.66, 163
3, 12:00:00-000, 197, 173, 24, 8, 1348.62, 5, 1352.20, 185
3, 12:01:00-000, 192, 145, 47, 8, 1349.00, 10, 1350.60, 168
3, 12:02:00-000, 186, 125, 61, 28, 1347.03, 13, 1351.92, 148
3, 12:03:00-000, 192, 125, 67, 8, 1346.63, 13, 1351.31, 171
3, 12:04:00-000, 158, 100, 58, 10, 1347.10, 21, 1351.38, 127
3, 12:05:00-000, 218, 164, 54, 21, 1350.85, 11, 1352.82, 184
3, 12:06:00-000, 200, 159, 41, 6, 1348.00, 12, 1350.67, 185
3, 12:07:00-000, 186, 158, 28, 1, 1350.00, 2, 1351.00, 175
3, 12:08:00-000, 209, 168, 41, 11, 1348.09, 5, 1350.40, 200
3, 12:09:00-000, 202, 147, 55, 4, 1351.25, 7, 1350.71, 191
3, 12:10:00-000, 218, 182, 36, 9, 1351.00, 10, 1352.60, 201
3, 12:11:00-000, 205, 177, 28, 11, 1351.73, 14, 1353.57, 174
3, 12:12:00-000, 221, 194, 27, 15, 1348.40, 4, 1350.25, 209
3, 12:13:00-000, 192, 149, 43, 10, 1347.30, 8, 1351.50, 173
3, 12:14:00-000, 209, 114, 95, 18, 1347.39, 8, 1351.00, 176
3, 12:15:00-000, 216, 104, 112, 1, 1349.00, 11, 1350.36, 210
3, 12:16:00-000, 192, 133, 59, 3, 1346.00, 9, 1351.67, 176
3, 12:17:00-000, 191, 173, 18, 6, 1349.33, 11, 1352.54, 172
3, 12:18:00-000, 254, 197, 57, 22, 1348.41, 0, 0.00, 232
3, 12:19:00-000, 187, 141, 46, 2, 1350.00, 15, 1350.86, 178
3, 12:20:00-000, 187, 152, 35, 15, 1347.67, 4, 1351.00, 168
3, 12:21:00-000, 218, 154, 64, 8, 1348.75, 4, 1350.50, 204
3, 12:22:00-000, 205, 119, 86, 11, 1348.36, 9, 1350.67, 180
3, 12:23:00-000, 183, 96, 87, 8, 1347.87, 13, 1352.00, 162
3, 12:24:00-000, 188, 113, 75, 3, 1348.33, 16, 1351.25, 174
3, 12:25:00-000, 145, 85, 60, 8, 1347.12, 11, 1350.73, 128
3, 12:26:00-000, 195, 122, 73, 11, 1349.00, 9, 1352.67, 174
3, 12:27:00-000, 248, 154, 94, 13, 1349.46, 15, 1350.40, 210
3, 12:28:00-000, 228, 141, 87, 5, 1345.20, 11, 1350.82, 215
3, 12:29:00-000, 207, 170, 37, 6, 1350.17, 13, 1351.00, 189
3, 12:30:00-000, 189, 155, 34, 8, 1348.00, 4, 1350.50, 182
3, 12:31:00-000, 190, 150, 40, 9, 1347.67, 0, 0.00, 182
3, 12:32:00-000, 223, 164, 59, 4, 1347.00, 17, 1350.59, 189
3, 12:33:00-000, 185, 160, 25, 14, 1348.50, 4, 1350.75, 177
3, 12:34:00-000, 230, 161, 69, 8, 1347.00, 6, 1349.67, 218
3, 12:35:00-000, 189, 112, 77, 18, 1349.50, 7, 1350.71, 154
3, 12:36:00-000, 197, 110, 87, 7, 1349.86, 16, 1352.18, 182
3, 12:37:00-000, 192, 125, 67, 5, 1346.80, 4, 1351.00, 176
3, 12:38:00-000, 186, 121, 65, 2, 1346.00, 6, 1351.33, 184
3, 12:39:00-000, 223, 175, 48, 3, 1349.00, 7, 1352.29, 216
3, 12:40:00-000, 210, 185, 25, 15, 1347.80, 4, 1351.50, 192
3, 12:41:00-000, 189, 156, 33, 10, 1346.30, 4, 1353.75, 168
3, 12:42:00-000, 216, 142, 74, 6, 1348.00, 6, 1351.17, 212
3, 12:43:00-000, 220, 144, 76, 2, 1347.00, 9, 1351.00, 207
3, 12:44:00-000, 195, 122, 73, 8, 1348.37, 17, 1350.88, 166
3, 12:45:00-000, 206, 177, 29, 8, 1347.12, 4, 1352.00, 193
3, 12:46:00-000, 195, 146, 49, 15, 1348.06, 7, 1352.14, 173
3, 12:47:00-000, 229, 183, 46, 1, 1347.00, 14, 1352.07, 221
3, 12:48:00-000, 211, 153, 58, 18, 1348.89, 9, 1352.22, 177
3, 12:49:00-000, 208, 143, 65, 13, 1347.08, 9, 1350.44, 187
3, 12:50:00-000, 203, 147, 56, 9, 1349.33, 13, 1350.92, 185
3, 12:51:00-000, 218, 178, 40, 4, 1347.25, 8, 1350.12, 202
3, 12:52:00-000, 205, 150, 55, 20, 1347.65, 6, 1350.50, 177
3, 12:53:00-000, 191, 112, 79, 13, 1348.23, 26, 1352.00, 156
3, 12:54:00-000, 247, 191, 56, 19, 1346.94, 15, 1351.20, 217
3, 12:55:00-000, 220, 182, 38, 3, 1350.67, 19, 1351.26, 197
3, 12:56:00-000, 190, 175, 15, 3, 1347.33, 2, 1352.00, 186
3, 12:57:00-000, 170, 148, 22, 7, 1351.14, 15, 1352.33, 147
3, 12:58:00-000, 170, 164, 6, 11, 1350.54, 3, 1351.33, 157
3, 12:59:00-000, 196, 137, 59, 19, 1350.63, 3, 1353.33, 170
3, 13:00:00-000, 210, 130, 80, 9, 1347.55, 29, 1351.89, 172
3, 13:01:00-000, 184, 136, 48, 5, 1347.80, 2, 1352.00, 181
3, 13:02:00-000, 176, 138, 38, 4, 1347.25, 9, 1350.67, 161
3, 13:03:00-000, 189, 184, 5, 2, 1352.50, 5, 1352.00, 183
3, 13:04:00-000, 205, 170, 35, 15, 1347.33, 1, 1351.00, 188
3, 13:05:00-000, 220, 169, 51, 8, 1346.25, 10, 1350.60, 203
3, 13:06:00-000, 182, 132, 50, 13, 1349.61, 5, 1351.20, 162
3, 13:07:00-000, 231, 190, 41, 7, 1347.86, 6, 1352.67, 221
3, 13:08:00-000, 219, 198, 21, 6, 1347.83, 7, 1351.43, 205
3, 13:09:00-000, 180, 171, 9, 6, 1347.17, 1, 1353.00, 174
3, 13:10:00-000, 190, 126, 64, 14, 1347.07, 9, 1350.89, 165
3, 13:11:00-000, 229, 135, 94, 8, 1348.25, 20, 1351.15, 200
3, 13:12:00-000, 180, 113, 67, 16, 1348.31, 20, 1350.65, 146
3, 13:13:00-000, 196, 148, 48, 6, 1348.00, 12, 1350.42, 176
3, 13:14:00-000, 202, 152, 50, 9, 1347.67, 17, 1352.59, 179
3, 13:15:00-000, 202, 189, 13, 9, 1351.44, 5, 1352.80, 185
3, 13:16:00-000, 206, 162, 44, 26, 1348.34, 18, 1351.16, 162
3, 13:17:00-000, 217, 206, 11, 2, 1349.50, 3, 1351.33, 207
3, 13:18:00-000, 195, 175, 20, 14, 1347.64, 4, 1351.25, 183
3, 13:19:00-000, 207, 162, 45, 6, 1347.00, 8, 1350.62, 189
3, 13:20:00-000, 168, 140, 28, 10, 1345.60, 7, 1348.29, 157
3, 13:21:00-000, 206, 163, 43, 10, 1349.70, 9, 1352.22, 187
3, 13:22:00-000, 194, 135, 59, 6, 1347.67, 9, 1351.89, 171
3, 13:23:00-000, 192, 137, 55, 2, 1348.50, 8, 1351.63, 191
3, 13:24:00-000, 192, 183, 9, 10, 1347.20, 5, 1351.60, 170
3, 13:25:00-000, 217, 151, 66, 6, 1348.00, 7, 1351.57, 207
3, 13:26:00-000, 207, 135, 72, 5, 1347.20, 12, 1351.58, 183
3, 13:27:00-000, 192, 177, 15, 3, 1347.67, 2, 1350.00, 194
3, 13:28:00-000, 173, 150, 23, 12, 1349.91, 8, 1353.62, 146
3, 13:29:00-000, 209, 160, 49, 20, 1350.55, 9, 1351.89, 173
3, 13:30:00-000, 200, 147, 53, 12, 1347.41, 7, 1351.00, 195
3, 13:31:00-000, 190, 144, 46, 5, 1348.20, 8, 1350.50, 171
3, 13:32:00-000, 204, 148, 56, 22, 1348.54, 22, 1351.04, 162
3, 13:33:00-000, 201, 143, 58, 15, 1349.60, 29, 1352.17, 160
3, 13:34:00-000, 220, 188, 32, 10, 1346.80, 1, 1351.00, 212
3, 13:35:00-000, 207, 133, 74, 2, 1350.00, 22, 1351.59, 174
3, 13:36:00-000, 175, 137, 38, 14, 1348.85, 10, 1350.20, 150
3, 13:37:00-000, 192, 167, 25, 13, 1350.38, 6, 1353.00, 182
3, 13:38:00-000, 194, 163, 31, 5, 1348.00, 5, 1350.60, 182
3, 13:39:00-000, 162, 125, 37, 9, 1345.67, 2, 1350.00, 155
3, 13:40:00-000, 187, 132, 55, 17, 1349.65, 23, 1351.04, 147
3, 13:41:00-000, 212, 145, 67, 17, 1347.88, 7, 1352.00, 183
3, 13:42:00-000, 177, 98, 79, 21, 1349.57, 11, 1350.63, 147
3, 13:43:00-000, 225, 112, 113, 4, 1347.75, 5, 1350.40, 215
3, 13:44:00-000, 259, 198, 61, 4, 1348.75, 22, 1351.54, 226
3, 13:45:00-000, 182, 150, 32, 24, 1347.25, 3, 1350.67, 165
3, 13:46:00-000, 256, 145, 111, 19, 1347.53, 22, 1350.59, 202
3, 13:47:00-000, 179, 139, 40, 2, 1345.00, 14, 1350.57, 176
3, 13:48:00-000, 181, 118, 63, 17, 1348.06, 24, 1352.08, 141
3, 13:49:00-000, 192, 142, 50, 4, 1349.25, 10, 1352.00, 170
3, 13:50:00-000, 210, 183, 27, 11, 1348.27, 6, 1350.83, 200
3, 13:51:00-000, 224, 207, 17, 4, 1348.25, 3, 1351.33, 210
3, 13:52:00-000, 221, 156, 65, 17, 1347.41, 12, 1352.33, 193
3, 13:53:00-000, 175, 136, 39, 10, 1347.10, 8, 1350.75, 165
3, 13:54:00-000, 166, 143, 23, 2, 1348.50, 3, 1351.00, 155
3, 13:55:00-000, 234, 182, 52, 3, 1347.67, 5, 1351.80, 229
3, 13:56:00-000, 194, 142, 52, 6, 1347.67, 8, 1352.12, 173
3, 13:57:00-000, 183, 137, 46, 11, 1347.82, 1, 1350.00, 179
3, 13:58:00-000, 196, 136, 60, 13, 1350.77, 32, 1352.65, 151
3, 13:59:00-000, 190, 157, 33, 5, 1349.80, 5, 1351.80, 177
3, 14:00:00-000, 194, 135, 59, 28, 1350.57, 16, 1351.19, 155
3, 14:01:00-000, 174, 129, 45, 0, 0.00, 8, 1350.87, 166
3, 14:02:00-000, 203, 156, 47, 11, 1347.82, 6, 1350.67, 178
3, 14:03:00-000, 179, 136, 43, 3, 1348.00, 9, 1349.78, 172
3, 14:04:00-000, 200, 170, 30, 15, 1349.60, 10, 1350.90, 169
3, 14:05:00-000, 201, 147, 54, 13, 1347.23, 7, 1350.43, 188
3, 14:06:00-000, 223, 118, 105, 16, 1347.50, 16, 1351.75, 189
3, 14:07:00-000, 201, 130, 71, 8, 1347.00, 5, 1351.60, 190
3, 14:08:00-000, 213, 121, 92, 8, 1348.87, 12, 1350.75, 187
3, 14:09:00-000, 194, 150, 44, 5, 1347.40, 6, 1350.83, 189
3, 14:10:00-000, 228, 177, 51, 5, 1348.80, 10, 1351.50, 200
3, 14:11:00-000, 240, 228, 12, 1, 1349.00, 3, 1351.67, 244
3, 14:12:00-000, 220, 178, 42, 16, 1347.12, 3, 1347.00, 205
3, 14:13:00-000, 210, 158, 52, 11, 1349.73, 15, 1352.60, 185
3, 14:14:00-000, 203, 155, 48, 7, 1348.71, 8, 1351.62, 190
3, 14:15:00-000, 219, 176, 43, 5, 1349.00, 4, 1351.00, 208
3, 14:16:00-000, 202, 143, 59, 10, 1349.20, 21, 1351.86, 163
3, 14:17:00-000, 188, 111, 77, 18, 1351.67, 5, 1350.60, 175
3, 14:18:00-000, 206, 154, 52, 9, 1347.78, 19, 1350.52, 178
3, 14:19:00-000, 217, 172, 45, 14, 1349.57, 8, 1352.63, 191
3, 14:20:00-000, 186, 136, 50, 14, 1349.78, 14, 1352.57, 148
3, 14:21:00-000, 202, 148, 54, 13, 1347.92, 15, 1350.80, 184
3, 14:22:00-000, 204, 183, 21, 15, 1349.60, 10, 1351.80, 180
3, 14:23:00-000, 218, 181, 37, 8, 1347.75, 8, 1351.00, 200
3, 14:24:00-000, 224, 191, 33, 6, 1348.17, 8, 1351.25, 214
3, 14:25:00-000, 213, 169, 44, 8, 1349.00, 19, 1352.31, 183
3, 14:26:00-000, 202, 167, 35, 18, 1349.22, 4, 1350.50, 175
3, 14:27:00-000, 220, 178, 42, 7, 1348.00, 4, 1351.25, 218
3, 14:28:00-000, 181, 143, 38, 8, 1348.50, 8, 1352.87, 159
3, 14:29:00-000, 188, 138, 50, 7, 1349.43, 6, 1351.83, 177
3, 14:30:00-000, 197, 138, 59, 7, 1350.14, 12, 1352.75, 176
3, 14:31:00-000, 177, 135, 42, 7, 1347.86, 11, 1351.27, 163
3, 14:32:00-000, 217, 146, 71, 13, 1349.08, 13, 1352.15, 182
3, 14:33:00-000, 174, 130, 44, 13, 1348.54, 20, 1350.80, 152
3, 14:34:00-000, 230, 192, 38, 11, 1347.64, 9, 1352.11, 208
3, 14:35:00-000, 187, 151, 36, 7, 1346.86, 3, 1350.00, 175
3, 14:36:00-000, 196, 164, 32, 6, 1349.17, 20, 1352.55, 174
3, 14:37:00-000, 189, 167, 22, 4, 1348.50, 3, 1353.00, 175
3, 14:38:00-000, 174, 146, 28, 15, 1347.26, 2, 1351.50, 163
3, 14:39:00-000, 184, 150, 34, 4, 1346.00, 3, 1350.33, 172
3, 14:40:00-000, 206, 167, 39, 20, 1347.10, 14, 1352.93, 174
3, 14:41:00-000, 183, 112, 71, 11, 1347.36, 1, 1350.00, 167
3, 14:42:00-000, 193, 127, 66, 18, 1348.50, 24, 1351.29, 158
3, 14:43:00-000, 175, 108, 67, 4, 1349.75, 9, 1350.44, 159
3, 14:44:00-000, 204, 177, 27, 0, 0.00, 9, 1352.00, 199
3, 14:45:00-000, 228, 176, 52, 12, 1350.00, 7, 1353.00, 202
3, 14:46:00-000, 189, 134, 55, 20, 1350.10, 15, 1351.20, 153
3, 14:47:00-000, 259, 177, 82, 11, 1345.36, 3, 1348.00, 248
3, 14:48:00-000, 194, 113, 81, 4, 1347.25, 9, 1351.44, 186
3, 14:49:00-000, 199, 118, 81, 4, 1346.50, 5, 1350.60, 182
3, 14:50:00-000, 216, 153, 63, 12, 1347.17, 10, 1349.60, 201
3, 14:51:00-000, 190, 140, 50, 6, 1351.67, 19, 1352.79, 158
3, 14:52:00-000, 215, 171, 44, 23, 1348.56, 14, 1352.86, 178
3, 14:53:00-000, 173, 140, 33, 6, 1349.67, 17, 1350.88, 155
3, 14:54:00-000, 182, 120, 62, 12, 1348.66, 8, 1352.00, 154
3, 14:55:00-000, 193, 130, 63, 3, 1350.00, 12, 1351.67, 187
3, 14:56:00-000, 197, 126, 71, 20, 1347.80, 7, 1350.43, 167
3, 14:57:00-000, 172, 116, 56, 7, 1348.28, 9, 1350.33, 152
3, 14:58:00-000, 185, 95, 90, 19, 1346.42, 6, 1351.33, 167
3, 14:59:00-000, 244, 115, 129, 6, 1347.67, 15, 1350.20, 214
3, 15:00:00-000, 222, 117, 105, 13, 1347.08, 10, 1350.80, 209
3, 15:01:00-000, 227, 113, 114, 6, 1349.33, 4, 1349.50, 217
3, 15:02:00-000, 174, 81, 93, 11, 1348.09, 14, 1350.71, 149
3, 15:03:00-000, 205, 127, 78, 2, 1345.00, 5, 1351.60, 190
3, 15:04:00-000, 204, 117, 87, 17, 1347.35, 19, 1351.42, 172
3, 15:05:00-000, 190, 151, 39, 6, 1350.83, 13, 1351.38, 170
3, 15:06:00-000, 189, 133, 56, 11, 1349.91, 5, 1351.00, 173
3, 15:07:00-000, 194, 166, 28, 2, 1351.50, 12, 1351.42, 186
3, 15:08:00-000, 204, 138, 66, 18, 1347.05, 9, 1353.00, 175
3, 15:09:00-000, 192, 146, 46, 9, 1348.67, 9, 1351.44, 175
3, 15:10:00-000, 211, 171, 40, 26, 1348.04, 19, 1351.84, 161
3, 15:11:00-000, 196, 154, 42, 12, 1350.25, 14, 1351.07, 169
3, 15:12:00-000, 172, 102, 70, 17, 1348.41, 12, 1350.58, 144
3, 15:13:00-000, 211, 126, 85, 4, 1347.00, 15, 1351.33, 198
3, 15:14:00-000, 188, 133, 55, 2, 1348.00, 7, 1351.29, 172
3, 15:15:00-000, 212, 177, 35, 10, 1349.50, 8, 1350.00, 194
3, 15:16:00-000, 234, 112, 122, 25, 1347.76, 4, 1351.50, 211
3, 15:17:00-000, 202, 98, 104, 9, 1348.22, 13, 1351.69, 174
3, 15:18:00-000, 188, 110, 78, 12, 1346.91, 11, 1350.82, 168
3, 15:19:00-000, 228, 108, 120, 15, 1347.33, 5, 1350.60, 207
3, 15:20:00-000, 190, 118, 72, 22, 1349.41, 38, 1351.83, 126
3, 15:21:00-000, 223, 166, 57, 12, 1348.25, 18, 1351.33, 202
3, 15:22:00-000, 174, 150, 24, 7, 1350.00, 10, 1352.10, 145
3, 15:23:00-000, 203, 195, 8, 4, 1350.75, 4, 1351.00, 205
3, 15:24:00-000, 183, 165, 18, 6, 1348.00, 12, 1351.00, 165
3, 15:25:00-000, 235, 190, 45, 18, 1349.22, 8, 1350.50, 202
3, 15:26:00-000, 198, 113, 85, 19, 1348.21, 7, 1350.43, 175
3, 15:27:00-000, 206, 106, 100, 1, 1348.00, 4, 1350.50, 201
3, 15:28:00-000, 210, 144, 66, 8, 1349.25, 9, 1351.22, 187
3, 15:29:00-000, 203, 153, 50, 3, 1347.00, 5, 1350.00, 206
3, 15:30:00-000, 221, 169, 52, 17, 1347.00, 13, 1350.92, 187
3, 15:31:00-000, 239, 137, 102, 7, 1349.00, 11, 1350.73, 223
3, 15:32:00-000, 225, 138, 87, 18, 1348.66, 15, 1351.07, 194
3, 15:33:00-000, 191, 98, 93, 8, 1349.87, 6, 1351.00, 176
3, 15:34:00-000, 159, 70, 89, 7, 1348.71, 24, 1352.29, 130
3, 15:35:00-000, 199, 159, 40, 1, 1349.00, 4, 1351.50, 193
3, 15:36:00-000, 199, 159, 40, 16, 1347.44, 12, 1351.33, 171
3, 15:37:00-000, 196, 135, 61, 11, 1350.45, 11, 1351.73, 171
3, 15:38:00-000, 204, 174, 30, 7, 1348.71, 10, 1351.40, 186
3, 15:39:00-000, 209, 167, 42, 13, 1348.61, 4, 1352.50, 195
3, 15:40:00-000, 193, 153, 40, 7, 1349.14, 9, 1351.66, 171
3, 15:41:00-000, 181, 136, 45, 14, 1350.64, 7, 1351.86, 160
3, 15:42:00-000, 211, 145, 66, 6, 1348.83, 15, 1350.27, 195
3, 15:43:00-000, 229, 185, 44, 3, 1349.00, 5, 1351.20, 221
3, 15:44:00-000, 232, 201, 31, 10, 1348.30, 8, 1350.87, 212
3, 15:45:00-000, 196, 175, 21, 11, 1350.82, 13, 1353.07, 175
3, 15:46:00-000, 230, 162, 68, 26, 1348.27, 11, 1351.18, 181
3, 15:47:00-000, 201, 142, 59, 7, 1349.00, 10, 1350.80, 196
3, 15:48:00-000, 211, 125, 86, 20, 1349.20, 3, 1351.33, 187
3, 15:49:00-000, 182, 98, 84, 9, 1349.22, 17, 1350.94, 157
3, 15:50:00-000, 202, 119, 83, 8, 1348.75, 18, 1350.66, 178
3, 15:51:00-000, 203, 149, 54, 5, 1348.20, 9, 1350.44, 187
3, 15:52:00-000, 186, 129, 57, 4, 1349.25, 5, 1351.20, 175
3, 15:53:00-000, 184, 129, 55, 4, 1348.00, 4, 1351.25, 170
3, 15:54:00-000, 222, 181, 41, 11, 1350.45, 8, 1352.62, 211
3, 15:55:00-000, 196, 153, 43, 3, 1347.33, 18, 1350.11, 177
3, 15:56:00-000, 205, 126, 79, 22, 1348.82, 14, 1351.07, 168
3, 15:57:00-000, 227, 120, 107, 6, 1349.00, 14, 1350.93, 204
3, 15:58:00-000, 200, 166, 34, 15, 1348.53, 10, 1351.20, 171
3, 15:59:00-000, 182, 143, 39, 1, 1349.00, 3, 1351.00, 171
3, 16:00:00-000, 193, 170, 23, 11, 1348.64, 8, 1350.75, 184
3, 16:01:00-000, 192, 156, 36, 11, 1348.27, 7, 1351.71, 170
3, 16:02:00-000, 200, 169, 31, 14, 1348.64, 16, 1352.37, 172
3, 16:03:00-000, 219, 165, 54, 8, 1350.00, 4, 1350.00, 205
3, 16:04:00-000, 210, 155, 55, 13, 1347.54, 13, 1351.15, 183
3, 16:05:00-000, 192, 146, 46, 3, 1348.67, 12, 1351.08, 183
3, 16:06:00-000, 217, 168, 49, 15, 1347.20, 7, 1350.86, 196
3, 16:07:00-000, 185, 118, 67, 7, 1349.14, 0, 0.00, 178
3, 16:08:00-000, 209, 159, 50, 12, 1349.33, 35, 1351.28, 164
3, 16:09:00-000, 186, 147, 39, 8, 1348.13, 4, 1350.25, 167
3, 16:10:00-000, 204, 158, 46, 20, 1347.20, 15, 1350.46, 164
3, 16:11:00-000, 199, 154, 45, 16, 1347.31, 6, 1350.17, 181
3, 16:12:00-000, 207, 119, 88, 21, 1347.90, 10, 1350.60, 183
3, 16:13:00-000, 189, 131, 58, 3, 1349.33, 7, 1351.29, 179
3, 16:14:00-000, 237, 169, 68, 8, 1348.25, 11, 1350.09, 214
3, 16:15:00-000, 191, 124, 67, 6, 1348.67, 10, 1350.80, 173
3, 16:16:00-000, 238, 186, 52, 20, 1348.15, 12, 1351.08, 202
3, 16:17:00-000, 171, 106, 65, 11, 1349.18, 21, 1350.38, 150
3, 16:18:00-000, 206, 124, 82, 19, 1347.47, 29, 1351.72, 149
3, 16:19:00-000, 214, 140, 74, 2, 1351.50, 12, 1351.42, 197
3, 16:20:00-000, 176, 162, 14, 8, 1348.12, 1, 1352.00, 176
3, 16:21:00-000, 182, 149, 33, 5, 1348.60, 4, 1352.25, 174
3, 16:22:00-000, 220, 159, 61, 19, 1348.21, 12, 1351.42, 186
3, 16:23:00-000, 206, 133, 73, 7, 1347.57, 1, 1351.00, 197
3, 16:24:00-000, 209, 138, 71, 5, 1348.80, 18, 1350.89, 193
3, 16:25:00-000, 205, 188, 17, 9, 1348.11, 4, 1351.50, 186
3, 16:26:00-000, 189, 136, 53, 11, 1348.18, 16, 1351.62, 165
3, 16:27:00-000, 250, 175, 75, 22, 1349.22, 17, 1351.29, 207
3, 16:28:00-000, 194, 144, 50, 13, 1350.23, 13, 1351.54, 174
3, 16:29:00-000, 208, 127, 81, 13, 1349.31, 16, 1353.56, 178
4, 09:03:00-000, 273, 273, 0, 7, 1353.00, 0, 0.00, 266
4, 09:06:00-000, 264, 263, 1, 262, 1351.00, 0, 0.00, 0
4, 09:07:00-000, 7, 6, 1, 5, 1350.80, 1, 1350.00, 2
4, 09:08:00-000, 24, 20, 4, 4, 1350.75, 4, 1350.75, 14
4, 09:09:00-000, 101, 78, 23, 19, 1375.57, 19, 1375.57, 36
4, 09:10:00-000, 84, 70, 14, 18, 1399.11, 18, 1399.11, 68
4, 09:11:00-000, 107, 84, 23, 22, 1410.82, 22, 1410.82, 46
4, 09:12:00-000, 47, 40, 7, 8, 1484.75, 8, 1484.75, 43
4, 09:13:00-000, 103, 95, 8, 86, 1410.93, 6, 1405.67, 24
4, 09:14:00-000, 86, 78, 8, 69, 1355.68, 7, 1353.57, 6
4, 09:15:00-000, 77, 64, 13, 57, 1355.81, 10, 1354.80, 11
4, 09:16:00-000, 91, 50, 41, 45, 1355.35, 42, 1355.71, 1
4, 09:17:00-000, 96, 45, 51, 44, 1352.17, 50, 1354.29, 8
4, 09:18:00-000, 65, 29, 36, 29, 1350.37, 30, 1350.66, 4
4, 09:19:00-000, 68, 36, 32, 36, 1354.88, 23, 1354.52, 10
4, 09:20:00-000, 79, 33, 46, 33, 1363.54, 43, 1363.25, 0
4, 09:21:00-000, 78, 40, 38, 40, 1355.16, 43, 1356.57, 1
4, 09:22:00-000, 77, 25, 52, 24, 1350.49, 42, 1349.45, 3
4, 09:23:00-000, 78, 33, 45, 33, 1351.87, 45, 1351.99, 5
4, 09:24:00-000, 103, 50, 53, 44, 1351.51, 44, 1351.49, 4
4, 09:25:00-000, 80, 34, 46, 35, 1349.82, 42, 1349.61, 10
4, 09:26:00-000, 58, 27, 31, 31, 1349.67, 24, 1348.91, 1
4, 09:27:00-000, 99, 48, 51, 41, 1351.41, 51, 1351.70, 11
4, 09:28:00-000, 90, 53, 37, 48, 1352.03, 34, 1351.76, 9
4, 09:29:00-000, 80, 36, 44, 36, 1351.16, 36, 1351.61, 7
4, 09:30:00-000, 68, 38, 30, 33, 1350.60, 33, 1349.96, 0
4, 09:31:00-000, 68, 45, 23, 32, 1352.27, 21, 1352.00, 17
4, 09:32:00-000, 107, 60, 47, 50, 1353.17, 45, 1353.19, 4
4, 09:33:00-000, 101, 48, 53, 47, 1356.48, 52, 1356.53, 13
4, 09:34:00-000, 82, 39, 43, 39, 1352.07, 37, 1351.21, 1
4, 09:35:00-000, 81, 50, 31, 48, 1352.26, 34, 1352.17, 2
4, 09:36:00-000, 61, 32, 29, 33, 1349.33, 27, 1349.55, 1
4, 09:37:00-000, 71, 36, 35, 36, 1350.19, 39, 1350.48, 0
4, 09:38:00-000, 93, 30, 63, 30, 1349.83, 45, 1349.17, 12
4, 09:39:00-000, 97, 39, 58, 39, 1349.81, 45, 1349.95, 8
4, 09:40:00-000, 74, 36, 38, 35, 1350.71, 42, 1351.54, 1
4, 09:41:00-000, 64, 33, 31, 31, 1350.90, 26, 1350.65, 10
4, 09:42:00-000, 85, 57, 28, 57, 1351.27, 26, 1351.19, 0
4, 09:43:00-000, 84, 51, 33, 48, 1351.37, 32, 1350.99, 4
4, 09:44:00-000, 79, 53, 26, 58, 1355.11, 25, 1353.75, 0
4, 09:45:00-000, 90, 50, 40, 48, 1353.30, 32, 1352.62, 8
4, 09:46:00-000, 84, 40, 44, 35, 1349.99, 37, 1350.35, 13
4, 09:47:00-000, 84, 20, 64, 18, 1348.89, 35, 1349.25, 14
4, 09:48:00-000, 92, 38, 54, 40, 1352.32, 57, 1351.71, 4
4, 09:49:00-000, 75, 37, 38, 31, 1349.67, 28, 1349.35, 11
4, 09:50:00-000, 107, 33, 74, 38, 1349.78, 60, 1350.44, 9
4, 09:51:00-000, 79, 39, 40, 39, 1351.07, 40, 1351.19, 11
4, 09:52:00-000, 81, 36, 45, 31, 1350.51, 40, 1350.67, 1
4, 09:53:00-000, 82, 32, 50, 30, 1347.73, 41, 1348.28, 15
4, 09:54:00-000, 88, 53, 35, 56, 1351.12, 38, 1351.39, 1
4, 09:55:00-000, 61, 17, 44, 19, 1350.26, 33, 1350.57, 7
4, 09:56:00-000, 95, 47, 48, 40, 1351.94, 46, 1351.34, 3
4, 09:57:00-000, 92, 40, 52, 39, 1350.43, 41, 1350.53, 17
4, 09:58:00-000, 72, 37, 35, 32, 1350.59, 37, 1350.70, 7
4, 09:59:00-000, 87, 41, 46, 38, 1351.47, 39, 1351.35, 1
4, 10:00:00-000, 101, 52, 49, 50, 1351.45, 57, 1351.36, 0
4, 10:01:00-000, 79, 39, 40, 32, 1351.84, 35, 1352.28, 13
4, 10:02:00-000, 59, 33, 26, 31, 1351.06, 21, 1350.14, 4
4, 10:03:00-000, 76, 28, 48, 30, 1348.43, 42, 1348.80, 5
4, 10:04:00-000, 62, 29, 33, 28, 1351.64, 39, 1351.66, 0
4, 10:05:00-000, 88, 57, 31, 43, 1351.32, 27, 1350.99, 10
4, 10:06:00-000, 77, 42, 35, 44, 1352.99, 34, 1353.67, 2
4, 10:07:00-000, 76, 40, 36, 41, 1351.07, 34, 1352.14, 5
4, 10:08:00-000, 74, 28, 46, 28, 1349.67, 48, 1350.18, 0
4, 10:09:00-000, 85, 37, 48, 32, 1349.68, 36, 1349.24, 0
4, 10:10:00-000, 80, 41, 39, 40, 1349.74, 46, 1349.93, 7
4, 10:11:00-000, 65, 28, 37, 27, 1348.74, 33, 1349.08, 5
4, 10:12:00-000, 89, 53, 36, 50, 1352.75, 39, 1351.84, 0
4, 10:13:00-000, 97, 49, 48, 46, 1350.99, 42, 1351.51, 8
4, 10:14:00-000, 88, 39, 49, 38, 1352.63, 49, 1352.52, 3
4, 10:15:00-000, 87, 58, 29, 44, 1352.97, 26, 1349.84, 10
4, 10:16:00-000, 94, 46, 48, 48, 1350.89, 46, 1351.88, 8
4, 10:17:00-000, 78, 46, 32, 47, 1353.82, 31, 1353.03, 1
4, 10:18:00-000, 80, 35, 45, 33, 1349.09, 42, 1349.49, 4
4, 10:19:00-000, 97, 40, 57, 38, 1350.86, 39, 1350.76, 1
4, 10:20:00-000, 97, 47, 50, 42, 1351.28, 57, 1351.94, 7
4, 10:21:00-000, 59, 35, 24, 39, 1350.27, 25, 1350.56, 2
4, 10:22:00-000, 82, 34, 48, 37, 1350.78, 48, 1351.18, 2
4, 10:23:00-000, 94, 50, 44, 42, 1350.64, 37, 1351.48, 6
4, 10:24:00-000, 89, 43, 46, 46, 1351.97, 39, 1351.10, 8
4, 10:25:00-000, 77, 42, 35, 38, 1349.49, 26, 1349.76, 4
4, 10:26:00-000, 95, 38, 57, 42, 1349.97, 60, 1349.41, 1
4, 10:27:00-000, 76, 43, 33, 41, 1350.33, 32, 1349.74, 7
4, 10:28:00-000, 66, 25, 41, 21, 1349.66, 25, 1349.80, 12
4, 10:29:00-000, 81, 49, 32, 50, 1352.91, 31, 1352.09, 8
4, 10:30:00-000, 81, 48, 33, 42, 1353.14, 31, 1353.41, 6
4, 10:31:00-000, 89, 46, 43, 40, 1351.32, 37, 1351.96, 4
4, 10:32:00-000, 72, 22, 50, 28, 1348.57, 42, 1348.92, 7
4, 10:33:00-000, 63, 24, 39, 24, 1348.79, 35, 1350.31, 6
4, 10:34:00-000, 83, 44, 39, 38, 1350.26, 41, 1350.65, 7
4, 10:35:00-000, 70, 33, 37, 31, 1349.80, 26, 1350.45, 7
4, 10:36:00-000, 88, 44, 44, 45, 1350.48, 49, 1350.40, 0
4, 10:37:00-000, 76, 37, 39, 37, 1351.18, 37, 1350.45, 2
4, 10:38:00-000, 73, 23, 50, 21, 1348.85, 37, 1346.72, 14
4, 10:39:00-000, 88, 34, 54, 32, 1348.31, 40, 1348.52, 9
4, 10:40:00-000, 99, 34, 65, 35, 1349.42, 50, 1349.71, 16
4, 10:41:00-000, 77, 36, 41, 34, 1350.61, 31, 1351.00, 16
4, 10:42:00-000, 102, 42, 60, 42, 1350.26, 54, 1350.25, 3
4, 10:43:00-000, 97, 42, 55, 42, 1349.33, 46, 1350.80, 7
4, 10:44:00-000, 76, 40, 36, 36, 1349.60, 40, 1349.99, 8
4, 10:45:00-000, 78, 47, 31, 43, 1350.25, 20, 1350.95, 3
4, 10:46:00-000, 101, 48, 53, 47, 1349.95, 59, 1350.26, 2
4, 10:47:00-000, 81, 37, 44, 37, 1348.70, 36, 1348.66, 4
4, 10:48:00-000, 89, 45, 44, 44, 1349.83, 48, 1350.30, 1
4, 10:49:00-000, 68, 31, 37, 29, 1348.48, 33, 1349.45, 8
4, 10:50:00-000, 86, 46, 40, 41, 1349.36, 43, 1349.60, 1
4, 10:51:00-000, 85, 39, 46, 35, 1350.97, 39, 1351.15, 13
4, 10:52:00-000, 58, 33, 25, 33, 1351.78, 28, 1351.49, 0
4, 10:53:00-000, 110, 59, 51, 56, 1353.80, 37, 1353.64, 5
4, 10:54:00-000, 89, 54, 35, 54, 1351.28, 43, 1352.08, 0
4, 10:55:00-000, 78, 41, 37, 41, 1352.19, 32, 1352.18, 7
4, 10:56:00-000, 71, 33, 38, 33, 1350.48, 25, 1350.59, 9
4, 10:57:00-000, 81, 45, 36, 40, 1351.47, 36, 1351.97, 7
4, 10:58:00-000, 73, 32, 41, 34, 1350.26, 37, 1350.45, 6
4, 10:59:00-000, 89, 50, 39, 48, 1350.72, 27, 1350.55, 3
4, 11:00:00-000, 75, 39, 36, 37, 1350.08, 41, 1349.89, 0
4, 11:01:00-000, 101, 42, 59, 39, 1348.99, 48, 1349.01, 16
4, 11:02:00-000, 84, 29, 55, 33, 1349.06, 53, 1349.69, 4
4, 11:03:00-000, 89, 41, 48, 37, 1351.32, 42, 1351.80, 3
4, 11:04:00-000, 80, 42, 38, 40, 1349.67, 34, 1350.38, 4
4, 11:05:00-000, 78, 36, 42, 31, 1350.45, 37, 1350.51, 7
4, 11:06:00-000, 81, 47, 34, 47, 1350.95, 37, 1351.45, 8
4, 11:07:00-000, 79, 42, 37, 33, 1351.08, 35, 1351.48, 1
4, 11:08:00-000, 79, 37, 42, 43, 1350.32, 27, 1349.81, 9
4, 11:09:00-000, 80, 48, 32, 48, 1352.84, 37, 1352.24, 3
4, 11:10:00-000, 70, 32, 38, 31, 1350.96, 25, 1350.68, 9
4, 11:11:00-000, 65, 27, 38, 26, 1349.80, 29, 1349.62, 12
4, 11:12:00-000, 91, 44, 47, 45, 1351.10, 33, 1350.84, 15
4, 11:13:00-000, 86, 27, 59, 25, 1349.52, 46, 1349.23, 7
4, 11:14:00-000, 77, 35, 42, 37, 1349.18, 49, 1349.48, 2
4, 11:15:00-000, 115, 52, 63, 46, 1349.51, 54, 1349.94, 6
4, 11:16:00-000, 82, 50, 32, 55, 1349.46, 34, 1350.61, 0
4, 11:17:00-000, 81, 50, 31, 43, 1349.76, 24, 1350.25, 3
4, 11:18:00-000, 62, 37, 25, 36, 1347.83, 26, 1349.30, 5
4, 11:19:00-000, 71, 24, 47, 24, 1351.20, 22, 1350.77, 13
4, 11:20:00-000, 106, 54, 52, 55, 1351.50, 62, 1350.75, 5
4, 11:21:00-000, 72, 24, 48, 23, 1349.91, 31, 1349.74, 15
4, 11:22:00-000, 86, 31, 55, 32, 1349.99, 41, 1349.82, 21
4, 11:23:00-000, 87, 46, 41, 42, 1350.94, 39, 1350.71, 3
4, 11:24:00-000, 95, 39, 56, 39, 1349.30, 42, 1349.75, 3
4, 11:25:00-000, 78, 48, 30, 38, 1349.60, 39, 1349.71, 5
4, 11:26:00-000, 86, 45, 41, 50, 1350.45, 36, 1350.66, 6
4, 11:27:00-000, 73, 32, 41, 32, 1349.21, 30, 1349.99, 9
4, 11:28:00-000, 100, 42, 58, 42, 1351.25, 52, 1350.93, 2
4, 11:29:00-000, 96, 44, 52, 32, 1349.65, 49, 1350.05, 15
4, 11:30:00-000, 70, 40, 30, 38, 1352.20, 38, 1352.81, 4
4, 11:31:00-000, 80, 34, 46, 34, 1351.14, 33, 1351.36, 3
4, 11:32:00-000, 89, 51, 38, 47, 1351.10, 44, 1351.19, 1
4, 11:33:00-000, 99, 57, 42, 60, 1349.06, 23, 1349.35, 16
4, 11:34:00-000, 101, 48, 53, 47, 1349.76, 50, 1349.77, 6
4, 11:35:00-000, 59, 30, 29, 26, 1349.84, 31, 1349.90, 6
4, 11:36:00-000, 87, 31, 56, 28, 1351.49, 42, 1350.71, 7
4, 11:37:00-000, 65, 24, 41, 25, 1351.19, 29, 1351.65, 13
4, 11:38:00-000, 125, 88, 37, 75, 1354.76, 42, 1354.06, 7
4, 11:39:00-000, 78, 21, 57, 22, 1351.90, 34, 1353.43, 21
4, 11:40:00-000, 103, 59, 44, 56, 1351.42, 53, 1351.55, 0
4, 11:41:00-000, 94, 35, 59, 35, 1350.82, 54, 1351.17, 1
4, 11:42:00-000, 88, 32, 56, 34, 1350.20, 56, 1351.06, 2
4, 11:43:00-000, 91, 44, 47, 35, 1350.02, 41, 1349.77, 1
4, 11:44:00-000, 84, 35, 49, 40, 1349.22, 52, 1349.67, 3
4, 11:45:00-000, 88, 47, 41, 43, 1349.60, 40, 1349.99, 6
4, 11:46:00-000, 91, 48, 43, 52, 1349.87, 41, 1349.87, 3
4, 11:47:00-000, 80, 40, 40, 37, 1350.56, 33, 1350.54, 3
4, 11:48:00-000, 85, 38, 47, 33, 1350.57, 40, 1351.09, 9
4, 11:49:00-000, 58, 27, 31, 28, 1348.92, 30, 1348.49, 5
4, 11:50:00-000, 71, 33, 38, 33, 1351.63, 43, 1351.36, 0
4, 11:51:00-000, 110, 59, 51, 52, 1351.55, 48, 1351.53, 2
4, 11:52:00-000, 60, 32, 28, 38, 1350.44, 31, 1350.38, 1
4, 11:53:00-000, 104, 54, 50, 48, 1351.49, 43, 1350.97, 0
4, 11:54:00-000, 78, 49, 29, 43, 1350.90, 36, 1351.63, 8
4, 11:55:00-000, 88, 42, 46, 45, 1350.88, 30, 1350.60, 3
4, 11:56:00-000, 89, 61, 28, 59, 1352.99, 36, 1351.91, 5
4, 11:57:00-000, 89, 33, 56, 33, 1350.51, 47, 1351.52, 4
4, 11:58:00-000, 102, 37, 65, 31, 1349.87, 62, 1350.29, 1
4, 11:59:00-000, 89, 46, 43, 48, 1350.60, 46, 1349.93, 4
4, 12:00:00-000, 82, 48, 34, 40, 1351.37, 37, 1351.88, 6
4, 12:01:00-000, 56, 19, 37, 16, 1349.50, 34, 1350.38, 4
4, 12:02:00-000, 130, 65, 65, 68, 1350.78, 60, 1350.96, 10
4, 12:03:00-000, 85, 33, 52, 31, 1348.25, 44, 1349.27, 0
4, 12:04:00-000, 72, 53, 19, 49, 1351.28, 27, 1351.33, 3
4, 12:05:00-000, 99, 43, 56, 41, 1352.02, 38, 1351.33, 2
4, 12:06:00-000, 76, 33, 43, 32, 1350.59, 48, 1351.76, 1
4, 12:07:00-000, 69, 28, 41, 28, 1350.28, 38, 1349.89, 13
4, 12:08:00-000, 101, 49, 52, 46, 1350.93, 48, 1351.36, 6
4, 12:09:00-000, 81, 41, 40, 39, 1350.66, 37, 1350.67, 10
4, 12:10:00-000, 63, 48, 15, 46, 1354.38, 15, 1354.40, 1
4, 12:11:00-000, 88, 50, 38, 47, 1353.18, 34, 1352.32, 4
4, 12:12:00-000, 95, 37, 58, 37, 1350.72, 53, 1350.95, 6
4, 12:13:00-000, 98, 49, 49, 50, 1351.37, 44, 1351.81, 6
4, 12:14:00-000, 80, 28, 52, 23, 1348.60, 45, 1349.66, 7
4, 12:15:00-000, 69, 29, 40, 31, 1349.32, 31, 1348.93, 7
4, 12:16:00-000, 93, 41, 52, 35, 1349.68, 53, 1350.31, 8
4, 12:17:00-000, 105, 59, 46, 55, 1349.97, 46, 1350.30, 0
4, 12:18:00-000, 71, 28, 43, 37, 1349.86, 22, 1349.77, 9
4, 12:19:00-000, 88, 51, 37, 48, 1350.45, 35, 1350.39, 13
4, 12:20:00-000, 86, 42, 44, 44, 1350.74, 45, 1350.75, 0
4, 12:21:00-000, 82, 28, 54, 25, 1349.28, 32, 1349.50, 16
4, 12:22:00-000, 79, 43, 36, 39, 1350.61, 32, 1350.87, 4
4, 12:23:00-000, 108, 51, 57, 47, 1350.50, 58, 1350.84, 10
4, 12:24:00-000, 70, 29, 41, 30, 1350.93, 34, 1351.73, 2
4, 12:25:00-000, 78, 37, 41, 37, 1350.53, 45, 1350.13, 3
4, 12:26:00-000, 72, 43, 29, 35, 1350.85, 29, 1350.96, 4
4, 12:27:00-000, 82, 50, 32, 51, 1351.05, 31, 1350.32, 4
4, 12:28:00-000, 78, 31, 47, 31, 1349.25, 37, 1349.02, 13
4, 12:29:00-000, 98, 53, 45, 53, 1351.12, 38, 1350.57, 1
4, 12:30:00-000, 89, 40, 49, 39, 1350.20, 48, 1350.49, 5
4, 12:31:00-000, 87, 39, 48, 34, 1349.47, 36, 1349.88, 5
4, 12:32:00-000, 85, 44, 41, 45, 1349.41, 48, 1349.84, 4
4, 12:33:00-000, 106, 42, 64, 41, 1350.26, 52, 1349.90, 5
4, 12:34:00-000, 91, 41, 50, 44, 1348.45, 49, 1348.95, 5
4, 12:35:00-000, 71, 31, 40, 29, 1351.92, 30, 1351.59, 5
4, 12:36:00-000, 78, 33, 45, 31, 1351.54, 47, 1352.50, 4
4, 12:37:00-000, 94, 35, 59, 35, 1349.45, 51, 1350.13, 8
4, 12:38:00-000, 71, 28, 43, 28, 1349.39, 37, 1349.40, 4
4, 12:39:00-000, 78, 45, 33, 38, 1352.18, 32, 1351.15, 12
4, 12:40:00-000, 98, 56, 42, 54, 1352.06, 31, 1350.80, 6
4, 12:41:00-000, 91, 44, 47, 43, 1349.59, 60, 1349.67, 0
4, 12:42:00-000, 72, 36, 36, 32, 1350.18, 30, 1350.63, 1
4, 12:43:00-000, 81, 52, 29, 44, 1350.40, 24, 1350.79, 12
4, 12:44:00-000, 74, 39, 35, 42, 1351.28, 38, 1351.28, 0
4, 12:45:00-000, 78, 44, 34, 38, 1351.49, 36, 1351.55, 3
4, 12:46:00-000, 94, 43, 51, 42, 1348.68, 42, 1348.94, 11
4, 12:47:00-000, 59, 25, 34, 27, 1350.44, 27, 1350.18, 2
4, 12:48:00-000, 89, 43, 46, 43, 1350.83, 35, 1351.20, 5
4, 12:49:00-000, 91, 34, 57, 36, 1350.02, 58, 1349.56, 8
4, 12:50:00-000, 101, 53, 48, 40, 1351.44, 38, 1351.81, 12
4, 12:51:00-000, 58, 23, 35, 23, 1350.91, 21, 1351.61, 21
4, 12:52:00-000, 93, 45, 48, 46, 1350.38, 45, 1350.50, 2
4, 12:53:00-000, 77, 44, 33, 39, 1351.56, 39, 1352.12, 4
4, 12:54:00-000, 94, 35, 59, 30, 1350.26, 51, 1350.46, 10
4, 12:55:00-000, 71, 46, 25, 46, 1351.56, 12, 1351.58, 9
4, 12:56:00-000, 95, 35, 60, 36, 1348.33, 60, 1348.89, 3
4, 12:57:00-000, 86, 41, 45, 40, 1351.84, 26, 1352.07, 6
4, 12:58:00-000, 78, 47, 31, 33, 1353.05, 40, 1352.39, 14
4, 12:59:00-000, 87, 41, 46, 40, 1351.77, 36, 1351.52, 11
4, 13:00:00-000, 65, 34, 31, 35, 1349.39, 33, 1349.93, 3
4, 13:01:00-000, 106, 42, 64, 38, 1349.62, 55, 1349.46, 4
4, 13:02:00-000, 68, 27, 41, 31, 1348.09, 49, 1348.26, 1
4, 13:03:00-000, 81, 45, 36, 43, 1352.46, 32, 1352.15, 2
4, 13:04:00-000, 80, 43, 37, 45, 1349.17, 37, 1349.91, 2
4, 13:05:00-000, 81, 43, 38, 39, 1350.20, 36, 1351.24, 0
4, 13:06:00-000, 72, 32, 40, 36, 1350.74, 38, 1350.65, 4
4, 13:07:00-000, 70, 32, 38, 28, 1349.57, 37, 1349.97, 2
4, 13:08:00-000, 99, 57, 42, 48, 1352.30, 38, 1352.05, 5
4, 13:09:00-000, 70, 30, 40, 33, 1350.14, 29, 1351.03, 8
4, 13:10:00-000, 79, 44, 35, 43, 1350.16, 37, 1350.29, 8
4, 13:11:00-000, 79, 43, 36, 42, 1350.64, 32, 1350.53, 3
4, 13:12:00-000, 91, 35, 56, 36, 1350.02, 45, 1350.53, 6
4, 13:13:00-000, 47, 26, 21, 22, 1350.54, 24, 1351.66, 3
4, 13:14:00-000, 99, 51, 48, 53, 1351.03, 44, 1351.27, 6
4, 13:15:00-000, 85, 40, 45, 37, 1352.16, 40, 1350.52, 10
4, 13:16:00-000, 106, 55, 51, 52, 1351.07, 47, 1350.59, 0
4, 13:17:00-000, 87, 59, 28, 55, 1352.72, 26, 1350.84, 7
4, 13:18:00-000, 83, 33, 50, 32, 1350.21, 48, 1350.76, 3
4, 13:19:00-000, 63, 34, 29, 29, 1351.34, 31, 1350.77, 2
4, 13:20:00-000, 75, 38, 37, 37, 1348.53, 35, 1349.39, 4
4, 13:21:00-000, 93, 55, 38, 56, 1350.34, 33, 1350.33, 7
4, 13:22:00-000, 64, 24, 40, 23, 1349.26, 35, 1349.79, 1
4, 13:23:00-000, 83, 41, 42, 41, 1349.77, 34, 1349.29, 10
4, 13:24:00-000, 67, 26, 41, 13, 1351.15, 32, 1351.43, 10
4, 13:25:00-000, 94, 31, 63, 35, 1348.45, 56, 1348.69, 4
4, 13:26:00-000, 87, 40, 47, 40, 1350.37, 60, 1350.10, 4
4, 13:27:00-000, 76, 36, 40, 33, 1348.54, 27, 1348.77, 7
4, 13:28:00-000, 81, 53, 28, 37, 1353.10, 30, 1352.03, 3
4, 13:29:00-000, 75, 49, 26, 52, 1352.76, 28, 1351.67, 12
4, 13:30:00-000, 70, 33, 37, 34, 1348.64, 32, 1349.15, 2
4, 13:31:00-000, 91, 37, 54, 38, 1350.70, 32, 1350.84, 3
4, 13:32:00-000, 73, 36, 37, 35, 1350.59, 59, 1351.31, 0
4, 13:33:00-000, 89, 47, 42, 47, 1352.03, 33, 1351.96, 1
4, 13:34:00-000, 68, 35, 33, 36, 1349.66, 35, 1351.45, 0
4, 13:35:00-000, 95, 54, 41, 49, 1350.69, 40, 1350.57, 1
4, 13:36:00-000, 73, 46, 27, 40, 1352.02, 28, 1351.17, 3
4, 13:37:00-000, 82, 52, 30, 50, 1351.85, 24, 1351.91, 17
4, 13:38:00-000, 98, 43, 55, 41, 1349.48, 48, 1349.84, 4
4, 13:39:00-000, 81, 32, 49, 35, 1349.42, 37, 1349.53, 8
4, 13:40:00-000, 84, 43, 41, 32, 1351.74, 37, 1351.02, 10
4, 13:41:00-000, 86, 33, 53, 37, 1348.83, 53, 1349.65, 6
4, 13:42:00-000, 82, 31, 51, 34, 1350.37, 50, 1351.03, 0
4, 13:43:00-000, 65, 26, 39, 22, 1350.13, 25, 1349.72, 7
4, 13:44:00-000, 60, 30, 30, 34, 1350.46, 32, 1351.37, 2
4, 13:45:00-000, 88, 42, 46, 38, 1349.63, 44, 1350.01, 4
4, 13:46:00-000, 71, 32, 39, 35, 1348.71, 37, 1348.75, 2
4, 13:47:00-000, 102, 56, 46, 54, 1350.08, 49, 1350.60, 3
4, 13:48:00-000, 107, 57, 50, 54, 1351.94, 44, 1351.31, 0
4, 13:49:00-000, 95, 52, 43, 51, 1351.34, 36, 1349.94, 11
4, 13:50:00-000, 85, 37, 48, 38, 1352.20, 39, 1352.12, 6
4, 13:51:00-000, 89, 35, 54, 28, 1349.99, 44, 1349.88, 12
4, 13:52:00-000, 89, 39, 50, 43, 1349.95, 43, 1351.04, 7
4, 13:53:00-000, 65, 28, 37, 27, 1349.70, 27, 1350.07, 9
4, 13:54:00-000, 54, 25, 29, 24, 1349.66, 40, 1351.19, 1
4, 13:55:00-000, 108, 60, 48, 54, 1350.84, 49, 1350.95, 3
4, 13:56:00-000, 78, 33, 45, 36, 1349.97, 43, 1350.06, 3
4, 13:57:00-000, 71, 27, 44, 27, 1349.59, 30, 1349.53, 2
4, 13:58:00-000, 81, 56, 25, 54, 1353.49, 24, 1352.41, 4
4, 13:59:00-000, 69, 40, 29, 34, 1352.61, 29, 1352.54, 14
4, 14:00:00-000, 75, 34, 41, 35, 1351.02, 40, 1351.07, 1
4, 14:01:00-000, 60, 21, 39, 23, 1348.60, 32, 1348.34, 1
4, 14:02:00-000, 100, 37, 63, 33, 1350.20, 44, 1350.29, 10
4, 14:03:00-000, 85, 49, 36, 44, 1349.06, 35, 1348.82, 10
4, 14:04:00-000, 83, 46, 37, 52, 1350.55, 34, 1350.61, 4
4, 14:05:00-000, 75, 37, 38, 35, 1348.31, 24, 1348.91, 11
4, 14:06:00-000, 80, 34, 46, 32, 1348.74, 41, 1349.38, 7
4, 14:07:00-000, 73, 35, 38, 28, 1350.17, 23, 1350.34, 18
4, 14:08:00-000, 107, 51, 56, 55, 1349.61, 56, 1349.56, 1
4, 14:09:00-000, 61, 31, 30, 30, 1349.69, 27, 1349.99, 6
4, 14:10:00-000, 77, 36, 41, 36, 1350.10, 42, 1350.35, 6
4, 14:11:00-000, 96, 41, 55, 41, 1350.68, 49, 1351.30, 1
4, 14:12:00-000, 92, 25, 67, 21, 1346.81, 43, 1348.27, 8
4, 14:13:00-000, 75, 50, 25, 48, 1349.99, 42, 1349.85, 6
4, 14:14:00-000, 73, 29, 44, 36, 1349.49, 33, 1348.96, 0
4, 14:15:00-000, 89, 45, 44, 38, 1350.97, 41, 1351.21, 4
4, 14:16:00-000, 73, 36, 37, 43, 1351.57, 40, 1350.02, 2
4, 14:17:00-000, 104, 52, 52, 48, 1351.93, 45, 1352.10, 9
4, 14:18:00-000, 100, 33, 67, 37, 1350.13, 56, 1350.38, 0
4, 14:19:00-000, 83, 34, 49, 34, 1350.43, 47, 1350.33, 15
4, 14:20:00-000, 79, 51, 28, 41, 1351.43, 22, 1351.41, 3
4, 14:21:00-000, 83, 36, 47, 39, 1349.30, 38, 1350.07, 9
4, 14:22:00-000, 76, 45, 31, 46, 1353.62, 37, 1353.34, 1
4, 14:23:00-000, 97, 47, 50, 42, 1349.82, 36, 1349.41, 6
4, 14:24:00-000, 77, 43, 34, 47, 1350.74, 40, 1351.29, 2
4, 14:25:00-000, 81, 48, 33, 41, 1353.02, 23, 1351.91, 4
4, 14:26:00-000, 96, 37, 59, 41, 1349.31, 52, 1349.80, 6
4, 14:27:00-000, 75, 40, 35, 39, 1350.20, 32, 1350.56, 12
4, 14:28:00-000, 72, 40, 32, 40, 1351.41, 29, 1351.20, 1
4, 14:29:00-000, 85, 42, 43, 35, 1351.59, 38, 1350.28, 9
4, 14:30:00-000, 99, 38, 61, 42, 1349.71, 52, 1350.51, 2
4, 14:31:00-000, 87, 43, 44, 41, 1351.72, 28, 1351.96, 13
4, 14:32:00-000, 76, 44, 32, 45, 1350.64, 48, 1351.28, 0
4, 14:33:00-000, 93, 44, 49, 36, 1349.94, 37, 1349.99, 9
4, 14:34:00-000, 81, 26, 55, 35, 1346.71, 48, 1347.87, 10
4, 14:35:00-000, 66, 24, 42, 21, 1349.76, 32, 1350.37, 5
4, 14:36:00-000, 106, 60, 46, 57, 1352.06, 44, 1351.20, 2
4, 14:37:00-000, 69, 23, 46, 23, 1349.86, 46, 1350.47, 3
4, 14:38:00-000, 83, 35, 48, 33, 1349.93, 40, 1350.07, 4
4, 14:39:00-000, 85, 48, 37, 44, 1350.08, 36, 1350.02, 13
4, 14:40:00-000, 76, 33, 43, 29, 1352.96, 41, 1351.92, 3
4, 14:41:00-000, 84, 25, 59, 31, 1349.19, 33, 1349.63, 5
4, 14:42:00-000, 107, 57, 50, 57, 1351.31, 72, 1350.36, 0
4, 14:43:00-000, 92, 44, 48, 44, 1349.99, 48, 1349.87, 0
4, 14:44:00-000, 73, 38, 35, 34, 1353.17, 26, 1353.26, 8
4, 14:45:00-000, 83, 40, 43, 35, 1350.99, 27, 1350.51, 15
4, 14:46:00-000, 101, 59, 42, 64, 1352.02, 47, 1351.93, 1
4, 14:47:00-000, 82, 23, 59, 23, 1347.12, 42, 1348.11, 9
4, 14:48:00-000, 78, 35, 43, 35, 1348.65, 42, 1348.87, 2
4, 14:49:00-000, 80, 28, 52, 26, 1348.65, 42, 1348.83, 6
4, 14:50:00-000, 80, 44, 36, 40, 1350.67, 47, 1350.12, 1
4, 14:51:00-000, 75, 43, 32, 48, 1352.49, 27, 1352.73, 2
4, 14:52:00-000, 67, 43, 24, 27, 1351.88, 28, 1353.03, 6
4, 14:53:00-000, 97, 57, 40, 51, 1351.28, 37, 1351.05, 9
4, 14:54:00-000, 63, 28, 35, 37, 1350.78, 30, 1350.53, 1
4, 14:55:00-000, 77, 38, 39, 40, 1351.49, 37, 1351.21, 0
4, 14:56:00-000, 104, 56, 48, 51, 1349.68, 48, 1350.43, 2
4, 14:57:00-000, 108, 49, 59, 40, 1350.57, 54, 1351.12, 2
4, 14:58:00-000, 68, 39, 29, 45, 1349.68, 31, 1351.22, 0
4, 14:59:00-000, 106, 56, 50, 58, 1350.07, 43, 1349.69, 8
4, 15:00:00-000, 95, 46, 49, 44, 1349.51, 49, 1350.44, 7
4, 15:01:00-000, 63, 25, 38, 27, 1349.33, 26, 1349.19, 2
4, 15:02:00-000, 79, 38, 41, 33, 1349.09, 55, 1350.26, 2
4, 15:03:00-000, 74, 27, 47, 24, 1347.50, 31, 1347.57, 1
4, 15:04:00-000, 108, 54, 54, 51, 1349.79, 54, 1350.47, 17
4, 15:05:00-000, 73, 46, 27, 41, 1351.75, 28, 1351.82, 3
4, 15:06:00-000, 77, 43, 34, 46, 1350.08, 33, 1350.23, 1
4, 15:07:00-000, 76, 33, 43, 35, 1350.62, 40, 1350.32, 1
4, 15:08:00-000, 64, 23, 41, 24, 1348.20, 35, 1349.65, 2
4, 15:09:00-000, 72, 37, 35, 34, 1349.91, 37, 1350.48, 6
4, 15:10:00-000, 107, 59, 48, 56, 1352.03, 47, 1352.84, 3
4, 15:11:00-000, 101, 44, 57, 45, 1349.99, 44, 1349.97, 5
4, 15:12:00-000, 56, 26, 30, 20, 1349.75, 23, 1350.78, 4
4, 15:13:00-000, 89, 55, 34, 49, 1350.26, 45, 1350.39, 6
4, 15:14:00-000, 97, 42, 55, 47, 1349.91, 48, 1349.39, 2
4, 15:15:00-000, 83, 38, 45, 38, 1350.81, 35, 1350.79, 3
4, 15:16:00-000, 76, 35, 41, 32, 1350.12, 42, 1351.02, 11
4, 15:17:00-000, 69, 36, 33, 30, 1349.96, 36, 1350.30, 1
4, 15:18:00-000, 87, 44, 43, 42, 1349.04, 38, 1349.99, 2
4, 15:19:00-000, 113, 48, 65, 49, 1348.95, 55, 1349.44, 4
4, 15:20:00-000, 119, 72, 47, 78, 1352.77, 45, 1352.70, 5
4, 15:21:00-000, 69, 33, 36, 31, 1351.25, 35, 1351.02, 10
4, 15:22:00-000, 83, 54, 29, 52, 1351.87, 25, 1352.12, 1
4, 15:23:00-000, 74, 28, 46, 29, 1351.99, 33, 1351.87, 1
4, 15:24:00-000, 78, 32, 46, 29, 1350.20, 46, 1351.49, 0
4, 15:25:00-000, 91, 48, 43, 48, 1349.87, 49, 1350.26, 7
4, 15:26:00-000, 69, 24, 45, 26, 1348.88, 41, 1349.94, 0
4, 15:27:00-000, 86, 52, 34, 52, 1349.58, 36, 1349.60, 4
4, 15:28:00-000, 92, 47, 45, 39, 1349.68, 43, 1349.88, 1
4, 15:29:00-000, 86, 38, 48, 43, 1347.53, 35, 1348.25, 7
4, 15:30:00-000, 75, 35, 40, 29, 1351.17, 45, 1351.10, 8
4, 15:31:00-000, 90, 51, 39, 48, 1351.37, 31, 1351.61, 6
4, 15:32:00-000, 93, 37, 56, 40, 1351.14, 53, 1351.54, 5
4, 15:33:00-000, 80, 36, 44, 35, 1350.56, 42, 1351.11, 2
4, 15:34:00-000, 77, 35, 42, 37, 1350.94, 40, 1351.89, 1
4, 15:35:00-000, 73, 29, 44, 29, 1351.58, 35, 1351.68, 7
4, 15:36:00-000, 79, 43, 36, 41, 1350.21, 45, 1350.66, 0
4, 15:37:00-000, 75, 49, 26, 47, 1351.10, 25, 1350.52, 3
4, 15:38:00-000, 96, 29, 67, 29, 1349.62, 55, 1349.63, 0
4, 15:39:00-000, 74, 40, 34, 36, 1350.46, 41, 1349.53, 5
4, 15:40:00-000, 79, 38, 41, 40, 1350.61, 31, 1350.54, 9
4, 15:41:00-000, 99, 44, 55, 44, 1352.42, 35, 1350.94, 10
4, 15:42:00-000, 79, 38, 41, 34, 1350.38, 43, 1350.71, 2
4, 15:43:00-000, 96, 53, 43, 51, 1351.31, 40, 1351.02, 9
4, 15:44:00-000, 79, 44, 35, 42, 1351.02, 42, 1351.25, 3
4, 15:45:00-000, 75, 36, 39, 34, 1353.11, 30, 1352.23, 1
4, 15:46:00-000, 102, 44, 58, 49, 1349.48, 47, 1349.22, 10
4, 15:47:00-000, 95, 56, 39, 55, 1350.90, 37, 1350.80, 7
4, 15:48:00-000, 93, 50, 43, 38, 1350.36, 44, 1350.67, 6
4, 15:49:00-000, 65, 22, 43, 25, 1349.48, 38, 1349.83, 3
4, 15:50:00-000, 57, 29, 28, 28, 1348.71, 33, 1350.27, 1
4, 15:51:00-000, 103, 40, 63, 42, 1350.18, 59, 1349.96, 1
4, 15:52:00-000, 90, 32, 58, 33, 1348.42, 55, 1349.55, 0
4, 15:53:00-000, 81, 47, 34, 45, 1350.77, 30, 1350.23, 2
4, 15:54:00-000, 73, 44, 29, 42, 1350.30, 32, 1351.59, 0
4, 15:55:00-000, 84, 44, 40, 46, 1349.23, 35, 1349.54, 3
4, 15:56:00-000, 92, 54, 38, 50, 1349.85, 39, 1349.76, 8
4, 15:57:00-000, 72, 28, 44, 25, 1348.91, 37, 1350.29, 6
4, 15:58:00-000, 85, 41, 44, 44, 1351.60, 48, 1351.22, 3
4, 15:59:00-000, 92, 47, 45, 42, 1350.73, 34, 1351.17, 0
4, 16:00:00-000, 76, 40, 36, 43, 1350.41, 41, 1351.19, 3
4, 16:01:00-000, 96, 50, 46, 44, 1350.15, 35, 1349.88, 1
4, 16:02:00-000, 83, 51, 32, 52, 1351.94, 42, 1351.11, 7
4, 16:03:00-000, 80, 36, 44, 36, 1349.97, 35, 1349.88, 4
4, 16:04:00-000, 99, 46, 53, 42, 1352.18, 45, 1350.51, 8
4, 16:05:00-000, 75, 34, 41, 36, 1351.02, 37, 1351.13, 8
4, 16:06:00-000, 105, 40, 65, 36, 1347.61, 51, 1348.26, 6
4, 16:07:00-000, 66, 35, 31, 36, 1349.10, 33, 1349.72, 6
4, 16:08:00-000, 69, 36, 33, 36, 1350.80, 37, 1351.37, 2
4, 16:09:00-000, 83, 34, 49, 34, 1349.32, 34, 1349.17, 7
4, 16:10:00-000, 69, 46, 23, 44, 1350.22, 26, 1350.96, 2
4, 16:11:00-000, 87, 43, 44, 34, 1350.26, 38, 1350.07, 7
4, 16:12:00-000, 87, 39, 48, 34, 1349.58, 50, 1349.85, 5
4, 16:13:00-000, 90, 40, 50, 43, 1349.29, 50, 1349.65, 8
4, 16:14:00-000, 72, 34, 38, 34, 1348.08, 30, 1348.53, 2
4, 16:15:00-000, 94, 52, 42, 51, 1350.68, 37, 1351.18, 12
4, 16:16:00-000, 87, 41, 46, 39, 1349.71, 46, 1349.95, 0
4, 16:17:00-000, 83, 36, 47, 31, 1349.77, 48, 1350.22, 0
4, 16:18:00-000, 88, 53, 35, 55, 1350.62, 31, 1351.41, 6
4, 16:19:00-000, 69, 48, 21, 43, 1350.74, 22, 1350.63, 0
4, 16:20:00-000, 81, 37, 44, 43, 1347.87, 35, 1347.74, 3
4, 16:21:00-000, 101, 51, 50, 44, 1349.33, 51, 1349.46, 6
4, 16:22:00-000, 68, 26, 42, 34, 1351.11, 36, 1351.91, 2
4, 16:23:00-000, 78, 30, 48, 25, 1347.52, 41, 1348.26, 4
4, 16:24:00-000, 75, 40, 35, 41, 1350.65, 38, 1350.70, 5
4, 16:25:00-000, 78, 34, 44, 29, 1350.51, 34, 1350.82, 4
4, 16:26:00-000, 77, 38, 39, 40, 1351.09, 49, 1351.48, 0
4, 16:27:00-000, 76, 30, 46, 32, 1350.34, 31, 1350.67, 6
4, 16:28:00-000, 87, 37, 50, 34, 1352.49, 52, 1352.80, 4
4, 16:29:00-000, 74, 39, 35, 34, 1352.43, 28, 1351.21, 7
5, 09:13:00-000, 10369, 5570, 4799, 3787, 1348.27, 3735, 1350.01, 0
5, 09:14:00-000, 0, 0, 0, 1, 1347.00, 69, 1356.00, 709
5, 09:15:00-000, 0, 0, 0, 8, 1347.00, 45, 1356.15, 2010
5, 09:16:00-000, 0, 0, 0, 0, 0.00, 0, 0.00, 5
5, 09:26:00-000, 10371, 5535, 4836, 3701, 1348.18, 3652, 1348.22, 0
5, 09:27:00-000, 0, 0, 0, 49, 1348.00, 66, 1356.00, 0
5, 09:28:00-000, 9, 2, 7, 46, 1347.08, 130, 1355.73, 2014
5, 09:29:00-000, 23, 20, 3, 19, 1351.42, 3, 1348.33, 722
5, 09:30:00-000, 62, 30, 32, 22, 1349.72, 28, 1351.53, 0
5, 09:31:00-000, 0, 0, 0, 2, 1346.00, 2, 1359.00, 1
5, 09:32:00-000, 201, 120, 81, 83, 1348.24, 83, 1350.54, 6
5, 09:33:00-000, 423, 213, 210, 164, 1348.67, 206, 1350.48, 9
5, 09:34:00-000, 647, 330, 317, 215, 1349.31, 236, 1349.88, 37
5, 09:35:00-000, 0, 0, 0, 9, 1347.00, 44, 1357.06, 40
5, 09:36:00-000, 888, 486, 402, 337, 1349.73, 356, 1350.86, 123
5, 09:37:00-000, 1292, 591, 701, 452, 1348.45, 499, 1348.87, 114
5, 09:38:00-000, 1305, 664, 641, 522, 1348.77, 529, 1349.67, 123
5, 09:39:00-000, 0, 0, 0, 73, 1345.00, 4, 1356.00, 204
5, 09:40:00-000, 1374, 706, 668, 497, 1348.54, 563, 1349.90, 189
5, 09:41:00-000, 1313, 708, 605, 496, 1348.76, 476, 1349.24, 254
5, 09:42:00-000, 1212, 648, 564, 462, 1349.26, 461, 1349.98, 238
5, 09:43:00-000, 0, 0, 0, 7, 1346.00, 64, 1357.43, 223
5, 09:44:00-000, 973, 552, 421, 373, 1349.60, 396, 1351.50, 201
5, 09:45:00-000, 1002, 516, 486, 373, 1348.94, 363, 1349.81, 119
5, 09:46:00-000, 928, 533, 395, 424, 1349.15, 357, 1350.15, 171
5, 09:47:00-000, 0, 0, 0, 22, 1346.18, 0, 0.00, 154
5, 09:48:00-000, 956, 523, 433, 434, 1349.29, 416, 1350.32, 157
5, 09:49:00-000, 928, 493, 435, 343, 1348.87, 405, 1350.12, 82
5, 09:50:00-000, 1124, 605, 519, 392, 1349.02, 412, 1349.57, 103
5, 09:51:00-000, 0, 0, 0, 29, 1347.76, 11, 1356.91, 149
5, 09:52:00-000, 1142, 584, 558, 457, 1349.24, 463, 1349.94, 197
5, 09:53:00-000, 1014, 507, 507, 398, 1348.04, 425, 1349.21, 194
5, 09:54:00-000, 1024, 530, 494, 409, 1348.68, 420, 1349.64, 135
5, 09:55:00-000, 0, 0, 0, 0, 0.00, 0, 0.00, 142
5, 09:56:00-000, 1100, 584, 516, 429, 1348.88, 449, 1349.79, 160
5, 09:57:00-000, 1059, 520, 539, 405, 1348.19, 428, 1349.36, 155
5, 09:58:00-000, 988, 493, 495, 393, 1348.51, 382, 1349.34, 136
5, 09:59:00-000, 1, 1, 0, 32, 1344.72, 28, 1355.21, 165
5, 10:00:00-000, 1066, 522, 544, 388, 1348.89, 436, 1349.56, 146
5, 10:01:00-000, 943, 528, 415, 384, 1349.30, 346, 1349.93, 183
5, 10:02:00-000, 882, 465, 417, 354, 1348.67, 332, 1349.54, 124
5, 10:03:00-000, 0, 0, 0, 21, 1345.00, 0, 0.00, 157
5, 10:04:00-000, 1002, 501, 501, 396, 1348.16, 388, 1349.20, 150
5, 10:05:00-000, 1077, 526, 551, 399, 1349.21, 417, 1349.14, 193
5, 10:06:00-000, 1084, 556, 528, 419, 1348.95, 433, 1349.83, 163
5, 10:07:00-000, 0, 0, 0, 26, 1346.00, 28, 1356.00, 158
5, 10:08:00-000, 1033, 485, 548, 437, 1347.94, 434, 1348.81, 126
5, 10:09:00-000, 963, 506, 457, 372, 1348.81, 384, 1349.34, 133
5, 10:10:00-000, 1017, 544, 473, 418, 1348.75, 388, 1349.03, 189
5, 10:11:00-000, 5, 0, 5, 29, 1345.38, 32, 1356.28, 125
5, 10:12:00-000, 949, 469, 480, 383, 1347.81, 435, 1349.79, 113
5, 10:13:00-000, 1023, 533, 490, 376, 1349.47, 406, 1350.00, 111
5, 10:14:00-000, 993, 564, 429, 423, 1349.55, 399, 1350.66, 124
5, 10:15:00-000, 0, 0, 0, 57, 1345.76, 13, 1357.00, 171
5, 10:16:00-000, 1075, 585, 490, 486, 1349.24, 438, 1349.92, 103
5, 10:17:00-000, 1020, 562, 458, 422, 1348.67, 375, 1349.02, 98
5, 10:18:00-000, 1040, 534, 506, 408, 1348.83, 368, 1349.62, 114
5, 10:19:00-000, 0, 0, 0, 25, 1345.28, 28, 1354.53, 133
5, 10:20:00-000, 1052, 525, 527, 406, 1348.78, 465, 1349.68, 199
5, 10:21:00-000, 1083, 551, 532, 395, 1348.99, 422, 1349.85, 147
5, 10:22:00-000, 959, 498, 461, 379, 1348.64, 394, 1349.99, 163
5, 10:23:00-000, 0, 0, 0, 0, 0.00, 42, 1357.09, 160
5, 10:24:00-000, 1031, 566, 465, 418, 1349.78, 391, 1350.41, 125
5, 10:25:00-000, 1059, 557, 502, 446, 1348.88, 415, 1349.26, 154
5, 10:26:00-000, 1074, 559, 515, 447, 1348.71, 405, 1349.00, 147
5, 10:27:00-000, 0, 0, 0, 1, 1345.00, 13, 1355.00, 185
5, 10:28:00-000, 1005, 520, 485, 400, 1348.88, 482, 1350.52, 129
5, 10:29:00-000, 1004, 535, 469, 400, 1349.24, 446, 1350.23, 115
5, 10:30:00-000, 1035, 505, 530, 387, 1348.60, 467, 1350.40, 93
5, 10:31:00-000, 0, 0, 0, 16, 1346.00, 2, 1356.00, 87
5, 10:32:00-000, 993, 487, 506, 406, 1348.16, 422, 1349.19, 162
5, 10:33:00-000, 1070, 530, 540, 375, 1348.68, 404, 1348.90, 141
5, 10:34:00-000, 968, 476, 492, 357, 1348.50, 402, 1349.21, 171
5, 10:35:00-000, 0, 0, 0, 31, 1345.41, 26, 1356.00, 156
5, 10:36:00-000, 1087, 542, 545, 420, 1348.37, 432, 1349.34, 170
5, 10:37:00-000, 954, 488, 466, 404, 1348.95, 375, 1349.22, 130
5, 10:38:00-000, 989, 526, 463, 429, 1348.45, 372, 1348.65, 163
5, 10:39:00-000, 0, 0, 0, 12, 1345.67, 19, 1356.00, 111
5, 10:40:00-000, 1040, 517, 523, 447, 1348.08, 404, 1348.67, 131
5, 10:41:00-000, 1051, 531, 520, 405, 1348.67, 444, 1349.94, 113
5, 10:42:00-000, 1104, 584, 520, 474, 1348.91, 439, 1349.37, 158
5, 10:43:00-000, 0, 0, 0, 38, 1344.81, 39, 1356.61, 132
5, 10:44:00-000, 1058, 527, 531, 392, 1348.15, 395, 1348.83, 92
5, 10:45:00-000, 913, 484, 429, 395, 1349.34, 359, 1349.60, 214
5, 10:46:00-000, 1005, 552, 453, 405, 1348.45, 387, 1349.89, 153
5, 10:47:00-000, 0, 0, 0, 24, 1345.00, 2, 1356.00, 110
5, 10:48:00-000, 995, 488, 507, 375, 1348.83, 386, 1349.08, 153
5, 10:49:00-000, 1024, 534, 490, 424, 1349.14, 374, 1349.96, 188
5, 10:50:00-000, 1061, 573, 488, 495, 1348.38, 441, 1350.16, 108
5, 10:51:00-000, 0, 0, 0, 8, 1345.00, 35, 1355.74, 146
5, 10:52:00-000, 1067, 550, 517, 455, 1348.63, 464, 1349.82, 117
5, 10:53:00-000, 1056, 498, 558, 355, 1348.10, 434, 1349.25, 92
5, 10:54:00-000, 1035, 516, 519, 389, 1348.35, 443, 1349.37, 168
5, 10:55:00-000, 2, 2, 0, 16, 1346.00, 16, 1355.00, 180
5, 10:56:00-000, 987, 527, 460, 382, 1350.45, 374, 1351.33, 125
5, 10:57:00-000, 987, 508, 479, 370, 1349.24, 338, 1349.39, 177
5, 10:58:00-000, 1110, 561, 549, 504, 1348.34, 482, 1349.77, 135
5, 10:59:00-000, 0, 0, 0, 0, 0.00, 18, 1356.00, 151
5, 11:00:00-000, 1009, 504, 505, 406, 1348.23, 389, 1349.06, 172
5, 11:01:00-000, 1072, 521, 551, 439, 1347.84, 442, 1348.58, 160
5, 11:02:00-000, 923, 464, 459, 363, 1347.86, 370, 1348.97, 126
5, 11:03:00-000, 0, 0, 0, 0, 0.00, 9, 1356.00, 130
5, 11:04:00-000, 1085, 564, 521, 386, 1349.22, 419, 1349.69, 157
5, 11:05:00-000, 1075, 529, 546, 373, 1348.83, 411, 1349.43, 190
5, 11:06:00-000, 1021, 562, 459, 423, 1349.43, 369, 1350.19, 211
5, 11:07:00-000, 7, 0, 7, 33, 1346.85, 0, 0.00, 155
5, 11:08:00-000, 922, 486, 436, 402, 1348.88, 378, 1350.23, 172
5, 11:09:00-000, 1116, 598, 518, 430, 1349.50, 408, 1349.93, 146
5, 11:10:00-000, 1078, 538, 540, 412, 1348.97, 449, 1349.31, 166
5, 11:11:00-000, 0, 0, 0, 2, 1346.00, 2, 1355.00, 167
5, 11:12:00-000, 987, 498, 489, 363, 1348.96, 429, 1350.43, 176
5, 11:13:00-000, 1054, 481, 573, 355, 1348.16, 399, 1348.64, 139
5, 11:14:00-000, 978, 515, 463, 416, 1348.50, 381, 1349.05, 166
5, 11:15:00-000, 0, 0, 0, 17, 1346.00, 55, 1355.61, 162
5, 11:16:00-000, 985, 512, 473, 413, 1348.81, 408, 1350.14, 141
5, 11:17:00-000, 983, 442, 541, 349, 1347.93, 356, 1348.61, 147
5, 11:18:00-000, 1048, 542, 506, 439, 1348.35, 415, 1349.30, 124
5, 11:19:00-000, 0, 0, 0, 6, 1345.00, 38, 1354.89, 178
5, 11:20:00-000, 1028, 532, 496, 420, 1349.03, 395, 1349.55, 137
5, 11:21:00-000, 1016, 500, 516, 347, 1349.21, 368, 1349.50, 173
5, 11:22:00-000, 1007, 513, 494, 416, 1348.34, 413, 1349.88, 170
5, 11:23:00-000, 0, 0, 0, 30, 1345.77, 27, 1355.00, 176
5, 11:24:00-000, 1038, 522, 516, 381, 1349.51, 405, 1349.92, 146
5, 11:25:00-000, 1013, 533, 480, 375, 1348.45, 377, 1348.98, 177
5, 11:26:00-000, 982, 507, 475, 443, 1348.20, 379, 1349.56, 161
5, 11:27:00-000, 0, 0, 0, 0, 0.00, 20, 1355.00, 159
5, 11:28:00-000, 1100, 606, 494, 465, 1349.07, 440, 1350.05, 130
5, 11:29:00-000, 986, 530, 456, 387, 1348.41, 335, 1349.21, 161
5, 11:30:00-000, 984, 490, 494, 401, 1348.74, 430, 1349.70, 158
5, 11:31:00-000, 0, 0, 0, 18, 1345.00, 12, 1356.00, 170
5, 11:32:00-000, 1060, 564, 496, 426, 1348.54, 392, 1349.64, 125
5, 11:33:00-000, 1046, 463, 583, 385, 1348.19, 434, 1348.91, 194
5, 11:34:00-000, 1019, 514, 505, 404, 1348.05, 406, 1349.50, 112
5, 11:35:00-000, 0, 0, 0, 31, 1345.22, 46, 1355.64, 145
5, 11:36:00-000, 1064, 529, 535, 431, 1348.49, 427, 1348.80, 144
5, 11:37:00-000, 1038, 579, 459, 379, 1349.49, 373, 1350.01, 179
5, 11:38:00-000, 983, 553, 430, 422, 1349.65, 392, 1351.01, 122
5, 11:39:00-000, 1, 1, 0, 36, 1347.08, 23, 1357.39, 147
5, 11:40:00-000, 962, 430, 532, 344, 1348.08, 391, 1349.17, 143
5, 11:41:00-000, 1087, 588, 499, 443, 1349.28, 434, 1349.54, 150
5, 11:42:00-000, 1034, 539, 495, 421, 1348.52, 404, 1349.93, 146
5, 11:43:00-000, 2, 2, 0, 16, 1345.00, 11, 1356.00, 158
5, 11:44:00-000, 1054, 534, 520, 427, 1348.10, 391, 1349.33, 168
5, 11:45:00-000, 1014, 543, 471, 382, 1348.10, 407, 1348.84, 186
5, 11:46:00-000, 964, 487, 477, 375, 1348.88, 415, 1349.66, 127
5, 11:47:00-000, 0, 0, 0, 4, 1345.00, 10, 1356.00, 136
5, 11:48:00-000, 1036, 541, 495, 371, 1349.40, 407, 1350.63, 189
5, 11:49:00-000, 1076, 556, 520, 411, 1348.85, 400, 1349.40, 159
5, 11:50:00-000, 952, 485, 467, 434, 1348.31, 382, 1348.86, 161
5, 11:51:00-000, 1, 1, 0, 5, 1345.00, 24, 1356.00, 174
5, 11:52:00-000, 980, 491, 489, 369, 1348.64, 404, 1349.60, 149
5, 11:53:00-000, 1100, 518, 582, 445, 1348.42, 476, 1349.63, 140
5, 11:54:00-000, 1087, 593, 494, 435, 1349.37, 425, 1349.84, 127
5, 11:55:00-000, 0, 0, 0, 10, 1346.00, 32, 1356.41, 117
5, 11:56:00-000, 922, 452, 470, 348, 1347.83, 366, 1349.13, 150
5, 11:57:00-000, 1186, 624, 562, 451, 1348.53, 415, 1348.88, 185
5, 11:58:00-000, 1034, 507, 527, 398, 1348.76, 360, 1349.15, 181
5, 11:59:00-000, 1, 0, 1, 6, 1346.00, 29, 1354.86, 199
5, 12:00:00-000, 1045, 552, 493, 443, 1349.32, 434, 1350.82, 176
5, 12:01:00-000, 1007, 487, 520, 391, 1347.99, 390, 1348.66, 153
5, 12:02:00-000, 1059, 593, 466, 433, 1348.88, 367, 1349.06, 166
5, 12:03:00-000, 1, 1, 0, 29, 1345.69, 23, 1355.00, 154
5, 12:04:00-000, 944, 527, 417, 415, 1349.06, 366, 1350.45, 183
5, 12:05:00-000, 1063, 525, 538, 413, 1349.19, 423, 1349.84, 128
5, 12:06:00-000, 1139, 568, 571, 428, 1348.62, 461, 1349.73, 128
5, 12:07:00-000, 0, 0, 0, 28, 1346.00, 17, 1355.00, 129
5, 12:08:00-000, 993, 485, 508, 419, 1348.42, 383, 1349.08, 189
5, 12:09:00-000, 1133, 656, 477, 460, 1349.64, 426, 1349.78, 127
5, 12:10:00-000, 990, 489, 501, 372, 1348.75, 418, 1349.59, 160
5, 12:11:00-000, 0, 0, 0, 15, 1346.00, 0, 0.00, 188
5, 12:12:00-000, 950, 461, 489, 359, 1348.93, 373, 1349.95, 149
5, 12:13:00-000, 1048, 534, 514, 411, 1349.26, 441, 1349.60, 169
5, 12:14:00-000, 992, 495, 497, 347, 1348.43, 391, 1349.00, 125
5, 12:15:00-000, 0, 0, 0, 26, 1345.00, 9, 1355.00, 157
5, 12:16:00-000, 1021, 557, 464, 444, 1348.71, 386, 1349.90, 188
5, 12:17:00-000, 1047, 573, 474, 394, 1349.28, 412, 1350.05, 148
5, 12:18:00-000, 1109, 505, 604, 436, 1348.67, 475, 1349.23, 135
5, 12:19:00-000, 0, 0, 0, 32, 1345.00, 25, 1355.64, 153
5, 12:20:00-000, 1055, 626, 429, 413, 1349.71, 267, 1349.38, 143
5, 12:21:00-000, 1016, 513, 503, 312, 1348.60, 314, 1348.49, 244
5, 12:22:00-000, 1011, 519, 492, 422, 1348.99, 390, 1349.26, 243
5, 12:23:00-000, 1, 0, 1, 0, 0.00, 1, 1351.00, 272
5, 12:24:00-000, 1108, 557, 551, 371, 1348.78, 409, 1348.33, 185
5, 12:25:00-000, 1003, 494, 509, 342, 1348.78, 379, 1348.56, 238
5, 12:26:00-000, 1052, 556, 496, 427, 1348.91, 386, 1349.81, 221
5, 12:27:00-000, 2, 2, 0, 0, 0.00, 0, 0.00, 190
5, 12:28:00-000, 958, 474, 484, 373, 1348.97, 346, 1348.57, 221
5, 12:29:00-000, 1147, 576, 571, 420, 1348.85, 381, 1348.97, 173
5, 12:30:00-000, 1046, 544, 502, 404, 1348.78, 362, 1348.84, 200
5, 12:31:00-000, 1, 1, 0, 18, 1346.00, 0, 0.00, 244
5, 12:32:00-000, 1006, 537, 469, 399, 1349.64, 384, 1349.40, 182
5, 12:33:00-000, 1071, 504, 567, 371, 1348.49, 421, 1349.16, 223
5, 12:34:00-000, 989, 498, 491, 380, 1348.67, 407, 1349.02, 153
5, 12:35:00-000, 0, 0, 0, 0, 0.00, 0, 0.00, 237
5, 12:36:00-000, 931, 456, 475, 344, 1348.81, 367, 1349.74, 143
5, 12:37:00-000, 1046, 525, 521, 391, 1348.48, 407, 1349.05, 167
5, 12:38:00-000, 1006, 512, 494, 367, 1348.96, 346, 1349.57, 180
5, 12:39:00-000, 1, 1, 0, 3, 1346.00, 14, 1355.00, 180
5, 12:40:00-000, 1087, 621, 466, 487, 1349.23, 392, 1349.87, 197
5, 12:41:00-000, 1086, 550, 536, 394, 1349.04, 413, 1349.28, 185
5, 12:42:00-000, 1021, 531, 490, 378, 1349.01, 361, 1349.10, 150
5, 12:43:00-000, 1, 1, 0, 3, 1348.33, 11, 1355.00, 218
5, 12:44:00-000, 1119, 574, 545, 460, 1348.91, 426, 1349.69, 208
5, 12:45:00-000, 1088, 538, 550, 403, 1349.16, 425, 1349.55, 159
5, 12:46:00-000, 975, 534, 441, 402, 1348.73, 418, 1350.63, 183
5, 12:47:00-000, 1, 0, 1, 27, 1345.29, 1, 1351.00, 133
5, 12:48:00-000, 1037, 485, 552, 387, 1348.12, 441, 1349.66, 145
5, 12:49:00-000, 1031, 520, 511, 410, 1348.87, 427, 1349.94, 166
5, 12:50:00-000, 937, 487, 450, 395, 1348.90, 381, 1349.31, 148
5, 12:51:00-000, 1, 0, 1, 21, 1345.33, 1, 1350.00, 135
5, 12:52:00-000, 990, 498, 492, 385, 1349.19, 405, 1349.94, 117
5, 12:53:00-000, 1056, 548, 508, 417, 1348.89, 427, 1349.22, 130
5, 12:54:00-000, 1041, 555, 486, 407, 1348.80, 365, 1349.01, 152
5, 12:55:00-000, 1, 0, 1, 6, 1345.00, 13, 1354.54, 155
5, 12:56:00-000, 1124, 596, 528, 496, 1348.82, 410, 1349.90, 191
5, 12:57:00-000, 1029, 563, 466, 393, 1349.66, 397, 1350.27, 193
5, 12:58:00-000, 984, 519, 465, 429, 1348.75, 432, 1350.15, 115
5, 12:59:00-000, 2, 2, 0, 9, 1346.67, 20, 1357.00, 136
5, 13:00:00-000, 981, 491, 490, 401, 1348.38, 380, 1349.47, 131
5, 13:01:00-000, 1003, 505, 498, 358, 1349.42, 431, 1350.09, 131
5, 13:02:00-000, 1054, 541, 513, 426, 1348.65, 477, 1350.26, 159
5, 13:03:00-000, 1, 1, 0, 58, 1344.96, 3, 1356.00, 104
5, 13:04:00-000, 887, 450, 437, 358, 1348.56, 350, 1349.73, 116
5, 13:05:00-000, 1052, 530, 522, 392, 1348.93, 398, 1350.14, 146
5, 13:06:00-000, 1035, 609, 426, 426, 1349.55, 395, 1350.31, 161
5, 13:07:00-000, 6, 6, 0, 20, 1346.65, 0, 0.00, 151
5, 13:08:00-000, 1105, 495, 610, 447, 1347.92, 478, 1349.70, 148
5, 13:09:00-000, 1086, 576, 510, 438, 1349.08, 422, 1349.46, 169
5, 13:10:00-000, 1043, 550, 493, 396, 1348.59, 419, 1349.51, 159
5, 13:11:00-000, 9, 9, 0, 9, 1346.00, 0, 0.00, 135
5, 13:12:00-000, 981, 503, 478, 408, 1348.62, 383, 1349.34, 165
5, 13:13:00-000, 963, 471, 492, 358, 1348.39, 362, 1349.06, 174
5, 13:14:00-000, 1004, 460, 544, 360, 1348.31, 409, 1349.03, 158
5, 13:15:00-000, 1, 1, 0, 16, 1344.81, 54, 1354.55, 134
5, 13:16:00-000, 1014, 505, 509, 413, 1348.32, 421, 1349.12, 151
5, 13:17:00-000, 1128, 604, 524, 400, 1349.24, 401, 1349.63, 167
5, 13:18:00-000, 1040, 501, 539, 396, 1348.51, 443, 1349.71, 147
5, 13:19:00-000, 0, 0, 0, 48, 1345.00, 15, 1355.00, 188
5, 13:20:00-000, 1036, 535, 501, 401, 1348.99, 386, 1349.79, 143
5, 13:21:00-000, 1103, 543, 560, 376, 1348.58, 387, 1349.19, 200
5, 13:22:00-000, 1072, 567, 505, 439, 1349.09, 466, 1349.92, 164
5, 13:23:00-000, 5, 0, 5, 36, 1345.50, 10, 1350.90, 201
5, 13:24:00-000, 1113, 554, 559, 404, 1348.11, 451, 1349.59, 175
5, 13:25:00-000, 996, 516, 480, 362, 1349.05, 348, 1349.26, 178
5, 13:26:00-000, 1053, 471, 582, 418, 1348.25, 434, 1349.20, 180
5, 13:27:00-000, 8, 2, 6, 5, 1346.00, 16, 1355.50, 192
5, 13:28:00-000, 1016, 538, 478, 415, 1349.46, 429, 1350.12, 150
5, 13:29:00-000, 1027, 493, 534, 399, 1348.41, 399, 1349.27, 130
5, 13:30:00-000, 959, 452, 507, 386, 1347.84, 402, 1348.83, 158
5, 13:31:00-000, 0, 0, 0, 28, 1343.82, 18, 1355.00, 125
5, 13:32:00-000, 1074, 540, 534, 459, 1349.24, 441, 1349.66, 147
5, 13:33:00-000, 978, 524, 454, 399, 1349.38, 380, 1349.96, 143
5, 13:34:00-000, 1136, 586, 550, 458, 1348.74, 435, 1349.67, 96
5, 13:35:00-000, 0, 0, 0, 20, 1345.10, 0, 0.00, 134
5, 13:36:00-000, 1021, 482, 539, 382, 1348.90, 458, 1350.36, 178
5, 13:37:00-000, 1037, 550, 487, 408, 1349.43, 367, 1350.08, 176
5, 13:38:00-000, 1092, 567, 525, 452, 1348.45, 383, 1349.56, 146
5, 13:39:00-000, 2, 1, 1, 41, 1344.71, 16, 1355.00, 135
5, 13:40:00-000, 1088, 538, 550, 430, 1348.32, 424, 1349.53, 204
5, 13:41:00-000, 1002, 525, 477, 399, 1349.31, 375, 1349.87, 190
5, 13:42:00-000, 1005, 540, 465, 379, 1349.08, 392, 1350.01, 162
5, 13:43:00-000, 2, 2, 0, 15, 1346.00, 5, 1355.40, 167
5, 13:44:00-000, 1020, 546, 474, 404, 1349.24, 368, 1349.84, 194
5, 13:45:00-000, 977, 428, 549, 373, 1348.16, 440, 1348.96, 129
5, 13:46:00-000, 1022, 500, 522, 396, 1348.76, 396, 1349.23, 168
5, 13:47:00-000, 5, 0, 5, 25, 1345.20, 20, 1354.85, 117
5, 13:48:00-000, 909, 459, 450, 365, 1348.74, 423, 1350.10, 179
5, 13:49:00-000, 983, 528, 455, 383, 1349.42, 354, 1350.03, 94
5, 13:50:00-000, 1150, 616, 534, 447, 1348.85, 428, 1349.75, 113
5, 13:51:00-000, 4, 4, 0, 18, 1346.50, 6, 1356.00, 184
5, 13:52:00-000, 1068, 537, 531, 461, 1348.32, 406, 1349.00, 194
5, 13:53:00-000, 1027, 491, 536, 381, 1348.14, 402, 1348.71, 161
5, 13:54:00-000, 1101, 570, 531, 407, 1349.65, 426, 1350.06, 187
5, 13:55:00-000, 8, 7, 1, 27, 1347.44, 27, 1355.85, 166
5, 13:56:00-000, 1162, 641, 521, 498, 1349.14, 407, 1350.13, 168
5, 13:57:00-000, 989, 523, 466, 409, 1349.62, 381, 1349.95, 187
5, 13:58:00-000, 1008, 535, 473, 376, 1349.53, 390, 1350.31, 173
5, 13:59:00-000, 1, 0, 1, 19, 1346.95, 0, 0.00, 147
5, 14:00:00-000, 1023, 514, 509, 384, 1348.83, 437, 1349.54, 165
5, 14:01:00-000, 1120, 585, 535, 417, 1349.18, 437, 1349.99, 137
5, 14:02:00-000, 1031, 441, 590, 414, 1347.79, 389, 1348.89, 170
5, 14:03:00-000, 0, 0, 0, 12, 1345.00, 11, 1354.00, 153
5, 14:04:00-000, 1061, 548, 513, 402, 1349.35, 486, 1350.48, 204
5, 14:05:00-000, 1065, 538, 527, 424, 1348.56, 438, 1349.27, 151
5, 14:06:00-000, 1085, 577, 508, 423, 1349.16, 402, 1350.05, 140
5, 14:07:00-000, 1, 0, 1, 0, 0.00, 36, 1355.86, 159
5, 14:08:00-000, 1034, 522, 512, 423, 1348.99, 437, 1350.18, 161
5, 14:09:00-000, 966, 537, 429, 387, 1349.23, 371, 1349.89, 180
5, 14:10:00-000, 1094, 579, 515, 435, 1348.83, 418, 1349.55, 123
5, 14:11:00-000, 0, 0, 0, 44, 1345.00, 7, 1356.00, 117
5, 14:12:00-000, 972, 517, 455, 436, 1348.53, 359, 1349.69, 159
5, 14:13:00-000, 1075, 531, 544, 366, 1349.00, 390, 1349.21, 170
5, 14:14:00-000, 970, 463, 507, 415, 1348.09, 395, 1349.15, 137
5, 14:15:00-000, 2, 2, 0, 4, 1345.00, 0, 0.00, 185
5, 14:16:00-000, 957, 481, 476, 380, 1349.37, 412, 1350.73, 137
5, 14:17:00-000, 990, 534, 456, 362, 1349.09, 380, 1349.77, 173
5, 14:18:00-000, 968, 485, 483, 352, 1349.00, 376, 1349.63, 142
5, 14:19:00-000, 3, 0, 3, 7, 1346.00, 14, 1353.78, 170
5, 14:20:00-000, 1047, 534, 513, 439, 1348.52, 409, 1349.61, 178
5, 14:21:00-000, 1003, 500, 503, 410, 1348.77, 386, 1348.87, 183
5, 14:22:00-000, 1030, 550, 480, 378, 1349.88, 389, 1350.60, 133
5, 14:23:00-000, 0, 0, 0, 29, 1346.76, 31, 1356.64, 131
5, 14:24:00-000, 1056, 592, 464, 483, 1349.10, 410, 1350.37, 163
5, 14:25:00-000, 1003, 485, 518, 375, 1348.57, 434, 1349.32, 135
5, 14:26:00-000, 944, 443, 501, 346, 1348.13, 370, 1348.51, 128
5, 14:27:00-000, 1, 1, 0, 12, 1345.00, 9, 1354.00, 150
5, 14:28:00-000, 1061, 556, 505, 409, 1348.54, 422, 1349.55, 156
5, 14:29:00-000, 1069, 536, 533, 413, 1348.33, 432, 1348.82, 140
5, 14:30:00-000, 1073, 516, 557, 397, 1348.66, 482, 1350.24, 183
5, 14:31:00-000, 2, 2, 0, 8, 1346.00, 33, 1357.00, 143
5, 14:32:00-000, 976, 527, 449, 404, 1348.80, 374, 1349.94, 158
5, 14:33:00-000, 1043, 484, 559, 411, 1347.63, 381, 1348.46, 120
5, 14:34:00-000, 1065, 603, 462, 477, 1349.22, 441, 1350.77, 153
5, 14:35:00-000, 10, 1, 9, 29, 1345.55, 23, 1355.56, 136
5, 14:36:00-000, 1121, 596, 525, 443, 1349.59, 426, 1350.32, 144
5, 14:37:00-000, 1181, 589, 592, 462, 1348.86, 438, 1349.53, 173
5, 14:38:00-000, 1017, 518, 499, 405, 1348.58, 440, 1349.79, 176
5, 14:39:00-000, 0, 0, 0, 27, 1345.00, 7, 1356.00, 180
5, 14:40:00-000, 1044, 572, 472, 462, 1349.80, 453, 1351.00, 126
5, 14:41:00-000, 999, 468, 531, 323, 1349.12, 403, 1349.95, 130
5, 14:42:00-000, 1022, 516, 506, 385, 1349.28, 374, 1349.90, 106
5, 14:43:00-000, 4, 2, 2, 10, 1346.60, 12, 1355.00, 212
5, 14:44:00-000, 1106, 571, 535, 472, 1348.53, 496, 1350.39, 166
5, 14:45:00-000, 1019, 519, 500, 362, 1348.99, 402, 1349.63, 131
5, 14:46:00-000, 978, 528, 450, 436, 1349.04, 353, 1350.28, 144
5, 14:47:00-000, 0, 0, 0, 24, 1344.75, 1, 1356.00, 165
5, 14:48:00-000, 988, 474, 514, 356, 1347.81, 389, 1349.05, 157
5, 14:49:00-000, 1106, 569, 537, 431, 1348.72, 401, 1349.10, 158
5, 14:50:00-000, 992, 493, 499, 402, 1348.97, 423, 1350.22, 181
5, 14:51:00-000, 3, 2, 1, 42, 1344.80, 3, 1356.00, 182
5, 14:52:00-000, 1029, 557, 472, 399, 1349.59, 421, 1350.64, 133
5, 14:53:00-000, 1031, 512, 519, 381, 1349.03, 396, 1349.42, 125
5, 14:54:00-000, 945, 457, 488, 366, 1348.33, 389, 1349.49, 185
5, 14:55:00-000, 7, 0, 7, 15, 1345.00, 1, 1352.00, 130
5, 14:56:00-000, 1085, 538, 547, 440, 1348.64, 485, 1349.82, 156
5, 14:57:00-000, 1063, 551, 512, 432, 1349.03, 425, 1350.26, 151
5, 14:58:00-000, 1134, 564, 570, 433, 1348.23, 454, 1349.06, 140
5, 14:59:00-000, 5, 0, 5, 12, 1344.00, 5, 1350.60, 135
5, 15:00:00-000, 1061, 513, 548, 409, 1348.99, 478, 1349.72, 178
5, 15:01:00-000, 977, 488, 489, 366, 1348.27, 349, 1348.43, 150
5, 15:02:00-000, 1017, 505, 512, 415, 1348.25, 377, 1349.38, 151
5, 15:03:00-000, 3, 3, 0, 38, 1345.49, 24, 1355.00, 164
5, 15:04:00-000, 1045, 544, 501, 412, 1348.75, 374, 1349.37, 147
5, 15:05:00-000, 1049, 539, 510, 394, 1349.31, 439, 1350.00, 203
5, 15:06:00-000, 958, 491, 467, 385, 1349.04, 393, 1349.71, 141
5, 15:07:00-000, 2, 2, 0, 45, 1345.44, 0, 0.00, 189
5, 15:08:00-000, 974, 492, 482, 386, 1348.37, 375, 1349.48, 122
5, 15:09:00-000, 1062, 560, 502, 402, 1349.06, 418, 1349.23, 154
5, 15:10:00-000, 1071, 547, 524, 447, 1348.49, 430, 1349.83, 150
5, 15:11:00-000, 3, 1, 2, 42, 1345.33, 5, 1354.00, 131
5, 15:12:00-000, 1038, 537, 501, 418, 1348.39, 400, 1350.03, 167
5, 15:13:00-000, 976, 502, 474, 396, 1349.23, 395, 1349.84, 158
5, 15:14:00-000, 1028, 509, 519, 440, 1348.81, 414, 1349.57, 136
5, 15:15:00-000, 0, 0, 0, 6, 1345.00, 11, 1356.00, 116
5, 15:16:00-000, 1002, 493, 509, 379, 1348.79, 403, 1349.69, 141
5, 15:17:00-000, 1111, 593, 518, 415, 1349.40, 398, 1349.67, 163
5, 15:18:00-000, 1006, 471, 535, 362, 1348.20, 461, 1349.40, 160
5, 15:19:00-000, 3, 1, 2, 37, 1345.10, 39, 1355.33, 187
5, 15:20:00-000, 1019, 508, 511, 424, 1348.22, 437, 1350.00, 133
5, 15:21:00-000, 924, 484, 440, 360, 1348.12, 342, 1348.64, 114
5, 15:22:00-000, 1113, 585, 528, 410, 1349.57, 460, 1350.48, 131
5, 15:23:00-000, 6, 1, 5, 72, 1345.30, 21, 1355.47, 136
5, 15:24:00-000, 989, 511, 478, 379, 1348.99, 383, 1349.90, 142
5, 15:25:00-000, 1016, 495, 521, 379, 1348.29, 416, 1348.65, 185
5, 15:26:00-000, 1126, 590, 536, 457, 1348.97, 464, 1350.05, 133
5, 15:27:00-000, 1, 0, 1, 0, 0.00, 0, 0.00, 146
5, 15:28:00-000, 1077, 596, 481, 449, 1349.06, 406, 1349.86, 174
5, 15:29:00-000, 937, 473, 464, 399, 1348.26, 391, 1349.11, 126
5, 15:30:00-000, 999, 559, 440, 393, 1349.35, 364, 1349.84, 189
5, 15:31:00-000, 7, 1, 6, 34, 1345.82, 0, 0.00, 119
5, 15:32:00-000, 1070, 583, 487, 430, 1349.66, 394, 1350.18, 129
5, 15:33:00-000, 974, 510, 464, 383, 1349.69, 376, 1350.40, 189
5, 15:34:00-000, 1054, 565, 489, 449, 1349.25, 409, 1350.65, 137
5, 15:35:00-000, 4, 1, 3, 31, 1347.10, 32, 1356.59, 156
5, 15:36:00-000, 1034, 491, 543, 445, 1348.30, 441, 1349.48, 135
5, 15:37:00-000, 1002, 532, 470, 359, 1349.66, 383, 1350.24, 144
5, 15:38:00-000, 1054, 550, 504, 440, 1348.65, 442, 1349.32, 124
5, 15:39:00-000, 2, 2, 0, 26, 1346.00, 13, 1357.00, 151
5, 15:40:00-000, 1073, 570, 503, 378, 1349.68, 326, 1349.03, 165
5, 15:41:00-000, 964, 500, 464, 340, 1349.03, 320, 1348.86, 226
5, 15:42:00-000, 1086, 564, 522, 392, 1348.74, 376, 1349.00, 230
5, 15:43:00-000, 4, 1, 3, 1, 1350.00, 3, 1351.33, 226
5, 15:44:00-000, 989, 470, 519, 328, 1349.19, 394, 1349.56, 275
5, 15:45:00-000, 1033, 512, 521, 351, 1349.84, 347, 1349.48, 178
5, 15:46:00-000, 979, 501, 478, 376, 1349.26, 351, 1349.39, 226
5, 15:47:00-000, 2, 2, 0, 0, 0.00, 0, 0.00, 240
5, 15:48:00-000, 998, 501, 497, 386, 1348.96, 391, 1349.84, 207
5, 15:49:00-000, 1018, 498, 520, 336, 1348.79, 356, 1348.43, 152
5, 15:50:00-000, 987, 521, 466, 359, 1349.69, 340, 1349.92, 211
5, 15:51:00-000, 2, 2, 0, 7, 1347.29, 0, 0.00, 207
5, 15:52:00-000, 1142, 583, 559, 454, 1348.65, 430, 1348.92, 253
5, 15:53:00-000, 1049, 525, 524, 382, 1349.00, 393, 1349.35, 182
5, 15:54:00-000, 984, 442, 542, 333, 1348.67, 426, 1349.15, 205
5, 15:55:00-000, 3, 0, 3, 0, 0.00, 2, 1350.00, 196
5, 15:56:00-000, 1106, 580, 526, 465, 1349.74, 404, 1350.16, 169
5, 15:57:00-000, 970, 490, 480, 376, 1348.80, 354, 1349.20, 176
5, 15:58:00-000, 1011, 467, 544, 347, 1348.56, 381, 1348.56, 212
5, 15:59:00-000, 2, 2, 0, 11, 1347.64, 0, 0.00, 166
5, 16:00:00-000, 1096, 561, 535, 437, 1349.13, 427, 1349.86, 201
5, 16:01:00-000, 991, 495, 496, 361, 1349.15, 419, 1349.60, 182
5, 16:02:00-000, 986, 446, 540, 395, 1347.81, 427, 1348.55, 180
5, 16:03:00-000, 6, 5, 1, 1, 1349.00, 24, 1355.00, 115
5, 16:04:00-000, 1042, 556, 486, 395, 1348.86, 402, 1349.38, 140
5, 16:05:00-000, 1027, 510, 517, 360, 1348.14, 382, 1348.90, 167
5, 16:06:00-000, 1080, 560, 520, 456, 1348.36, 449, 1349.59, 183
5, 16:07:00-000, 2, 2, 0, 20, 1345.40, 35, 1354.68, 144
5, 16:08:00-000, 1020, 526, 494, 427, 1348.64, 368, 1348.92, 142
5, 16:09:00-000, 1037, 566, 471, 421, 1348.56, 372, 1349.24, 164
5, 16:10:00-000, 1043, 513, 530, 426, 1348.54, 413, 1349.18, 209
5, 16:11:00-000, 8, 2, 6, 1, 1351.00, 26, 1354.46, 141
5, 16:12:00-000, 1087, 548, 539, 436, 1348.60, 430, 1349.60, 180
5, 16:13:00-000, 989, 541, 448, 413, 1348.90, 373, 1349.81, 117
5, 16:14:00-000, 1027, 542, 485, 398, 1348.64, 392, 1349.26, 179
5, 16:15:00-000, 1, 0, 1, 23, 1345.00, 25, 1355.00, 145
5, 16:16:00-000, 1031, 527, 504, 444, 1349.63, 414, 1351.01, 140
5, 16:17:00-000, 1014, 527, 487, 403, 1348.94, 387, 1349.36, 135
5, 16:18:00-000, 1126, 584, 542, 455, 1349.15, 449, 1349.69, 134
5, 16:19:00-000, 2, 0, 2, 7, 1346.00, 4, 1354.25, 142
5, 16:20:00-000, 977, 533, 444, 418, 1348.90, 371, 1349.69, 164
5, 16:21:00-000, 1021, 516, 505, 382, 1348.28, 404, 1349.28, 183
5, 16:22:00-000, 1115, 575, 540, 391, 1348.74, 430, 1349.27, 146
5, 16:23:00-000, 1, 0, 1, 18, 1346.00, 1, 1352.00, 179
5, 16:24:00-000, 1077, 562, 515, 398, 1349.32, 436, 1349.90, 189
5, 16:25:00-000, 1084, 572, 512, 424, 1348.95, 393, 1349.32, 193
5, 16:26:00-000, 1012, 512, 500, 412, 1348.97, 453, 1350.54, 173
5, 16:27:00-000, 3, 0, 3, 0, 0.00, 5, 1354.80, 176
5, 16:28:00-000, 959, 503, 456, 391, 1348.91, 363, 1349.67, 132
5, 16:29:00-000, 1096, 612, 484, 400, 1349.17, 385, 1349.60, 170
5, 16:30:00-000, 0, 0, 0, 0, 0.00, 0, 0.00, 1
6, 12:20:00-000, 6950, 3478, 3472, 1547, 1347.91, 1719, 1348.46, 0
6, 12:21:00-000, 0, 0, 0, 80, 1347.00, 58, 1354.00, 0
6, 12:22:00-000, 0, 0, 0, 79, 1346.62, 144, 1354.03, 0
6, 12:23:00-000, 0, 0, 0, 58, 1346.00, 18, 1355.00, 0
6, 12:24:00-000, 0, 0, 0, 105, 1346.00, 106, 1355.00, 0
6, 12:25:00-000, 0, 0, 0, 45, 1346.00, 0, 0.00, 0
6, 12:26:00-000, 0, 0, 0, 0, 0.00, 15, 1355.00, 0
6, 12:28:00-000, 0, 0, 0, 20, 1345.00, 52, 1355.00, 0
6, 12:29:00-000, 0, 0, 0, 0, 0.00, 11, 1355.00, 0
6, 12:30:00-000, 0, 0, 0, 0, 0.00, 26, 1355.00, 0
6, 12:31:00-000, 0, 0, 0, 14, 1345.00, 6, 1355.00, 0
6, 12:32:00-000, 0, 0, 0, 23, 1345.00, 73, 1355.78, 0
6, 12:33:00-000, 0, 0, 0, 21, 1345.00, 4, 1356.00, 0
6, 12:34:00-000, 0, 0, 0, 73, 1345.00, 39, 1356.00, 0
6, 12:35:00-000, 0, 0, 0, 47, 1345.00, 0, 0.00, 0
6, 12:37:00-000, 0, 0, 0, 10, 1345.00, 0, 0.00, 0
6, 12:38:00-000, 0, 0, 0, 8, 1345.00, 13, 1356.00, 0
6, 12:40:00-000, 0, 0, 0, 0, 0.00, 8, 1356.00, 139
6, 12:41:00-000, 0, 0, 0, 2, 1345.00, 4, 1356.00, 112
6, 12:42:00-000, 0, 0, 0, 0, 0.00, 2, 1356.00, 113
6, 12:43:00-000, 0, 0, 0, 0, 0.00, 25, 1356.00, 113
6, 12:44:00-000, 0, 0, 0, 8, 1345.00, 15, 1356.00, 112
6, 12:45:00-000, 0, 0, 0, 0, 0.00, 47, 1356.00, 125
6, 12:46:00-000, 0, 0, 0, 1, 1344.00, 8, 1356.00, 108
6, 12:47:00-000, 0, 0, 0, 32, 1344.00, 18, 1357.00, 132
6, 12:48:00-000, 0, 0, 0, 0, 0.00, 0, 0.00, 130
6, 12:49:00-000, 0, 0, 0, 0, 0.00, 0, 0.00, 112
6, 12:50:00-000, 0, 0, 0, 0, 0.00, 20, 1357.00, 129
6, 12:51:00-000, 0, 0, 0, 0, 0.00, 0, 0.00, 116
6, 12:52:00-000, 0, 0, 0, 0, 0.00, 0, 0.00, 124
6, 12:53:00-000, 0, 0, 0, 0, 0.00, 0, 0.00, 126
6, 12:54:00-000, 0, 0, 0, 0, 0.00, 39, 1357.00, 95
6, 12:55:00-000, 0, 0, 0, 0, 0.00, 0, 0.00, 115
6, 12:56:00-000, 0, 0, 0, 0, 0.00, 0, 0.00, 99
6, 12:57:00-000, 0, 0, 0, 0, 0.00, 0, 0.00, 104
6, 12:58:00-000, 0, 0, 0, 0, 0.00, 5, 1358.00, 99
6, 12:59:00-000, 0, 0, 0, 0, 0.00, 4, 1358.00, 95
6, 15:40:00-000, 6953, 3421, 3532, 1567, 1347.83, 1674, 1348.55, 0
6, 15:41:00-000, 0, 0, 0, 60, 1347.00, 64, 1354.00, 0
6, 15:42:00-000, 0, 0, 0, 85, 1346.00, 90, 1354.00, 0
6, 15:43:00-000, 0, 0, 0, 38, 1346.00, 63, 1354.00, 0
6, 15:44:00-000, 0, 0, 0, 71, 1346.00, 42, 1354.00, 0
6, 15:45:00-000, 0, 0, 0, 0, 0.00, 53, 1355.00, 0
6, 15:46:00-000, 0, 0, 0, 33, 1346.00, 81, 1355.00, 0
6, 15:47:00-000, 0, 0, 0, 0, 0.00, 42, 1355.00, 0
6, 15:48:00-000, 0, 0, 0, 14, 1345.00, 49, 1355.00, 0
6, 15:49:00-000, 0, 0, 0, 30, 1345.00, 0, 0.00, 0
6, 15:54:00-000, 0, 0, 0, 83, 1345.00, 11, 1356.00, 0
6, 15:55:00-000, 0, 0, 0, 29, 1345.00, 0, 0.00, 0
6, 15:57:00-000, 0, 0, 0, 12, 1345.00, 0, 0.00, 0
6, 15:58:00-000, 0, 0, 0, 61, 1345.00, 0, 0.00, 0
6, 16:00:00-000, 0, 0, 0, 0, 0.00, 20, 1356.00, 122
6, 16:01:00-000, 0, 0, 0, 0, 0.00, 0, 0.00, 150
6, 16:02:00-000, 0, 0, 0, 16, 1345.00, 0, 0.00, 134
6, 16:03:00-000, 0, 0, 0, 0, 0.00, 0, 0.00, 144
6, 16:04:00-000, 0, 0, 0, 0, 0.00, 24, 1356.00, 130
6, 16:05:00-000, 0, 0, 0, 0, 0.00, 0, 0.00, 133
6, 16:06:00-000, 0, 0, 0, 0, 0.00, 0, 0.00, 143
6, 16:07:00-000, 0, 0, 0, 0, 0.00, 0, 0.00, 130
6, 16:08:00-000, 0, 0, 0, 0, 0.00, 53, 1356.00, 143
6, 16:09:00-000, 0, 0, 0, 0, 0.00, 23, 1356.00, 108
6, 16:10:00-000, 0, 0, 0, 10, 1344.00, 18, 1356.00, 110
6, 16:11:00-000, 0, 0, 0, 0, 0.00, 4, 1356.00, 117
6, 16:12:00-000, 0, 0, 0, 13, 1344.00, 0, 0.00, 130
6, 16:13:00-000, 0, 0, 0, 3, 1344.00, 0, 0.00, 126
6, 16:14:00-000, 0, 0, 0, 18, 1344.00, 0, 0.00, 108
6, 16:15:00-000, 0, 0, 0, 8, 1344.00, 0, 0.00, 110
6, 16:16:00-000, 0, 0, 0, 0, 0.00, 0, 0.00, 113
6, 16:17:00-000, 0, 0, 0, 0, 0.00, 0, 0.00, 122
6, 16:18:00-000, 0, 0, 0, 0, 0.00, 0, 0.00, 105
6, 16:19:00-000, 0, 0, 0, 0, 0.00, 0, 0.00, 112
6, 16:20:00-000, 17, 10, 7, 6, 1348.00, 4, 1353.00, 1
7, 09:07:00-000, 18081, 14044, 4037, 0, 0.00, 0, 0.00, 18081
7, 09:17:00-000, 3114, 1149, 1965, 8, 1352.50, 8, 1352.00, 3098
7, 09:23:00-000, 6733, 2937, 3796, 0, 0.00, 0, 0.00, 6733
7, 09:25:00-000, 1018, 18, 1000, 0, 0.00, 0, 0.00, 1018
7, 09:26:00-000, 12153, 3565, 8588, 2, 1348.00, 2, 1346.00, 12149
7, 09:31:00-000, 1579, 1570, 9, 0, 0.00, 0, 0.00, 1579
7, 09:37:00-000, 3441, 2108, 1333, 1, 1350.00, 1, 1350.00, 3439
7, 09:38:00-000, 10449, 3264, 7185, 0, 0.00, 0, 0.00, 10449
7, 09:39:00-000, 1525, 15, 1510, 0, 0.00, 0, 0.00, 1525
7, 09:40:00-000, 4517, 2339, 2178, 7, 1352.71, 7, 1352.00, 4503
7, 09:41:00-000, 1067, 7, 1060, 0, 0.00, 0, 0.00, 1067
7, 09:45:00-000, 8106, 3429, 4677, 0, 0.00, 0, 0.00, 8106
7, 09:46:00-000, 9254, 5073, 4181, 3, 1349.67, 3, 1347.00, 9248
7, 09:54:00-000, 1110, 10, 1100, 0, 0.00, 0, 0.00, 1110
7, 09:55:00-000, 8696, 4352, 4344, 0, 0.00, 0, 0.00, 8696
7, 09:56:00-000, 3646, 1410, 2236, 0, 0.00, 0, 0.00, 3646
7, 09:57:00-000, 3856, 1656, 2200, 0, 0.00, 0, 0.00, 3684
7, 09:58:00-000, 12641, 3528, 9113, 1, 1352.00, 1, 1352.00, 12811
7, 09:59:00-000, 13232, 9806, 3426, 13, 1351.15, 13, 1352.69, 13206
7, 10:00:00-000, 992, 990, 2, 0, 0.00, 0, 0.00, 992
7, 10:02:00-000, 920, 920, 0, 0, 0.00, 0, 0.00, 920
7, 10:04:00-000, 8422, 5406, 3016, 81, 1353.34, 81, 1351.27, 8260
7, 10:05:00-000, 5249, 4488, 761, 0, 0.00, 0, 0.00, 5249
7, 10:06:00-000, 1270, 243, 1027, 66, 1353.07, 66, 1352.13, 1138
7, 10:07:00-000, 12993, 7350, 5643, 17, 1349.24, 17, 1347.12, 12959
7, 10:08:00-000, 16917, 7267, 9650, 73, 1350.92, 73, 1349.15, 16771
7, 10:09:00-000, 4549, 927, 3622, 0, 0.00, 0, 0.00, 4549
7, 10:10:00-000, 11086, 2973, 8113, 0, 0.00, 0, 0.00, 11086
7, 10:11:00-000, 6053, 4698, 1355, 1, 1347.00, 1, 1351.00, 6051
7, 10:12:00-000, 1213, 13, 1200, 13, 1353.92, 13, 1352.00, 1187
7, 10:13:00-000, 8360, 3251, 5109, 6, 1349.00, 3, 1348.00, 8351
7, 10:14:00-000, 2902, 2879, 23, 9, 1355.56, 12, 1352.00, 2881
7, 10:15:00-000, 9625, 4016, 5609, 0, 0.00, 0, 0.00, 8380
7, 10:16:00-000, 1425, 1422, 3, 2, 1352.50, 2, 1352.50, 2666
7, 10:17:00-000, 2993, 1870, 1123, 12, 1355.08, 12, 1352.00, 2969
7, 10:18:00-000, 9931, 8410, 1521, 1, 1349.00, 1, 1351.00, 9929
7, 10:19:00-000, 660, 650, 10, 0, 0.00, 0, 0.00, 660
7, 10:20:00-000, 556, 6, 550, 2, 1349.00, 2, 1352.00, 552
7, 10:21:00-000, 2697, 2686, 11, 4, 1355.50, 4, 1352.50, 2689
7, 10:22:00-000, 5451, 2945, 2506, 0, 0.00, 0, 0.00, 5451
7, 10:23:00-000, 9754, 4652, 5102, 1, 1352.00, 1, 1352.00, 9378
7, 10:24:00-000, 4827, 800, 4027, 90, 1349.00, 90, 1348.30, 5021
7, 10:25:00-000, 5839, 3055, 2784, 13, 1348.00, 13, 1349.46, 5813
7, 10:26:00-000, 4960, 30, 4930, 0, 0.00, 0, 0.00, 4960
7, 10:27:00-000, 1650, 1640, 10, 0, 0.00, 0, 0.00, 1650
7, 10:28:00-000, 10221, 4491, 5730, 1, 1349.00, 1, 1349.00, 10219
7, 10:32:00-000, 470, 20, 450, 0, 0.00, 0, 0.00, 470
7, 10:33:00-000, 7099, 2595, 4504, 26, 1348.00, 26, 1349.23, 7047
7, 10:34:00-000, 19235, 12628, 6607, 28, 1346.28, 12, 1352.08, 19195
7, 10:35:00-000, 15833, 10039, 5794, 4, 1348.00, 20, 1347.75, 15809
7, 10:36:00-000, 13846, 7468, 6378, 28, 1349.60, 29, 1351.38, 13789
7, 10:37:00-000, 7477, 3288, 4189, 78, 1351.30, 74, 1353.30, 7325
7, 10:38:00-000, 3, 0, 3, 0, 0.00, 3, 1346.67, 0
7, 10:39:00-000, 3737, 3680, 57, 1, 1349.00, 1, 1348.00, 3735
7, 10:40:00-000, 3536, 2050, 1486, 0, 0.00, 0, 0.00, 3536
7, 10:41:00-000, 3826, 2517, 1309, 0, 0.00, 0, 0.00, 3826
7, 10:42:00-000, 17476, 11753, 5723, 1, 1350.00, 1, 1350.00, 17474
7, 10:43:00-000, 9498, 7374, 2124, 61, 1347.32, 47, 1348.25, 9390
7, 10:44:00-000, 4269, 878, 3391, 47, 1347.04, 61, 1347.04, 4161
7, 10:45:00-000, 11577, 3212, 8365, 5, 1351.00, 5, 1351.60, 11567
7, 10:46:00-000, 8631, 4461, 4170, 1, 1352.00, 1, 1350.00, 8629
7, 10:47:00-000, 1092, 6, 1086, 6, 1349.00, 6, 1346.00, 1080
7, 10:48:00-000, 8660, 1490, 7170, 0, 0.00, 0, 0.00, 8660
7, 10:49:00-000, 3645, 1391, 2254, 0, 0.00, 0, 0.00, 3645
7, 10:50:00-000, 9694, 7013, 2681, 42, 1352.07, 42, 1352.45, 9610
7, 10:51:00-000, 7526, 2081, 5445, 0, 0.00, 0, 0.00, 7526
7, 10:52:00-000, 5153, 2726, 2427, 65, 1352.93, 65, 1350.73, 5023
7, 10:54:00-000, 13909, 9528, 4381, 0, 0.00, 0, 0.00, 13909
7, 10:55:00-000, 8387, 6533, 1854, 0, 0.00, 0, 0.00, 8387
7, 10:58:00-000, 15081, 7238, 7843, 4, 1350.75, 4, 1350.00, 15073
7, 10:59:00-000, 5685, 3580, 2105, 0, 0.00, 0, 0.00, 5681
7, 11:00:00-000, 11178, 6365, 4813, 7, 1354.14, 7, 1351.00, 11168
7, 11:01:00-000, 12119, 4518, 7601, 3, 1348.33, 3, 1349.67, 11014
7, 11:02:00-000, 4807, 3780, 1027, 62, 1347.99, 62, 1349.30, 5782
7, 11:03:00-000, 5934, 1422, 4512, 6, 1350.00, 6, 1348.83, 5922
7, 11:04:00-000, 5909, 4637, 1272, 0, 0.00, 0, 0.00, 5909
7, 11:05:00-000, 1359, 1344, 15, 4, 1351.00, 4, 1352.00, 1351
7, 11:06:00-000, 792, 20, 772, 13, 1350.77, 2, 1351.00, 777
7, 11:07:00-000, 7822, 1966, 5856, 0, 0.00, 11, 1347.09, 7811
7, 11:08:00-000, 1332, 30, 1302, 12, 1346.00, 4, 1351.00, 1316
7, 11:09:00-000, 8, 0, 8, 0, 0.00, 8, 1349.38, 0
7, 11:10:00-000, 10044, 5251, 4793, 0, 0.00, 0, 0.00, 10044
7, 11:11:00-000, 6735, 2304, 4431, 1, 1351.00, 1, 1351.00, 6733
7, 11:12:00-000, 8308, 3550, 4758, 0, 0.00, 0, 0.00, 8308
7, 11:13:00-000, 5516, 2789, 2727, 0, 0.00, 0, 0.00, 5516
7, 11:14:00-000, 12701, 4392, 8309, 17, 1346.12, 17, 1348.65, 12667
7, 11:15:00-000, 5313, 1779, 3534, 3, 1348.00, 3, 1349.00, 5307
7, 11:16:00-000, 4007, 1712, 2295, 15, 1347.00, 15, 1345.47, 3977
7, 11:17:00-000, 2376, 1384, 992, 26, 1345.50, 26, 1344.38, 2324
7, 11:18:00-000, 3432, 1948, 1484, 3, 1346.00, 3, 1347.00, 3426
7, 11:19:00-000, 1314, 10, 1304, 10, 1344.40, 10, 1350.10, 1294
7, 11:20:00-000, 13015, 7751, 5264, 5, 1348.00, 5, 1350.60, 13005
7, 11:21:00-000, 1825, 1504, 321, 7, 1348.14, 7, 1352.00, 1811
7, 11:22:00-000, 6836, 2543, 4293, 0, 0.00, 0, 0.00, 6836
7, 11:23:00-000, 6362, 3795, 2567, 0, 0.00, 0, 0.00, 6362
7, 11:24:00-000, 5134, 1461, 3673, 15, 1345.93, 15, 1348.20, 5104
7, 11:25:00-000, 13853, 5901, 7952, 45, 1348.70, 45, 1351.71, 13763
7, 11:26:00-000, 9735, 4270, 5465, 4, 1349.00, 4, 1346.00, 9727
7, 11:27:00-000, 3502, 3480, 22, 0, 0.00, 0, 0.00, 3502
7, 11:28:00-000, 8099, 4714, 3385, 31, 1353.16, 30, 1352.30, 8038
7, 11:29:00-000, 12593, 6129, 6464, 15, 1350.80, 16, 1350.81, 11841
7, 11:30:00-000, 5505, 3249, 2256, 13, 1347.23, 13, 1351.30, 6200
7, 11:31:00-000, 17347, 11178, 6169, 0, 0.00, 0, 0.00, 17347
7, 11:32:00-000, 5107, 1764, 3343, 23, 1351.61, 23, 1352.00, 5061
7, 11:33:00-000, 7680, 6139, 1541, 46, 1347.30, 46, 1347.58, 7588
7, 11:34:00-000, 11416, 2626, 8790, 11, 1347.91, 11, 1346.82, 11394
7, 11:35:00-000, 8194, 5511, 2683, 1, 1350.00, 1, 1351.00, 8192
7, 11:36:00-000, 5834, 2803, 3031, 10, 1350.60, 10, 1350.00, 5814
7, 11:37:00-000, 1199, 1191, 8, 1, 1351.00, 1, 1350.00, 1197
7, 11:40:00-000, 22024, 11507, 10517, 10, 1349.60, 18, 1352.78, 21996
7, 11:41:00-000, 3457, 1720, 1737, 8, 1353.00, 0, 0.00, 3449
7, 11:42:00-000, 6697, 2690, 4007, 41, 1350.75, 41, 1351.63, 6615
7, 11:43:00-000, 3346, 2622, 724, 0, 0.00, 0, 0.00, 3346
7, 11:44:00-000, 14928, 5310, 9618, 13, 1350.92, 13, 1350.92, 14902
7, 11:45:00-000, 7321, 1169, 6152, 5, 1348.00, 5, 1348.00, 7311
7, 11:46:00-000, 1239, 1230, 9, 4, 1348.00, 4, 1346.00, 1231
7, 11:47:00-000, 3315, 1078, 2237, 5, 1349.00, 5, 1349.80, 3305
7, 11:48:00-000, 1256, 1250, 6, 0, 0.00, 0, 0.00, 1256
7, 11:50:00-000, 14683, 8125, 6558, 31, 1349.00, 19, 1348.63, 14633
7, 11:51:00-000, 4002, 1533, 2469, 3, 1351.67, 15, 1345.00, 3984
7, 11:52:00-000, 9711, 1882, 7829, 8, 1351.25, 8, 1351.88, 9695
7, 11:53:00-000, 6017, 2425, 3592, 5, 1351.60, 5, 1351.00, 6007
7, 11:54:00-000, 4093, 43, 4050, 5, 1355.00, 5, 1350.40, 4083
7, 11:55:00-000, 1054, 4, 1050, 0, 0.00, 0, 0.00, 1054
7, 11:57:00-000, 7127, 5319, 1808, 0, 0.00, 0, 0.00, 7127
7, 11:58:00-000, 5176, 1608, 3568, 1, 1349.00, 1, 1350.00, 5174
7, 11:59:00-000, 1160, 1151, 9, 1, 1353.00, 1, 1351.00, 1158
7, 12:00:00-000, 5869, 2696, 3173, 2, 1354.00, 2, 1352.00, 5865
7, 12:01:00-000, 6516, 85, 6431, 26, 1350.69, 26, 1351.69, 6464
7, 12:02:00-000, 2627, 214, 2413, 2, 1351.00, 2, 1352.00, 1092
7, 12:03:00-000, 2982, 32, 2950, 10, 1353.00, 10, 1352.00, 4493
7, 12:04:00-000, 4127, 1967, 2160, 7, 1353.86, 7, 1352.00, 4113
7, 12:05:00-000, 10725, 9127, 1598, 14, 1351.07, 14, 1351.36, 10695
7, 12:06:00-000, 7334, 142, 7192, 0, 0.00, 0, 0.00, 7336
7, 12:07:00-000, 7296, 5225, 2071, 1, 1350.00, 1, 1351.00, 7294
7, 12:08:00-000, 11080, 8717, 2363, 2, 1352.00, 2, 1351.00, 10206
7, 12:09:00-000, 3374, 574, 2800, 0, 0.00, 0, 0.00, 4244
7, 12:11:00-000, 1247, 7, 1240, 0, 0.00, 0, 0.00, 1247
7, 12:12:00-000, 16371, 11301, 5070, 15, 1351.27, 17, 1351.35, 16339
7, 12:13:00-000, 6524, 3451, 3073, 4, 1351.75, 2, 1353.00, 6518
7, 12:14:00-000, 4641, 3065, 1576, 0, 0.00, 0, 0.00, 3901
7, 12:15:00-000, 13821, 9246, 4575, 1, 1348.00, 1, 1350.00, 14353
7, 12:16:00-000, 12836, 6739, 6097, 5, 1351.00, 8, 1351.38, 13029
7, 12:17:00-000, 3, 3, 0, 3, 1352.00, 0, 0.00, 0
7, 12:18:00-000, 4283, 1196, 3087, 2, 1346.50, 2, 1349.00, 4279
7, 12:19:00-000, 1308, 1301, 7, 1, 1354.00, 1, 1351.00, 1306
7, 12:20:00-000, 1813, 1800, 13, 0, 0.00, 0, 0.00, 1405
7, 12:21:00-000, 0, 0, 0, 0, 0.00, 0, 0.00, 408
7, 12:22:00-000, 989, 980, 9, 0, 0.00, 0, 0.00, 989
7, 12:23:00-000, 7621, 5194, 2427, 18, 1350.28, 18, 1351.94, 7569
7, 12:24:00-000, 7107, 1840, 5267, 0, 0.00, 0, 0.00, 7116
7, 12:25:00-000, 9153, 6020, 3133, 0, 0.00, 0, 0.00, 9160
7, 12:28:00-000, 1521, 10, 1511, 1, 1347.00, 1, 1346.00, 1519
7, 12:30:00-000, 1507, 7, 1500, 0, 0.00, 0, 0.00, 1507
7, 12:31:00-000, 3642, 3590, 52, 0, 0.00, 0, 0.00, 3642
7, 12:33:00-000, 11039, 976, 10063, 1, 1349.00, 1, 1350.00, 9412
7, 12:34:00-000, 0, 0, 0, 0, 0.00, 0, 0.00, 1625
7, 12:36:00-000, 2047, 1053, 994, 0, 0.00, 0, 0.00, 2047
7, 12:41:00-000, 8899, 4021, 4878, 1, 1350.00, 1, 1349.00, 8897
7, 12:42:00-000, 19221, 8213, 11008, 7, 1350.86, 10, 1351.70, 19204
7, 12:43:00-000, 3802, 1894, 1908, 9, 1350.89, 6, 1351.33, 3787
7, 12:47:00-000, 2243, 1344, 899, 0, 0.00, 0, 0.00, 2243
7, 12:48:00-000, 1850, 1830, 20, 18, 1347.83, 18, 1349.39, 1814
7, 12:50:00-000, 3678, 1923, 1755, 11, 1345.73, 11, 1351.82, 3656
7, 12:51:00-000, 5318, 68, 5250, 0, 0.00, 0, 0.00, 5310
7, 12:52:00-000, 14794, 6406, 8388, 27, 1348.74, 13, 1350.00, 14762
7, 12:53:00-000, 3771, 1903, 1868, 0, 0.00, 14, 1348.28, 3757
7, 12:54:00-000, 1871, 1850, 21, 10, 1351.40, 10, 1350.20, 1851
7, 12:55:00-000, 2124, 14, 2110, 0, 0.00, 0, 0.00, 2124
7, 12:56:00-000, 1144, 1140, 4, 0, 0.00, 0, 0.00, 1144
7, 12:57:00-000, 919, 9, 910, 0, 0.00, 0, 0.00, 919
7, 13:00:00-000, 4791, 2341, 2450, 12, 1347.75, 12, 1349.92, 4767
7, 13:01:00-000, 7989, 3575, 4414, 14, 1345.93, 14, 1349.57, 7961
7, 13:02:00-000, 3882, 1846, 2036, 7, 1355.00, 7, 1350.86, 3868
7, 13:03:00-000, 5554, 4177, 1377, 3, 1349.00, 3, 1353.00, 5548
7, 13:04:00-000, 6578, 3795, 2783, 29, 1349.38, 19, 1349.53, 6530
7, 13:05:00-000, 5246, 3892, 1354, 1, 1351.00, 11, 1347.72, 5234
7, 13:06:00-000, 17446, 9134, 8312, 15, 1352.20, 15, 1351.07, 17416
7, 13:07:00-000, 3465, 3420, 45, 0, 0.00, 0, 0.00, 3465
7, 13:08:00-000, 6246, 4561, 1685, 12, 1348.83, 12, 1351.67, 6222
7, 13:09:00-000, 2222, 1463, 759, 6, 1348.00, 1, 1351.00, 2215
7, 13:10:00-000, 4568, 2663, 1905, 8, 1349.87, 13, 1347.69, 4547
7, 13:11:00-000, 5589, 1504, 4085, 1, 1354.00, 1, 1353.00, 5587
7, 13:12:00-000, 10549, 4926, 5623, 1, 1349.00, 1, 1349.00, 10544
7, 13:13:00-000, 18615, 7794, 10821, 43, 1349.67, 43, 1349.20, 18531
7, 13:14:00-000, 8503, 5097, 3406, 12, 1348.50, 14, 1351.71, 8478
7, 13:15:00-000, 2, 2, 0, 2, 1350.00, 0, 0.00, 0
7, 13:16:00-000, 4867, 1957, 2910, 3, 1347.33, 15, 1352.00, 4849
7, 13:17:00-000, 6374, 3393, 2981, 40, 1351.00, 28, 1351.04, 6306
7, 13:18:00-000, 21901, 10226, 11675, 4, 1348.00, 4, 1350.75, 21893
7, 13:19:00-000, 6733, 4650, 2083, 0, 0.00, 0, 0.00, 6733
7, 13:20:00-000, 5804, 3748, 2056, 46, 1347.52, 46, 1348.56, 5712
7, 13:21:00-000, 4155, 3126, 1029, 39, 1349.00, 24, 1350.08, 4092
7, 13:22:00-000, 20694, 10184, 10510, 24, 1348.33, 23, 1350.09, 20647
7, 13:23:00-000, 2815, 1615, 1200, 0, 0.00, 16, 1346.00, 2799
7, 13:24:00-000, 4323, 53, 4270, 0, 0.00, 0, 0.00, 4323
7, 13:25:00-000, 5258, 2362, 2896, 3, 1349.00, 3, 1348.00, 5252
7, 13:26:00-000, 15019, 9432, 5587, 3, 1350.67, 16, 1351.00, 15000
7, 13:27:00-000, 12925, 3502, 9423, 13, 1349.54, 4, 1350.00, 11914
7, 13:28:00-000, 139, 9, 130, 6, 1351.33, 2, 1350.00, 1125
7, 13:29:00-000, 6264, 4676, 1588, 2, 1349.50, 2, 1350.00, 5343
7, 13:30:00-000, 5715, 3183, 2532, 0, 0.00, 0, 0.00, 6632
7, 13:31:00-000, 6803, 3575, 3228, 0, 0.00, 0, 0.00, 5949
7, 13:32:00-000, 5421, 3104, 2317, 31, 1347.87, 31, 1349.87, 6213
7, 13:33:00-000, 2060, 813, 1247, 13, 1351.77, 13, 1351.92, 2034
7, 13:34:00-000, 7421, 1021, 6400, 20, 1349.25, 20, 1346.75, 7381
7, 13:35:00-000, 10781, 7340, 3441, 18, 1347.17, 18, 1350.11, 10745
7, 13:36:00-000, 9516, 3996, 5520, 1, 1348.00, 1, 1349.00, 9514
7, 13:37:00-000, 5664, 2707, 2957, 22, 1353.00, 22, 1352.00, 4317
7, 13:38:00-000, 4354, 3192, 1162, 7, 1350.71, 7, 1352.57, 5643
7, 13:39:00-000, 9472, 2465, 7007, 5, 1346.60, 5, 1347.00, 9462
7, 13:40:00-000, 4935, 2792, 2143, 4, 1355.00, 4, 1351.00, 4927
7, 13:41:00-000, 6895, 2279, 4616, 15, 1346.80, 15, 1347.60, 5922
7, 13:42:00-000, 8639, 5907, 2732, 7, 1351.14, 7, 1351.14, 9568
7, 13:43:00-000, 14353, 9685, 4668, 2, 1349.50, 2, 1351.00, 12985
7, 13:44:00-000, 10969, 6939, 4030, 20, 1350.05, 6, 1350.00, 10874
7, 13:45:00-000, 7017, 329, 6688, 42, 1349.33, 56, 1349.55, 8352
7, 13:46:00-000, 17020, 8453, 8567, 21, 1348.57, 35, 1348.85, 16964
7, 13:47:00-000, 726, 715, 11, 15, 1352.60, 1, 1346.00, 710
7, 13:48:00-000, 6945, 1202, 5743, 20, 1350.05, 20, 1351.05, 6905
7, 13:49:00-000, 528, 500, 28, 19, 1348.00, 19, 1348.63, 490
7, 13:50:00-000, 4298, 2194, 2104, 0, 0.00, 0, 0.00, 4298
7, 13:51:00-000, 9336, 4368, 4968, 0, 0.00, 0, 0.00, 9336
7, 13:52:00-000, 9022, 6281, 2741, 33, 1348.63, 28, 1349.10, 8961
7, 13:53:00-000, 16945, 12551, 4394, 8, 1350.00, 13, 1349.61, 16147
7, 13:54:00-000, 8573, 5903, 2670, 3, 1352.00, 3, 1351.33, 9344
7, 13:55:00-000, 2864, 2252, 612, 2, 1353.50, 2, 1351.00, 2860
7, 13:56:00-000, 9365, 3573, 5792, 12, 1351.42, 12, 1349.92, 9341
7, 13:57:00-000, 16139, 5366, 10773, 4, 1348.00, 4, 1347.00, 16131
7, 13:58:00-000, 3424, 2518, 906, 8, 1355.50, 8, 1353.00, 3408
7, 14:00:00-000, 4596, 36, 4560, 1, 1350.00, 1, 1351.00, 4594
7, 14:01:00-000, 3260, 18, 3242, 2, 1349.00, 2, 1348.50, 3256
7, 14:02:00-000, 3615, 5, 3610, 0, 0.00, 0, 0.00, 2442
7, 14:03:00-000, 5870, 2802, 3068, 0, 0.00, 0, 0.00, 7043
7, 14:04:00-000, 4113, 1338, 2775, 0, 0.00, 0, 0.00, 4113
7, 14:05:00-000, 1452, 2, 1450, 0, 0.00, 0, 0.00, 1452
7, 14:06:00-000, 7685, 4483, 3202, 2, 1350.50, 2, 1349.50, 7681
7, 14:07:00-000, 2666, 2623, 43, 26, 1348.46, 26, 1349.84, 2614
7, 14:08:00-000, 4389, 2809, 1580, 48, 1352.16, 48, 1351.90, 4293
7, 14:09:00-000, 750, 0, 750, 0, 0.00, 0, 0.00, 750
7, 14:10:00-000, 3406, 54, 3352, 18, 1349.00, 36, 1351.83, 3352
7, 14:11:00-000, 10303, 4034, 6269, 21, 1352.24, 3, 1351.00, 10279
7, 14:13:00-000, 4841, 923, 3918, 25, 1349.76, 25, 1351.76, 4791
7, 14:14:00-000, 2669, 1541, 1128, 1, 1349.00, 1, 1347.00, 2667
7, 14:15:00-000, 12641, 8452, 4189, 2, 1350.50, 2, 1351.00, 12637
7, 14:16:00-000, 6709, 4682, 2027, 3, 1349.00, 3, 1349.00, 6703
7, 14:17:00-000, 4147, 1104, 3043, 0, 0.00, 0, 0.00, 4147
7, 14:18:00-000, 5712, 2888, 2824, 13, 1346.15, 13, 1351.23, 5686
7, 14:19:00-000, 5666, 2513, 3153, 17, 1349.65, 17, 1353.53, 5632
7, 14:20:00-000, 1256, 3, 1253, 3, 1347.00, 3, 1350.00, 1250
7, 14:21:00-000, 11130, 5906, 5224, 12, 1350.75, 12, 1350.92, 11106
7, 14:23:00-000, 9954, 7233, 2721, 6, 1350.83, 3, 1351.00, 9933
7, 14:24:00-000, 3, 0, 3, 0, 0.00, 3, 1349.00, 12
7, 14:25:00-000, 5293, 2988, 2305, 0, 0.00, 0, 0.00, 5293
7, 14:26:00-000, 4364, 3130, 1234, 7, 1347.43, 5, 1348.20, 4352
7, 14:27:00-000, 13837, 8799, 5038, 1, 1349.00, 3, 1347.33, 13833
7, 14:28:00-000, 2877, 27, 2850, 0, 0.00, 0, 0.00, 2877
7, 14:29:00-000, 2895, 21, 2874, 4, 1349.00, 4, 1354.00, 2179
7, 14:30:00-000, 8906, 7548, 1358, 0, 0.00, 0, 0.00, 9614
7, 14:31:00-000, 3868, 3545, 323, 2, 1355.00, 2, 1351.00, 3864
7, 14:33:00-000, 8994, 4972, 4022, 9, 1349.00, 9, 1349.67, 8976
7, 14:34:00-000, 3014, 1096, 1918, 1, 1346.00, 0, 0.00, 3013
7, 14:35:00-000, 15879, 4051, 11828, 13, 1349.38, 14, 1346.36, 14393
7, 14:36:00-000, 3183, 2371, 812, 0, 0.00, 0, 0.00, 4642
7, 14:37:00-000, 7875, 5500, 2375, 8, 1349.13, 8, 1349.87, 7859
7, 14:38:00-000, 10955, 7695, 3260, 4, 1347.50, 3, 1352.00, 10948
7, 14:39:00-000, 6472, 4975, 1497, 4, 1350.50, 5, 1350.40, 5168
7, 14:40:00-000, 3625, 904, 2721, 17, 1350.71, 17, 1352.00, 4886
7, 14:41:00-000, 6108, 1554, 4554, 6, 1348.83, 6, 1347.17, 6096
7, 14:42:00-000, 4662, 49, 4613, 16, 1349.87, 20, 1351.45, 4626
7, 14:43:00-000, 15153, 10254, 4899, 5, 1349.80, 1, 1352.00, 15147
7, 14:45:00-000, 2677, 12, 2665, 5, 1349.00, 5, 1348.00, 2667
7, 14:47:00-000, 705, 700, 5, 0, 0.00, 0, 0.00, 705
7, 14:48:00-000, 11045, 4228, 6817, 12, 1348.50, 12, 1350.83, 11021
7, 14:49:00-000, 13353, 5076, 8277, 9, 1346.56, 9, 1351.56, 13335
7, 14:50:00-000, 1592, 12, 1580, 0, 0.00, 0, 0.00, 1592
7, 14:51:00-000, 9787, 3551, 6236, 0, 0.00, 0, 0.00, 8948
7, 14:52:00-000, 2280, 2260, 20, 6, 1355.17, 6, 1352.00, 3107
7, 14:53:00-000, 5782, 1882, 3900, 0, 0.00, 0, 0.00, 5782
7, 14:54:00-000, 13847, 4649, 9198, 7, 1351.00, 7, 1351.86, 12529
7, 14:55:00-000, 9309, 5278, 4031, 0, 0.00, 0, 0.00, 9584
7, 14:56:00-000, 9396, 5557, 3839, 11, 1347.91, 11, 1349.36, 10403
7, 14:57:00-000, 11291, 4428, 6863, 10, 1351.20, 10, 1349.90, 11271
7, 14:58:00-000, 12093, 2625, 9468, 4, 1350.00, 4, 1349.75, 10826
7, 14:59:00-000, 17623, 10173, 7450, 3, 1349.00, 0, 0.00, 18879
7, 15:00:00-000, 15462, 8028, 7434, 31, 1347.97, 34, 1347.58, 15397
7, 15:01:00-000, 7264, 2864, 4400, 12, 1345.00, 12, 1350.25, 7240
7, 15:02:00-000, 9586, 3120, 6466, 13, 1348.84, 13, 1348.61, 9560
7, 15:03:00-000, 5334, 3747, 1587, 0, 0.00, 0, 0.00, 5334
7, 15:04:00-000, 5458, 1009, 4449, 4, 1351.00, 5, 1350.40, 5449
7, 15:05:00-000, 11062, 2784, 8278, 16, 1352.19, 15, 1352.80, 11031
7, 15:06:00-000, 7544, 1124, 6420, 1, 1350.00, 5, 1351.00, 7538
7, 15:07:00-000, 5260, 4584, 676, 5, 1353.00, 1, 1350.00, 5254
7, 15:08:00-000, 6213, 1549, 4664, 18, 1349.11, 18, 1345.11, 6177
7, 15:09:00-000, 7141, 4211, 2930, 6, 1350.00, 5, 1350.80, 7130
7, 15:10:00-000, 6168, 1700, 4468, 46, 1352.64, 47, 1351.59, 6075
7, 15:11:00-000, 11476, 6538, 4938, 2, 1351.00, 2, 1351.00, 9935
7, 15:12:00-000, 5563, 3426, 2137, 28, 1350.35, 28, 1351.32, 7026
7, 15:13:00-000, 23591, 11624, 11967, 5, 1352.80, 5, 1350.00, 23599
7, 15:14:00-000, 16537, 7810, 8727, 6, 1350.17, 6, 1349.00, 16525
7, 15:15:00-000, 5897, 4587, 1310, 0, 0.00, 0, 0.00, 5132
7, 15:16:00-000, 8958, 1184, 7774, 9, 1349.78, 9, 1348.55, 8981
7, 15:17:00-000, 10289, 3843, 6446, 10, 1350.00, 7, 1350.71, 10996
7, 15:18:00-000, 5469, 892, 4577, 12, 1351.00, 15, 1347.13, 5442
7, 15:19:00-000, 13866, 5169, 8697, 1, 1350.00, 1, 1350.00, 13864
7, 15:20:00-000, 1457, 570, 887, 7, 1351.43, 7, 1350.00, 1443
7, 15:21:00-000, 2885, 2874, 11, 4, 1351.00, 4, 1351.50, 2877
7, 15:23:00-000, 2465, 2442, 23, 4, 1349.50, 4, 1352.00, 2457
7, 15:24:00-000, 9355, 5609, 3746, 7, 1354.71, 7, 1351.00, 9337
7, 15:25:00-000, 19166, 11332, 7834, 10, 1349.90, 10, 1349.90, 19150
7, 15:26:00-000, 19151, 14142, 5009, 1, 1348.00, 1, 1352.00, 19149
7, 15:27:00-000, 12407, 3724, 8683, 0, 0.00, 0, 0.00, 12407
7, 15:28:00-000, 17513, 11063, 6450, 30, 1349.20, 30, 1350.00, 17450
7, 15:29:00-000, 3767, 2653, 1114, 0, 0.00, 0, 0.00, 3770
7, 15:30:00-000, 6880, 3922, 2958, 10, 1351.80, 10, 1350.60, 6860
7, 15:31:00-000, 6937, 4618, 2319, 6, 1350.00, 6, 1349.00, 6915
7, 15:32:00-000, 4814, 1357, 3457, 3, 1352.67, 3, 1352.00, 4818
7, 15:36:00-000, 5241, 3985, 1256, 26, 1352.04, 26, 1350.34, 5189
7, 15:37:00-000, 5683, 4386, 1297, 5, 1354.60, 5, 1352.60, 5673
7, 15:39:00-000, 4683, 3466, 1217, 2, 1350.50, 2, 1351.00, 4679
7, 15:42:00-000, 13619, 3706, 9913, 10, 1348.80, 10, 1350.50, 13599
7, 15:43:00-000, 1817, 1790, 27, 0, 0.00, 0, 0.00, 1817
7, 15:44:00-000, 5379, 3308, 2071, 4, 1352.00, 4, 1351.00, 5371
7, 15:46:00-000, 1076, 1070, 6, 0, 0.00, 0, 0.00, 1076
7, 15:47:00-000, 2460, 2440, 20, 0, 0.00, 0, 0.00, 2460
7, 15:48:00-000, 3155, 845, 2310, 0, 0.00, 0, 0.00, 1657
7, 15:49:00-000, 6836, 1429, 5407, 14, 1348.43, 14, 1347.86, 8306
7, 15:50:00-000, 2209, 9, 2200, 0, 0.00, 3, 1352.00, 2206
7, 15:51:00-000, 11190, 6367, 4823, 13, 1351.00, 10, 1350.40, 11167
7, 15:52:00-000, 4191, 2078, 2113, 37, 1348.56, 37, 1351.05, 4117
7, 15:53:00-000, 8168, 4431, 3737, 0, 0.00, 0, 0.00, 8168
7, 15:57:00-000, 4924, 2060, 2864, 0, 0.00, 0, 0.00, 4924
7, 15:58:00-000, 2445, 35, 2410, 20, 1349.00, 20, 1348.35, 2405
7, 15:59:00-000, 8299, 3373, 4926, 0, 0.00, 0, 0.00, 8299
7, 16:00:00-000, 970, 960, 10, 0, 0.00, 0, 0.00, 970
7, 16:02:00-000, 1224, 1210, 14, 0, 0.00, 0, 0.00, 1224
7, 16:03:00-000, 3819, 2422, 1397, 1, 1348.00, 1, 1350.00, 3817
7, 16:04:00-000, 293, 275, 18, 0, 0.00, 0, 0.00, 293
7, 16:05:00-000, 4038, 2476, 1562, 4, 1351.50, 4, 1351.00, 4030
7, 16:06:00-000, 2327, 1908, 419, 0, 0.00, 1, 1351.00, 2326
7, 16:07:00-000, 6064, 3278, 2786, 5, 1350.20, 4, 1349.25, 6055
7, 16:08:00-000, 103, 100, 3, 0, 0.00, 0, 0.00, 103
7, 16:09:00-000, 2503, 946, 1557, 1, 1353.00, 1, 1350.00, 2501
7, 16:10:00-000, 3900, 3035, 865, 0, 0.00, 1, 1351.00, 2861
7, 16:11:00-000, 2462, 1551, 911, 2, 1350.00, 1, 1346.00, 3497
7, 16:12:00-000, 2680, 2660, 20, 0, 0.00, 0, 0.00, 2680
7, 16:13:00-000, 10360, 5134, 5226, 2, 1349.00, 8, 1349.25, 10350
7, 16:14:00-000, 1796, 820, 976, 8, 1350.25, 2, 1352.00, 1786
7, 16:15:00-000, 11339, 8612, 2727, 0, 0.00, 0, 0.00, 11339
7, 16:16:00-000, 11189, 3800, 7389, 6, 1351.00, 6, 1351.00, 11177
7, 16:17:00-000, 6492, 2643, 3849, 56, 1349.29, 56, 1350.75, 6380
7, 16:18:00-000, 14460, 9589, 4871, 8, 1349.00, 8, 1347.50, 14444
7, 16:19:00-000, 7510, 2873, 4637, 17, 1349.23, 17, 1352.06, 7476
7, 16:20:00-000, 3705, 3491, 214, 1, 1356.00, 1, 1350.00, 3503
7, 16:21:00-000, 14481, 10175, 4306, 46, 1348.34, 46, 1348.30, 14589
7, 16:22:00-000, 3608, 2053, 1555, 0, 0.00, 0, 0.00, 3608
7, 16:23:00-000, 3444, 2254, 1190, 21, 1352.52, 21, 1351.57, 3402
7, 16:24:00-000, 6580, 4426, 2154, 25, 1347.08, 27, 1348.81, 6528
7, 16:25:00-000, 8434, 3354, 5080, 7, 1351.71, 5, 1351.00, 7232
7, 16:26:00-000, 12020, 3500, 8520, 34, 1353.14, 34, 1352.41, 13142
7, 16:28:00-000, 3763, 33, 3730, 0, 0.00, 0, 0.00, 3763
7, 16:29:00-000, 3521, 1622, 1899, 0, 0.00, 0, 0.00, 3521
8, 09:07:00-000, 6202, 5307, 895, 0, 0.00, 0, 0.00, 6202
8, 09:17:00-000, 80, 10, 70, 0, 0.00, 0, 0.00, 80
8, 09:23:00-000, 121, 20, 101, 0, 0.00, 0, 0.00, 121
8, 09:25:00-000, 1539, 1530, 9, 0, 0.00, 0, 0.00, 1539
8, 09:26:00-000, 1193, 162, 1031, 0, 0.00, 0, 0.00, 1193
8, 09:37:00-000, 1096, 16, 1080, 0, 0.00, 0, 0.00, 1096
8, 09:38:00-000, 2998, 1717, 1281, 34, 1346.29, 34, 1348.73, 2930
8, 09:39:00-000, 84, 4, 80, 0, 0.00, 0, 0.00, 84
8, 09:40:00-000, 2326, 2301, 25, 0, 0.00, 0, 0.00, 2326
8, 09:45:00-000, 2142, 1209, 933, 0, 0.00, 0, 0.00, 2142
8, 09:46:00-000, 2619, 1732, 887, 3, 1350.00, 3, 1347.00, 2613
8, 09:54:00-000, 838, 809, 29, 0, 0.00, 0, 0.00, 838
8, 09:55:00-000, 2580, 1404, 1176, 13, 1350.54, 13, 1352.69, 2554
8, 09:56:00-000, 415, 167, 248, 27, 1353.41, 27, 1352.00, 361
8, 09:57:00-000, 51, 25, 26, 0, 0.00, 0, 0.00, 51
8, 09:58:00-000, 1820, 1631, 189, 3, 1351.33, 3, 1350.67, 1814
8, 09:59:00-000, 2096, 1569, 527, 1, 1350.00, 1, 1351.00, 2094
8, 10:04:00-000, 1745, 807, 938, 1, 1349.00, 1, 1349.00, 1743
8, 10:05:00-000, 3401, 1603, 1798, 8, 1355.00, 8, 1353.00, 3385
8, 10:07:00-000, 1191, 200, 991, 9, 1351.55, 9, 1351.89, 1173
8, 10:08:00-000, 1312, 1310, 2, 0, 0.00, 0, 0.00, 1312
8, 10:09:00-000, 227, 87, 140, 0, 0.00, 0, 0.00, 227
8, 10:10:00-000, 2938, 860, 2078, 0, 0.00, 0, 0.00, 2938
8, 10:11:00-000, 98, 8, 90, 0, 0.00, 0, 0.00, 98
8, 10:12:00-000, 210, 205, 5, 5, 1352.00, 5, 1351.00, 200
8, 10:13:00-000, 994, 14, 980, 0, 0.00, 0, 0.00, 994
8, 10:14:00-000, 54, 50, 4, 0, 0.00, 0, 0.00, 54
8, 10:15:00-000, 480, 39, 441, 0, 0.00, 0, 0.00, 480
8, 10:17:00-000, 705, 700, 5, 0, 0.00, 0, 0.00, 705
8, 10:18:00-000, 163, 23, 140, 0, 0.00, 0, 0.00, 163
8, 10:19:00-000, 1621, 1521, 100, 0, 0.00, 0, 0.00, 1621
8, 10:22:00-000, 291, 121, 170, 0, 0.00, 0, 0.00, 291
8, 10:23:00-000, 1052, 773, 279, 2, 1352.00, 2, 1351.00, 1048
8, 10:25:00-000, 251, 1, 250, 0, 0.00, 0, 0.00, 251
8, 10:26:00-000, 2409, 2199, 210, 8, 1347.00, 8, 1349.50, 2393
8, 10:27:00-000, 853, 826, 27, 1, 1350.00, 1, 1352.00, 851
8, 10:28:00-000, 2650, 2470, 180, 0, 0.00, 0, 0.00, 2650
8, 10:31:00-000, 110, 102, 8, 2, 1351.00, 2, 1351.00, 106
8, 10:32:00-000, 156, 100, 56, 0, 0.00, 0, 0.00, 156
8, 10:33:00-000, 138, 23, 115, 0, 0.00, 0, 0.00, 138
8, 10:34:00-000, 498, 288, 210, 0, 0.00, 0, 0.00, 498
8, 10:35:00-000, 1725, 340, 1385, 4, 1349.00, 4, 1349.75, 1717
8, 10:36:00-000, 2863, 1944, 919, 3, 1349.67, 3, 1349.33, 2857
8, 10:37:00-000, 892, 882, 10, 2, 1351.00, 2, 1351.00, 888
8, 10:39:00-000, 123, 39, 84, 3, 1350.00, 3, 1345.33, 117
8, 10:40:00-000, 113, 52, 61, 2, 1346.00, 2, 1348.50, 109
8, 10:41:00-000, 821, 43, 778, 0, 0.00, 0, 0.00, 821
8, 10:42:00-000, 2830, 1718, 1112, 0, 0.00, 0, 0.00, 2830
8, 10:43:00-000, 3011, 968, 2043, 0, 0.00, 0, 0.00, 3011
8, 10:44:00-000, 1533, 1337, 196, 3, 1348.00, 3, 1347.67, 1527
8, 10:45:00-000, 2069, 385, 1684, 2, 1348.00, 2, 1348.50, 2065
8, 10:46:00-000, 2448, 901, 1547, 0, 0.00, 0, 0.00, 2447
8, 10:47:00-000, 876, 574, 302, 61, 1348.22, 61, 1347.53, 755
8, 10:48:00-000, 1330, 169, 1161, 57, 1350.76, 57, 1351.68, 1216
8, 10:49:00-000, 1392, 12, 1380, 4, 1349.00, 4, 1351.00, 1384
8, 10:50:00-000, 1595, 81, 1514, 0, 0.00, 0, 0.00, 1595
8, 10:51:00-000, 2012, 1386, 626, 0, 0.00, 0, 0.00, 2012
8, 10:52:00-000, 930, 87, 843, 0, 0.00, 0, 0.00, 930
8, 10:54:00-000, 5613, 2567, 3046, 18, 1352.00, 18, 1353.00, 5577
8, 10:55:00-000, 2141, 926, 1215, 0, 0.00, 0, 0.00, 2058
8, 10:56:00-000, 599, 583, 16, 6, 1351.50, 6, 1351.17, 670
8, 10:58:00-000, 2644, 514, 2130, 0, 0.00, 0, 0.00, 2644
8, 10:59:00-000, 1495, 725, 770, 0, 0.00, 0, 0.00, 799
8, 11:00:00-000, 787, 4, 783, 3, 1348.00, 3, 1348.00, 1477
8, 11:01:00-000, 2005, 95, 1910, 0, 0.00, 0, 0.00, 2005
8, 11:02:00-000, 1691, 110, 1581, 10, 1346.70, 10, 1351.60, 1671
8, 11:03:00-000, 166, 63, 103, 0, 0.00, 0, 0.00, 166
8, 11:04:00-000, 1902, 1623, 279, 7, 1349.86, 7, 1347.71, 1888
8, 11:06:00-000, 272, 114, 158, 0, 0.00, 0, 0.00, 272
8, 11:07:00-000, 1738, 8, 1730, 0, 0.00, 0, 0.00, 1738
8, 11:10:00-000, 1674, 115, 1559, 0, 0.00, 0, 0.00, 1674
8, 11:11:00-000, 2369, 1593, 776, 0, 0.00, 0, 0.00, 2369
8, 11:12:00-000, 1338, 1330, 8, 0, 0.00, 0, 0.00, 1338
8, 11:13:00-000, 95, 15, 80, 0, 0.00, 0, 0.00, 95
8, 11:14:00-000, 1637, 116, 1521, 15, 1345.73, 15, 1350.53, 1607
8, 11:15:00-000, 337, 81, 256, 0, 0.00, 0, 0.00, 337
8, 11:16:00-000, 798, 238, 560, 11, 1351.09, 17, 1352.35, 770
8, 11:17:00-000, 1711, 1696, 15, 15, 1349.33, 9, 1349.78, 1687
8, 11:19:00-000, 789, 780, 9, 0, 0.00, 0, 0.00, 789
8, 11:21:00-000, 1203, 103, 1100, 0, 0.00, 0, 0.00, 1203
8, 11:22:00-000, 246, 87, 159, 13, 1352.54, 13, 1351.23, 220
8, 11:23:00-000, 880, 861, 19, 1, 1352.00, 1, 1351.00, 768
8, 11:24:00-000, 4, 4, 0, 4, 1350.00, 4, 1352.00, 106
8, 11:25:00-000, 1247, 942, 305, 1, 1350.00, 1, 1350.00, 1245
8, 11:26:00-000, 3540, 1648, 1892, 1, 1351.00, 1, 1350.00, 3538
8, 11:27:00-000, 1278, 1191, 87, 0, 0.00, 0, 0.00, 1278
8, 11:28:00-000, 901, 101, 800, 4, 1351.00, 4, 1351.00, 893
8, 11:29:00-000, 847, 87, 760, 0, 0.00, 0, 0.00, 847
8, 11:30:00-000, 59, 51, 8, 8, 1352.38, 8, 1353.00, 43
8, 11:31:00-000, 3759, 306, 3453, 0, 0.00, 0, 0.00, 3759
8, 11:32:00-000, 2931, 408, 2523, 15, 1350.80, 15, 1353.00, 2901
8, 11:33:00-000, 101, 1, 100, 0, 0.00, 0, 0.00, 101
8, 11:34:00-000, 221, 57, 164, 0, 0.00, 0, 0.00, 221
8, 11:35:00-000, 3267, 3169, 98, 0, 0.00, 0, 0.00, 3267
8, 11:36:00-000, 1678, 37, 1641, 0, 0.00, 0, 0.00, 1678
8, 11:40:00-000, 628, 625, 3, 0, 0.00, 0, 0.00, 628
8, 11:41:00-000, 3687, 2481, 1206, 0, 0.00, 0, 0.00, 3398
8, 11:42:00-000, 2848, 720, 2128, 6, 1350.00, 20, 1350.90, 3111
8, 11:43:00-000, 843, 817, 26, 16, 1350.81, 2, 1351.00, 825
8, 11:44:00-000, 1065, 951, 114, 1, 1350.00, 1, 1350.00, 1063
8, 11:45:00-000, 208, 92, 116, 15, 1353.27, 15, 1351.80, 178
8, 11:47:00-000, 1706, 832, 874, 5, 1349.00, 5, 1347.20, 1696
8, 11:50:00-000, 756, 460, 296, 0, 0.00, 0, 0.00, 756
8, 11:51:00-000, 1786, 151, 1635, 1, 1348.00, 1, 1348.00, 1784
8, 11:52:00-000, 303, 164, 139, 0, 0.00, 2, 1353.00, 301
8, 11:53:00-000, 2, 2, 0, 2, 1355.00, 0, 0.00, 0
8, 11:54:00-000, 714, 710, 4, 0, 0.00, 0, 0.00, 714
8, 11:55:00-000, 76, 10, 66, 10, 1347.90, 10, 1350.00, 56
8, 11:57:00-000, 225, 197, 28, 7, 1354.71, 7, 1351.14, 211
8, 11:58:00-000, 58, 54, 4, 4, 1351.00, 4, 1351.00, 50
8, 12:00:00-000, 232, 152, 80, 3, 1352.00, 3, 1351.00, 226
8, 12:01:00-000, 639, 360, 279, 2, 1348.00, 2, 1347.00, 635
8, 12:03:00-000, 825, 800, 25, 0, 0.00, 0, 0.00, 825
8, 12:05:00-000, 104, 100, 4, 0, 0.00, 0, 0.00, 104
8, 12:06:00-000, 1653, 1600, 53, 1, 1348.00, 1, 1349.00, 59
8, 12:07:00-000, 2149, 1031, 1118, 19, 1349.79, 19, 1351.00, 3703
8, 12:08:00-000, 1800, 124, 1676, 4, 1348.00, 4, 1351.25, 1792
8, 12:09:00-000, 21, 20, 1, 0, 0.00, 0, 0.00, 21
8, 12:12:00-000, 4213, 2815, 1398, 5, 1350.80, 5, 1351.00, 3474
8, 12:13:00-000, 3516, 1650, 1866, 1, 1353.00, 1, 1353.00, 4243
8, 12:14:00-000, 1579, 1468, 111, 3, 1350.00, 3, 1349.33, 1573
8, 12:15:00-000, 4269, 2347, 1922, 1, 1349.00, 1, 1347.00, 4267
8, 12:16:00-000, 5849, 2022, 3827, 20, 1350.25, 22, 1351.68, 5807
8, 12:17:00-000, 2, 2, 0, 2, 1353.00, 0, 0.00, 0
8, 12:20:00-000, 758, 739, 19, 10, 1350.90, 19, 1351.47, 729
8, 12:21:00-000, 31, 10, 21, 10, 1353.50, 1, 1347.00, 20
8, 12:22:00-000, 21, 1, 20, 0, 0.00, 0, 0.00, 21
8, 12:23:00-000, 919, 894, 25, 8, 1350.25, 8, 1353.00, 903
8, 12:24:00-000, 388, 182, 206, 0, 0.00, 0, 0.00, 388
8, 12:25:00-000, 361, 102, 259, 0, 0.00, 0, 0.00, 361
8, 12:30:00-000, 877, 7, 870, 0, 0.00, 0, 0.00, 0
8, 12:31:00-000, 1540, 1540, 0, 0, 0.00, 0, 0.00, 2417
8, 12:33:00-000, 1611, 155, 1456, 0, 0.00, 0, 0.00, 1608
8, 12:34:00-000, 208, 4, 204, 4, 1349.00, 4, 1347.00, 203
8, 12:36:00-000, 2466, 1597, 869, 3, 1353.00, 3, 1352.00, 2460
8, 12:40:00-000, 91, 85, 6, 5, 1353.00, 5, 1351.00, 81
8, 12:41:00-000, 2005, 894, 1111, 3, 1348.00, 1, 1349.00, 2001
8, 12:42:00-000, 3561, 1178, 2383, 11, 1348.00, 11, 1351.73, 3539
8, 12:43:00-000, 76, 4, 72, 0, 0.00, 2, 1348.50, 74
8, 12:47:00-000, 256, 250, 6, 0, 0.00, 0, 0.00, 256
8, 12:50:00-000, 88, 79, 9, 9, 1351.22, 9, 1352.00, 70
8, 12:51:00-000, 3382, 2843, 539, 0, 0.00, 0, 0.00, 3382
8, 12:52:00-000, 397, 90, 307, 3, 1348.33, 3, 1351.00, 391
8, 12:53:00-000, 288, 79, 209, 0, 0.00, 0, 0.00, 288
8, 12:55:00-000, 68, 7, 61, 7, 1346.57, 7, 1352.71, 54
8, 12:56:00-000, 771, 33, 738, 0, 0.00, 0, 0.00, 771
8, 12:57:00-000, 1536, 752, 784, 2, 1355.00, 2, 1352.00, 1532
8, 13:00:00-000, 209, 9, 200, 0, 0.00, 0, 0.00, 209
8, 13:01:00-000, 1461, 1248, 213, 3, 1350.67, 3, 1351.00, 1455
8, 13:03:00-000, 263, 250, 13, 0, 0.00, 0, 0.00, 263
8, 13:04:00-000, 1064, 722, 342, 23, 1345.52, 23, 1347.43, 1018
8, 13:05:00-000, 1779, 945, 834, 1, 1352.00, 1, 1352.00, 1777
8, 13:06:00-000, 1835, 421, 1414, 1, 1350.00, 1, 1350.00, 1833
8, 13:07:00-000, 1638, 106, 1532, 0, 0.00, 0, 0.00, 1638
8, 13:08:00-000, 1470, 1460, 10, 0, 0.00, 0, 0.00, 1470
8, 13:10:00-000, 2098, 2003, 95, 7, 1352.00, 7, 1351.00, 2084
8, 13:11:00-000, 1568, 874, 694, 5, 1348.00, 5, 1349.40, 1558
8, 13:12:00-000, 878, 812, 66, 12, 1346.67, 12, 1352.00, 854
8, 13:13:00-000, 2908, 1679, 1229, 8, 1349.50, 8, 1351.87, 2632
8, 13:14:00-000, 226, 66, 160, 2, 1350.00, 2, 1348.50, 482
8, 13:18:00-000, 1871, 1257, 614, 0, 0.00, 0, 0.00, 1871
8, 13:19:00-000, 3648, 2700, 948, 0, 0.00, 0, 0.00, 3648
8, 13:21:00-000, 147, 140, 7, 0, 0.00, 0, 0.00, 147
8, 13:22:00-000, 3333, 1766, 1567, 8, 1347.25, 1, 1348.00, 3324
8, 13:23:00-000, 130, 48, 82, 4, 1346.25, 11, 1346.82, 115
8, 13:24:00-000, 1706, 25, 1681, 0, 0.00, 0, 0.00, 1706
8, 13:25:00-000, 432, 168, 264, 0, 0.00, 0, 0.00, 432
8, 13:26:00-000, 3397, 1930, 1467, 40, 1348.50, 40, 1347.22, 3317
8, 13:27:00-000, 2741, 784, 1957, 8, 1353.87, 8, 1349.88, 2725
8, 13:29:00-000, 89, 80, 9, 0, 0.00, 0, 0.00, 89
8, 13:30:00-000, 621, 105, 516, 11, 1348.00, 11, 1347.91, 599
8, 13:31:00-000, 1224, 1074, 150, 2, 1350.00, 2, 1350.00, 1220
8, 13:32:00-000, 102, 2, 100, 0, 0.00, 0, 0.00, 102
8, 13:34:00-000, 158, 36, 122, 1, 1350.00, 1, 1349.00, 156
8, 13:35:00-000, 107, 12, 95, 0, 0.00, 0, 0.00, 107
8, 13:36:00-000, 2432, 2366, 66, 1, 1352.00, 1, 1351.00, 2430
8, 13:37:00-000, 846, 790, 56, 0, 0.00, 0, 0.00, 846
8, 13:40:00-000, 214, 198, 16, 16, 1352.19, 16, 1351.44, 182
8, 13:41:00-000, 4198, 4170, 28, 0, 0.00, 0, 0.00, 4198
8, 13:42:00-000, 2660, 1594, 1066, 18, 1349.11, 18, 1350.17, 2529
8, 13:43:00-000, 558, 316, 242, 1, 1350.00, 1, 1351.00, 651
8, 13:44:00-000, 1905, 212, 1693, 11, 1349.45, 11, 1348.55, 1883
8, 13:45:00-000, 1184, 72, 1112, 4, 1348.00, 4, 1348.00, 1176
8, 13:46:00-000, 1678, 1056, 622, 0, 0.00, 0, 0.00, 1678
8, 13:47:00-000, 96, 90, 6, 0, 0.00, 0, 0.00, 96
8, 13:48:00-000, 1934, 910, 1024, 45, 1351.60, 45, 1350.86, 1844
8, 13:49:00-000, 85, 80, 5, 0, 0.00, 0, 0.00, 85
8, 13:50:00-000, 148, 4, 144, 4, 1349.00, 4, 1349.00, 140
8, 13:51:00-000, 1118, 8, 1110, 0, 0.00, 0, 0.00, 1118
8, 13:52:00-000, 2388, 2272, 116, 11, 1348.27, 11, 1347.00, 2366
8, 13:53:00-000, 4219, 2274, 1945, 0, 0.00, 0, 0.00, 4219
8, 13:54:00-000, 3163, 2612, 551, 31, 1351.84, 33, 1351.63, 3099
8, 13:55:00-000, 259, 97, 162, 2, 1353.00, 0, 0.00, 257
8, 13:56:00-000, 2280, 2110, 170, 0, 0.00, 0, 0.00, 2280
8, 13:57:00-000, 3583, 899, 2684, 6, 1349.67, 6, 1347.17, 3571
8, 14:00:00-000, 369, 62, 307, 0, 0.00, 0, 0.00, 369
8, 14:01:00-000, 1497, 1490, 7, 0, 0.00, 0, 0.00, 1497
8, 14:02:00-000, 120, 34, 86, 4, 1352.00, 4, 1352.00, 112
8, 14:03:00-000, 1469, 1227, 242, 1, 1352.00, 1, 1349.00, 1467
8, 14:04:00-000, 203, 158, 45, 0, 0.00, 0, 0.00, 203
8, 14:05:00-000, 632, 620, 12, 0, 0.00, 0, 0.00, 632
8, 14:06:00-000, 1242, 298, 944, 4, 1349.00, 7, 1351.00, 1231
8, 14:07:00-000, 635, 5, 630, 3, 1352.00, 0, 0.00, 632
8, 14:08:00-000, 153, 3, 150, 0, 0.00, 0, 0.00, 153
8, 14:09:00-000, 2451, 1390, 1061, 1, 1350.00, 1, 1351.00, 2449
8, 14:11:00-000, 1028, 747, 281, 1, 1349.00, 1, 1350.00, 706
8, 14:12:00-000, 154, 4, 150, 0, 0.00, 0, 0.00, 474
8, 14:13:00-000, 511, 16, 495, 0, 0.00, 0, 0.00, 511
8, 14:14:00-000, 1558, 1427, 131, 27, 1347.22, 27, 1346.37, 1504
8, 14:15:00-000, 746, 16, 730, 0, 0.00, 0, 0.00, 746
8, 14:16:00-000, 871, 73, 798, 3, 1349.00, 3, 1352.00, 865
8, 14:17:00-000, 1080, 324, 756, 3, 1351.00, 3, 1351.00, 1074
8, 14:19:00-000, 1264, 613, 651, 0, 0.00, 0, 0.00, 992
8, 14:20:00-000, 170, 170, 0, 0, 0.00, 0, 0.00, 442
8, 14:21:00-000, 1261, 1240, 21, 0, 0.00, 0, 0.00, 1261
8, 14:23:00-000, 1549, 700, 849, 1, 1349.00, 1, 1349.00, 1547
8, 14:24:00-000, 141, 42, 99, 2, 1349.00, 2, 1351.00, 137
8, 14:25:00-000, 1787, 40, 1747, 40, 1354.42, 40, 1352.62, 1707
8, 14:26:00-000, 135, 37, 98, 1, 1348.00, 1, 1350.00, 133
8, 14:27:00-000, 1334, 1201, 133, 3, 1350.67, 3, 1350.33, 1328
8, 14:28:00-000, 25, 20, 5, 5, 1345.60, 5, 1348.40, 15
8, 14:29:00-000, 22, 21, 1, 1, 1355.00, 1, 1351.00, 20
8, 14:30:00-000, 544, 454, 90, 0, 0.00, 0, 0.00, 544
8, 14:31:00-000, 828, 18, 810, 0, 0.00, 0, 0.00, 828
8, 14:33:00-000, 1602, 1587, 15, 5, 1351.00, 5, 1350.00, 1592
8, 14:34:00-000, 163, 153, 10, 10, 1350.80, 10, 1351.00, 143
8, 14:35:00-000, 4625, 4590, 35, 0, 0.00, 0, 0.00, 4625
8, 14:36:00-000, 668, 13, 655, 0, 0.00, 0, 0.00, 668
8, 14:37:00-000, 298, 68, 230, 1, 1349.00, 1, 1348.00, 237
8, 14:38:00-000, 1641, 1630, 11, 0, 0.00, 0, 0.00, 1700
8, 14:39:00-000, 946, 940, 6, 0, 0.00, 0, 0.00, 946
8, 14:40:00-000, 1887, 17, 1870, 1, 1350.00, 0, 0.00, 1886
8, 14:41:00-000, 58, 7, 51, 0, 0.00, 1, 1349.00, 57
8, 14:42:00-000, 2199, 1117, 1082, 2, 1349.00, 2, 1348.00, 2195
8, 14:43:00-000, 5337, 710, 4627, 0, 0.00, 0, 0.00, 5337
8, 14:45:00-000, 73, 70, 3, 0, 0.00, 0, 0.00, 73
8, 14:46:00-000, 122, 95, 27, 4, 1351.00, 4, 1351.00, 114
8, 14:48:00-000, 854, 4, 850, 0, 0.00, 0, 0.00, 854
8, 14:49:00-000, 2350, 893, 1457, 1, 1349.00, 1, 1349.00, 2348
8, 14:50:00-000, 1539, 1430, 109, 5, 1346.20, 0, 0.00, 1534
8, 14:51:00-000, 991, 125, 866, 0, 0.00, 5, 1349.80, 886
8, 14:52:00-000, 0, 0, 0, 0, 0.00, 0, 0.00, 100
8, 14:53:00-000, 1612, 1600, 12, 0, 0.00, 0, 0.00, 1612
8, 14:54:00-000, 671, 246, 425, 3, 1351.00, 3, 1351.00, 665
8, 14:55:00-000, 308, 100, 208, 0, 0.00, 0, 0.00, 308
8, 14:56:00-000, 2239, 755, 1484, 1, 1353.00, 1, 1351.00, 2237
8, 14:57:00-000, 440, 80, 360, 1, 1349.00, 1, 1348.00, 438
8, 14:58:00-000, 3993, 3858, 135, 0, 0.00, 0, 0.00, 3986
8, 14:59:00-000, 5348, 2452, 2896, 0, 0.00, 0, 0.00, 5355
8, 15:00:00-000, 2921, 1488, 1433, 0, 0.00, 0, 0.00, 2142
8, 15:01:00-000, 359, 179, 180, 0, 0.00, 0, 0.00, 1138
8, 15:02:00-000, 2346, 16, 2330, 0, 0.00, 0, 0.00, 2346
8, 15:04:00-000, 547, 461, 86, 0, 0.00, 0, 0.00, 547
8, 15:05:00-000, 2275, 98, 2177, 2, 1349.00, 2, 1354.00, 2271
8, 15:06:00-000, 1044, 1021, 23, 1, 1350.00, 1, 1350.00, 1042
8, 15:07:00-000, 1490, 5, 1485, 0, 0.00, 0, 0.00, 1490
8, 15:08:00-000, 1901, 1832, 69, 0, 0.00, 4, 1350.00, 1896
8, 15:09:00-000, 2265, 2239, 26, 4, 1350.25, 0, 0.00, 2262
8, 15:11:00-000, 2584, 2501, 83, 0, 0.00, 0, 0.00, 2584
8, 15:12:00-000, 254, 91, 163, 4, 1349.25, 4, 1347.25, 246
8, 15:13:00-000, 3009, 159, 2850, 0, 0.00, 0, 0.00, 3009
8, 15:14:00-000, 2584, 744, 1840, 0, 0.00, 0, 0.00, 2584
8, 15:15:00-000, 915, 111, 804, 4, 1348.00, 4, 1346.75, 886
8, 15:16:00-000, 1909, 823, 1086, 13, 1346.23, 14, 1347.14, 1903
8, 15:17:00-000, 6063, 2825, 3238, 4, 1349.25, 3, 1349.67, 6056
8, 15:18:00-000, 838, 830, 8, 0, 0.00, 0, 0.00, 838
8, 15:19:00-000, 3197, 3030, 167, 1, 1348.00, 1, 1347.00, 3188
8, 15:20:00-000, 0, 0, 0, 0, 0.00, 0, 0.00, 7
8, 15:21:00-000, 357, 19, 338, 10, 1349.00, 10, 1349.50, 337
8, 15:23:00-000, 1562, 2, 1560, 0, 0.00, 0, 0.00, 1562
8, 15:24:00-000, 1778, 126, 1652, 17, 1353.65, 17, 1352.00, 1744
8, 15:25:00-000, 3166, 381, 2785, 2, 1349.00, 2, 1349.00, 3162
8, 15:26:00-000, 2895, 316, 2579, 5, 1350.80, 5, 1349.80, 2885
8, 15:27:00-000, 823, 752, 71, 0, 0.00, 0, 0.00, 823
8, 15:28:00-000, 2367, 2240, 127, 20, 1349.10, 2, 1350.00, 2345
8, 15:29:00-000, 2278, 2255, 23, 5, 1351.00, 23, 1346.78, 2250
8, 15:30:00-000, 629, 456, 173, 4, 1352.00, 5, 1351.00, 620
8, 15:31:00-000, 667, 661, 6, 1, 1351.00, 0, 0.00, 666
8, 15:35:00-000, 485, 475, 10, 0, 0.00, 0, 0.00, 485
8, 15:36:00-000, 79, 70, 9, 0, 0.00, 0, 0.00, 79
8, 15:38:00-000, 796, 6, 790, 0, 0.00, 0, 0.00, 796
8, 15:39:00-000, 24, 4, 20, 0, 0.00, 0, 0.00, 24
8, 15:42:00-000, 90, 52, 38, 6, 1351.00, 6, 1351.00, 78
8, 15:43:00-000, 855, 840, 15, 0, 0.00, 0, 0.00, 855
8, 15:44:00-000, 1381, 1297, 84, 0, 0.00, 0, 0.00, 1381
8, 15:48:00-000, 180, 84, 96, 0, 0.00, 0, 0.00, 180
8, 15:49:00-000, 311, 294, 17, 4, 1350.00, 4, 1353.00, 303
8, 15:51:00-000, 333, 227, 106, 10, 1351.60, 10, 1351.00, 313
8, 15:53:00-000, 958, 848, 110, 0, 0.00, 0, 0.00, 958
8, 15:56:00-000, 203, 99, 104, 6, 1347.67, 6, 1349.33, 191
8, 15:57:00-000, 1612, 22, 1590, 0, 0.00, 0, 0.00, 1612
8, 15:58:00-000, 271, 21, 250, 15, 1347.73, 15, 1352.00, 241
8, 15:59:00-000, 973, 908, 65, 0, 0.00, 0, 0.00, 973
8, 16:00:00-000, 1638, 1607, 31, 6, 1352.33, 6, 1350.17, 1626
8, 16:01:00-000, 902, 12, 890, 2, 1353.00, 2, 1353.00, 898
8, 16:02:00-000, 1511, 1, 1510, 0, 0.00, 0, 0.00, 1511
8, 16:03:00-000, 1559, 1420, 139, 0, 0.00, 0, 0.00, 1559
8, 16:06:00-000, 79, 50, 29, 0, 0.00, 0, 0.00, 79
8, 16:07:00-000, 1231, 1154, 77, 4, 1349.00, 4, 1347.50, 1223
8, 16:09:00-000, 57, 50, 7, 0, 0.00, 0, 0.00, 57
8, 16:10:00-000, 1660, 1660, 0, 0, 0.00, 0, 0.00, 1660
8, 16:12:00-000, 2363, 13, 2350, 0, 0.00, 0, 0.00, 2363
8, 16:13:00-000, 21, 1, 20, 0, 0.00, 0, 0.00, 21
8, 16:14:00-000, 1299, 91, 1208, 28, 1346.93, 28, 1348.93, 1243
8, 16:15:00-000, 1625, 209, 1416, 6, 1352.83, 9, 1351.00, 1610
8, 16:16:00-000, 712, 633, 79, 4, 1351.00, 1, 1350.00, 401
8, 16:17:00-000, 602, 506, 96, 5, 1349.20, 5, 1346.00, 898
8, 16:18:00-000, 2603, 1713, 890, 15, 1346.40, 11, 1350.73, 2577
8, 16:19:00-000, 199, 190, 9, 0, 0.00, 6, 1349.00, 193
8, 16:20:00-000, 106, 6, 100, 2, 1356.00, 0, 0.00, 104
8, 16:21:00-000, 2331, 197, 2134, 11, 1348.91, 11, 1351.73, 2309
8, 16:22:00-000, 1758, 858, 900, 0, 0.00, 0, 0.00, 1758
8, 16:23:00-000, 186, 82, 104, 1, 1347.00, 1, 1346.00, 184
8, 16:24:00-000, 1830, 829, 1001, 12, 1353.75, 12, 1352.00, 1806
8, 16:25:00-000, 3304, 234, 3070, 0, 0.00, 0, 0.00, 3304
8, 16:26:00-000, 758, 506, 252, 10, 1355.60, 10, 1351.90, 738
8, 16:29:00-000, 168, 83, 85, 4, 1355.00, 4, 1349.00, 160
9, 09:07:00-000, 5660, 1520, 4140, 0, 0.00, 0, 0.00, 5070
9, 09:08:00-000, 190, 0, 190, 0, 0.00, 0, 0.00, 780
9, 09:18:00-000, 2061, 901, 1160, 1, 1352.00, 1, 1351.00, 2059
9, 09:23:00-000, 3770, 2930, 840, 0, 0.00, 0, 0.00, 3770
9, 09:25:00-000, 1240, 0, 1240, 0, 0.00, 0, 0.00, 1240
9, 09:26:00-000, 7840, 4280, 3560, 0, 0.00, 0, 0.00, 7840
9, 09:37:00-000, 3710, 2860, 850, 0, 0.00, 0, 0.00, 3710
9, 09:38:00-000, 5750, 3330, 2420, 0, 0.00, 0, 0.00, 5750
9, 09:39:00-000, 780, 0, 780, 0, 0.00, 0, 0.00, 780
9, 09:40:00-000, 690, 690, 0, 0, 0.00, 0, 0.00, 690
9, 09:45:00-000, 5140, 3060, 2080, 0, 0.00, 0, 0.00, 5140
9, 09:46:00-000, 6188, 4480, 1708, 18, 1348.00, 18, 1348.00, 6152
9, 09:54:00-000, 63, 3, 60, 3, 1354.00, 3, 1353.00, 57
9, 09:55:00-000, 7930, 3950, 3980, 0, 0.00, 0, 0.00, 7930
9, 09:56:00-000, 1180, 1180, 0, 0, 0.00, 0, 0.00, 1180
9, 09:57:00-000, 3010, 1100, 1910, 0, 0.00, 0, 0.00, 3010
9, 09:58:00-000, 2470, 1370, 1100, 0, 0.00, 0, 0.00, 2470
9, 09:59:00-000, 10390, 4030, 6360, 0, 0.00, 0, 0.00, 10390
9, 10:00:00-000, 825, 820, 5, 5, 1348.00, 5, 1351.20, 815
9, 10:01:00-000, 1211, 91, 1120, 48, 1354.58, 48, 1352.00, 1115
9, 10:04:00-000, 5502, 972, 4530, 32, 1355.12, 32, 1352.84, 5438
9, 10:05:00-000, 4830, 0, 4830, 0, 0.00, 0, 0.00, 4830
9, 10:07:00-000, 5094, 2080, 3014, 49, 1347.97, 49, 1347.83, 4996
9, 10:08:00-000, 13520, 6100, 7420, 0, 0.00, 0, 0.00, 13520
9, 10:09:00-000, 7215, 2750, 4465, 20, 1346.00, 20, 1348.15, 7175
9, 10:10:00-000, 4203, 2143, 2060, 3, 1349.00, 3, 1352.00, 4197
9, 10:11:00-000, 3810, 1490, 2320, 0, 0.00, 0, 0.00, 3810
9, 10:12:00-000, 3211, 1, 3210, 1, 1352.00, 1, 1352.00, 3209
9, 10:13:00-000, 2820, 0, 2820, 0, 0.00, 0, 0.00, 2820
9, 10:15:00-000, 3560, 800, 2760, 0, 0.00, 0, 0.00, 3560
9, 10:17:00-000, 1100, 1100, 0, 0, 0.00, 0, 0.00, 1100
9, 10:18:00-000, 5632, 2242, 3390, 42, 1352.92, 42, 1353.00, 5548
9, 10:21:00-000, 1970, 0, 1970, 0, 0.00, 0, 0.00, 1970
9, 10:22:00-000, 2778, 1401, 1377, 20, 1352.30, 28, 1351.00, 2730
9, 10:23:00-000, 4518, 2188, 2330, 8, 1353.00, 0, 0.00, 4510
9, 10:24:00-000, 2230, 1330, 900, 0, 0.00, 0, 0.00, 2230
9, 10:25:00-000, 1920, 760, 1160, 0, 0.00, 0, 0.00, 1920
9, 10:26:00-000, 5642, 3150, 2492, 2, 1348.00, 2, 1346.00, 5638
9, 10:27:00-000, 2090, 920, 1170, 0, 0.00, 0, 0.00, 2090
9, 10:28:00-000, 4380, 1190, 3190, 0, 0.00, 0, 0.00, 4380
9, 10:32:00-000, 1290, 1290, 0, 0, 0.00, 0, 0.00, 1290
9, 10:33:00-000, 7996, 4556, 3440, 16, 1353.12, 16, 1352.00, 7964
9, 10:34:00-000, 9073, 4143, 4930, 3, 1352.00, 3, 1351.00, 9067
9, 10:35:00-000, 10590, 8390, 2200, 0, 0.00, 0, 0.00, 9570
9, 10:36:00-000, 12499, 7750, 4749, 9, 1348.00, 9, 1349.00, 13501
9, 10:37:00-000, 2800, 950, 1850, 0, 0.00, 0, 0.00, 2800
9, 10:38:00-000, 1190, 1190, 0, 0, 0.00, 0, 0.00, 1190
9, 10:39:00-000, 2090, 0, 2090, 0, 0.00, 0, 0.00, 2090
9, 10:40:00-000, 820, 0, 820, 0, 0.00, 0, 0.00, 820
9, 10:41:00-000, 3310, 2490, 820, 0, 0.00, 0, 0.00, 3310
9, 10:42:00-000, 11280, 3860, 7420, 0, 0.00, 0, 0.00, 11280
9, 10:43:00-000, 8000, 3190, 4810, 0, 0.00, 0, 0.00, 8000
9, 10:44:00-000, 7239, 3409, 3830, 19, 1353.68, 19, 1352.00, 7201
9, 10:45:00-000, 7112, 4130, 2982, 8, 1347.00, 8, 1348.87, 7096
9, 10:46:00-000, 2860, 1490, 1370, 0, 0.00, 0, 0.00, 2860
9, 10:47:00-000, 2431, 1280, 1151, 11, 1348.00, 11, 1348.73, 2409
9, 10:48:00-000, 7791, 5791, 2000, 31, 1346.71, 19, 1346.63, 7741
9, 10:49:00-000, 12, 0, 12, 0, 0.00, 12, 1345.00, 0
9, 10:50:00-000, 1280, 1280, 0, 0, 0.00, 0, 0.00, 1280
9, 10:51:00-000, 5950, 1960, 3990, 0, 0.00, 0, 0.00, 5950
9, 10:52:00-000, 770, 0, 770, 0, 0.00, 0, 0.00, 770
9, 10:54:00-000, 8724, 3894, 4830, 3, 1352.67, 3, 1352.00, 8718
9, 10:55:00-000, 1720, 760, 960, 0, 0.00, 0, 0.00, 1720
9, 10:58:00-000, 7129, 4145, 2984, 9, 1349.67, 7, 1350.86, 7113
9, 10:59:00-000, 7072, 3380, 3692, 0, 0.00, 2, 1351.00, 7070
9, 11:00:00-000, 2710, 2710, 0, 0, 0.00, 0, 0.00, 2710
9, 11:01:00-000, 8882, 6100, 2782, 2, 1347.00, 2, 1346.00, 8878
9, 11:02:00-000, 5140, 2750, 2390, 0, 0.00, 0, 0.00, 5140
9, 11:03:00-000, 5360, 2840, 2520, 34, 1354.26, 34, 1352.00, 5292
9, 11:04:00-000, 4239, 1186, 3053, 19, 1349.00, 19, 1350.05, 4201
9, 11:07:00-000, 2242, 791, 1451, 32, 1352.28, 32, 1351.19, 2178
9, 11:09:00-000, 1100, 30, 1070, 17, 1355.29, 17, 1353.00, 1066
9, 11:10:00-000, 4572, 2350, 2222, 2, 1349.00, 1, 1349.00, 4569
9, 11:11:00-000, 1691, 870, 821, 0, 0.00, 1, 1348.00, 1690
9, 11:12:00-000, 3160, 2490, 670, 0, 0.00, 0, 0.00, 3160
9, 11:13:00-000, 3200, 2420, 780, 10, 1348.00, 10, 1346.70, 3180
9, 11:14:00-000, 5035, 835, 4200, 5, 1352.00, 5, 1352.00, 5025
9, 11:15:00-000, 2180, 2180, 0, 0, 0.00, 0, 0.00, 2180
9, 11:16:00-000, 7805, 2297, 5508, 25, 1348.52, 25, 1348.48, 7755
9, 11:19:00-000, 3150, 1000, 2150, 0, 0.00, 0, 0.00, 3150
9, 11:20:00-000, 8374, 2224, 6150, 14, 1350.00, 14, 1352.00, 8346
9, 11:21:00-000, 3060, 1500, 1560, 0, 0.00, 0, 0.00, 3060
9, 11:22:00-000, 2412, 1310, 1102, 2, 1348.00, 7, 1352.14, 2403
9, 11:23:00-000, 4285, 3305, 980, 5, 1355.00, 0, 0.00, 4280
9, 11:24:00-000, 990, 990, 0, 0, 0.00, 0, 0.00, 0
9, 11:25:00-000, 5280, 0, 5280, 0, 0.00, 0, 0.00, 6270
9, 11:26:00-000, 860, 0, 860, 0, 0.00, 0, 0.00, 860
9, 11:27:00-000, 4318, 2210, 2108, 8, 1348.00, 8, 1348.75, 4302
9, 11:28:00-000, 7434, 2444, 4990, 15, 1354.86, 15, 1353.00, 7404
9, 11:29:00-000, 1000, 1000, 0, 0, 0.00, 0, 0.00, 1000
9, 11:30:00-000, 1045, 5, 1040, 5, 1355.00, 5, 1351.00, 1035
9, 11:31:00-000, 12110, 6240, 5870, 0, 0.00, 0, 0.00, 10710
9, 11:32:00-000, 8128, 4158, 3970, 12, 1353.17, 12, 1351.00, 9504
9, 11:33:00-000, 4296, 1574, 2722, 26, 1347.73, 26, 1347.81, 4244
9, 11:34:00-000, 8290, 7000, 1290, 0, 0.00, 0, 0.00, 8290
9, 11:35:00-000, 3940, 1510, 2430, 0, 0.00, 0, 0.00, 3940
9, 11:36:00-000, 2480, 2480, 0, 0, 0.00, 0, 0.00, 2480
9, 11:37:00-000, 1620, 840, 780, 0, 0.00, 0, 0.00, 1620
9, 11:40:00-000, 6230, 3760, 2470, 0, 0.00, 0, 0.00, 6230
9, 11:41:00-000, 4740, 1040, 3700, 0, 0.00, 0, 0.00, 4740
9, 11:42:00-000, 3930, 860, 3070, 0, 0.00, 0, 0.00, 3930
9, 11:43:00-000, 5440, 4510, 930, 0, 0.00, 0, 0.00, 5440
9, 11:44:00-000, 2140, 720, 1420, 0, 0.00, 0, 0.00, 2140
9, 11:45:00-000, 2311, 1, 2310, 1, 1356.00, 1, 1350.00, 2309
9, 11:46:00-000, 2477, 1320, 1157, 12, 1346.00, 12, 1347.50, 2453
9, 11:47:00-000, 893, 890, 3, 3, 1347.00, 3, 1346.00, 887
9, 11:48:00-000, 1090, 0, 1090, 0, 0.00, 0, 0.00, 1090
9, 11:50:00-000, 2470, 788, 1682, 10, 1351.10, 10, 1350.80, 2450
9, 11:51:00-000, 1530, 0, 1530, 0, 0.00, 0, 0.00, 1530
9, 11:52:00-000, 3010, 730, 2280, 0, 0.00, 0, 0.00, 3010
9, 11:54:00-000, 4660, 2180, 2480, 0, 0.00, 0, 0.00, 4660
9, 11:55:00-000, 1050, 1050, 0, 0, 0.00, 0, 0.00, 1050
9, 11:57:00-000, 8714, 2027, 6687, 27, 1351.63, 27, 1350.59, 8660
9, 11:58:00-000, 2050, 1140, 910, 0, 0.00, 0, 0.00, 2050
9, 12:00:00-000, 2400, 2400, 0, 0, 0.00, 0, 0.00, 2400
9, 12:01:00-000, 2120, 840, 1280, 0, 0.00, 0, 0.00, 2120
9, 12:02:00-000, 4855, 1546, 3309, 45, 1350.73, 54, 1351.63, 4756
9, 12:03:00-000, 3854, 2727, 1127, 37, 1351.05, 28, 1351.64, 3789
9, 12:05:00-000, 5278, 888, 4390, 8, 1348.25, 8, 1354.00, 5262
9, 12:06:00-000, 8753, 4203, 4550, 3, 1353.00, 3, 1352.00, 8747
9, 12:07:00-000, 12070, 4580, 7490, 0, 0.00, 0, 0.00, 12070
9, 12:08:00-000, 5470, 3600, 1870, 0, 0.00, 0, 0.00, 5470
9, 12:09:00-000, 2460, 930, 1530, 0, 0.00, 0, 0.00, 2460
9, 12:10:00-000, 1543, 3, 1540, 3, 1356.00, 3, 1353.00, 1537
9, 12:11:00-000, 1250, 1250, 0, 0, 0.00, 0, 0.00, 1250
9, 12:12:00-000, 8060, 3430, 4630, 0, 0.00, 0, 0.00, 8060
9, 12:13:00-000, 4667, 2610, 2057, 7, 1346.00, 7, 1349.57, 4653
9, 12:14:00-000, 3646, 6, 3640, 6, 1350.00, 6, 1352.00, 3634
9, 12:15:00-000, 9960, 3610, 6350, 0, 0.00, 0, 0.00, 9960
9, 12:16:00-000, 6510, 3480, 3030, 0, 0.00, 0, 0.00, 6510
9, 12:18:00-000, 1472, 1460, 12, 12, 1345.33, 12, 1349.33, 1448
9, 12:21:00-000, 1220, 0, 1220, 0, 0.00, 0, 0.00, 1220
9, 12:23:00-000, 2740, 1670, 1070, 0, 0.00, 0, 0.00, 2740
9, 12:24:00-000, 3070, 1520, 1550, 0, 0.00, 0, 0.00, 3070
9, 12:25:00-000, 4583, 2220, 2363, 3, 1347.00, 3, 1349.33, 4577
9, 12:33:00-000, 2090, 920, 1170, 0, 0.00, 0, 0.00, 2090
9, 12:34:00-000, 1190, 1190, 0, 0, 0.00, 0, 0.00, 1190
9, 12:36:00-000, 4021, 2250, 1771, 1, 1348.00, 1, 1350.00, 4019
9, 12:41:00-000, 7491, 3231, 4260, 1, 1349.00, 1, 1352.00, 7489
9, 12:42:00-000, 3530, 1280, 2250, 0, 0.00, 0, 0.00, 3530
9, 12:43:00-000, 610, 0, 610, 0, 0.00, 0, 0.00, 610
9, 12:44:00-000, 5302, 2752, 2550, 2, 1351.00, 2, 1352.00, 5298
9, 12:45:00-000, 1470, 1470, 0, 0, 0.00, 0, 0.00, 1470
9, 12:47:00-000, 1200, 0, 1200, 0, 0.00, 0, 0.00, 1200
9, 12:50:00-000, 2470, 1600, 870, 0, 0.00, 0, 0.00, 2470
9, 12:51:00-000, 6760, 5580, 1180, 0, 0.00, 0, 0.00, 6760
9, 12:52:00-000, 6970, 2450, 4520, 0, 0.00, 0, 0.00, 6970
9, 12:53:00-000, 2430, 1280, 1150, 0, 0.00, 0, 0.00, 2430
9, 12:54:00-000, 2300, 2300, 0, 0, 0.00, 0, 0.00, 2300
9, 12:55:00-000, 3630, 2590, 1040, 0, 0.00, 0, 0.00, 3630
9, 12:56:00-000, 3410, 1320, 2090, 0, 0.00, 0, 0.00, 3410
9, 13:00:00-000, 4490, 4490, 0, 0, 0.00, 0, 0.00, 4490
9, 13:01:00-000, 7515, 6610, 905, 5, 1348.00, 5, 1348.40, 7505
9, 13:02:00-000, 2275, 15, 2260, 15, 1355.66, 15, 1353.00, 2245
9, 13:03:00-000, 2120, 2120, 0, 0, 0.00, 0, 0.00, 2120
9, 13:04:00-000, 6630, 3976, 2654, 30, 1349.30, 30, 1348.56, 6570
9, 13:05:00-000, 5661, 3651, 2010, 11, 1345.64, 11, 1348.82, 5639
9, 13:06:00-000, 7250, 4480, 2770, 0, 0.00, 0, 0.00, 7250
9, 13:07:00-000, 1040, 1040, 0, 0, 0.00, 0, 0.00, 1040
9, 13:08:00-000, 1605, 795, 810, 14, 1351.14, 15, 1352.00, 1576
9, 13:09:00-000, 1231, 1, 1230, 1, 1355.00, 0, 0.00, 1230
9, 13:10:00-000, 4732, 4710, 22, 22, 1347.00, 5, 1351.00, 4705
9, 13:11:00-000, 2047, 2030, 17, 0, 0.00, 17, 1348.41, 2030
9, 13:13:00-000, 4420, 3210, 1210, 0, 0.00, 0, 0.00, 4420
9, 13:14:00-000, 2370, 2370, 0, 0, 0.00, 0, 0.00, 2370
9, 13:16:00-000, 4534, 1424, 3110, 4, 1353.00, 4, 1352.00, 4526
9, 13:17:00-000, 4021, 981, 3040, 7, 1351.14, 7, 1352.00, 4007
9, 13:18:00-000, 6471, 5691, 780, 1, 1352.00, 1, 1352.00, 6469
9, 13:19:00-000, 3680, 2260, 1420, 0, 0.00, 0, 0.00, 3680
9, 13:20:00-000, 859, 59, 800, 14, 1351.86, 33, 1352.00, 812
9, 13:21:00-000, 2589, 2589, 0, 19, 1355.00, 0, 0.00, 2570
9, 13:22:00-000, 12011, 4582, 7429, 41, 1345.82, 41, 1347.66, 11929
9, 13:23:00-000, 3942, 2060, 1882, 2, 1346.00, 2, 1351.00, 3938
9, 13:24:00-000, 4313, 1473, 2840, 33, 1354.39, 33, 1351.00, 4247
9, 13:25:00-000, 2440, 0, 2440, 0, 0.00, 0, 0.00, 2440
9, 13:26:00-000, 8868, 6348, 2520, 21, 1353.43, 21, 1352.00, 8826
9, 13:27:00-000, 8430, 3890, 4540, 0, 0.00, 0, 0.00, 8430
9, 13:30:00-000, 931, 1, 930, 1, 1350.00, 1, 1352.00, 929
9, 13:31:00-000, 3130, 870, 2260, 0, 0.00, 0, 0.00, 3130
9, 13:32:00-000, 4857, 1377, 3480, 7, 1352.43, 7, 1352.14, 4843
9, 13:34:00-000, 3270, 3270, 0, 0, 0.00, 0, 0.00, 3270
9, 13:35:00-000, 3600, 1660, 1940, 0, 0.00, 0, 0.00, 3600
9, 13:36:00-000, 4200, 1570, 2630, 0, 0.00, 0, 0.00, 4200
9, 13:37:00-000, 760, 0, 760, 0, 0.00, 0, 0.00, 760
9, 13:38:00-000, 2800, 2800, 0, 0, 0.00, 0, 0.00, 2800
9, 13:39:00-000, 4290, 2710, 1580, 0, 0.00, 0, 0.00, 4290
9, 13:40:00-000, 1402, 1400, 2, 2, 1346.00, 2, 1353.00, 1398
9, 13:41:00-000, 8176, 2290, 5886, 6, 1348.00, 6, 1346.00, 8164
9, 13:42:00-000, 5430, 1570, 3860, 0, 0.00, 0, 0.00, 5430
9, 13:43:00-000, 4040, 810, 3230, 0, 0.00, 0, 0.00, 4040
9, 13:44:00-000, 3490, 1340, 2150, 0, 0.00, 0, 0.00, 3490
9, 13:45:00-000, 10466, 2196, 8270, 4, 1349.50, 4, 1352.00, 9618
9, 13:46:00-000, 7612, 4240, 3372, 2, 1348.00, 2, 1350.00, 8448
9, 13:47:00-000, 3052, 1532, 1520, 2, 1352.00, 2, 1352.00, 3048
9, 13:48:00-000, 680, 0, 680, 0, 0.00, 0, 0.00, 680
9, 13:49:00-000, 730, 0, 730, 0, 0.00, 0, 0.00, 730
9, 13:50:00-000, 2135, 15, 2120, 8, 1354.75, 8, 1352.00, 2119
9, 13:51:00-000, 2330, 1240, 1090, 0, 0.00, 0, 0.00, 2330
9, 13:52:00-000, 6320, 1540, 4780, 0, 0.00, 0, 0.00, 6320
9, 13:53:00-000, 13260, 7610, 5650, 0, 0.00, 0, 0.00, 13260
9, 13:54:00-000, 4310, 2230, 2080, 0, 0.00, 0, 0.00, 4310
9, 13:55:00-000, 3894, 2204, 1690, 4, 1354.00, 4, 1353.00, 3886
9, 13:56:00-000, 3740, 700, 3040, 0, 0.00, 0, 0.00, 3740
9, 13:57:00-000, 11740, 7540, 4200, 0, 0.00, 0, 0.00, 11740
9, 14:00:00-000, 2087, 17, 2070, 6, 1351.67, 17, 1352.00, 2064
9, 14:01:00-000, 3671, 1111, 2560, 11, 1355.45, 0, 0.00, 3660
9, 14:02:00-000, 2780, 2780, 0, 0, 0.00, 0, 0.00, 2780
9, 14:03:00-000, 5520, 3190, 2330, 0, 0.00, 0, 0.00, 5520
9, 14:04:00-000, 1180, 1170, 10, 10, 1348.00, 10, 1348.50, 1160
9, 14:05:00-000, 5375, 5340, 35, 35, 1349.00, 35, 1345.25, 5305
9, 14:06:00-000, 2970, 970, 2000, 0, 0.00, 0, 0.00, 2970
9, 14:07:00-000, 3340, 1140, 2200, 0, 0.00, 0, 0.00, 3340
9, 14:08:00-000, 4669, 849, 3820, 14, 1351.86, 16, 1351.69, 4639
9, 14:09:00-000, 2, 2, 0, 2, 1350.00, 0, 0.00, 0
9, 14:10:00-000, 1150, 0, 1150, 0, 0.00, 0, 0.00, 1150
9, 14:11:00-000, 6950, 5340, 1610, 0, 0.00, 0, 0.00, 6950
9, 14:13:00-000, 7657, 4317, 3340, 7, 1355.00, 7, 1352.00, 7643
9, 14:14:00-000, 2085, 1220, 865, 5, 1348.00, 5, 1350.60, 2075
9, 14:15:00-000, 4620, 3940, 680, 0, 0.00, 0, 0.00, 4620
9, 14:16:00-000, 2070, 2070, 0, 0, 0.00, 0, 0.00, 2070
9, 14:17:00-000, 3680, 3680, 0, 0, 0.00, 0, 0.00, 3680
9, 14:19:00-000, 2240, 1100, 1140, 0, 0.00, 0, 0.00, 2240
9, 14:20:00-000, 1221, 1220, 1, 1, 1345.00, 1, 1352.00, 1219
9, 14:21:00-000, 6568, 2723, 3845, 12, 1349.42, 32, 1351.56, 6524
9, 14:22:00-000, 39, 39, 0, 20, 1355.45, 0, 0.00, 19
9, 14:23:00-000, 2570, 2570, 0, 0, 0.00, 0, 0.00, 2570
9, 14:25:00-000, 910, 910, 0, 0, 0.00, 0, 0.00, 910
9, 14:26:00-000, 6089, 4420, 1669, 22, 1347.00, 22, 1346.68, 6045
9, 14:27:00-000, 10050, 5480, 4570, 0, 0.00, 0, 0.00, 10050
9, 14:29:00-000, 1180, 1180, 0, 0, 0.00, 0, 0.00, 1180
9, 14:30:00-000, 7406, 4010, 3396, 29, 1349.00, 29, 1346.96, 5848
9, 14:31:00-000, 4000, 1170, 2830, 0, 0.00, 0, 0.00, 5500
9, 14:32:00-000, 1190, 1190, 0, 0, 0.00, 0, 0.00, 1190
9, 14:33:00-000, 880, 880, 0, 0, 0.00, 0, 0.00, 880
9, 14:34:00-000, 1290, 1290, 0, 0, 0.00, 0, 0.00, 1290
9, 14:35:00-000, 3420, 1250, 2170, 0, 0.00, 0, 0.00, 3420
9, 14:36:00-000, 2053, 2050, 3, 3, 1347.00, 3, 1349.00, 2047
9, 14:37:00-000, 3860, 1390, 2470, 0, 0.00, 0, 0.00, 3860
9, 14:38:00-000, 6691, 1681, 5010, 1, 1351.00, 1, 1352.00, 6689
9, 14:39:00-000, 2970, 0, 2970, 0, 0.00, 0, 0.00, 2970
9, 14:40:00-000, 1027, 844, 183, 35, 1350.00, 35, 1349.08, 957
9, 14:42:00-000, 1950, 1950, 0, 0, 0.00, 0, 0.00, 1950
9, 14:43:00-000, 7660, 3610, 4050, 0, 0.00, 0, 0.00, 7660
9, 14:45:00-000, 1067, 1060, 7, 7, 1349.00, 7, 1349.00, 1053
9, 14:46:00-000, 3909, 2531, 1378, 18, 1350.50, 18, 1351.28, 3873
9, 14:47:00-000, 1410, 0, 1410, 0, 0.00, 0, 0.00, 1410
9, 14:48:00-000, 7299, 3567, 3732, 12, 1353.08, 12, 1351.00, 7275
9, 14:49:00-000, 10540, 7420, 3120, 0, 0.00, 0, 0.00, 10540
9, 14:50:00-000, 3681, 1031, 2650, 1, 1351.00, 1, 1352.00, 3679
9, 14:51:00-000, 3100, 2250, 850, 0, 0.00, 0, 0.00, 3100
9, 14:52:00-000, 1050, 0, 1050, 0, 0.00, 0, 0.00, 1050
9, 14:53:00-000, 3110, 2450, 660, 0, 0.00, 0, 0.00, 3110
9, 14:54:00-000, 2480, 730, 1750, 0, 0.00, 0, 0.00, 2480
9, 14:55:00-000, 7322, 5602, 1720, 22, 1353.27, 22, 1353.00, 7278
9, 14:56:00-000, 2050, 0, 2050, 0, 0.00, 0, 0.00, 2050
9, 14:57:00-000, 9170, 1250, 7920, 20, 1350.50, 20, 1349.75, 9130
9, 14:58:00-000, 11780, 4290, 7490, 0, 0.00, 0, 0.00, 11780
9, 14:59:00-000, 8920, 890, 8030, 0, 0.00, 0, 0.00, 8920
9, 15:00:00-000, 7330, 4640, 2690, 18, 1347.00, 18, 1346.33, 7294
9, 15:01:00-000, 4650, 2020, 2630, 0, 0.00, 0, 0.00, 4650
9, 15:02:00-000, 4946, 6, 4940, 6, 1351.33, 6, 1352.00, 4934
9, 15:04:00-000, 1560, 1560, 0, 0, 0.00, 0, 0.00, 1560
9, 15:05:00-000, 821, 1, 820, 1, 1352.00, 1, 1352.00, 819
9, 15:06:00-000, 3586, 6, 3580, 6, 1351.00, 6, 1352.00, 3574
9, 15:07:00-000, 3970, 1520, 2450, 0, 0.00, 0, 0.00, 3970
9, 15:08:00-000, 1374, 4, 1370, 4, 1350.00, 4, 1352.00, 1366
9, 15:09:00-000, 5684, 4660, 1024, 24, 1345.00, 24, 1346.33, 5636
9, 15:11:00-000, 3900, 2670, 1230, 0, 0.00, 0, 0.00, 3900
9, 15:12:00-000, 6264, 4040, 2224, 4, 1346.00, 4, 1346.75, 5356
9, 15:13:00-000, 6082, 2272, 3810, 2, 1352.00, 2, 1352.00, 6978
9, 15:14:00-000, 4110, 770, 3340, 0, 0.00, 0, 0.00, 4110
9, 15:15:00-000, 3340, 2350, 990, 0, 0.00, 3, 1351.00, 3337
9, 15:16:00-000, 1023, 1023, 0, 3, 1351.00, 0, 0.00, 1020
9, 15:17:00-000, 1590, 1590, 0, 0, 0.00, 0, 0.00, 1590
9, 15:18:00-000, 6256, 1660, 4596, 36, 1347.83, 15, 1345.60, 6205
9, 15:19:00-000, 10071, 6490, 3581, 0, 0.00, 21, 1345.62, 8960
9, 15:20:00-000, 2626, 1506, 1120, 36, 1347.28, 36, 1347.63, 3644
9, 15:21:00-000, 2457, 907, 1550, 7, 1354.29, 7, 1353.00, 2443
9, 15:24:00-000, 6761, 2941, 3820, 24, 1351.62, 24, 1354.00, 5313
9, 15:25:00-000, 10200, 5910, 4290, 0, 0.00, 0, 0.00, 10720
9, 15:26:00-000, 14397, 10000, 4397, 7, 1347.00, 7, 1347.43, 15263
9, 15:27:00-000, 3860, 2700, 1160, 0, 0.00, 0, 0.00, 2490
9, 15:28:00-000, 2730, 750, 1980, 0, 0.00, 0, 0.00, 4100
9, 15:29:00-000, 2630, 1435, 1195, 19, 1347.63, 19, 1348.58, 2592
9, 15:30:00-000, 5870, 3310, 2560, 0, 0.00, 0, 0.00, 5870
9, 15:31:00-000, 1260, 1260, 0, 0, 0.00, 0, 0.00, 1260
9, 15:32:00-000, 3503, 23, 3480, 14, 1351.43, 14, 1352.00, 3475
9, 15:33:00-000, 1361, 1, 1360, 1, 1352.00, 1, 1352.00, 1359
9, 15:34:00-000, 734, 4, 730, 4, 1354.00, 4, 1353.00, 726
9, 15:35:00-000, 2060, 890, 1170, 0, 0.00, 0, 0.00, 2060
9, 15:36:00-000, 2640, 2640, 0, 0, 0.00, 0, 0.00, 2640
9, 15:37:00-000, 2580, 2580, 0, 0, 0.00, 0, 0.00, 2580
9, 15:39:00-000, 1000, 0, 1000, 0, 0.00, 0, 0.00, 1000
9, 15:42:00-000, 6030, 800, 5230, 0, 0.00, 0, 0.00, 5230
9, 15:43:00-000, 910, 910, 0, 0, 0.00, 0, 0.00, 1710
9, 15:44:00-000, 4410, 2510, 1900, 0, 0.00, 0, 0.00, 4410
9, 15:46:00-000, 1440, 0, 1440, 0, 0.00, 0, 0.00, 1440
9, 15:48:00-000, 2330, 1220, 1110, 0, 0.00, 0, 0.00, 2330
9, 15:49:00-000, 2270, 950, 1320, 0, 0.00, 0, 0.00, 2270
9, 15:50:00-000, 1528, 8, 1520, 8, 1351.38, 8, 1352.00, 1512
9, 15:51:00-000, 2370, 2370, 0, 0, 0.00, 0, 0.00, 2370
9, 15:53:00-000, 1190, 0, 1190, 0, 0.00, 0, 0.00, 1190
9, 15:54:00-000, 2505, 45, 2460, 24, 1355.04, 24, 1353.00, 2457
9, 15:56:00-000, 1030, 1030, 0, 0, 0.00, 0, 0.00, 0
9, 15:57:00-000, 4365, 2172, 2193, 5, 1348.40, 5, 1350.20, 5385
9, 15:58:00-000, 2100, 840, 1260, 0, 0.00, 0, 0.00, 2100
9, 15:59:00-000, 3730, 2260, 1470, 0, 0.00, 0, 0.00, 3730
9, 16:00:00-000, 1991, 11, 1980, 8, 1353.00, 8, 1353.00, 1975
9, 16:01:00-000, 1390, 1390, 0, 0, 0.00, 0, 0.00, 1390
9, 16:05:00-000, 1110, 1110, 0, 0, 0.00, 0, 0.00, 1110
9, 16:07:00-000, 2280, 2280, 0, 0, 0.00, 0, 0.00, 2280
9, 16:08:00-000, 1354, 14, 1340, 14, 1354.93, 14, 1352.00, 1326
9, 16:09:00-000, 760, 760, 0, 0, 0.00, 0, 0.00, 760
9, 16:10:00-000, 2460, 1110, 1350, 0, 0.00, 0, 0.00, 2460
9, 16:11:00-000, 1570, 0, 1570, 0, 0.00, 0, 0.00, 800
9, 16:12:00-000, 2400, 1110, 1290, 0, 0.00, 0, 0.00, 3170
9, 16:13:00-000, 5210, 3850, 1360, 0, 0.00, 0, 0.00, 5210
9, 16:14:00-000, 780, 780, 0, 0, 0.00, 0, 0.00, 780
9, 16:15:00-000, 5410, 1620, 3790, 0, 0.00, 0, 0.00, 5410
9, 16:16:00-000, 7180, 1120, 6060, 9, 1342.89, 1, 1351.00, 7170
9, 16:17:00-000, 1890, 661, 1229, 1, 1350.00, 9, 1345.33, 1880
9, 16:18:00-000, 6330, 2350, 3980, 0, 0.00, 0, 0.00, 6330
9, 16:19:00-000, 1750, 1010, 740, 0, 0.00, 0, 0.00, 1750
9, 16:20:00-000, 3492, 2340, 1152, 2, 1348.00, 2, 1346.00, 3488
9, 16:21:00-000, 5951, 721, 5230, 1, 1351.00, 1, 1350.00, 5949
9, 16:22:00-000, 1410, 10, 1400, 10, 1350.20, 10, 1352.00, 1390
9, 16:23:00-000, 2370, 2370, 0, 0, 0.00, 0, 0.00, 2370
9, 16:24:00-000, 1450, 0, 1450, 0, 0.00, 0, 0.00, 1450
9, 16:25:00-000, 10440, 5400, 5040, 0, 0.00, 0, 0.00, 10440
9, 16:26:00-000, 8020, 0, 8020, 0, 0.00, 0, 0.00, 8020
9, 16:28:00-000, 3640, 3640, 0, 0, 0.00, 0, 0.00, 3640
9, 16:29:00-000, 4080, 2130, 1950, 0, 0.00, 0, 0.00, 4080
