TraderType,Time,EnterQty,BuyEnterQty,SellEnterQty,BuyExecutedQty,BuyExecutedPx,SellExecutedQty,SellExecutedPx,CanceledQty
1, 09:06:00-000, 3145, 3145, 0, 941, 1348.05, 0, 0.00, 0
1, 09:07:00-000, 0, 0, 0, 0, 0.00, 0, 0.00, 2193
1, 09:08:00-000, 0, 0, 0, 0, 0.00, 0, 0.00, 11
1, 09:13:00-000, 3103, 2162, 941, 1201, 1347.76, 941, 1347.33, 0
1, 09:14:00-000, 11, 7, 4, 0, 0.00, 4, 1353.75, 961
1, 09:15:00-000, 19, 6, 13, 2, 1355.00, 13, 1353.54, 7
1, 09:16:00-000, 189, 114, 75, 55, 1349.37, 72, 1357.31, 7
1, 09:17:00-000, 173, 127, 46, 28, 1349.17, 49, 1357.17, 52
1, 09:18:00-000, 697, 463, 234, 193, 1349.16, 234, 1351.65, 136
1, 09:19:00-000, 378, 226, 152, 108, 1348.82, 152, 1353.34, 198
1, 09:20:00-000, 776, 458, 318, 314, 1347.76, 318, 1349.91, 174
1, 09:21:00-000, 382, 249, 133, 165, 1347.08, 133, 1346.45, 99
1, 09:22:00-000, 595, 368, 227, 244, 1347.24, 227, 1349.32, 85
1, 09:23:00-000, 272, 183, 89, 135, 1347.82, 89, 1349.36, 104
1, 09:24:00-000, 575, 390, 185, 256, 1348.08, 183, 1347.67, 102
1, 09:25:00-000, 310, 180, 130, 152, 1347.32, 130, 1348.24, 87
1, 09:26:00-000, 591, 416, 175, 202, 1349.48, 175, 1352.58, 113
1, 09:27:00-000, 347, 197, 150, 82, 1349.12, 150, 1349.28, 152
1, 09:28:00-000, 621, 359, 262, 177, 1349.04, 259, 1348.34, 184
1, 09:29:00-000, 279, 159, 120, 120, 1347.78, 123, 1347.93, 105
1, 09:30:00-000, 555, 319, 236, 245, 1347.15, 236, 1347.42, 68
1, 09:31:00-000, 323, 216, 107, 121, 1348.48, 107, 1348.96, 61
1, 09:32:00-000, 638, 377, 261, 293, 1347.80, 261, 1348.23, 85
1, 09:33:00-000, 308, 196, 112, 90, 1349.09, 112, 1348.87, 102
1, 09:34:00-000, 627, 402, 225, 235, 1347.99, 225, 1348.01, 96
1, 09:35:00-000, 301, 173, 128, 135, 1347.86, 128, 1346.97, 159
1, 09:36:00-000, 664, 432, 232, 232, 1347.73, 232, 1347.69, 104
1, 09:37:00-000, 342, 214, 128, 130, 1348.44, 128, 1347.80, 144
1, 09:38:00-000, 619, 398, 221, 209, 1348.35, 220, 1348.33, 96
1, 09:39:00-000, 300, 190, 110, 97, 1349.77, 111, 1349.37, 165
1, 09:40:00-000, 583, 350, 233, 247, 1348.01, 233, 1348.47, 90
1, 09:41:00-000, 341, 174, 167, 131, 1348.01, 167, 1346.13, 97
1, 09:42:00-000, 639, 425, 214, 196, 1348.31, 214, 1348.56, 96
1, 09:43:00-000, 294, 196, 98, 120, 1348.27, 98, 1348.01, 159
1, 09:44:00-000, 649, 415, 234, 351, 1348.40, 234, 1347.25, 94
1, 09:45:00-000, 296, 179, 117, 98, 1347.86, 117, 1348.05, 94
1, 09:46:00-000, 571, 333, 238, 239, 1347.98, 238, 1347.52, 114
1, 09:47:00-000, 267, 170, 97, 90, 1347.36, 97, 1347.80, 57
1, 09:48:00-000, 618, 378, 240, 218, 1348.15, 240, 1348.10, 116
1, 09:49:00-000, 289, 168, 121, 122, 1347.45, 121, 1346.67, 99
1, 09:50:00-000, 681, 368, 313, 242, 1347.31, 313, 1347.12, 96
1, 09:51:00-000, 375, 229, 146, 138, 1347.64, 146, 1347.49, 87
1, 09:52:00-000, 598, 395, 203, 230, 1348.16, 203, 1348.49, 101
1, 09:53:00-000, 322, 207, 115, 153, 1348.40, 115, 1347.42, 143
1, 09:54:00-000, 561, 367, 194, 175, 1348.40, 194, 1347.84, 112
1, 09:55:00-000, 317, 180, 137, 119, 1348.22, 135, 1348.01, 134
1, 09:56:00-000, 627, 356, 271, 221, 1348.49, 273, 1348.09, 122
1, 09:57:00-000, 314, 179, 135, 123, 1347.94, 135, 1347.85, 90
1, 09:58:00-000, 576, 345, 231, 222, 1348.02, 231, 1347.29, 108
1, 09:59:00-000, 283, 171, 112, 112, 1348.65, 112, 1348.24, 81
1, 10:00:00-000, 548, 313, 235, 180, 1348.14, 235, 1347.28, 96
1, 10:01:00-000, 311, 201, 110, 117, 1349.44, 110, 1348.55, 94
1, 10:02:00-000, 574, 374, 200, 267, 1348.58, 200, 1347.85, 106
1, 10:03:00-000, 284, 190, 94, 99, 1347.83, 94, 1347.58, 75
1, 10:04:00-000, 570, 343, 227, 246, 1347.49, 227, 1346.68, 111
1, 10:05:00-000, 259, 178, 81, 97, 1347.92, 81, 1347.48, 86
1, 10:06:00-000, 621, 368, 253, 230, 1347.42, 252, 1347.22, 84
1, 10:07:00-000, 279, 191, 88, 122, 1349.18, 89, 1348.23, 129
1, 10:08:00-000, 580, 346, 234, 244, 1348.19, 234, 1348.00, 77
1, 10:09:00-000, 325, 210, 115, 146, 1348.13, 115, 1346.94, 96
1, 10:10:00-000, 600, 368, 232, 260, 1347.96, 232, 1347.17, 80
1, 10:11:00-000, 274, 166, 108, 88, 1347.93, 108, 1347.84, 103
1, 10:12:00-000, 595, 356, 239, 259, 1347.86, 239, 1346.20, 73
1, 10:13:00-000, 259, 150, 109, 110, 1347.63, 109, 1346.85, 90
1, 10:14:00-000, 512, 271, 241, 200, 1347.43, 241, 1346.53, 71
1, 10:15:00-000, 297, 157, 140, 160, 1346.91, 140, 1346.76, 32
1, 10:16:00-000, 630, 407, 223, 201, 1348.32, 223, 1348.55, 61
1, 10:17:00-000, 377, 227, 150, 173, 1347.63, 150, 1347.66, 129
1, 10:18:00-000, 614, 358, 256, 220, 1347.88, 256, 1348.00, 103
1, 10:19:00-000, 257, 165, 92, 104, 1348.47, 92, 1348.76, 102
1, 10:20:00-000, 602, 357, 245, 207, 1349.34, 245, 1348.61, 110
1, 10:21:00-000, 323, 207, 116, 154, 1349.30, 116, 1349.49, 80
1, 10:22:00-000, 616, 385, 231, 203, 1348.20, 231, 1347.88, 91
1, 10:23:00-000, 317, 234, 83, 113, 1349.31, 83, 1348.87, 151
1, 10:24:00-000, 560, 324, 236, 283, 1347.98, 236, 1346.99, 122
1, 10:25:00-000, 353, 187, 166, 104, 1348.31, 166, 1348.53, 66
1, 10:26:00-000, 584, 324, 260, 214, 1347.98, 258, 1347.62, 111
1, 10:27:00-000, 291, 209, 82, 127, 1349.06, 84, 1348.20, 84
1, 10:28:00-000, 667, 423, 244, 292, 1348.33, 244, 1347.79, 87
1, 10:29:00-000, 315, 168, 147, 150, 1346.96, 147, 1346.49, 88
1, 10:30:00-000, 656, 427, 229, 240, 1348.01, 229, 1346.89, 88
1, 10:31:00-000, 313, 197, 116, 117, 1348.49, 116, 1348.08, 126
1, 10:32:00-000, 587, 365, 222, 210, 1348.89, 222, 1348.35, 133
1, 10:33:00-000, 308, 174, 134, 96, 1348.53, 134, 1348.06, 129
1, 10:34:00-000, 639, 379, 260, 269, 1348.07, 260, 1347.23, 79
1, 10:35:00-000, 287, 170, 117, 110, 1347.70, 117, 1347.37, 107
1, 10:36:00-000, 648, 351, 297, 245, 1348.02, 297, 1347.86, 92
1, 10:37:00-000, 299, 187, 112, 99, 1347.16, 112, 1347.01, 83
1, 10:38:00-000, 565, 326, 239, 232, 1347.07, 239, 1347.21, 83
1, 10:39:00-000, 313, 186, 127, 122, 1347.06, 127, 1346.69, 83
1, 10:40:00-000, 640, 429, 211, 265, 1347.90, 211, 1347.51, 107
1, 10:41:00-000, 286, 170, 116, 123, 1347.71, 116, 1347.06, 114
1, 10:42:00-000, 637, 421, 216, 285, 1347.95, 216, 1347.15, 108
1, 10:43:00-000, 299, 193, 106, 118, 1347.77, 106, 1347.76, 98
1, 10:44:00-000, 585, 376, 209, 229, 1348.00, 209, 1347.81, 116
1, 10:45:00-000, 254, 166, 88, 122, 1348.62, 88, 1348.23, 92
1, 10:46:00-000, 642, 381, 261, 245, 1348.12, 261, 1347.45, 77
1, 10:47:00-000, 413, 204, 209, 154, 1347.44, 209, 1346.53, 90
1, 10:48:00-000, 655, 396, 259, 291, 1348.05, 259, 1347.35, 53
1, 10:49:00-000, 269, 171, 98, 151, 1347.69, 98, 1347.38, 93
1, 10:50:00-000, 604, 336, 268, 225, 1348.28, 268, 1347.67, 85
1, 10:51:00-000, 301, 193, 108, 106, 1347.89, 108, 1347.64, 81
1, 10:52:00-000, 675, 402, 273, 284, 1347.97, 273, 1346.94, 97
1, 10:53:00-000, 390, 228, 162, 148, 1348.77, 162, 1347.81, 100
1, 10:54:00-000, 633, 382, 251, 229, 1347.53, 251, 1347.54, 119
1, 10:55:00-000, 316, 191, 125, 139, 1349.12, 125, 1348.59, 107
1, 10:56:00-000, 601, 389, 212, 231, 1348.62, 212, 1347.75, 105
1, 10:57:00-000, 291, 163, 128, 147, 1348.46, 128, 1346.56, 89
1, 10:58:00-000, 567, 316, 251, 207, 1347.53, 251, 1347.18, 51
1, 10:59:00-000, 328, 180, 148, 138, 1347.12, 148, 1346.86, 67
1, 11:00:00-000, 620, 348, 272, 236, 1347.91, 272, 1347.53, 98
1, 11:01:00-000, 301, 181, 120, 105, 1349.72, 120, 1349.23, 91
1, 11:02:00-000, 617, 351, 266, 262, 1347.83, 266, 1346.84, 68
1, 11:03:00-000, 306, 212, 94, 130, 1349.00, 94, 1348.60, 101
1, 11:04:00-000, 636, 412, 224, 261, 1348.33, 224, 1347.73, 108
1, 11:05:00-000, 313, 180, 133, 109, 1347.80, 133, 1347.79, 113
1, 11:06:00-000, 629, 380, 249, 243, 1347.93, 249, 1347.78, 108
1, 11:07:00-000, 319, 214, 105, 142, 1349.63, 105, 1347.19, 94
1, 11:08:00-000, 566, 350, 216, 282, 1348.11, 216, 1346.89, 88
1, 11:09:00-000, 261, 146, 115, 107, 1346.61, 113, 1346.15, 62
1, 11:10:00-000, 611, 337, 274, 223, 1347.66, 276, 1347.28, 47
1, 11:11:00-000, 302, 174, 128, 120, 1348.46, 128, 1348.76, 99
1, 11:12:00-000, 641, 374, 267, 273, 1347.18, 267, 1346.67, 88
1, 11:13:00-000, 315, 178, 137, 111, 1346.79, 137, 1346.67, 76
1, 11:14:00-000, 535, 322, 213, 240, 1348.43, 213, 1346.99, 72
1, 11:15:00-000, 350, 212, 138, 133, 1348.18, 138, 1347.82, 78
1, 11:16:00-000, 654, 375, 279, 230, 1347.86, 279, 1347.41, 122
1, 11:17:00-000, 323, 158, 165, 142, 1346.87, 165, 1346.39, 76
1, 11:18:00-000, 641, 388, 253, 254, 1347.62, 253, 1346.91, 59
1, 11:19:00-000, 279, 169, 110, 101, 1348.09, 110, 1348.11, 101
1, 11:20:00-000, 623, 413, 210, 239, 1347.78, 210, 1347.89, 111
1, 11:21:00-000, 302, 163, 139, 141, 1347.58, 139, 1347.33, 139
1, 11:22:00-000, 675, 398, 277, 296, 1347.29, 277, 1346.83, 32
1, 11:23:00-000, 296, 173, 123, 128, 1348.67, 123, 1347.74, 70
1, 11:24:00-000, 634, 380, 254, 278, 1347.96, 254, 1347.86, 102
1, 11:25:00-000, 309, 187, 122, 126, 1348.91, 122, 1347.50, 71
1, 11:26:00-000, 512, 306, 206, 217, 1348.06, 206, 1347.22, 79
1, 11:27:00-000, 315, 203, 112, 130, 1347.87, 112, 1347.29, 81
1, 11:28:00-000, 704, 400, 304, 254, 1348.24, 304, 1347.71, 83
1, 11:29:00-000, 329, 167, 162, 168, 1347.05, 161, 1345.88, 94
1, 11:30:00-000, 547, 322, 225, 223, 1347.45, 226, 1347.25, 63
1, 11:31:00-000, 318, 203, 115, 131, 1347.97, 115, 1347.58, 45
1, 11:32:00-000, 645, 409, 236, 277, 1348.31, 236, 1347.72, 104
1, 11:33:00-000, 298, 181, 117, 97, 1348.59, 117, 1348.60, 127
1, 11:34:00-000, 610, 380, 230, 209, 1347.62, 228, 1347.60, 95
1, 11:35:00-000, 316, 182, 134, 141, 1348.77, 136, 1348.46, 119
1, 11:36:00-000, 611, 303, 308, 263, 1348.00, 308, 1347.07, 77
1, 11:37:00-000, 284, 168, 116, 84, 1348.94, 116, 1348.00, 49
1, 11:38:00-000, 651, 387, 264, 237, 1348.16, 264, 1347.57, 102
1, 11:39:00-000, 291, 148, 143, 126, 1347.41, 143, 1347.32, 107
1, 11:40:00-000, 631, 325, 306, 258, 1347.88, 306, 1347.09, 35
1, 11:41:00-000, 306, 205, 101, 114, 1347.98, 101, 1348.10, 77
1, 11:42:00-000, 567, 369, 198, 251, 1347.94, 198, 1347.91, 83
1, 11:43:00-000, 305, 183, 122, 154, 1348.55, 122, 1347.72, 94
1, 11:44:00-000, 636, 395, 241, 271, 1348.27, 241, 1347.33, 96
1, 11:45:00-000, 288, 199, 89, 89, 1349.52, 89, 1348.68, 93
1, 11:46:00-000, 567, 339, 228, 215, 1348.10, 228, 1347.42, 116
1, 11:47:00-000, 313, 129, 184, 112, 1346.73, 184, 1346.85, 81
1, 11:48:00-000, 646, 392, 254, 267, 1347.87, 254, 1347.74, 76
1, 11:49:00-000, 359, 207, 152, 172, 1347.76, 151, 1347.46, 67
1, 11:50:00-000, 593, 377, 216, 214, 1349.06, 217, 1348.66, 90
1, 11:51:00-000, 276, 170, 106, 99, 1349.22, 106, 1348.55, 133
1, 11:52:00-000, 553, 339, 214, 224, 1347.40, 214, 1347.47, 87
1, 11:53:00-000, 291, 170, 121, 114, 1348.28, 121, 1347.52, 107
1, 11:54:00-000, 582, 373, 209, 245, 1348.77, 209, 1347.41, 64
1, 11:55:00-000, 322, 173, 149, 165, 1347.89, 149, 1347.58, 99
1, 11:56:00-000, 547, 307, 240, 227, 1347.61, 240, 1346.29, 35
1, 11:57:00-000, 345, 206, 139, 123, 1348.25, 139, 1347.73, 66
1, 11:58:00-000, 592, 371, 221, 274, 1347.78, 221, 1347.13, 92
1, 11:59:00-000, 348, 223, 125, 123, 1347.60, 125, 1347.20, 91
1, 12:00:00-000, 558, 316, 242, 251, 1347.96, 242, 1347.40, 71
1, 12:01:00-000, 300, 185, 115, 146, 1347.75, 115, 1347.08, 83
1, 12:02:00-000, 573, 365, 208, 267, 1347.98, 208, 1347.46, 76
1, 12:03:00-000, 367, 205, 162, 133, 1347.30, 162, 1347.44, 69
1, 12:04:00-000, 582, 343, 239, 247, 1348.51, 239, 1347.76, 79
1, 12:05:00-000, 362, 224, 138, 164, 1348.25, 138, 1347.65, 98
1, 12:06:00-000, 602, 310, 292, 226, 1347.63, 292, 1346.72, 87
1, 12:07:00-000, 303, 187, 116, 138, 1347.90, 116, 1346.86, 51
1, 12:08:00-000, 618, 329, 289, 254, 1346.80, 289, 1346.22, 61
1, 12:09:00-000, 250, 165, 85, 96, 1348.32, 85, 1346.56, 70
1, 12:10:00-000, 751, 437, 314, 316, 1348.09, 314, 1347.22, 85
1, 12:11:00-000, 283, 198, 85, 108, 1348.57, 85, 1348.85, 69
1, 12:12:00-000, 684, 409, 275, 301, 1347.79, 275, 1347.44, 105
1, 12:13:00-000, 347, 211, 136, 105, 1347.51, 136, 1347.45, 102
1, 12:14:00-000, 627, 361, 266, 273, 1348.15, 266, 1348.01, 122
1, 12:15:00-000, 324, 165, 159, 146, 1347.81, 159, 1347.04, 59
1, 12:16:00-000, 618, 359, 259, 305, 1347.50, 259, 1346.87, 52
1, 12:17:00-000, 318, 172, 146, 137, 1346.93, 146, 1345.64, 41
1, 12:18:00-000, 619, 390, 229, 231, 1348.30, 229, 1347.23, 62
1, 12:19:00-000, 368, 222, 146, 173, 1348.07, 146, 1347.10, 116
1, 12:20:00-000, 527, 290, 237, 175, 1348.98, 237, 1347.22, 109
1, 12:21:00-000, 333, 216, 117, 119, 1348.49, 117, 1347.41, 81
1, 12:22:00-000, 647, 355, 292, 233, 1347.91, 292, 1347.11, 120
1, 12:23:00-000, 340, 172, 168, 109, 1348.32, 168, 1346.67, 109
1, 12:24:00-000, 695, 409, 286, 294, 1348.84, 286, 1347.05, 82
1, 12:25:00-000, 322, 178, 144, 104, 1347.24, 144, 1346.49, 83
1, 12:26:00-000, 686, 465, 221, 257, 1348.48, 221, 1347.46, 111
1, 12:27:00-000, 307, 215, 92, 140, 1348.74, 92, 1348.25, 151
1, 12:28:00-000, 609, 338, 271, 267, 1347.73, 271, 1347.36, 103
1, 12:29:00-000, 340, 243, 97, 126, 1349.10, 97, 1348.46, 69
1, 12:30:00-000, 638, 395, 243, 269, 1348.16, 243, 1347.86, 123
1, 12:31:00-000, 280, 128, 152, 75, 1347.26, 152, 1346.34, 113
1, 12:32:00-000, 665, 410, 255, 251, 1348.72, 255, 1346.98, 91
1, 12:33:00-000, 308, 176, 132, 156, 1349.03, 132, 1347.40, 108
1, 12:34:00-000, 630, 352, 278, 253, 1348.20, 278, 1346.90, 65
1, 12:35:00-000, 316, 197, 119, 144, 1347.79, 119, 1347.11, 63
1, 12:36:00-000, 618, 380, 238, 286, 1347.64, 238, 1347.06, 70
1, 12:37:00-000, 299, 221, 78, 66, 1350.00, 78, 1349.77, 94
1, 12:38:00-000, 687, 389, 298, 293, 1348.37, 298, 1347.83, 164
1, 12:39:00-000, 281, 166, 115, 93, 1348.85, 115, 1348.34, 85
1, 12:40:00-000, 511, 311, 200, 216, 1347.78, 200, 1347.22, 100
1, 12:41:00-000, 350, 167, 183, 115, 1348.13, 183, 1347.75, 63
1, 12:42:00-000, 558, 315, 243, 233, 1347.39, 243, 1346.86, 69
1, 12:43:00-000, 264, 116, 148, 80, 1347.19, 148, 1346.12, 64
1, 12:44:00-000, 634, 378, 256, 262, 1347.85, 256, 1346.26, 87
1, 12:45:00-000, 342, 220, 122, 147, 1348.60, 122, 1348.05, 61
1, 12:46:00-000, 598, 351, 247, 278, 1347.33, 247, 1346.64, 98
1, 12:47:00-000, 265, 170, 95, 128, 1347.21, 95, 1346.34, 57
1, 12:48:00-000, 533, 338, 195, 242, 1347.93, 195, 1347.23, 47
1, 12:49:00-000, 263, 154, 109, 100, 1347.84, 109, 1348.95, 76
1, 12:50:00-000, 673, 415, 258, 318, 1348.32, 258, 1347.62, 71
1, 12:51:00-000, 293, 171, 122, 131, 1347.81, 122, 1347.22, 75
1, 12:52:00-000, 642, 339, 303, 269, 1346.96, 303, 1346.71, 70
1, 12:53:00-000, 274, 176, 98, 86, 1349.29, 98, 1348.33, 55
1, 12:54:00-000, 616, 378, 238, 269, 1348.18, 238, 1347.62, 104
1, 12:55:00-000, 330, 213, 117, 133, 1348.78, 117, 1348.38, 89
1, 12:56:00-000, 702, 406, 296, 298, 1347.60, 296, 1346.71, 87
1, 12:57:00-000, 308, 178, 130, 129, 1349.24, 130, 1348.01, 95
1, 12:58:00-000, 677, 342, 335, 231, 1347.45, 335, 1346.75, 65
1, 12:59:00-000, 294, 190, 104, 146, 1347.91, 104, 1346.51, 86
1, 13:00:00-000, 606, 370, 236, 252, 1348.52, 236, 1347.55, 100
1, 13:01:00-000, 319, 186, 133, 163, 1347.44, 133, 1347.00, 61
1, 13:02:00-000, 580, 334, 246, 251, 1347.36, 246, 1346.73, 42
1, 13:03:00-000, 348, 164, 184, 135, 1347.21, 184, 1346.16, 68
1, 13:04:00-000, 669, 423, 246, 235, 1348.67, 246, 1348.01, 88
1, 13:05:00-000, 257, 128, 129, 75, 1347.75, 129, 1348.20, 128
1, 13:06:00-000, 592, 319, 273, 232, 1347.25, 273, 1346.55, 86
1, 13:07:00-000, 264, 152, 112, 109, 1348.37, 112, 1346.95, 79
1, 13:08:00-000, 532, 330, 202, 233, 1347.86, 202, 1346.94, 56
1, 13:09:00-000, 323, 206, 117, 148, 1348.35, 117, 1347.77, 78
1, 13:10:00-000, 698, 413, 285, 301, 1347.38, 285, 1346.82, 69
1, 13:11:00-000, 316, 224, 92, 139, 1348.79, 92, 1348.15, 95
1, 13:12:00-000, 558, 327, 231, 226, 1347.99, 231, 1347.86, 125
1, 13:13:00-000, 284, 169, 115, 138, 1347.26, 115, 1346.65, 50
1, 13:14:00-000, 618, 350, 268, 273, 1348.17, 268, 1347.19, 75
1, 13:15:00-000, 341, 188, 153, 149, 1347.65, 153, 1347.25, 51
1, 13:16:00-000, 676, 417, 259, 278, 1348.31, 259, 1347.82, 72
1, 13:17:00-000, 306, 154, 152, 93, 1348.15, 152, 1347.71, 98
1, 13:18:00-000, 598, 345, 253, 277, 1348.03, 253, 1346.86, 66
1, 13:19:00-000, 349, 220, 129, 146, 1348.22, 129, 1347.07, 66
1, 13:20:00-000, 595, 321, 274, 278, 1348.18, 274, 1347.94, 92
1, 13:21:00-000, 284, 178, 106, 131, 1347.58, 106, 1347.21, 21
1, 13:22:00-000, 633, 395, 238, 229, 1348.40, 238, 1348.19, 88
1, 13:23:00-000, 318, 169, 149, 124, 1348.16, 149, 1348.18, 117
1, 13:24:00-000, 624, 355, 269, 341, 1347.34, 269, 1347.50, 41
1, 13:25:00-000, 243, 128, 115, 94, 1348.35, 115, 1347.29, 39
1, 13:26:00-000, 669, 410, 259, 263, 1347.85, 259, 1346.72, 84
1, 13:27:00-000, 344, 205, 139, 181, 1347.48, 139, 1346.32, 57
1, 13:28:00-000, 652, 327, 325, 242, 1347.42, 325, 1347.08, 81
1, 13:29:00-000, 347, 185, 162, 129, 1348.73, 162, 1347.59, 55
1, 13:30:00-000, 658, 345, 313, 288, 1347.19, 313, 1346.40, 80
1, 13:31:00-000, 255, 147, 108, 101, 1346.75, 108, 1346.27, 44
1, 13:32:00-000, 604, 364, 240, 255, 1348.49, 240, 1346.82, 60
1, 13:33:00-000, 297, 168, 129, 144, 1346.73, 129, 1346.68, 79
1, 13:34:00-000, 671, 382, 289, 262, 1347.96, 289, 1347.83, 79
1, 13:35:00-000, 281, 145, 136, 108, 1347.48, 136, 1346.64, 56
1, 13:36:00-000, 532, 320, 212, 228, 1347.95, 212, 1347.14, 63
1, 13:37:00-000, 298, 170, 128, 124, 1347.13, 128, 1346.39, 73
1, 13:38:00-000, 562, 331, 231, 272, 1347.52, 231, 1347.57, 77
1, 13:39:00-000, 281, 170, 111, 138, 1347.51, 111, 1347.07, 50
1, 13:40:00-000, 588, 302, 286, 232, 1347.71, 286, 1346.64, 35
1, 13:41:00-000, 266, 149, 117, 85, 1348.23, 117, 1347.52, 59
1, 13:42:00-000, 677, 369, 308, 295, 1347.55, 308, 1347.55, 71
1, 13:43:00-000, 288, 187, 101, 110, 1348.51, 101, 1347.45, 64
1, 13:44:00-000, 561, 327, 234, 216, 1348.72, 234, 1348.41, 92
1, 13:45:00-000, 299, 191, 108, 127, 1348.02, 108, 1347.22, 94
1, 13:46:00-000, 559, 283, 276, 230, 1347.40, 276, 1346.52, 72
1, 13:47:00-000, 331, 223, 108, 147, 1348.46, 108, 1347.39, 54
1, 13:48:00-000, 661, 410, 251, 262, 1348.25, 251, 1347.95, 92
1, 13:49:00-000, 313, 188, 125, 148, 1348.77, 125, 1347.43, 111
1, 13:50:00-000, 598, 360, 238, 264, 1347.64, 238, 1346.93, 69
1, 13:51:00-000, 301, 167, 134, 123, 1347.62, 134, 1346.74, 90
1, 13:52:00-000, 632, 378, 254, 233, 1348.13, 254, 1347.51, 75
1, 13:53:00-000, 291, 179, 112, 106, 1347.89, 112, 1348.11, 89
1, 13:54:00-000, 638, 404, 234, 262, 1348.30, 234, 1347.61, 119
1, 13:55:00-000, 337, 195, 142, 130, 1348.57, 142, 1348.32, 90
1, 13:56:00-000, 589, 345, 244, 272, 1348.28, 244, 1347.71, 95
1, 13:57:00-000, 362, 208, 154, 155, 1348.09, 154, 1347.56, 64
1, 13:58:00-000, 608, 379, 229, 250, 1347.93, 229, 1347.49, 74
1, 13:59:00-000, 373, 234, 139, 165, 1348.90, 139, 1348.70, 78
1, 14:00:00-000, 553, 290, 263, 202, 1348.00, 263, 1347.62, 116
1, 14:01:00-000, 325, 161, 164, 106, 1347.01, 164, 1346.87, 61
1, 14:02:00-000, 623, 371, 252, 215, 1347.96, 252, 1347.39, 86
1, 14:03:00-000, 318, 195, 123, 151, 1347.39, 123, 1347.73, 115
1, 14:04:00-000, 676, 411, 265, 296, 1348.27, 265, 1347.57, 95
1, 14:05:00-000, 286, 162, 124, 119, 1348.36, 124, 1347.75, 78
1, 14:06:00-000, 539, 324, 215, 181, 1348.18, 215, 1347.92, 78
1, 14:07:00-000, 282, 148, 134, 111, 1348.67, 134, 1347.81, 110
1, 14:08:00-000, 601, 362, 239, 254, 1348.28, 239, 1347.42, 84
1, 14:09:00-000, 300, 144, 156, 124, 1348.09, 156, 1347.62, 63
1, 14:10:00-000, 568, 351, 217, 255, 1347.98, 217, 1347.36, 55
1, 14:11:00-000, 269, 159, 110, 111, 1348.18, 110, 1345.99, 72
1, 14:12:00-000, 605, 381, 224, 263, 1348.24, 224, 1347.15, 82
1, 14:13:00-000, 312, 188, 124, 132, 1349.75, 124, 1347.41, 83
1, 14:14:00-000, 609, 383, 226, 243, 1348.66, 226, 1348.25, 78
1, 14:15:00-000, 308, 184, 124, 149, 1348.11, 124, 1347.46, 95
1, 14:16:00-000, 567, 369, 198, 217, 1348.98, 198, 1348.57, 81
1, 14:17:00-000, 301, 140, 161, 131, 1347.80, 161, 1347.69, 87
1, 14:18:00-000, 652, 383, 269, 270, 1348.18, 269, 1347.98, 92
1, 14:19:00-000, 286, 156, 130, 147, 1347.11, 130, 1346.10, 52
1, 14:20:00-000, 647, 388, 259, 185, 1348.20, 259, 1348.16, 80
1, 14:21:00-000, 299, 180, 119, 127, 1347.47, 119, 1347.55, 116
1, 14:22:00-000, 597, 306, 291, 244, 1348.06, 291, 1346.92, 93
1, 14:23:00-000, 296, 188, 108, 121, 1349.05, 108, 1348.53, 62
1, 14:24:00-000, 572, 375, 197, 227, 1347.45, 197, 1347.41, 75
1, 14:25:00-000, 305, 176, 129, 125, 1349.16, 129, 1348.41, 119
1, 14:26:00-000, 607, 371, 236, 197, 1348.43, 236, 1347.82, 92
1, 14:27:00-000, 385, 261, 124, 153, 1348.93, 124, 1347.17, 139
1, 14:28:00-000, 602, 397, 205, 270, 1348.67, 205, 1348.01, 124
1, 14:29:00-000, 322, 169, 153, 175, 1348.10, 153, 1347.10, 77
1, 14:30:00-000, 590, 345, 245, 236, 1347.49, 245, 1346.80, 52
1, 14:31:00-000, 325, 214, 111, 146, 1349.15, 111, 1348.59, 85
1, 14:32:00-000, 595, 359, 236, 222, 1348.47, 236, 1347.64, 81
1, 14:33:00-000, 290, 147, 143, 146, 1346.94, 143, 1345.85, 107
1, 14:34:00-000, 583, 341, 242, 274, 1348.00, 242, 1347.24, 43
1, 14:35:00-000, 370, 198, 172, 152, 1347.41, 172, 1346.72, 48
1, 14:36:00-000, 633, 381, 252, 280, 1347.34, 252, 1346.16, 79
1, 14:37:00-000, 285, 170, 115, 124, 1348.23, 115, 1347.29, 79
1, 14:38:00-000, 523, 332, 191, 190, 1348.27, 191, 1348.06, 71
1, 14:39:00-000, 345, 199, 146, 136, 1347.82, 146, 1346.83, 99
1, 14:40:00-000, 615, 315, 300, 265, 1347.19, 300, 1346.92, 60
1, 14:41:00-000, 393, 209, 184, 178, 1347.31, 184, 1346.80, 65
1, 14:42:00-000, 656, 409, 247, 305, 1347.07, 247, 1346.41, 62
1, 14:43:00-000, 353, 198, 155, 157, 1347.50, 155, 1346.39, 67
1, 14:44:00-000, 615, 390, 225, 281, 1348.72, 225, 1347.89, 65
1, 14:45:00-000, 351, 201, 150, 165, 1347.46, 150, 1346.68, 72
1, 14:46:00-000, 579, 342, 237, 218, 1348.42, 237, 1347.84, 83
1, 14:47:00-000, 318, 172, 146, 123, 1347.40, 146, 1346.14, 71
1, 14:48:00-000, 643, 424, 219, 285, 1347.72, 219, 1347.07, 98
1, 14:49:00-000, 360, 172, 188, 133, 1347.88, 188, 1347.92, 99
1, 14:50:00-000, 570, 335, 235, 258, 1347.38, 235, 1346.88, 82
1, 14:51:00-000, 315, 156, 159, 139, 1347.27, 159, 1346.92, 42
1, 14:52:00-000, 617, 368, 249, 240, 1347.95, 249, 1347.42, 36
1, 14:53:00-000, 362, 188, 174, 112, 1348.52, 174, 1348.02, 108
1, 14:54:00-000, 638, 332, 306, 291, 1347.51, 306, 1346.90, 68
1, 14:55:00-000, 302, 148, 154, 148, 1346.67, 154, 1346.31, 37
1, 14:56:00-000, 571, 314, 257, 250, 1347.63, 257, 1346.80, 35
1, 14:57:00-000, 288, 153, 135, 111, 1346.52, 135, 1345.76, 40
1, 14:58:00-000, 649, 382, 267, 246, 1348.38, 267, 1347.58, 66
1, 14:59:00-000, 272, 174, 98, 135, 1349.10, 98, 1348.80, 82
1, 15:00:00-000, 640, 347, 293, 267, 1347.55, 293, 1347.02, 82
1, 15:01:00-000, 265, 166, 99, 120, 1347.46, 99, 1346.67, 55
1, 15:02:00-000, 578, 321, 257, 213, 1348.16, 257, 1346.88, 97
1, 15:03:00-000, 300, 177, 123, 151, 1348.68, 123, 1348.09, 70
1, 15:04:00-000, 658, 366, 292, 265, 1347.43, 292, 1347.04, 50
1, 15:05:00-000, 308, 202, 106, 110, 1349.54, 106, 1348.68, 85
1, 15:06:00-000, 556, 338, 218, 268, 1348.12, 218, 1347.47, 100
1, 15:07:00-000, 314, 182, 132, 141, 1348.81, 132, 1348.87, 69
1, 15:08:00-000, 589, 376, 213, 240, 1348.58, 213, 1348.25, 56
1, 15:09:00-000, 277, 158, 119, 120, 1348.55, 119, 1347.30, 94
1, 15:10:00-000, 654, 368, 286, 274, 1347.74, 286, 1346.77, 70
1, 15:11:00-000, 310, 180, 130, 136, 1347.81, 130, 1346.60, 68
1, 15:12:00-000, 741, 409, 332, 303, 1347.27, 332, 1346.22, 73
1, 15:13:00-000, 300, 181, 119, 120, 1348.68, 119, 1347.83, 78
1, 15:14:00-000, 583, 337, 246, 244, 1347.64, 246, 1346.94, 79
1, 15:15:00-000, 246, 108, 138, 105, 1347.16, 138, 1346.11, 77
1, 15:16:00-000, 662, 341, 321, 260, 1347.44, 321, 1346.12, 24
1, 15:17:00-000, 300, 178, 122, 120, 1348.72, 122, 1347.45, 71
1, 15:18:00-000, 543, 344, 199, 232, 1347.69, 199, 1347.16, 52
1, 15:19:00-000, 302, 178, 124, 148, 1348.39, 124, 1347.85, 73
1, 15:20:00-000, 630, 351, 279, 263, 1347.30, 279, 1346.69, 73
1, 15:21:00-000, 251, 132, 119, 94, 1348.58, 119, 1347.33, 85
1, 15:22:00-000, 571, 325, 246, 211, 1348.01, 246, 1347.66, 60
1, 15:23:00-000, 262, 139, 123, 108, 1346.84, 123, 1346.48, 90
1, 15:24:00-000, 564, 348, 216, 223, 1348.65, 216, 1348.27, 75
1, 15:25:00-000, 321, 160, 161, 142, 1347.36, 161, 1346.69, 63
1, 15:26:00-000, 669, 442, 227, 296, 1348.69, 227, 1347.60, 72
1, 15:27:00-000, 307, 166, 141, 118, 1347.43, 141, 1347.36, 86
1, 15:28:00-000, 685, 424, 261, 262, 1348.19, 261, 1347.93, 119
1, 15:29:00-000, 298, 185, 113, 136, 1347.58, 113, 1347.18, 87
1, 15:30:00-000, 587, 362, 225, 220, 1348.45, 225, 1348.22, 102
1, 15:31:00-000, 315, 201, 114, 122, 1347.68, 114, 1346.85, 109
1, 15:32:00-000, 522, 311, 211, 178, 1348.78, 211, 1347.61, 123
1, 15:33:00-000, 315, 179, 136, 107, 1347.71, 136, 1347.72, 98
1, 15:34:00-000, 702, 395, 307, 314, 1347.92, 307, 1347.37, 91
1, 15:35:00-000, 278, 189, 89, 127, 1348.99, 89, 1348.17, 62
1, 15:36:00-000, 636, 402, 234, 271, 1348.15, 234, 1347.64, 75
1, 15:37:00-000, 262, 181, 81, 85, 1349.70, 81, 1349.91, 119
1, 15:38:00-000, 585, 321, 264, 237, 1348.09, 264, 1347.71, 100
1, 15:39:00-000, 282, 152, 130, 92, 1348.25, 130, 1347.50, 80
1, 15:40:00-000, 666, 428, 238, 217, 1348.86, 238, 1347.59, 101
1, 15:41:00-000, 362, 240, 122, 130, 1349.08, 122, 1347.85, 176
1, 15:42:00-000, 743, 454, 289, 330, 1348.43, 289, 1347.70, 115
1, 15:43:00-000, 261, 135, 126, 103, 1349.24, 126, 1346.89, 123
1, 15:44:00-000, 567, 359, 208, 208, 1348.30, 208, 1347.57, 63
1, 15:45:00-000, 242, 146, 96, 94, 1347.82, 96, 1347.50, 98
1, 15:46:00-000, 670, 431, 239, 272, 1348.34, 239, 1347.30, 123
1, 15:47:00-000, 338, 204, 134, 135, 1349.25, 134, 1348.45, 97
1, 15:48:00-000, 652, 423, 229, 271, 1348.56, 229, 1347.66, 87
1, 15:49:00-000, 333, 218, 115, 150, 1348.19, 115, 1347.76, 131
1, 15:50:00-000, 567, 348, 219, 232, 1348.50, 219, 1346.71, 78
1, 15:51:00-000, 402, 202, 200, 177, 1347.99, 200, 1346.58, 99
1, 15:52:00-000, 571, 320, 251, 244, 1348.64, 251, 1347.23, 62
1, 15:53:00-000, 255, 169, 86, 71, 1348.76, 86, 1347.88, 64
1, 15:54:00-000, 656, 386, 270, 310, 1347.38, 270, 1346.71, 65
1, 15:55:00-000, 307, 172, 135, 119, 1347.89, 135, 1346.86, 101
1, 15:56:00-000, 589, 373, 216, 234, 1348.92, 216, 1347.55, 68
1, 15:57:00-000, 386, 216, 170, 150, 1348.44, 167, 1348.38, 112
1, 15:58:00-000, 617, 360, 257, 229, 1348.41, 260, 1348.18, 88
1, 15:59:00-000, 235, 118, 117, 104, 1347.60, 117, 1347.06, 91
1, 16:00:00-000, 646, 371, 275, 253, 1347.45, 275, 1347.24, 72
1, 16:01:00-000, 326, 202, 124, 152, 1348.21, 124, 1347.63, 81
1, 16:02:00-000, 579, 316, 263, 250, 1347.38, 263, 1347.10, 53
1, 16:03:00-000, 268, 149, 119, 143, 1347.54, 119, 1347.19, 40
1, 16:04:00-000, 648, 395, 253, 295, 1348.61, 253, 1347.64, 57
1, 16:05:00-000, 279, 160, 119, 121, 1348.05, 119, 1347.17, 78
1, 16:06:00-000, 605, 414, 191, 234, 1349.06, 191, 1348.31, 73
1, 16:07:00-000, 307, 195, 112, 114, 1348.54, 111, 1347.79, 155
1, 16:08:00-000, 666, 375, 291, 310, 1347.65, 292, 1345.97, 68
1, 16:09:00-000, 325, 189, 136, 150, 1348.01, 136, 1346.99, 71
1, 16:10:00-000, 632, 366, 266, 282, 1347.86, 266, 1346.34, 52
1, 16:11:00-000, 299, 168, 131, 119, 1348.40, 131, 1348.09, 61
1, 16:12:00-000, 695, 380, 315, 288, 1347.35, 315, 1346.23, 72
1, 16:13:00-000, 310, 155, 155, 163, 1347.18, 155, 1346.25, 43
1, 16:14:00-000, 577, 348, 229, 264, 1347.67, 229, 1346.12, 47
1, 16:15:00-000, 283, 140, 143, 118, 1346.93, 143, 1346.50, 52
1, 16:16:00-000, 614, 371, 243, 244, 1348.56, 243, 1347.81, 66
1, 16:17:00-000, 318, 184, 134, 107, 1348.05, 134, 1347.30, 87
1, 16:18:00-000, 660, 381, 279, 239, 1348.04, 279, 1347.25, 76
1, 16:19:00-000, 344, 187, 157, 142, 1349.06, 157, 1349.24, 112
1, 16:20:00-000, 608, 355, 253, 302, 1347.31, 253, 1346.59, 89
1, 16:21:00-000, 332, 177, 155, 144, 1347.98, 155, 1346.42, 53
1, 16:22:00-000, 637, 362, 275, 299, 1347.80, 273, 1346.62, 40
1, 16:23:00-000, 346, 218, 128, 141, 1348.11, 130, 1347.60, 60
1, 16:24:00-000, 621, 338, 283, 249, 1348.24, 280, 1347.13, 86
1, 16:25:00-000, 271, 173, 98, 126, 1348.46, 101, 1347.94, 58
1, 16:26:00-000, 595, 326, 269, 210, 1348.81, 269, 1348.31, 86
1, 16:27:00-000, 352, 210, 142, 151, 1347.63, 142, 1346.84, 77
1, 16:28:00-000, 636, 341, 295, 230, 1348.62, 295, 1347.20, 95
1, 16:29:00-000, 378, 228, 150, 150, 1347.76, 150, 1347.34, 74
2, 09:06:00-000, 3149, 0, 3149, 0, 0.00, 1219, 1348.64, 0
2, 09:07:00-000, 0, 0, 0, 0, 0.00, 0, 0.00, 1917
2, 09:08:00-000, 0, 0, 0, 0, 0.00, 0, 0.00, 13
2, 09:13:00-000, 3157, 1219, 1938, 1219, 1352.74, 1558, 1350.99, 0
2, 09:14:00-000, 7, 3, 4, 3, 1354.33, 26, 1355.42, 358
2, 09:15:00-000, 17, 5, 12, 5, 1355.40, 12, 1353.58, 0
2, 09:16:00-000, 207, 88, 119, 88, 1356.67, 112, 1353.08, 0
2, 09:17:00-000, 167, 83, 84, 83, 1356.53, 76, 1352.64, 0
2, 09:18:00-000, 569, 299, 270, 299, 1354.34, 285, 1352.82, 0
2, 09:19:00-000, 481, 258, 223, 258, 1355.04, 223, 1353.38, 0
2, 09:20:00-000, 784, 391, 393, 391, 1354.64, 382, 1352.51, 0
2, 09:21:00-000, 363, 195, 168, 195, 1352.01, 170, 1353.02, 9
2, 09:22:00-000, 638, 297, 341, 296, 1353.49, 341, 1351.82, 0
2, 09:23:00-000, 354, 158, 196, 159, 1353.38, 195, 1351.53, 0
2, 09:24:00-000, 461, 205, 256, 205, 1352.29, 193, 1351.19, 11
2, 09:25:00-000, 276, 137, 139, 137, 1354.54, 185, 1352.96, 7
2, 09:26:00-000, 626, 329, 297, 329, 1354.74, 275, 1352.64, 0
2, 09:27:00-000, 332, 180, 152, 179, 1354.07, 131, 1352.44, 16
2, 09:28:00-000, 655, 342, 313, 343, 1353.45, 252, 1351.43, 37
2, 09:29:00-000, 274, 140, 134, 140, 1352.73, 121, 1352.40, 32
2, 09:30:00-000, 675, 328, 347, 328, 1352.89, 341, 1351.90, 20
2, 09:31:00-000, 287, 149, 138, 149, 1354.28, 156, 1353.54, 0
2, 09:32:00-000, 652, 270, 382, 270, 1352.71, 292, 1351.54, 6
2, 09:33:00-000, 304, 152, 152, 152, 1354.12, 174, 1353.04, 30
2, 09:34:00-000, 626, 271, 355, 271, 1353.42, 299, 1351.95, 49
2, 09:35:00-000, 333, 140, 193, 140, 1351.62, 184, 1351.01, 25
2, 09:36:00-000, 613, 287, 326, 287, 1352.69, 291, 1350.99, 21
2, 09:37:00-000, 296, 123, 173, 123, 1352.11, 135, 1351.58, 37
2, 09:38:00-000, 632, 345, 287, 345, 1353.21, 285, 1351.22, 25
2, 09:39:00-000, 318, 177, 141, 177, 1354.08, 121, 1353.17, 14
2, 09:40:00-000, 681, 352, 329, 352, 1353.66, 274, 1350.95, 34
2, 09:41:00-000, 276, 100, 176, 100, 1352.24, 123, 1350.35, 31
2, 09:42:00-000, 551, 276, 275, 276, 1352.91, 236, 1351.62, 56
2, 09:43:00-000, 362, 173, 189, 173, 1353.35, 170, 1351.91, 26
2, 09:44:00-000, 648, 264, 384, 264, 1352.38, 296, 1351.05, 56
2, 09:45:00-000, 284, 143, 141, 143, 1353.05, 133, 1351.91, 46
2, 09:46:00-000, 553, 256, 297, 256, 1352.90, 248, 1351.07, 40
2, 09:47:00-000, 339, 164, 175, 160, 1352.54, 150, 1351.84, 39
2, 09:48:00-000, 648, 272, 376, 276, 1352.46, 296, 1351.53, 54
2, 09:49:00-000, 326, 131, 195, 131, 1351.99, 138, 1351.15, 41
2, 09:50:00-000, 627, 267, 360, 267, 1352.45, 279, 1351.38, 79
2, 09:51:00-000, 296, 154, 142, 154, 1352.20, 142, 1351.56, 61
2, 09:52:00-000, 629, 294, 335, 294, 1354.05, 257, 1352.33, 17
2, 09:53:00-000, 316, 124, 192, 124, 1352.76, 168, 1351.98, 38
2, 09:54:00-000, 613, 286, 327, 286, 1352.75, 269, 1352.09, 55
2, 09:55:00-000, 281, 146, 135, 146, 1353.26, 123, 1352.29, 49
2, 09:56:00-000, 708, 322, 386, 322, 1352.71, 312, 1352.24, 47
2, 09:57:00-000, 307, 128, 179, 128, 1351.97, 139, 1350.89, 37
2, 09:58:00-000, 641, 280, 361, 280, 1352.08, 274, 1351.18, 70
2, 09:59:00-000, 322, 134, 188, 134, 1353.18, 152, 1352.31, 64
2, 10:00:00-000, 621, 259, 362, 259, 1352.09, 268, 1351.02, 43
2, 10:01:00-000, 269, 126, 143, 126, 1353.33, 120, 1352.16, 60
2, 10:02:00-000, 648, 273, 375, 273, 1352.25, 291, 1351.38, 53
2, 10:03:00-000, 270, 117, 153, 117, 1352.36, 130, 1350.92, 79
2, 10:04:00-000, 655, 286, 369, 286, 1352.72, 294, 1351.58, 32
2, 10:05:00-000, 396, 166, 230, 166, 1352.28, 189, 1351.60, 54
2, 10:06:00-000, 609, 301, 308, 301, 1352.33, 241, 1350.98, 59
2, 10:07:00-000, 299, 122, 177, 122, 1352.81, 145, 1352.26, 65
2, 10:08:00-000, 583, 279, 304, 279, 1352.83, 275, 1351.15, 50
2, 10:09:00-000, 313, 118, 195, 118, 1352.06, 131, 1350.60, 17
2, 10:10:00-000, 631, 289, 342, 289, 1352.11, 276, 1350.77, 50
2, 10:11:00-000, 350, 182, 168, 182, 1352.97, 164, 1352.49, 57
2, 10:12:00-000, 632, 251, 381, 251, 1351.80, 300, 1351.02, 43
2, 10:13:00-000, 322, 170, 152, 170, 1352.88, 135, 1352.19, 44
2, 10:14:00-000, 657, 285, 372, 285, 1352.82, 295, 1351.36, 46
2, 10:15:00-000, 245, 122, 123, 122, 1353.40, 108, 1352.02, 48
2, 10:16:00-000, 608, 273, 335, 273, 1353.02, 253, 1351.37, 49
2, 10:17:00-000, 317, 146, 171, 146, 1352.96, 155, 1351.13, 55
2, 10:18:00-000, 547, 244, 303, 244, 1352.34, 255, 1351.42, 31
2, 10:19:00-000, 319, 131, 188, 131, 1351.84, 154, 1351.08, 27
2, 10:20:00-000, 667, 321, 346, 321, 1353.28, 327, 1352.36, 53
2, 10:21:00-000, 260, 141, 119, 141, 1353.76, 104, 1352.31, 19
2, 10:22:00-000, 662, 312, 350, 312, 1352.77, 290, 1351.85, 18
2, 10:23:00-000, 268, 124, 144, 124, 1353.78, 132, 1352.47, 36
2, 10:24:00-000, 587, 254, 333, 254, 1352.09, 251, 1351.33, 46
2, 10:25:00-000, 354, 157, 197, 157, 1352.63, 145, 1352.06, 63
2, 10:26:00-000, 617, 291, 326, 291, 1352.81, 286, 1351.23, 41
2, 10:27:00-000, 264, 123, 141, 123, 1353.04, 142, 1351.61, 33
2, 10:28:00-000, 643, 285, 358, 285, 1352.97, 272, 1352.11, 38
2, 10:29:00-000, 364, 129, 235, 129, 1351.25, 159, 1350.26, 53
2, 10:30:00-000, 519, 229, 290, 226, 1351.75, 229, 1351.68, 100
2, 10:31:00-000, 303, 135, 168, 135, 1351.94, 137, 1351.41, 50
2, 10:32:00-000, 603, 310, 293, 310, 1353.33, 244, 1352.06, 50
2, 10:33:00-000, 352, 158, 194, 158, 1352.26, 128, 1350.75, 36
2, 10:34:00-000, 570, 274, 296, 274, 1352.36, 247, 1351.92, 67
2, 10:35:00-000, 362, 148, 214, 148, 1351.92, 137, 1350.91, 45
2, 10:36:00-000, 621, 292, 329, 292, 1352.55, 261, 1351.33, 78
2, 10:37:00-000, 322, 126, 196, 126, 1352.09, 160, 1350.95, 57
2, 10:38:00-000, 621, 226, 395, 226, 1352.35, 275, 1351.10, 61
2, 10:39:00-000, 310, 144, 166, 144, 1352.12, 129, 1350.75, 91
2, 10:40:00-000, 623, 254, 369, 254, 1351.76, 262, 1350.75, 77
2, 10:41:00-000, 278, 104, 174, 104, 1351.45, 159, 1351.25, 65
2, 10:42:00-000, 589, 271, 318, 271, 1352.74, 239, 1351.24, 46
2, 10:43:00-000, 350, 153, 197, 153, 1352.77, 159, 1351.39, 45
2, 10:44:00-000, 626, 259, 367, 259, 1352.44, 290, 1350.75, 74
2, 10:45:00-000, 327, 134, 193, 134, 1352.60, 149, 1351.73, 50
2, 10:46:00-000, 584, 255, 329, 255, 1352.26, 265, 1351.21, 66
2, 10:47:00-000, 388, 152, 236, 152, 1351.85, 161, 1351.40, 52
2, 10:48:00-000, 586, 275, 311, 275, 1353.15, 284, 1351.30, 63
2, 10:49:00-000, 273, 114, 159, 114, 1352.34, 103, 1351.01, 45
2, 10:50:00-000, 571, 279, 292, 279, 1353.31, 246, 1351.94, 56
2, 10:51:00-000, 298, 167, 131, 167, 1353.67, 127, 1351.78, 39
2, 10:52:00-000, 647, 257, 390, 257, 1352.35, 291, 1351.26, 21
2, 10:53:00-000, 315, 160, 155, 160, 1352.87, 121, 1351.84, 58
2, 10:54:00-000, 654, 284, 370, 284, 1352.39, 325, 1351.34, 63
2, 10:55:00-000, 313, 116, 197, 116, 1353.12, 144, 1352.67, 32
2, 10:56:00-000, 482, 214, 268, 214, 1352.43, 237, 1351.62, 52
2, 10:57:00-000, 328, 143, 185, 143, 1351.82, 135, 1351.03, 47
2, 10:58:00-000, 579, 261, 318, 261, 1352.41, 266, 1351.23, 54
2, 10:59:00-000, 323, 150, 173, 150, 1353.15, 131, 1351.66, 36
2, 11:00:00-000, 613, 325, 288, 325, 1353.28, 235, 1352.21, 47
2, 11:01:00-000, 342, 169, 173, 169, 1353.22, 156, 1352.02, 33
2, 11:02:00-000, 618, 265, 353, 265, 1352.03, 291, 1351.67, 57
2, 11:03:00-000, 322, 119, 203, 119, 1351.93, 144, 1351.26, 44
2, 11:04:00-000, 556, 263, 293, 263, 1353.10, 241, 1351.39, 66
2, 11:05:00-000, 275, 116, 159, 116, 1353.19, 114, 1351.58, 28
2, 11:06:00-000, 635, 246, 389, 246, 1351.71, 268, 1350.71, 87
2, 11:07:00-000, 365, 140, 225, 140, 1351.65, 179, 1351.13, 78
2, 11:08:00-000, 633, 281, 352, 281, 1352.28, 279, 1351.20, 92
2, 11:09:00-000, 307, 114, 193, 114, 1351.73, 141, 1349.62, 49
2, 11:10:00-000, 636, 302, 334, 302, 1352.59, 325, 1351.81, 41
2, 11:11:00-000, 268, 139, 129, 139, 1354.34, 108, 1352.10, 14
2, 11:12:00-000, 626, 260, 366, 260, 1350.87, 212, 1350.29, 71
2, 11:13:00-000, 280, 124, 156, 124, 1351.78, 157, 1351.20, 64
2, 11:14:00-000, 716, 329, 387, 329, 1352.35, 325, 1351.40, 47
2, 11:15:00-000, 253, 116, 137, 116, 1352.68, 107, 1350.74, 61
2, 11:16:00-000, 549, 215, 334, 215, 1351.92, 239, 1350.67, 37
2, 11:17:00-000, 286, 129, 157, 129, 1351.86, 135, 1350.32, 58
2, 11:18:00-000, 593, 263, 330, 263, 1351.58, 266, 1350.88, 53
2, 11:19:00-000, 352, 183, 169, 183, 1352.39, 144, 1351.78, 50
2, 11:20:00-000, 642, 302, 340, 302, 1352.74, 307, 1350.80, 32
2, 11:21:00-000, 254, 93, 161, 93, 1351.79, 87, 1350.61, 34
2, 11:22:00-000, 653, 290, 363, 290, 1352.22, 303, 1350.76, 103
2, 11:23:00-000, 264, 133, 131, 133, 1353.39, 126, 1352.10, 13
2, 11:24:00-000, 666, 296, 370, 296, 1352.78, 285, 1351.62, 41
2, 11:25:00-000, 288, 129, 159, 129, 1351.96, 103, 1351.24, 70
2, 11:26:00-000, 636, 280, 356, 280, 1352.22, 282, 1351.51, 53
2, 11:27:00-000, 356, 132, 224, 132, 1351.34, 152, 1351.35, 72
2, 11:28:00-000, 642, 320, 322, 320, 1352.90, 256, 1351.96, 58
2, 11:29:00-000, 253, 82, 171, 82, 1351.83, 91, 1349.97, 79
2, 11:30:00-000, 606, 218, 388, 218, 1351.88, 296, 1350.99, 81
2, 11:31:00-000, 330, 141, 189, 141, 1352.42, 152, 1351.69, 80
2, 11:32:00-000, 606, 259, 347, 259, 1352.95, 271, 1351.42, 78
2, 11:33:00-000, 386, 174, 212, 174, 1353.36, 179, 1352.14, 43
2, 11:34:00-000, 691, 290, 401, 290, 1353.28, 311, 1352.26, 46
2, 11:35:00-000, 357, 162, 195, 162, 1351.78, 161, 1351.28, 87
2, 11:36:00-000, 665, 259, 406, 259, 1351.79, 273, 1350.90, 67
2, 11:37:00-000, 268, 101, 167, 101, 1351.57, 129, 1351.26, 87
2, 11:38:00-000, 581, 271, 310, 271, 1352.37, 264, 1351.82, 48
2, 11:39:00-000, 324, 151, 173, 151, 1352.74, 141, 1351.31, 41
2, 11:40:00-000, 644, 305, 339, 305, 1352.17, 260, 1351.56, 45
2, 11:41:00-000, 289, 128, 161, 128, 1353.52, 104, 1351.25, 58
2, 11:42:00-000, 711, 332, 379, 332, 1352.34, 309, 1351.22, 77
2, 11:43:00-000, 324, 135, 189, 135, 1352.78, 164, 1352.00, 38
2, 11:44:00-000, 663, 264, 399, 264, 1351.64, 288, 1350.84, 80
2, 11:45:00-000, 297, 147, 150, 147, 1351.99, 130, 1352.53, 48
2, 11:46:00-000, 602, 253, 349, 253, 1351.74, 265, 1351.59, 66
2, 11:47:00-000, 352, 170, 182, 170, 1352.49, 145, 1350.69, 58
2, 11:48:00-000, 574, 261, 313, 261, 1352.40, 253, 1350.94, 62
2, 11:49:00-000, 290, 141, 149, 141, 1354.27, 135, 1352.23, 27
2, 11:50:00-000, 599, 264, 335, 264, 1352.73, 259, 1351.30, 51
2, 11:51:00-000, 407, 181, 226, 181, 1353.60, 149, 1351.19, 62
2, 11:52:00-000, 576, 252, 324, 252, 1352.54, 239, 1350.96, 89
2, 11:53:00-000, 367, 148, 219, 148, 1352.61, 151, 1351.70, 55
2, 11:54:00-000, 627, 265, 362, 265, 1351.89, 292, 1350.77, 95
2, 11:55:00-000, 280, 93, 187, 93, 1351.67, 101, 1351.39, 62
2, 11:56:00-000, 621, 315, 306, 315, 1352.73, 273, 1351.30, 79
2, 11:57:00-000, 346, 150, 196, 150, 1352.12, 158, 1351.45, 35
2, 11:58:00-000, 670, 288, 382, 288, 1353.19, 301, 1351.31, 39
2, 11:59:00-000, 317, 159, 158, 159, 1353.11, 150, 1352.40, 68
2, 12:00:00-000, 633, 261, 372, 261, 1351.33, 240, 1350.45, 50
2, 12:01:00-000, 250, 95, 155, 95, 1351.66, 120, 1350.96, 88
2, 12:02:00-000, 587, 216, 371, 216, 1352.18, 283, 1350.73, 68
2, 12:03:00-000, 304, 146, 158, 146, 1352.26, 127, 1351.45, 62
2, 12:04:00-000, 655, 316, 339, 316, 1353.20, 277, 1352.40, 51
2, 12:05:00-000, 313, 128, 185, 128, 1353.20, 135, 1351.20, 40
2, 12:06:00-000, 611, 269, 342, 269, 1352.24, 257, 1351.40, 79
2, 12:07:00-000, 315, 116, 199, 116, 1351.36, 138, 1350.66, 71
2, 12:08:00-000, 701, 273, 428, 273, 1351.71, 313, 1350.57, 53
2, 12:09:00-000, 356, 182, 174, 182, 1352.85, 187, 1351.41, 58
2, 12:10:00-000, 572, 268, 304, 268, 1352.94, 254, 1351.22, 46
2, 12:11:00-000, 372, 163, 209, 163, 1352.68, 181, 1351.74, 49
2, 12:12:00-000, 565, 239, 326, 239, 1352.38, 241, 1351.00, 48
2, 12:13:00-000, 295, 136, 159, 136, 1352.07, 123, 1351.40, 71
2, 12:14:00-000, 610, 305, 305, 305, 1352.58, 252, 1351.90, 18
2, 12:15:00-000, 326, 139, 187, 139, 1352.48, 154, 1351.85, 41
2, 12:16:00-000, 556, 229, 327, 229, 1351.67, 285, 1350.79, 63
2, 12:17:00-000, 285, 143, 142, 143, 1352.25, 114, 1350.61, 40
2, 12:18:00-000, 623, 290, 333, 290, 1351.92, 232, 1351.17, 37
2, 12:19:00-000, 309, 137, 172, 137, 1353.34, 136, 1351.82, 61
2, 12:20:00-000, 726, 318, 408, 318, 1351.96, 224, 1350.31, 86
2, 12:21:00-000, 303, 120, 183, 120, 1351.82, 127, 1350.97, 144
2, 12:22:00-000, 556, 207, 349, 207, 1351.66, 243, 1350.05, 98
2, 12:23:00-000, 294, 148, 146, 148, 1351.66, 95, 1350.96, 73
2, 12:24:00-000, 748, 289, 459, 289, 1352.43, 303, 1350.66, 79
2, 12:25:00-000, 254, 97, 157, 97, 1351.65, 114, 1350.30, 122
2, 12:26:00-000, 687, 262, 425, 262, 1351.78, 300, 1351.20, 77
2, 12:27:00-000, 233, 88, 145, 88, 1351.53, 112, 1350.21, 103
2, 12:28:00-000, 578, 219, 359, 219, 1351.81, 239, 1351.00, 49
2, 12:29:00-000, 334, 138, 196, 138, 1352.76, 120, 1351.10, 95
2, 12:30:00-000, 645, 297, 348, 297, 1351.85, 264, 1350.73, 110
2, 12:31:00-000, 278, 136, 142, 136, 1352.31, 113, 1350.90, 67
2, 12:32:00-000, 620, 271, 349, 271, 1353.05, 241, 1351.25, 36
2, 12:33:00-000, 307, 131, 176, 131, 1352.59, 134, 1351.25, 96
2, 12:34:00-000, 598, 236, 362, 236, 1351.81, 263, 1350.79, 71
2, 12:35:00-000, 301, 110, 191, 110, 1351.60, 119, 1351.01, 56
2, 12:36:00-000, 686, 259, 427, 259, 1351.90, 286, 1350.73, 99
2, 12:37:00-000, 296, 156, 140, 156, 1354.19, 141, 1351.39, 100
2, 12:38:00-000, 607, 278, 329, 278, 1352.97, 231, 1351.56, 64
2, 12:39:00-000, 318, 151, 167, 151, 1351.99, 120, 1351.49, 67
2, 12:40:00-000, 586, 257, 329, 257, 1351.44, 217, 1350.84, 72
2, 12:41:00-000, 266, 98, 168, 98, 1351.91, 103, 1351.19, 72
2, 12:42:00-000, 613, 222, 391, 222, 1351.63, 266, 1350.20, 105
2, 12:43:00-000, 282, 130, 152, 130, 1350.72, 107, 1350.61, 84
2, 12:44:00-000, 580, 226, 354, 226, 1352.43, 248, 1350.67, 60
2, 12:45:00-000, 277, 111, 166, 111, 1352.27, 140, 1351.15, 74
2, 12:46:00-000, 659, 209, 450, 209, 1352.04, 306, 1350.46, 79
2, 12:47:00-000, 279, 126, 153, 126, 1352.66, 151, 1351.37, 73
2, 12:48:00-000, 640, 262, 378, 262, 1351.91, 264, 1350.92, 62
2, 12:49:00-000, 306, 147, 159, 143, 1352.53, 129, 1352.04, 71
2, 12:50:00-000, 653, 254, 399, 258, 1352.72, 344, 1351.34, 68
2, 12:51:00-000, 338, 148, 190, 148, 1352.27, 159, 1351.01, 32
2, 12:52:00-000, 637, 309, 328, 309, 1352.00, 279, 1351.40, 40
2, 12:53:00-000, 312, 132, 180, 132, 1352.37, 137, 1352.01, 48
2, 12:54:00-000, 664, 285, 379, 285, 1352.56, 316, 1351.47, 49
2, 12:55:00-000, 276, 121, 155, 121, 1352.75, 119, 1351.78, 62
2, 12:56:00-000, 623, 304, 319, 304, 1351.96, 257, 1351.38, 52
2, 12:57:00-000, 286, 162, 124, 162, 1353.45, 105, 1351.58, 41
2, 12:58:00-000, 665, 261, 404, 261, 1351.71, 302, 1351.00, 49
2, 12:59:00-000, 266, 109, 157, 109, 1351.89, 107, 1349.63, 80
2, 13:00:00-000, 700, 307, 393, 307, 1352.32, 297, 1351.57, 41
2, 13:01:00-000, 282, 113, 169, 113, 1351.88, 144, 1351.17, 85
2, 13:02:00-000, 671, 284, 387, 284, 1351.93, 290, 1350.93, 70
2, 13:03:00-000, 367, 181, 186, 181, 1351.48, 153, 1351.85, 68
2, 13:04:00-000, 616, 287, 329, 287, 1352.30, 232, 1351.57, 58
2, 13:05:00-000, 273, 157, 116, 154, 1352.37, 110, 1352.43, 58
2, 13:06:00-000, 581, 236, 345, 239, 1352.50, 260, 1351.23, 53
2, 13:07:00-000, 294, 123, 171, 123, 1352.52, 126, 1351.66, 47
2, 13:08:00-000, 658, 272, 386, 271, 1352.23, 293, 1351.61, 72
2, 13:09:00-000, 281, 124, 157, 125, 1351.81, 94, 1350.51, 59
2, 13:10:00-000, 607, 293, 314, 293, 1352.32, 274, 1350.63, 53
2, 13:11:00-000, 341, 160, 181, 160, 1353.76, 161, 1351.86, 51
2, 13:12:00-000, 613, 233, 380, 233, 1352.48, 275, 1351.17, 41
2, 13:13:00-000, 268, 126, 142, 126, 1352.06, 109, 1351.01, 78
2, 13:14:00-000, 639, 273, 366, 273, 1352.13, 290, 1350.92, 71
2, 13:15:00-000, 368, 159, 209, 159, 1352.28, 162, 1350.48, 58
2, 13:16:00-000, 542, 241, 301, 241, 1352.78, 227, 1350.95, 56
2, 13:17:00-000, 299, 135, 164, 135, 1351.11, 133, 1351.02, 59
2, 13:18:00-000, 562, 219, 343, 219, 1351.66, 275, 1350.73, 50
2, 13:19:00-000, 351, 123, 228, 123, 1351.49, 147, 1350.79, 45
2, 13:20:00-000, 607, 302, 305, 302, 1353.20, 279, 1351.44, 87
2, 13:21:00-000, 299, 150, 149, 150, 1352.87, 128, 1351.36, 32
2, 13:22:00-000, 640, 284, 356, 284, 1352.84, 278, 1351.68, 35
2, 13:23:00-000, 300, 129, 171, 129, 1352.32, 89, 1350.88, 64
2, 13:24:00-000, 590, 265, 325, 265, 1352.36, 269, 1350.98, 54
2, 13:25:00-000, 279, 107, 172, 107, 1351.93, 120, 1350.89, 66
2, 13:26:00-000, 662, 296, 366, 296, 1352.21, 296, 1351.32, 63
2, 13:27:00-000, 295, 115, 180, 115, 1352.00, 147, 1351.15, 71
2, 13:28:00-000, 596, 275, 321, 275, 1351.43, 202, 1350.84, 51
2, 13:29:00-000, 342, 160, 182, 160, 1352.24, 160, 1351.65, 90
2, 13:30:00-000, 570, 166, 404, 166, 1351.69, 256, 1350.62, 58
2, 13:31:00-000, 285, 118, 167, 118, 1350.72, 115, 1350.55, 79
2, 13:32:00-000, 668, 303, 365, 303, 1352.09, 309, 1351.06, 75
2, 13:33:00-000, 385, 137, 248, 137, 1350.93, 172, 1350.12, 76
2, 13:34:00-000, 663, 333, 330, 333, 1352.66, 280, 1351.55, 79
2, 13:35:00-000, 287, 101, 186, 101, 1351.50, 122, 1351.65, 56
2, 13:36:00-000, 589, 261, 328, 261, 1352.17, 255, 1350.67, 66
2, 13:37:00-000, 343, 137, 206, 137, 1350.94, 142, 1350.95, 53
2, 13:38:00-000, 595, 276, 319, 276, 1353.28, 269, 1351.18, 75
2, 13:39:00-000, 281, 132, 149, 132, 1352.36, 147, 1351.60, 31
2, 13:40:00-000, 561, 237, 324, 237, 1351.89, 214, 1350.89, 47
2, 13:41:00-000, 301, 136, 165, 136, 1352.17, 140, 1351.16, 59
2, 13:42:00-000, 657, 280, 377, 280, 1352.20, 257, 1350.53, 70
2, 13:43:00-000, 329, 168, 161, 168, 1352.88, 160, 1351.66, 82
2, 13:44:00-000, 580, 257, 323, 257, 1352.85, 246, 1352.12, 29
2, 13:45:00-000, 299, 127, 172, 127, 1351.74, 137, 1351.62, 50
2, 13:46:00-000, 594, 259, 335, 259, 1352.14, 234, 1350.88, 62
2, 13:47:00-000, 336, 127, 209, 127, 1352.50, 159, 1351.95, 71
2, 13:48:00-000, 640, 250, 390, 250, 1352.27, 331, 1351.46, 68
2, 13:49:00-000, 317, 119, 198, 119, 1352.62, 127, 1351.30, 59
2, 13:50:00-000, 591, 243, 348, 243, 1351.93, 264, 1351.05, 77
2, 13:51:00-000, 308, 134, 174, 134, 1352.10, 144, 1351.36, 68
2, 13:52:00-000, 597, 242, 355, 242, 1351.81, 257, 1351.45, 58
2, 13:53:00-000, 295, 149, 146, 149, 1353.24, 121, 1351.60, 69
2, 13:54:00-000, 646, 320, 326, 320, 1353.13, 282, 1351.65, 41
2, 13:55:00-000, 375, 175, 200, 175, 1353.37, 146, 1351.42, 36
2, 13:56:00-000, 619, 280, 339, 280, 1352.41, 246, 1350.60, 71
2, 13:57:00-000, 274, 141, 133, 141, 1352.13, 94, 1351.95, 78
2, 13:58:00-000, 660, 240, 420, 240, 1351.79, 318, 1350.68, 59
2, 13:59:00-000, 383, 166, 217, 166, 1353.32, 164, 1351.28, 64
2, 14:00:00-000, 596, 240, 356, 240, 1351.21, 225, 1351.20, 85
2, 14:01:00-000, 255, 104, 151, 104, 1351.81, 113, 1350.98, 98
2, 14:02:00-000, 644, 275, 369, 275, 1351.86, 296, 1351.59, 66
2, 14:03:00-000, 413, 194, 219, 194, 1353.00, 195, 1350.87, 59
2, 14:04:00-000, 652, 286, 366, 286, 1352.17, 271, 1350.79, 40
2, 14:05:00-000, 332, 135, 197, 135, 1352.47, 154, 1350.88, 77
2, 14:06:00-000, 546, 245, 301, 245, 1352.35, 205, 1351.13, 66
2, 14:07:00-000, 275, 137, 138, 137, 1352.08, 104, 1351.67, 66
2, 14:08:00-000, 624, 254, 370, 254, 1352.34, 260, 1351.12, 79
2, 14:09:00-000, 295, 147, 148, 147, 1352.65, 153, 1351.34, 44
2, 14:10:00-000, 639, 286, 353, 286, 1352.08, 290, 1351.03, 39
2, 14:11:00-000, 328, 114, 214, 114, 1351.08, 160, 1349.80, 53
2, 14:12:00-000, 654, 249, 405, 249, 1351.89, 233, 1350.54, 111
2, 14:13:00-000, 296, 137, 159, 137, 1352.63, 159, 1352.28, 84
2, 14:14:00-000, 627, 256, 371, 256, 1352.24, 264, 1351.39, 52
2, 14:15:00-000, 319, 98, 221, 98, 1351.35, 151, 1350.45, 82
2, 14:16:00-000, 614, 322, 292, 322, 1352.76, 263, 1351.58, 61
2, 14:17:00-000, 389, 148, 241, 148, 1351.79, 142, 1351.66, 41
2, 14:18:00-000, 665, 315, 350, 315, 1352.58, 296, 1351.10, 77
2, 14:19:00-000, 332, 146, 186, 146, 1352.50, 159, 1351.38, 59
2, 14:20:00-000, 630, 309, 321, 309, 1352.45, 274, 1351.87, 53
2, 14:21:00-000, 338, 141, 197, 141, 1352.20, 114, 1351.15, 47
2, 14:22:00-000, 546, 223, 323, 223, 1351.59, 249, 1351.08, 96
2, 14:23:00-000, 306, 129, 177, 129, 1352.78, 127, 1351.63, 54
2, 14:24:00-000, 687, 310, 377, 310, 1352.71, 323, 1351.00, 66
2, 14:25:00-000, 280, 99, 181, 99, 1352.01, 124, 1351.06, 41
2, 14:26:00-000, 630, 243, 387, 243, 1352.17, 288, 1351.67, 77
2, 14:27:00-000, 380, 163, 217, 163, 1352.87, 199, 1352.11, 52
2, 14:28:00-000, 653, 284, 369, 284, 1352.10, 287, 1351.35, 74
2, 14:29:00-000, 319, 164, 155, 164, 1352.42, 115, 1351.01, 41
2, 14:30:00-000, 557, 249, 308, 249, 1351.59, 242, 1350.69, 55
2, 14:31:00-000, 282, 130, 152, 130, 1352.53, 98, 1351.59, 54
2, 14:32:00-000, 602, 261, 341, 261, 1352.26, 277, 1351.36, 65
2, 14:33:00-000, 253, 106, 147, 106, 1351.93, 108, 1350.27, 60
2, 14:34:00-000, 753, 360, 393, 360, 1351.75, 311, 1350.99, 56
2, 14:35:00-000, 357, 192, 165, 192, 1352.88, 160, 1351.70, 37
2, 14:36:00-000, 569, 212, 357, 212, 1350.88, 219, 1350.22, 71
2, 14:37:00-000, 330, 143, 187, 143, 1352.55, 131, 1351.55, 75
2, 14:38:00-000, 641, 286, 355, 286, 1352.05, 237, 1351.73, 72
2, 14:39:00-000, 307, 108, 199, 108, 1351.24, 134, 1350.81, 106
2, 14:40:00-000, 692, 293, 399, 293, 1351.86, 238, 1350.43, 119
2, 14:41:00-000, 318, 132, 186, 132, 1351.66, 139, 1351.28, 98
2, 14:42:00-000, 638, 268, 370, 268, 1351.83, 269, 1350.71, 76
2, 14:43:00-000, 291, 94, 197, 94, 1351.04, 126, 1349.85, 74
2, 14:44:00-000, 578, 227, 351, 227, 1352.29, 244, 1351.09, 123
2, 14:45:00-000, 371, 150, 221, 150, 1351.99, 189, 1351.07, 70
2, 14:46:00-000, 637, 307, 330, 307, 1351.90, 258, 1350.85, 56
2, 14:47:00-000, 294, 124, 170, 124, 1351.00, 146, 1350.30, 56
2, 14:48:00-000, 577, 225, 352, 225, 1351.82, 225, 1350.22, 47
2, 14:49:00-000, 244, 131, 113, 131, 1352.61, 116, 1352.08, 74
2, 14:50:00-000, 617, 260, 357, 260, 1352.31, 300, 1350.49, 56
2, 14:51:00-000, 296, 134, 162, 134, 1352.18, 119, 1350.05, 39
2, 14:52:00-000, 611, 248, 363, 248, 1352.13, 303, 1351.51, 19
2, 14:53:00-000, 324, 127, 197, 127, 1352.62, 155, 1351.44, 61
2, 14:54:00-000, 670, 258, 412, 258, 1352.21, 310, 1350.93, 75
2, 14:55:00-000, 335, 125, 210, 125, 1352.08, 158, 1350.77, 65
2, 14:56:00-000, 595, 297, 298, 297, 1352.50, 282, 1350.94, 51
2, 14:57:00-000, 272, 137, 135, 137, 1353.08, 97, 1351.71, 43
2, 14:58:00-000, 648, 296, 352, 296, 1352.61, 291, 1351.99, 64
2, 14:59:00-000, 326, 148, 178, 148, 1353.83, 170, 1352.10, 22
2, 15:00:00-000, 756, 328, 428, 328, 1351.48, 310, 1350.96, 50
2, 15:01:00-000, 286, 149, 137, 149, 1352.28, 117, 1350.75, 73
2, 15:02:00-000, 569, 252, 317, 252, 1351.78, 248, 1350.47, 47
2, 15:03:00-000, 275, 122, 153, 122, 1352.42, 129, 1351.26, 42
2, 15:04:00-000, 604, 261, 343, 261, 1351.31, 252, 1350.49, 58
2, 15:05:00-000, 296, 142, 154, 142, 1352.78, 132, 1351.80, 46
2, 15:06:00-000, 704, 351, 353, 351, 1353.01, 296, 1351.22, 57
2, 15:07:00-000, 296, 139, 157, 139, 1352.80, 134, 1351.51, 35
2, 15:08:00-000, 556, 268, 288, 268, 1353.77, 251, 1352.54, 38
2, 15:09:00-000, 236, 99, 137, 99, 1352.04, 82, 1350.85, 39
2, 15:10:00-000, 585, 235, 350, 235, 1351.40, 224, 1350.75, 55
2, 15:11:00-000, 329, 146, 183, 146, 1351.76, 138, 1350.37, 102
2, 15:12:00-000, 629, 270, 359, 270, 1350.78, 281, 1350.37, 67
2, 15:13:00-000, 274, 112, 162, 112, 1352.85, 131, 1351.12, 68
2, 15:14:00-000, 548, 223, 325, 223, 1352.15, 249, 1351.15, 45
2, 15:15:00-000, 284, 107, 177, 107, 1350.96, 119, 1350.52, 61
2, 15:16:00-000, 723, 331, 392, 331, 1351.78, 331, 1351.24, 72
2, 15:17:00-000, 253, 87, 166, 87, 1351.63, 120, 1350.64, 59
2, 15:18:00-000, 697, 316, 381, 316, 1352.58, 286, 1350.67, 52
2, 15:19:00-000, 285, 114, 171, 114, 1352.25, 114, 1351.24, 72
2, 15:20:00-000, 649, 261, 388, 261, 1351.21, 326, 1350.72, 56
2, 15:21:00-000, 309, 122, 187, 122, 1351.38, 124, 1351.49, 71
2, 15:22:00-000, 660, 272, 388, 272, 1352.32, 303, 1351.08, 73
2, 15:23:00-000, 265, 90, 175, 90, 1351.41, 107, 1350.75, 70
2, 15:24:00-000, 632, 311, 321, 311, 1352.95, 281, 1351.71, 58
2, 15:25:00-000, 339, 149, 190, 149, 1351.93, 133, 1350.70, 49
2, 15:26:00-000, 604, 277, 327, 277, 1352.77, 269, 1351.71, 60
2, 15:27:00-000, 343, 145, 198, 145, 1351.00, 120, 1351.77, 68
2, 15:28:00-000, 703, 312, 391, 312, 1352.73, 315, 1351.75, 75
2, 15:29:00-000, 355, 160, 195, 160, 1352.76, 148, 1351.94, 81
2, 15:30:00-000, 629, 240, 389, 240, 1352.49, 285, 1351.23, 43
2, 15:31:00-000, 343, 120, 223, 120, 1351.40, 121, 1350.18, 103
2, 15:32:00-000, 607, 290, 317, 290, 1352.16, 274, 1351.63, 95
2, 15:33:00-000, 324, 124, 200, 124, 1351.20, 108, 1351.08, 52
2, 15:34:00-000, 704, 293, 411, 293, 1351.72, 315, 1351.39, 94
2, 15:35:00-000, 301, 119, 182, 119, 1352.08, 128, 1351.63, 85
2, 15:36:00-000, 604, 285, 319, 285, 1352.87, 262, 1351.18, 79
2, 15:37:00-000, 345, 178, 167, 178, 1352.91, 143, 1352.05, 34
2, 15:38:00-000, 625, 300, 325, 300, 1353.25, 287, 1351.70, 26
2, 15:39:00-000, 392, 166, 226, 166, 1351.81, 169, 1351.81, 44
2, 15:40:00-000, 603, 237, 366, 237, 1351.91, 226, 1349.83, 100
2, 15:41:00-000, 309, 126, 183, 126, 1352.16, 126, 1350.80, 82
2, 15:42:00-000, 608, 280, 328, 280, 1352.51, 195, 1350.73, 99
2, 15:43:00-000, 255, 115, 140, 115, 1351.93, 98, 1350.06, 92
2, 15:44:00-000, 618, 250, 368, 250, 1351.75, 277, 1351.39, 52
2, 15:45:00-000, 356, 160, 196, 160, 1352.53, 148, 1351.24, 83
2, 15:46:00-000, 621, 269, 352, 269, 1352.16, 263, 1350.34, 73
2, 15:47:00-000, 265, 126, 139, 126, 1352.95, 99, 1351.19, 74
2, 15:48:00-000, 608, 239, 369, 239, 1351.61, 270, 1350.80, 45
2, 15:49:00-000, 293, 111, 182, 111, 1352.00, 122, 1350.83, 92
2, 15:50:00-000, 577, 245, 332, 245, 1352.52, 227, 1350.66, 79
2, 15:51:00-000, 325, 121, 204, 121, 1352.05, 156, 1350.90, 68
2, 15:52:00-000, 595, 237, 358, 237, 1352.68, 274, 1351.57, 69
2, 15:53:00-000, 331, 132, 199, 132, 1352.98, 143, 1351.34, 85
2, 15:54:00-000, 670, 251, 419, 251, 1351.57, 321, 1350.47, 68
2, 15:55:00-000, 254, 91, 163, 91, 1350.89, 101, 1350.41, 85
2, 15:56:00-000, 640, 278, 362, 278, 1352.52, 271, 1351.37, 70
2, 15:57:00-000, 250, 116, 134, 116, 1353.38, 104, 1350.73, 87
2, 15:58:00-000, 643, 296, 347, 296, 1352.70, 248, 1351.71, 53
2, 15:59:00-000, 371, 170, 201, 170, 1351.87, 176, 1351.56, 68
2, 16:00:00-000, 605, 295, 310, 295, 1352.75, 237, 1350.88, 43
2, 16:01:00-000, 358, 126, 232, 126, 1351.47, 138, 1350.42, 55
2, 16:02:00-000, 593, 229, 364, 229, 1352.12, 192, 1350.80, 119
2, 16:03:00-000, 315, 109, 206, 109, 1351.56, 137, 1350.90, 117
2, 16:04:00-000, 613, 252, 361, 252, 1352.02, 255, 1351.02, 106
2, 16:05:00-000, 314, 123, 191, 123, 1351.95, 131, 1351.24, 92
2, 16:06:00-000, 627, 291, 336, 291, 1353.13, 273, 1351.51, 71
2, 16:07:00-000, 256, 89, 167, 89, 1353.25, 125, 1350.71, 58
2, 16:08:00-000, 645, 244, 401, 244, 1351.31, 298, 1350.22, 56
2, 16:09:00-000, 369, 153, 216, 153, 1352.60, 138, 1351.63, 96
2, 16:10:00-000, 586, 230, 356, 230, 1351.88, 240, 1350.60, 82
2, 16:11:00-000, 327, 161, 166, 161, 1352.16, 131, 1351.42, 86
2, 16:12:00-000, 634, 265, 369, 265, 1352.11, 247, 1351.19, 89
2, 16:13:00-000, 337, 146, 191, 146, 1351.49, 154, 1351.05, 93
2, 16:14:00-000, 651, 266, 385, 266, 1350.95, 297, 1350.30, 49
2, 16:15:00-000, 273, 118, 155, 118, 1350.73, 111, 1349.62, 78
2, 16:16:00-000, 607, 211, 396, 211, 1351.66, 260, 1350.72, 51
2, 16:17:00-000, 272, 111, 161, 111, 1351.55, 112, 1351.25, 108
2, 16:18:00-000, 654, 330, 324, 330, 1352.77, 289, 1351.96, 54
2, 16:19:00-000, 332, 187, 145, 187, 1353.57, 136, 1351.99, 36
2, 16:20:00-000, 625, 213, 412, 213, 1352.00, 287, 1350.39, 30
2, 16:21:00-000, 285, 109, 176, 109, 1351.79, 139, 1351.55, 94
2, 16:22:00-000, 565, 248, 317, 248, 1351.96, 269, 1351.06, 56
2, 16:23:00-000, 285, 126, 159, 126, 1351.73, 112, 1350.96, 40
2, 16:24:00-000, 652, 313, 339, 313, 1352.33, 273, 1351.93, 52
2, 16:25:00-000, 338, 153, 185, 153, 1353.19, 156, 1350.57, 75
2, 16:26:00-000, 647, 235, 412, 235, 1352.01, 270, 1351.19, 44
2, 16:27:00-000, 338, 166, 172, 166, 1351.55, 144, 1351.19, 91
2, 16:28:00-000, 605, 296, 309, 296, 1352.03, 227, 1351.44, 82
2, 16:29:00-000, 280, 118, 162, 118, 1351.81, 105, 1350.22, 64
3, 09:00:00-000, 208, 198, 10, 1, 1349.00, 1, 1349.00, 203
3, 09:01:00-000, 184, 184, 0, 0, 0.00, 0, 0.00, 182
3, 09:02:00-000, 199, 199, 0, 0, 0.00, 0, 0.00, 204
3, 09:03:00-000, 193, 193, 0, 0, 0.00, 0, 0.00, 192
3, 09:04:00-000, 216, 216, 0, 0, 0.00, 0, 0.00, 205
3, 09:05:00-000, 190, 190, 0, 0, 0.00, 0, 0.00, 197
3, 09:06:00-000, 206, 206, 0, 0, 0.00, 0, 0.00, 205
3, 09:07:00-000, 181, 181, 0, 0, 0.00, 0, 0.00, 181
3, 09:08:00-000, 182, 182, 0, 0, 0.00, 0, 0.00, 182
3, 09:09:00-000, 214, 214, 0, 0, 0.00, 0, 0.00, 211
3, 09:10:00-000, 206, 206, 0, 0, 0.00, 0, 0.00, 209
3, 09:11:00-000, 204, 204, 0, 0, 0.00, 0, 0.00, 203
3, 09:12:00-000, 220, 220, 0, 1, 1490.00, 0, 0.00, 219
3, 09:13:00-000, 220, 220, 0, 10, 1511.10, 0, 0.00, 208
3, 09:14:00-000, 169, 169, 0, 1, 1354.00, 0, 0.00, 172
3, 09:15:00-000, 197, 190, 7, 7, 1352.00, 6, 1356.00, 185
3, 09:16:00-000, 187, 181, 6, 16, 1359.06, 6, 1354.83, 167
3, 09:17:00-000, 236, 232, 4, 4, 1353.50, 4, 1356.75, 215
3, 09:18:00-000, 208, 175, 33, 17, 1352.65, 13, 1355.00, 183
3, 09:19:00-000, 200, 182, 18, 13, 1358.92, 10, 1356.50, 185
3, 09:20:00-000, 216, 200, 16, 10, 1359.80, 8, 1366.87, 188
3, 09:21:00-000, 205, 161, 44, 7, 1345.00, 5, 1351.00, 198
3, 09:22:00-000, 228, 205, 23, 14, 1348.93, 11, 1353.09, 203
3, 09:23:00-000, 190, 171, 19, 2, 1349.00, 0, 0.00, 192
3, 09:24:00-000, 207, 185, 22, 5, 1348.60, 7, 1350.71, 189
3, 09:25:00-000, 221, 164, 57, 12, 1349.33, 18, 1351.17, 196
3, 09:26:00-000, 198, 169, 29, 11, 1354.09, 15, 1360.06, 163
3, 09:27:00-000, 187, 167, 20, 13, 1352.61, 6, 1355.00, 181
3, 09:28:00-000, 218, 177, 41, 5, 1349.20, 2, 1351.50, 205
3, 09:29:00-000, 222, 172, 50, 7, 1347.57, 4, 1351.75, 210
3, 09:30:00-000, 188, 144, 44, 19, 1346.63, 6, 1350.83, 168
3, 09:31:00-000, 210, 140, 70, 4, 1356.25, 18, 1356.16, 171
3, 09:32:00-000, 193, 140, 53, 11, 1349.18, 11, 1351.73, 179
3, 09:33:00-000, 187, 138, 49, 12, 1349.75, 8, 1351.62, 165
3, 09:34:00-000, 196, 132, 64, 14, 1349.14, 13, 1352.69, 176
3, 09:35:00-000, 187, 166, 21, 3, 1347.67, 7, 1351.71, 177
3, 09:36:00-000, 211, 173, 38, 10, 1349.40, 7, 1353.57, 199
3, 09:37:00-000, 192, 165, 27, 10, 1352.10, 4, 1354.50, 179
3, 09:38:00-000, 201, 151, 50, 2, 1350.00, 10, 1350.40, 183
3, 09:39:00-000, 202, 180, 22, 4, 1350.00, 1, 1353.00, 194
3, 09:40:00-000, 216, 170, 46, 17, 1348.41, 14, 1351.21, 194
3, 09:41:00-000, 219, 122, 97, 22, 1347.04, 11, 1349.00, 181
3, 09:42:00-000, 220, 126, 94, 13, 1350.92, 27, 1351.48, 184
3, 09:43:00-000, 200, 128, 72, 1, 1350.00, 13, 1350.61, 186
3, 09:44:00-000, 186, 155, 31, 7, 1350.43, 11, 1351.27, 167
3, 09:45:00-000, 205, 166, 39, 0, 0.00, 3, 1348.67, 193
3, 09:46:00-000, 190, 151, 39, 8, 1347.62, 7, 1350.86, 181
3, 09:47:00-000, 184, 172, 12, 6, 1348.50, 6, 1353.17, 171
3, 09:48:00-000, 178, 135, 43, 17, 1349.59, 2, 1351.00, 160
3, 09:49:00-000, 177, 155, 22, 8, 1349.62, 11, 1351.36, 152
3, 09:50:00-000, 200, 157, 43, 14, 1346.71, 18, 1350.67, 179
3, 09:51:00-000, 177, 159, 18, 9, 1348.89, 7, 1353.00, 160
3, 09:52:00-000, 231, 196, 35, 27, 1351.59, 6, 1352.33, 197
3, 09:53:00-000, 222, 156, 66, 11, 1349.27, 22, 1351.72, 190
3, 09:54:00-000, 172, 125, 47, 12, 1350.66, 17, 1351.64, 140
3, 09:55:00-000, 220, 185, 35, 4, 1351.00, 7, 1352.28, 205
3, 09:56:00-000, 196, 159, 37, 8, 1349.75, 3, 1352.33, 180
3, 09:57:00-000, 206, 169, 37, 5, 1348.80, 9, 1351.55, 203
3, 09:58:00-000, 209, 166, 43, 8, 1348.62, 14, 1350.86, 187
3, 09:59:00-000, 247, 225, 22, 13, 1351.54, 8, 1351.75, 213
3, 10:00:00-000, 211, 112, 99, 35, 1349.23, 11, 1351.54, 176
3, 10:01:00-000, 194, 107, 87, 7, 1351.00, 15, 1350.93, 165
3, 10:02:00-000, 214, 131, 83, 15, 1348.07, 8, 1352.12, 202
3, 10:03:00-000, 211, 118, 93, 6, 1346.83, 7, 1350.00, 195
3, 10:04:00-000, 200, 93, 107, 7, 1347.57, 8, 1350.62, 187
3, 10:05:00-000, 185, 110, 75, 6, 1349.00, 28, 1352.14, 150
3, 10:06:00-000, 220, 169, 51, 14, 1348.14, 16, 1351.43, 192
3, 10:07:00-000, 201, 160, 41, 9, 1349.89, 2, 1351.00, 189
3, 10:08:00-000, 195, 145, 50, 2, 1349.50, 12, 1351.25, 180
3, 10:09:00-000, 200, 171, 29, 2, 1349.00, 2, 1350.00, 190
3, 10:10:00-000, 192, 173, 19, 8, 1346.25, 8, 1350.38, 177
3, 10:11:00-000, 183, 180, 3, 4, 1351.25, 2, 1352.00, 182
3, 10:12:00-000, 212, 185, 27, 10, 1350.90, 9, 1352.11, 186
3, 10:13:00-000, 171, 138, 33, 12, 1350.33, 17, 1353.00, 146
3, 10:14:00-000, 223, 189, 34, 17, 1347.65, 10, 1350.90, 198
3, 10:15:00-000, 189, 129, 60, 4, 1346.50, 9, 1350.67, 165
3, 10:16:00-000, 207, 172, 35, 5, 1348.80, 16, 1350.81, 195
3, 10:17:00-000, 215, 207, 8, 2, 1350.50, 3, 1350.67, 214
3, 10:18:00-000, 207, 176, 31, 9, 1349.66, 2, 1350.50, 195
3, 10:19:00-000, 246, 216, 30, 1, 1349.00, 3, 1350.00, 239
3, 10:20:00-000, 212, 196, 16, 14, 1352.50, 4, 1352.00, 196
3, 10:21:00-000, 201, 167, 34, 7, 1353.00, 5, 1351.00, 182
3, 10:22:00-000, 242, 201, 41, 11, 1348.36, 8, 1351.50, 224
3, 10:23:00-000, 203, 158, 45, 7, 1349.29, 12, 1350.58, 185
3, 10:24:00-000, 152, 128, 24, 10, 1348.60, 13, 1351.31, 134
3, 10:25:00-000, 169, 140, 29, 6, 1349.33, 10, 1351.00, 155
3, 10:26:00-000, 211, 177, 34, 10, 1348.10, 4, 1353.75, 194
3, 10:27:00-000, 206, 174, 32, 3, 1347.00, 3, 1350.00, 196
3, 10:28:00-000, 210, 137, 73, 21, 1350.24, 14, 1352.28, 178
3, 10:29:00-000, 164, 118, 46, 1, 1352.00, 6, 1351.67, 161
3, 10:30:00-000, 227, 183, 44, 9, 1348.33, 13, 1350.77, 195
3, 10:31:00-000, 229, 194, 35, 2, 1348.50, 1, 1350.00, 227
3, 10:32:00-000, 216, 206, 10, 8, 1347.00, 11, 1349.91, 199
3, 10:33:00-000, 179, 142, 37, 12, 1349.42, 5, 1350.60, 167
3, 10:34:00-000, 186, 155, 31, 8, 1347.88, 8, 1351.62, 167
3, 10:35:00-000, 204, 182, 22, 1, 1352.00, 5, 1351.60, 187
3, 10:36:00-000, 207, 141, 66, 28, 1349.50, 10, 1351.80, 178
3, 10:37:00-000, 208, 143, 65, 9, 1347.22, 12, 1351.41, 191
3, 10:38:00-000, 174, 122, 52, 8, 1347.88, 12, 1351.83, 154
3, 10:39:00-000, 226, 188, 38, 4, 1348.00, 12, 1351.08, 207
3, 10:40:00-000, 188, 184, 4, 6, 1348.17, 4, 1350.50, 182
3, 10:41:00-000, 196, 184, 12, 6, 1348.00, 8, 1352.62, 183
3, 10:42:00-000, 244, 178, 66, 18, 1348.89, 17, 1350.82, 204
3, 10:43:00-000, 211, 183, 28, 0, 0.00, 2, 1352.00, 204
3, 10:44:00-000, 221, 169, 52, 17, 1350.70, 21, 1351.33, 187
3, 10:45:00-000, 221, 186, 35, 8, 1349.87, 12, 1353.33, 188
3, 10:46:00-000, 217, 182, 35, 14, 1350.36, 6, 1351.33, 212
3, 10:47:00-000, 195, 156, 39, 3, 1351.00, 13, 1352.54, 183
3, 10:48:00-000, 201, 189, 12, 8, 1349.75, 1, 1353.00, 192
3, 10:49:00-000, 211, 196, 15, 4, 1347.50, 6, 1351.83, 201
3, 10:50:00-000, 211, 183, 28, 15, 1347.87, 1, 1351.00, 188
3, 10:51:00-000, 234, 188, 46, 9, 1350.00, 12, 1352.66, 219
3, 10:52:00-000, 228, 177, 51, 4, 1349.00, 11, 1351.09, 210
3, 10:53:00-000, 192, 149, 43, 7, 1348.71, 13, 1351.61, 165
3, 10:54:00-000, 215, 185, 30, 8, 1348.62, 2, 1350.00, 217
3, 10:55:00-000, 182, 118, 64, 5, 1348.40, 3, 1351.00, 162
3, 10:56:00-000, 218, 148, 70, 15, 1350.00, 7, 1352.71, 186
3, 10:57:00-000, 186, 145, 41, 9, 1349.44, 23, 1351.60, 174
3, 10:58:00-000, 215, 195, 20, 14, 1349.28, 10, 1350.80, 183
3, 10:59:00-000, 186, 173, 13, 5, 1349.80, 2, 1353.00, 190
3, 11:00:00-000, 196, 137, 59, 15, 1348.13, 3, 1350.00, 170
3, 11:01:00-000, 206, 128, 78, 1, 1348.00, 0, 0.00, 212
3, 11:02:00-000, 213, 150, 63, 1, 1349.00, 7, 1350.71, 186
3, 11:03:00-000, 194, 156, 38, 1, 1351.00, 11, 1350.18, 194
3, 11:04:00-000, 205, 163, 42, 23, 1348.82, 12, 1351.16, 170
3, 11:05:00-000, 187, 135, 52, 4, 1347.00, 2, 1351.00, 182
3, 11:06:00-000, 185, 141, 44, 10, 1347.90, 5, 1350.00, 170
3, 11:07:00-000, 215, 127, 88, 1, 1350.00, 7, 1350.57, 211
3, 11:08:00-000, 170, 116, 54, 11, 1348.00, 12, 1350.83, 139
3, 11:09:00-000, 195, 140, 55, 7, 1348.43, 6, 1352.67, 191
3, 11:10:00-000, 194, 138, 56, 5, 1350.60, 9, 1350.89, 180
3, 11:11:00-000, 195, 158, 37, 5, 1349.00, 10, 1351.20, 176
3, 11:12:00-000, 200, 140, 60, 16, 1348.00, 8, 1350.00, 179
3, 11:13:00-000, 194, 160, 34, 9, 1348.00, 10, 1352.20, 172
3, 11:14:00-000, 196, 153, 43, 7, 1352.00, 19, 1351.31, 170
3, 11:15:00-000, 219, 202, 17, 18, 1348.55, 4, 1351.50, 197
3, 11:16:00-000, 212, 184, 28, 16, 1347.31, 3, 1351.00, 196
3, 11:17:00-000, 192, 94, 98, 10, 1349.80, 11, 1352.54, 170
3, 11:18:00-000, 184, 114, 70, 13, 1347.61, 20, 1351.35, 154
3, 11:19:00-000, 190, 135, 55, 2, 1349.00, 12, 1350.17, 166
3, 11:20:00-000, 218, 200, 18, 4, 1352.00, 12, 1353.33, 212
3, 11:21:00-000, 195, 167, 28, 9, 1350.22, 4, 1350.25, 182
3, 11:22:00-000, 196, 169, 27, 8, 1347.87, 13, 1349.77, 171
3, 11:23:00-000, 209, 188, 21, 14, 1350.00, 9, 1354.78, 186
3, 11:24:00-000, 210, 177, 33, 3, 1347.33, 7, 1351.00, 194
3, 11:25:00-000, 214, 189, 25, 12, 1346.92, 7, 1351.00, 198
3, 11:26:00-000, 188, 141, 47, 23, 1348.43, 6, 1350.67, 159
3, 11:27:00-000, 187, 117, 70, 1, 1347.00, 24, 1351.58, 164
3, 11:28:00-000, 193, 186, 7, 4, 1350.00, 3, 1352.67, 186
3, 11:29:00-000, 183, 161, 22, 11, 1347.00, 8, 1351.13, 166
3, 11:30:00-000, 188, 124, 64, 18, 1348.33, 7, 1350.71, 159
3, 11:31:00-000, 217, 148, 69, 6, 1346.00, 16, 1351.93, 196
3, 11:32:00-000, 184, 129, 55, 12, 1349.92, 12, 1351.16, 166
3, 11:33:00-000, 194, 142, 52, 12, 1352.25, 9, 1352.66, 171
3, 11:34:00-000, 193, 163, 30, 20, 1350.10, 9, 1352.89, 166
3, 11:35:00-000, 222, 164, 58, 3, 1348.33, 10, 1350.50, 209
3, 11:36:00-000, 194, 134, 60, 18, 1348.22, 5, 1350.20, 166
3, 11:37:00-000, 184, 133, 51, 2, 1351.00, 21, 1351.76, 167
3, 11:38:00-000, 191, 150, 41, 8, 1348.37, 10, 1352.10, 172
3, 11:39:00-000, 197, 181, 16, 9, 1348.78, 8, 1350.87, 175
3, 11:40:00-000, 213, 205, 8, 6, 1349.33, 6, 1352.17, 200
3, 11:41:00-000, 176, 151, 25, 10, 1348.00, 2, 1350.50, 166
3, 11:42:00-000, 190, 152, 38, 6, 1347.83, 4, 1349.75, 174
3, 11:43:00-000, 204, 155, 49, 3, 1349.33, 4, 1350.00, 204
3, 11:44:00-000, 197, 121, 76, 14, 1347.28, 21, 1351.76, 164
3, 11:45:00-000, 211, 142, 69, 24, 1348.58, 18, 1351.66, 167
3, 11:46:00-000, 213, 158, 55, 12, 1347.75, 15, 1351.40, 185
3, 11:47:00-000, 186, 132, 54, 8, 1349.37, 15, 1352.60, 162
3, 11:48:00-000, 221, 161, 60, 26, 1347.77, 12, 1351.17, 186
3, 11:49:00-000, 202, 126, 76, 5, 1349.80, 7, 1353.57, 186
3, 11:50:00-000, 205, 158, 47, 23, 1350.21, 27, 1352.81, 155
3, 11:51:00-000, 227, 204, 23, 12, 1350.42, 2, 1352.00, 203
3, 11:52:00-000, 198, 128, 70, 19, 1347.47, 3, 1349.33, 192
3, 11:53:00-000, 202, 113, 89, 3, 1348.00, 7, 1350.71, 190
3, 11:54:00-000, 185, 106, 79, 8, 1347.87, 8, 1350.75, 171
3, 11:55:00-000, 209, 113, 96, 7, 1348.28, 15, 1352.06, 182
3, 11:56:00-000, 209, 134, 75, 7, 1348.00, 19, 1351.68, 185
3, 11:57:00-000, 215, 162, 53, 11, 1349.09, 15, 1351.60, 192
3, 11:58:00-000, 237, 178, 59, 10, 1349.50, 17, 1352.23, 203
3, 11:59:00-000, 199, 169, 30, 3, 1354.00, 17, 1353.29, 175
3, 12:00:00-000, 216, 190, 26, 20, 1348.65, 12, 1350.58, 196
3, 12:01:00-000, 201, 185, 16, 5, 1349.40, 3, 1351.67, 190
3, 12:02:00-000, 214, 197, 17, 20, 1350.60, 4, 1353.25, 188
3, 12:03:00-000, 232, 177, 55, 14, 1348.93, 13, 1351.46, 208
3, 12:04:00-000, 221, 154, 67, 9, 1349.44, 20, 1351.20, 191
3, 12:05:00-000, 229, 165, 64, 2, 1347.50, 8, 1350.88, 215
3, 12:06:00-000, 197, 169, 28, 19, 1347.47, 8, 1351.37, 166
3, 12:07:00-000, 181, 144, 37, 1, 1349.00, 12, 1351.92, 179
3, 12:08:00-000, 216, 195, 21, 12, 1347.00, 5, 1353.00, 190
3, 12:09:00-000, 181, 145, 36, 9, 1348.11, 2, 1350.00, 177
3, 12:10:00-000, 175, 107, 68, 19, 1346.94, 15, 1351.26, 143
3, 12:11:00-000, 214, 163, 51, 4, 1349.50, 18, 1351.89, 184
3, 12:12:00-000, 203, 183, 20, 2, 1348.50, 3, 1350.67, 202
3, 12:13:00-000, 194, 171, 23, 11, 1352.00, 11, 1352.73, 172
3, 12:14:00-000, 192, 132, 60, 9, 1348.78, 13, 1351.84, 172
3, 12:15:00-000, 187, 151, 36, 10, 1347.20, 6, 1351.33, 170
3, 12:16:00-000, 209, 159, 50, 7, 1348.00, 4, 1350.75, 197
3, 12:17:00-000, 177, 155, 22, 5, 1350.00, 15, 1352.27, 156
3, 12:18:00-000, 197, 174, 23, 16, 1347.94, 4, 1353.25, 180
3, 12:19:00-000, 184, 156, 28, 2, 1348.50, 8, 1350.87, 172
3, 12:20:00-000, 214, 169, 45, 18, 1347.33, 5, 1350.00, 188
3, 12:21:00-000, 183, 139, 44, 2, 1350.00, 2, 1350.00, 179
3, 12:22:00-000, 186, 136, 50, 12, 1348.50, 7, 1351.14, 167
3, 12:23:00-000, 210, 182, 28, 7, 1349.57, 13, 1351.15, 196
3, 12:24:00-000, 217, 193, 24, 16, 1348.75, 7, 1351.43, 194
3, 12:25:00-000, 185, 140, 45, 7, 1349.29, 10, 1352.10, 154
3, 12:26:00-000, 208, 156, 52, 6, 1346.83, 11, 1350.54, 203
3, 12:27:00-000, 203, 182, 21, 2, 1348.00, 6, 1351.17, 194
3, 12:28:00-000, 263, 221, 42, 9, 1349.33, 4, 1351.00, 253
3, 12:29:00-000, 219, 185, 34, 20, 1346.95, 5, 1351.80, 192
3, 12:30:00-000, 187, 129, 58, 5, 1348.20, 5, 1351.40, 171
3, 12:31:00-000, 232, 179, 53, 6, 1348.83, 6, 1350.67, 229
3, 12:32:00-000, 214, 125, 89, 10, 1349.00, 12, 1351.08, 190
3, 12:33:00-000, 198, 116, 82, 5, 1349.20, 21, 1349.28, 172
3, 12:34:00-000, 232, 191, 41, 16, 1349.37, 14, 1352.50, 187
3, 12:35:00-000, 184, 140, 44, 6, 1347.83, 0, 0.00, 193
3, 12:36:00-000, 199, 130, 69, 7, 1348.28, 24, 1349.83, 165
3, 12:37:00-000, 188, 155, 33, 8, 1351.00, 14, 1351.14, 170
3, 12:38:00-000, 179, 118, 61, 16, 1349.37, 9, 1351.00, 153
3, 12:39:00-000, 223, 172, 51, 3, 1353.33, 17, 1352.17, 203
3, 12:40:00-000, 214, 200, 14, 15, 1351.47, 3, 1352.33, 186
3, 12:41:00-000, 192, 173, 19, 13, 1348.61, 0, 0.00, 184
3, 12:42:00-000, 200, 135, 65, 11, 1347.27, 14, 1350.71, 180
3, 12:43:00-000, 191, 106, 85, 13, 1347.23, 7, 1350.86, 171
3, 12:44:00-000, 206, 103, 103, 6, 1347.50, 9, 1351.78, 192
3, 12:45:00-000, 194, 125, 69, 9, 1347.22, 14, 1351.07, 159
3, 12:46:00-000, 209, 129, 80, 21, 1347.62, 15, 1350.33, 184
3, 12:47:00-000, 162, 103, 59, 5, 1348.00, 5, 1350.20, 151
3, 12:48:00-000, 211, 131, 80, 11, 1347.82, 23, 1350.48, 177
3, 12:49:00-000, 179, 147, 32, 5, 1351.20, 12, 1351.00, 163
3, 12:50:00-000, 205, 165, 40, 20, 1350.40, 2, 1352.00, 181
3, 12:51:00-000, 192, 128, 64, 9, 1348.89, 4, 1352.00, 172
3, 12:52:00-000, 193, 103, 90, 5, 1346.00, 8, 1350.13, 180
3, 12:53:00-000, 203, 153, 50, 10, 1349.10, 25, 1351.52, 177
3, 12:54:00-000, 226, 185, 41, 6, 1349.17, 10, 1350.60, 211
3, 12:55:00-000, 238, 185, 53, 11, 1348.54, 11, 1350.27, 209
3, 12:56:00-000, 215, 146, 69, 16, 1346.81, 15, 1351.20, 190
3, 12:57:00-000, 202, 145, 57, 6, 1348.67, 11, 1350.63, 176
3, 12:58:00-000, 168, 107, 61, 13, 1347.07, 6, 1351.00, 147
3, 12:59:00-000, 216, 127, 89, 15, 1346.73, 17, 1350.65, 195
3, 13:00:00-000, 210, 167, 43, 5, 1347.60, 8, 1350.37, 197
3, 13:01:00-000, 209, 158, 51, 8, 1348.50, 20, 1351.80, 179
3, 13:02:00-000, 251, 233, 18, 6, 1347.83, 1, 1350.00, 240
3, 13:03:00-000, 168, 145, 23, 8, 1347.62, 5, 1353.20, 160
3, 13:04:00-000, 212, 153, 59, 22, 1347.59, 10, 1351.50, 181
3, 13:05:00-000, 231, 209, 22, 5, 1350.80, 12, 1352.25, 206
3, 13:06:00-000, 208, 174, 34, 28, 1348.25, 4, 1352.00, 185
3, 13:07:00-000, 243, 139, 104, 6, 1349.00, 9, 1351.44, 228
3, 13:08:00-000, 205, 156, 49, 16, 1347.25, 17, 1353.23, 168
3, 13:09:00-000, 232, 166, 66, 10, 1349.10, 3, 1351.00, 222
3, 13:10:00-000, 212, 138, 74, 12, 1346.25, 8, 1350.37, 193
3, 13:11:00-000, 208, 105, 103, 7, 1353.00, 17, 1352.59, 177
3, 13:12:00-000, 233, 115, 118, 15, 1348.67, 9, 1351.11, 217
3, 13:13:00-000, 228, 109, 119, 8, 1348.25, 21, 1349.19, 193
3, 13:14:00-000, 182, 120, 62, 22, 1348.22, 19, 1351.68, 145
3, 13:15:00-000, 204, 115, 89, 19, 1347.10, 5, 1351.00, 182
3, 13:16:00-000, 216, 110, 106, 6, 1348.17, 30, 1350.76, 174
3, 13:17:00-000, 206, 154, 52, 9, 1348.67, 8, 1351.00, 193
3, 13:18:00-000, 194, 135, 59, 21, 1347.81, 3, 1350.33, 170
3, 13:19:00-000, 207, 78, 129, 2, 1350.00, 2, 1351.00, 197
3, 13:20:00-000, 200, 142, 58, 12, 1349.67, 23, 1352.21, 170
3, 13:21:00-000, 180, 155, 25, 5, 1349.60, 11, 1351.64, 165
3, 13:22:00-000, 193, 151, 42, 13, 1349.46, 4, 1350.50, 168
3, 13:23:00-000, 178, 151, 27, 9, 1349.56, 8, 1351.75, 170
3, 13:24:00-000, 162, 106, 56, 11, 1348.00, 21, 1351.43, 125
3, 13:25:00-000, 203, 163, 40, 2, 1349.00, 1, 1351.00, 205
3, 13:26:00-000, 210, 177, 33, 21, 1348.24, 6, 1351.67, 183
3, 13:27:00-000, 240, 164, 76, 2, 1348.50, 11, 1350.00, 214
3, 13:28:00-000, 223, 183, 40, 13, 1348.23, 12, 1351.92, 209
3, 13:29:00-000, 214, 165, 49, 16, 1350.31, 15, 1352.67, 179
3, 13:30:00-000, 215, 159, 56, 7, 1348.43, 6, 1352.50, 207
3, 13:31:00-000, 204, 125, 79, 1, 1349.00, 4, 1350.00, 200
3, 13:32:00-000, 199, 124, 75, 9, 1346.67, 5, 1350.40, 184
3, 13:33:00-000, 207, 120, 87, 5, 1348.80, 28, 1350.78, 171
3, 13:34:00-000, 195, 150, 45, 17, 1348.47, 18, 1351.22, 159
3, 13:35:00-000, 170, 150, 20, 4, 1346.25, 6, 1352.17, 165
3, 13:36:00-000, 202, 186, 16, 13, 1347.69, 10, 1351.40, 178
3, 13:37:00-000, 184, 163, 21, 6, 1347.50, 7, 1351.14, 163
3, 13:38:00-000, 210, 173, 37, 12, 1348.33, 6, 1350.67, 196
3, 13:39:00-000, 183, 118, 65, 0, 0.00, 2, 1350.00, 183
3, 13:40:00-000, 219, 153, 66, 15, 1348.07, 6, 1351.33, 195
3, 13:41:00-000, 185, 128, 57, 20, 1348.75, 10, 1351.30, 160
3, 13:42:00-000, 182, 116, 66, 10, 1348.20, 12, 1352.08, 155
3, 13:43:00-000, 190, 109, 81, 10, 1349.20, 6, 1350.33, 176
3, 13:44:00-000, 194, 160, 34, 15, 1350.07, 18, 1350.83, 162
3, 13:45:00-000, 190, 143, 47, 10, 1349.10, 13, 1350.77, 166
3, 13:46:00-000, 187, 138, 49, 23, 1348.39, 15, 1351.26, 151
3, 13:47:00-000, 190, 101, 89, 4, 1348.00, 8, 1350.75, 176
3, 13:48:00-000, 173, 132, 41, 8, 1350.87, 16, 1351.50, 146
3, 13:49:00-000, 156, 126, 30, 12, 1348.83, 3, 1353.33, 144
3, 13:50:00-000, 189, 133, 56, 13, 1346.84, 3, 1351.00, 178
3, 13:51:00-000, 195, 95, 100, 13, 1346.54, 6, 1350.00, 172
3, 13:52:00-000, 210, 140, 70, 12, 1349.33, 30, 1352.33, 161
3, 13:53:00-000, 197, 123, 74, 17, 1348.17, 14, 1350.14, 172
3, 13:54:00-000, 221, 129, 92, 11, 1347.45, 16, 1351.19, 196
3, 13:55:00-000, 208, 189, 19, 2, 1353.00, 7, 1352.14, 192
3, 13:56:00-000, 192, 169, 23, 11, 1348.91, 7, 1351.86, 182
3, 13:57:00-000, 208, 192, 16, 6, 1349.17, 7, 1351.71, 196
3, 13:58:00-000, 242, 158, 84, 36, 1348.00, 15, 1352.33, 189
3, 13:59:00-000, 199, 125, 74, 1, 1350.00, 15, 1351.06, 179
3, 14:00:00-000, 219, 173, 46, 2, 1348.00, 18, 1350.78, 202
3, 14:01:00-000, 189, 149, 40, 4, 1347.75, 4, 1350.25, 182
3, 14:02:00-000, 219, 175, 44, 20, 1349.25, 8, 1352.50, 190
3, 14:03:00-000, 211, 108, 103, 4, 1349.25, 8, 1350.25, 194
3, 14:04:00-000, 219, 143, 76, 17, 1348.53, 15, 1350.86, 192
3, 14:05:00-000, 192, 146, 46, 2, 1348.50, 2, 1350.00, 191
3, 14:06:00-000, 201, 135, 66, 16, 1348.75, 11, 1351.00, 167
3, 14:07:00-000, 196, 137, 59, 10, 1348.90, 12, 1351.50, 175
3, 14:08:00-000, 222, 134, 88, 21, 1348.62, 16, 1352.06, 186
3, 14:09:00-000, 204, 137, 67, 12, 1348.17, 25, 1351.56, 173
3, 14:10:00-000, 188, 142, 46, 10, 1348.40, 6, 1352.50, 164
3, 14:11:00-000, 201, 132, 69, 1, 1345.00, 2, 1350.00, 204
3, 14:12:00-000, 183, 95, 88, 14, 1348.00, 6, 1350.50, 164
3, 14:13:00-000, 186, 119, 67, 3, 1346.67, 11, 1349.36, 170
3, 14:14:00-000, 203, 129, 74, 6, 1348.17, 8, 1351.50, 192
3, 14:15:00-000, 190, 137, 53, 7, 1349.14, 5, 1351.40, 178
3, 14:16:00-000, 179, 130, 49, 15, 1348.20, 13, 1351.38, 147
3, 14:17:00-000, 206, 170, 36, 5, 1349.00, 7, 1349.57, 196
3, 14:18:00-000, 228, 170, 58, 17, 1347.17, 16, 1350.12, 194
3, 14:19:00-000, 225, 161, 64, 4, 1348.50, 4, 1352.00, 214
3, 14:20:00-000, 190, 114, 76, 10, 1350.40, 12, 1351.75, 163
3, 14:21:00-000, 225, 148, 77, 3, 1348.33, 1, 1352.00, 231
3, 14:22:00-000, 223, 143, 80, 18, 1348.50, 16, 1351.81, 188
3, 14:23:00-000, 216, 157, 59, 8, 1350.37, 16, 1352.50, 183
3, 14:24:00-000, 193, 143, 50, 15, 1348.93, 23, 1352.43, 166
3, 14:25:00-000, 211, 198, 13, 8, 1351.87, 7, 1354.28, 190
3, 14:26:00-000, 216, 188, 28, 10, 1348.50, 1, 1350.00, 206
3, 14:27:00-000, 227, 178, 49, 17, 1350.35, 13, 1351.61, 200
3, 14:28:00-000, 219, 156, 63, 28, 1350.28, 27, 1351.48, 165
3, 14:29:00-000, 200, 159, 41, 10, 1348.50, 12, 1352.83, 171
3, 14:30:00-000, 205, 193, 12, 4, 1348.25, 11, 1350.73, 196
3, 14:31:00-000, 211, 154, 57, 12, 1348.33, 3, 1349.67, 197
3, 14:32:00-000, 192, 129, 63, 14, 1349.43, 9, 1352.00, 167
3, 14:33:00-000, 201, 160, 41, 5, 1345.80, 11, 1351.09, 184
3, 14:34:00-000, 228, 132, 96, 24, 1346.79, 18, 1351.28, 182
3, 14:35:00-000, 225, 142, 83, 10, 1349.20, 6, 1351.33, 215
3, 14:36:00-000, 216, 109, 107, 11, 1347.63, 18, 1351.27, 179
3, 14:37:00-000, 204, 139, 65, 9, 1348.00, 10, 1351.00, 185
3, 14:38:00-000, 228, 183, 45, 16, 1349.12, 15, 1352.60, 197
3, 14:39:00-000, 203, 161, 42, 0, 0.00, 7, 1350.86, 194
3, 14:40:00-000, 220, 163, 57, 23, 1348.09, 13, 1350.61, 195
3, 14:41:00-000, 200, 108, 92, 9, 1347.67, 4, 1351.00, 186
3, 14:42:00-000, 190, 85, 105, 12, 1346.08, 15, 1350.93, 161
3, 14:43:00-000, 218, 159, 59, 9, 1351.00, 11, 1351.36, 196
3, 14:44:00-000, 183, 166, 17, 14, 1349.28, 12, 1351.41, 163
3, 14:45:00-000, 185, 116, 69, 11, 1348.09, 11, 1351.64, 162
3, 14:46:00-000, 236, 179, 57, 10, 1346.50, 13, 1352.08, 209
3, 14:47:00-000, 192, 120, 72, 8, 1346.25, 6, 1351.33, 179
3, 14:48:00-000, 189, 112, 77, 9, 1349.00, 9, 1351.33, 163
3, 14:49:00-000, 185, 107, 78, 8, 1348.50, 5, 1351.60, 175
3, 14:50:00-000, 170, 106, 64, 21, 1347.28, 14, 1351.71, 142
3, 14:51:00-000, 209, 102, 107, 6, 1345.67, 13, 1350.15, 189
3, 14:52:00-000, 213, 118, 95, 11, 1348.82, 14, 1350.43, 185
3, 14:53:00-000, 203, 141, 62, 10, 1349.20, 17, 1351.00, 178
3, 14:54:00-000, 207, 168, 39, 13, 1347.15, 9, 1352.00, 183
3, 14:55:00-000, 235, 153, 82, 7, 1347.00, 4, 1348.50, 216
3, 14:56:00-000, 206, 113, 93, 11, 1346.00, 6, 1350.50, 196
3, 14:57:00-000, 193, 134, 59, 6, 1346.17, 20, 1350.80, 170
3, 14:58:00-000, 184, 140, 44, 8, 1350.00, 10, 1353.60, 168
3, 14:59:00-000, 194, 164, 30, 16, 1354.06, 9, 1353.56, 169
3, 15:00:00-000, 202, 119, 83, 18, 1347.33, 14, 1350.86, 167
3, 15:01:00-000, 227, 124, 103, 11, 1348.36, 5, 1351.00, 208
3, 15:02:00-000, 184, 77, 107, 21, 1347.81, 25, 1350.24, 143
3, 15:03:00-000, 194, 108, 86, 9, 1348.56, 17, 1350.88, 166
3, 15:04:00-000, 206, 108, 98, 7, 1347.57, 12, 1350.00, 189
3, 15:05:00-000, 196, 138, 58, 12, 1347.92, 6, 1351.83, 181
3, 15:06:00-000, 195, 121, 74, 11, 1347.36, 7, 1351.28, 175
3, 15:07:00-000, 210, 108, 102, 3, 1347.33, 16, 1352.31, 193
3, 15:08:00-000, 215, 128, 87, 14, 1349.21, 13, 1352.08, 173
3, 15:09:00-000, 178, 113, 65, 17, 1349.17, 5, 1351.00, 160
3, 15:10:00-000, 218, 141, 77, 11, 1349.64, 20, 1351.95, 196
3, 15:11:00-000, 208, 160, 48, 13, 1347.92, 8, 1351.00, 187
3, 15:12:00-000, 207, 130, 77, 13, 1347.00, 20, 1351.35, 159
3, 15:13:00-000, 207, 165, 42, 8, 1349.87, 13, 1351.46, 199
3, 15:14:00-000, 193, 145, 48, 19, 1348.16, 14, 1351.07, 162
3, 15:15:00-000, 171, 135, 36, 7, 1345.86, 1, 1350.00, 165
3, 15:16:00-000, 242, 172, 70, 21, 1350.24, 22, 1352.13, 191
3, 15:17:00-000, 184, 127, 57, 6, 1349.50, 14, 1350.93, 165
3, 15:18:00-000, 206, 180, 26, 21, 1347.33, 6, 1352.50, 177
3, 15:19:00-000, 201, 135, 66, 8, 1348.88, 7, 1351.14, 189
3, 15:20:00-000, 184, 124, 60, 9, 1349.44, 31, 1351.83, 147
3, 15:21:00-000, 185, 160, 25, 7, 1350.43, 6, 1351.50, 161
3, 15:22:00-000, 197, 159, 38, 26, 1348.73, 9, 1351.67, 170
3, 15:23:00-000, 188, 137, 51, 5, 1347.60, 1, 1350.00, 185
3, 15:24:00-000, 214, 132, 82, 17, 1349.06, 24, 1351.29, 176
3, 15:25:00-000, 187, 127, 60, 12, 1346.75, 5, 1351.60, 164
3, 15:26:00-000, 216, 147, 69, 14, 1348.00, 12, 1351.58, 193
3, 15:27:00-000, 184, 118, 66, 5, 1347.60, 10, 1352.70, 167
3, 15:28:00-000, 179, 120, 59, 19, 1350.21, 15, 1351.00, 139
3, 15:29:00-000, 179, 118, 61, 8, 1351.50, 15, 1351.53, 166
3, 15:30:00-000, 222, 156, 66, 24, 1349.41, 17, 1351.47, 181
3, 15:31:00-000, 192, 130, 62, 9, 1348.56, 7, 1350.00, 168
3, 15:32:00-000, 227, 175, 52, 10, 1348.70, 15, 1352.00, 203
3, 15:33:00-000, 168, 134, 34, 5, 1349.60, 11, 1351.00, 159
3, 15:34:00-000, 238, 166, 72, 13, 1349.07, 7, 1350.71, 208
3, 15:35:00-000, 203, 127, 76, 4, 1348.00, 1, 1351.00, 205
3, 15:36:00-000, 204, 135, 69, 12, 1348.67, 21, 1351.95, 171
3, 15:37:00-000, 210, 146, 64, 6, 1349.00, 10, 1351.80, 194
3, 15:38:00-000, 194, 127, 67, 19, 1346.16, 15, 1352.20, 159
3, 15:39:00-000, 208, 170, 38, 2, 1349.50, 9, 1350.67, 186
3, 15:40:00-000, 194, 121, 73, 21, 1348.66, 20, 1351.30, 157
3, 15:41:00-000, 187, 135, 52, 6, 1347.17, 5, 1350.20, 177
3, 15:42:00-000, 209, 162, 47, 19, 1349.47, 10, 1351.10, 183
3, 15:43:00-000, 186, 145, 41, 3, 1348.33, 1, 1352.00, 178
3, 15:44:00-000, 175, 123, 52, 4, 1348.75, 11, 1351.82, 172
3, 15:45:00-000, 205, 148, 57, 10, 1347.90, 7, 1351.14, 188
3, 15:46:00-000, 183, 149, 34, 5, 1349.00, 15, 1351.00, 160
3, 15:47:00-000, 218, 213, 5, 3, 1351.00, 4, 1352.50, 205
3, 15:48:00-000, 167, 106, 61, 13, 1347.92, 4, 1350.25, 157
3, 15:49:00-000, 228, 172, 56, 12, 1348.08, 6, 1350.00, 194
3, 15:50:00-000, 184, 161, 23, 4, 1348.50, 6, 1350.00, 191
3, 15:51:00-000, 191, 139, 52, 13, 1347.85, 14, 1351.00, 163
3, 15:52:00-000, 242, 195, 47, 15, 1348.80, 16, 1350.81, 207
3, 15:53:00-000, 174, 98, 76, 10, 1348.30, 4, 1351.25, 159
3, 15:54:00-000, 200, 128, 72, 6, 1346.67, 21, 1351.05, 180
3, 15:55:00-000, 231, 209, 22, 2, 1349.00, 5, 1350.80, 217
3, 15:56:00-000, 191, 150, 41, 13, 1348.31, 17, 1350.35, 161
3, 15:57:00-000, 174, 139, 35, 5, 1353.20, 7, 1351.71, 169
3, 15:58:00-000, 227, 185, 42, 27, 1349.52, 13, 1351.38, 184
3, 15:59:00-000, 203, 175, 28, 10, 1352.10, 14, 1351.93, 170
3, 16:00:00-000, 211, 155, 56, 21, 1348.28, 14, 1350.86, 185
3, 16:01:00-000, 206, 124, 82, 17, 1347.88, 8, 1351.00, 169
3, 16:02:00-000, 200, 91, 109, 14, 1347.00, 13, 1351.92, 179
3, 16:03:00-000, 202, 115, 87, 14, 1348.93, 7, 1350.14, 176
3, 16:04:00-000, 237, 131, 106, 27, 1348.07, 33, 1350.78, 180
3, 16:05:00-000, 212, 137, 75, 7, 1348.28, 11, 1352.09, 205
3, 16:06:00-000, 201, 120, 81, 16, 1347.44, 17, 1351.41, 161
3, 16:07:00-000, 195, 163, 32, 5, 1349.00, 5, 1351.20, 192
3, 16:08:00-000, 201, 149, 52, 4, 1346.50, 15, 1352.00, 175
3, 16:09:00-000, 194, 148, 46, 10, 1350.20, 5, 1351.20, 182
3, 16:10:00-000, 219, 155, 64, 16, 1347.25, 13, 1351.46, 194
3, 16:11:00-000, 213, 125, 88, 14, 1347.28, 5, 1350.00, 191
3, 16:12:00-000, 211, 117, 94, 24, 1346.41, 25, 1351.44, 156
3, 16:13:00-000, 225, 155, 70, 10, 1349.00, 11, 1351.73, 201
3, 16:14:00-000, 190, 119, 71, 13, 1348.00, 17, 1350.94, 168
3, 16:15:00-000, 182, 105, 77, 5, 1346.20, 14, 1351.28, 156
3, 16:16:00-000, 191, 126, 65, 14, 1348.07, 22, 1351.45, 155
3, 16:17:00-000, 181, 150, 31, 8, 1348.12, 5, 1351.40, 178
3, 16:18:00-000, 214, 191, 23, 11, 1351.54, 9, 1352.66, 194
3, 16:19:00-000, 215, 191, 24, 3, 1353.67, 4, 1354.50, 200
3, 16:20:00-000, 203, 175, 28, 8, 1347.50, 1, 1353.00, 201
3, 16:21:00-000, 179, 117, 62, 4, 1346.50, 3, 1350.33, 166
3, 16:22:00-000, 198, 101, 97, 22, 1347.18, 12, 1347.42, 171
3, 16:23:00-000, 200, 118, 82, 4, 1345.00, 17, 1348.70, 171
3, 16:24:00-000, 205, 137, 68, 4, 1347.25, 15, 1351.07, 191
3, 16:25:00-000, 215, 170, 45, 16, 1349.19, 9, 1351.33, 194
3, 16:26:00-000, 210, 178, 32, 17, 1348.06, 17, 1351.35, 170
3, 16:27:00-000, 177, 138, 39, 7, 1347.57, 5, 1351.60, 167
3, 16:28:00-000, 202, 160, 42, 25, 1348.52, 5, 1351.40, 175
3, 16:29:00-000, 236, 180, 56, 0, 0.00, 16, 1351.06, 218
4, 09:03:00-000, 268, 268, 0, 0, 0.00, 0, 0.00, 260
4, 09:04:00-000, 0, 0, 0, 0, 0.00, 0, 0.00, 8
4, 09:06:00-000, 279, 279, 0, 278, 1351.00, 0, 0.00, 0
4, 09:07:00-000, 3, 3, 0, 0, 0.00, 0, 0.00, 1
4, 09:08:00-000, 28, 17, 11, 6, 1348.67, 6, 1348.67, 10
4, 09:09:00-000, 72, 57, 15, 16, 1353.75, 16, 1353.75, 35
4, 09:10:00-000, 143, 127, 16, 16, 1396.12, 16, 1396.12, 99
4, 09:11:00-000, 59, 47, 12, 12, 1454.83, 12, 1454.83, 53
4, 09:12:00-000, 82, 66, 16, 15, 1483.73, 16, 1484.12, 39
4, 09:13:00-000, 88, 73, 15, 63, 1380.87, 15, 1364.13, 27
4, 09:14:00-000, 81, 64, 17, 46, 1355.01, 16, 1354.00, 2
4, 09:15:00-000, 92, 78, 14, 77, 1355.99, 11, 1354.09, 19
4, 09:16:00-000, 72, 61, 11, 45, 1356.46, 14, 1356.21, 14
4, 09:17:00-000, 85, 56, 29, 42, 1354.16, 28, 1354.57, 11
4, 09:18:00-000, 105, 64, 41, 55, 1355.10, 32, 1356.43, 13
4, 09:19:00-000, 78, 37, 41, 31, 1357.35, 25, 1357.75, 16
4, 09:20:00-000, 86, 29, 57, 35, 1362.99, 42, 1364.16, 13
4, 09:21:00-000, 80, 29, 51, 29, 1349.92, 52, 1350.36, 14
4, 09:22:00-000, 87, 38, 49, 38, 1351.12, 49, 1351.85, 0
4, 09:23:00-000, 90, 39, 51, 37, 1349.80, 49, 1349.83, 2
4, 09:24:00-000, 66, 30, 36, 31, 1351.32, 30, 1351.76, 6
4, 09:25:00-000, 63, 22, 41, 23, 1350.86, 41, 1351.97, 0
4, 09:26:00-000, 89, 51, 38, 43, 1357.99, 38, 1357.97, 0
4, 09:27:00-000, 70, 39, 31, 40, 1355.75, 17, 1355.00, 21
4, 09:28:00-000, 90, 26, 64, 23, 1350.13, 51, 1349.68, 9
4, 09:29:00-000, 89, 36, 53, 33, 1350.33, 53, 1350.07, 3
4, 09:30:00-000, 86, 40, 46, 43, 1350.13, 39, 1350.22, 2
4, 09:31:00-000, 88, 56, 32, 48, 1355.12, 28, 1355.03, 16
4, 09:32:00-000, 52, 23, 29, 24, 1350.91, 26, 1351.76, 2
4, 09:33:00-000, 73, 50, 23, 50, 1351.65, 26, 1351.53, 2
4, 09:34:00-000, 92, 42, 50, 40, 1351.17, 38, 1351.18, 9
4, 09:35:00-000, 76, 44, 32, 38, 1351.99, 28, 1351.96, 6
4, 09:36:00-000, 92, 49, 43, 45, 1352.53, 47, 1352.82, 6
4, 09:37:00-000, 85, 45, 40, 42, 1352.30, 35, 1350.54, 4
4, 09:38:00-000, 103, 49, 54, 51, 1350.44, 53, 1350.69, 4
4, 09:39:00-000, 73, 29, 44, 29, 1351.27, 40, 1351.29, 2
4, 09:40:00-000, 76, 44, 32, 40, 1351.14, 32, 1351.27, 3
4, 09:41:00-000, 81, 27, 54, 27, 1348.40, 45, 1347.39, 13
4, 09:42:00-000, 96, 50, 46, 50, 1352.65, 44, 1352.67, 0
4, 09:43:00-000, 73, 30, 43, 30, 1350.23, 30, 1349.93, 5
4, 09:44:00-000, 99, 39, 60, 39, 1351.74, 64, 1351.69, 0
4, 09:45:00-000, 82, 36, 46, 34, 1349.35, 36, 1349.33, 7
4, 09:46:00-000, 76, 39, 37, 40, 1350.67, 38, 1350.94, 3
4, 09:47:00-000, 79, 47, 32, 44, 1352.33, 35, 1352.19, 4
4, 09:48:00-000, 90, 37, 53, 38, 1350.39, 50, 1350.69, 2
4, 09:49:00-000, 96, 46, 50, 40, 1350.12, 48, 1350.26, 4
4, 09:50:00-000, 85, 48, 37, 45, 1349.77, 41, 1350.19, 5
4, 09:51:00-000, 59, 32, 27, 24, 1353.74, 24, 1351.16, 10
4, 09:52:00-000, 90, 54, 36, 52, 1352.16, 31, 1352.16, 1
4, 09:53:00-000, 85, 39, 46, 39, 1351.43, 33, 1350.38, 3
4, 09:54:00-000, 95, 44, 51, 40, 1351.89, 48, 1351.99, 20
4, 09:55:00-000, 63, 31, 32, 31, 1351.74, 32, 1351.56, 2
4, 09:56:00-000, 57, 29, 28, 28, 1350.89, 29, 1350.86, 0
4, 09:57:00-000, 85, 40, 45, 39, 1352.38, 34, 1352.67, 4
4, 09:58:00-000, 101, 47, 54, 46, 1352.16, 64, 1352.02, 0
4, 09:59:00-000, 75, 43, 32, 35, 1351.99, 22, 1351.99, 10
4, 10:00:00-000, 81, 46, 35, 48, 1350.97, 39, 1352.15, 1
4, 10:01:00-000, 77, 37, 40, 38, 1352.39, 29, 1351.65, 6
4, 10:02:00-000, 86, 34, 52, 34, 1349.99, 48, 1350.37, 4
4, 10:03:00-000, 68, 28, 40, 28, 1350.43, 25, 1350.24, 5
4, 10:04:00-000, 80, 40, 40, 33, 1349.87, 42, 1350.30, 8
4, 10:05:00-000, 71, 46, 25, 46, 1351.25, 24, 1351.04, 6
4, 10:06:00-000, 85, 50, 35, 50, 1350.97, 43, 1351.71, 0
4, 10:07:00-000, 78, 33, 45, 33, 1352.20, 30, 1351.06, 9
4, 10:08:00-000, 81, 29, 52, 27, 1350.63, 49, 1350.38, 10
4, 10:09:00-000, 94, 35, 59, 36, 1350.22, 49, 1350.60, 3
4, 10:10:00-000, 109, 43, 66, 43, 1350.34, 70, 1350.06, 4
4, 10:11:00-000, 58, 25, 33, 23, 1351.43, 26, 1352.96, 0
4, 10:12:00-000, 77, 48, 29, 39, 1350.02, 34, 1350.91, 3
4, 10:13:00-000, 84, 47, 37, 42, 1353.28, 38, 1353.10, 8
4, 10:14:00-000, 77, 39, 38, 44, 1351.29, 31, 1351.64, 0
4, 10:15:00-000, 70, 41, 29, 29, 1348.31, 24, 1348.37, 14
4, 10:16:00-000, 93, 43, 50, 51, 1349.68, 45, 1350.44, 0
4, 10:17:00-000, 70, 41, 29, 38, 1352.15, 32, 1351.81, 4
4, 10:18:00-000, 65, 36, 29, 32, 1351.02, 27, 1351.77, 5
4, 10:19:00-000, 95, 53, 42, 43, 1350.92, 38, 1350.63, 6
4, 10:20:00-000, 72, 29, 43, 38, 1352.70, 32, 1351.99, 3
4, 10:21:00-000, 88, 40, 48, 36, 1351.38, 42, 1353.09, 9
4, 10:22:00-000, 58, 28, 30, 31, 1350.32, 35, 1350.59, 2
4, 10:23:00-000, 92, 47, 45, 47, 1352.36, 38, 1351.63, 3
4, 10:24:00-000, 85, 40, 45, 34, 1350.99, 38, 1351.26, 9
4, 10:25:00-000, 84, 60, 24, 52, 1353.37, 26, 1352.30, 10
4, 10:26:00-000, 64, 24, 40, 31, 1351.48, 29, 1351.93, 5
4, 10:27:00-000, 106, 58, 48, 51, 1349.58, 50, 1349.23, 6
4, 10:28:00-000, 84, 35, 49, 39, 1350.79, 40, 1350.11, 4
4, 10:29:00-000, 69, 25, 44, 25, 1351.16, 16, 1351.06, 13
4, 10:30:00-000, 96, 42, 54, 40, 1351.34, 71, 1351.34, 4
4, 10:31:00-000, 86, 36, 50, 38, 1350.18, 43, 1350.62, 0
4, 10:32:00-000, 64, 38, 26, 37, 1352.67, 30, 1351.86, 1
4, 10:33:00-000, 85, 36, 49, 36, 1350.30, 42, 1350.40, 4
4, 10:34:00-000, 83, 38, 45, 36, 1351.52, 43, 1351.78, 2
4, 10:35:00-000, 84, 37, 47, 32, 1351.53, 36, 1351.74, 11
4, 10:36:00-000, 72, 38, 34, 37, 1350.51, 37, 1351.56, 2
4, 10:37:00-000, 91, 42, 49, 40, 1350.09, 48, 1350.53, 8
4, 10:38:00-000, 75, 27, 48, 29, 1348.00, 36, 1348.66, 14
4, 10:39:00-000, 80, 39, 41, 36, 1349.46, 36, 1348.94, 6
4, 10:40:00-000, 78, 33, 45, 31, 1350.99, 45, 1351.48, 1
4, 10:41:00-000, 74, 42, 32, 39, 1352.99, 28, 1352.35, 4
4, 10:42:00-000, 95, 46, 49, 41, 1350.60, 45, 1350.28, 6
4, 10:43:00-000, 68, 39, 29, 31, 1350.03, 26, 1350.11, 14
4, 10:44:00-000, 71, 49, 22, 48, 1351.28, 24, 1351.58, 3
4, 10:45:00-000, 78, 41, 37, 35, 1352.48, 27, 1351.74, 11
4, 10:46:00-000, 95, 51, 44, 51, 1351.83, 39, 1351.91, 0
4, 10:47:00-000, 81, 58, 23, 50, 1351.17, 33, 1350.66, 1
4, 10:48:00-000, 69, 30, 39, 37, 1351.42, 36, 1351.77, 4
4, 10:49:00-000, 98, 32, 66, 23, 1351.04, 53, 1350.56, 1
4, 10:50:00-000, 76, 42, 34, 48, 1350.49, 39, 1351.81, 6
4, 10:51:00-000, 81, 35, 46, 35, 1352.02, 38, 1351.84, 5
4, 10:52:00-000, 81, 34, 47, 35, 1350.99, 50, 1351.23, 0
4, 10:53:00-000, 81, 42, 39, 40, 1351.27, 26, 1350.96, 10
4, 10:54:00-000, 72, 34, 38, 32, 1349.80, 41, 1350.31, 4
4, 10:55:00-000, 68, 28, 40, 29, 1349.54, 34, 1349.05, 0
4, 10:56:00-000, 76, 35, 41, 36, 1352.77, 43, 1351.50, 0
4, 10:57:00-000, 89, 52, 37, 51, 1352.87, 26, 1352.07, 13
4, 10:58:00-000, 79, 45, 34, 46, 1351.38, 33, 1351.81, 0
4, 10:59:00-000, 88, 34, 54, 33, 1350.94, 27, 1350.74, 14
4, 11:00:00-000, 79, 37, 42, 30, 1349.06, 45, 1350.19, 6
4, 11:01:00-000, 83, 36, 47, 41, 1350.12, 40, 1350.09, 12
4, 11:02:00-000, 93, 35, 58, 35, 1349.11, 53, 1349.56, 2
4, 11:03:00-000, 92, 44, 48, 43, 1350.74, 32, 1349.93, 7
4, 11:04:00-000, 67, 35, 32, 27, 1351.22, 48, 1351.68, 2
4, 11:05:00-000, 81, 41, 40, 37, 1350.67, 36, 1351.33, 14
4, 11:06:00-000, 54, 25, 29, 25, 1349.44, 27, 1349.48, 2
4, 11:07:00-000, 99, 44, 55, 44, 1349.76, 50, 1349.43, 9
4, 11:08:00-000, 90, 43, 47, 43, 1348.83, 45, 1348.86, 0
4, 11:09:00-000, 70, 33, 37, 29, 1349.03, 33, 1349.72, 1
4, 11:10:00-000, 105, 55, 50, 54, 1350.45, 54, 1350.49, 5
4, 11:11:00-000, 76, 41, 35, 38, 1351.39, 28, 1352.35, 6
4, 11:12:00-000, 66, 30, 36, 28, 1349.81, 30, 1349.76, 12
4, 11:13:00-000, 75, 43, 32, 39, 1349.66, 22, 1349.45, 2
4, 11:14:00-000, 90, 50, 40, 42, 1352.06, 49, 1350.89, 4
4, 11:15:00-000, 82, 36, 46, 32, 1350.56, 44, 1350.77, 7
4, 11:16:00-000, 68, 26, 42, 31, 1349.87, 39, 1350.10, 0
4, 11:17:00-000, 83, 34, 49, 29, 1347.79, 42, 1348.28, 7
4, 11:18:00-000, 65, 40, 25, 44, 1350.74, 30, 1351.39, 0
4, 11:19:00-000, 88, 34, 54, 35, 1350.05, 32, 1350.15, 1
4, 11:20:00-000, 67, 36, 31, 35, 1353.08, 44, 1352.08, 6
4, 11:21:00-000, 73, 36, 37, 34, 1350.64, 35, 1350.05, 0
4, 11:22:00-000, 93, 36, 57, 36, 1349.61, 47, 1348.38, 12
4, 11:23:00-000, 66, 32, 34, 34, 1355.35, 25, 1354.55, 6
4, 11:24:00-000, 68, 36, 32, 33, 1350.87, 32, 1349.65, 9
4, 11:25:00-000, 79, 33, 46, 33, 1350.39, 36, 1350.24, 0
4, 11:26:00-000, 101, 45, 56, 43, 1349.76, 59, 1350.35, 5
4, 11:27:00-000, 76, 45, 31, 40, 1351.12, 26, 1349.84, 6
4, 11:28:00-000, 85, 42, 43, 42, 1352.04, 47, 1352.52, 2
4, 11:29:00-000, 94, 43, 51, 42, 1349.83, 41, 1349.68, 2
4, 11:30:00-000, 61, 40, 21, 42, 1350.25, 27, 1350.66, 3
4, 11:31:00-000, 78, 52, 26, 44, 1351.06, 20, 1351.05, 0
4, 11:32:00-000, 68, 30, 38, 38, 1350.91, 35, 1350.48, 6
4, 11:33:00-000, 108, 61, 47, 59, 1352.11, 38, 1351.47, 2
4, 11:34:00-000, 78, 39, 39, 38, 1353.18, 40, 1353.19, 2
4, 11:35:00-000, 75, 25, 50, 25, 1350.40, 44, 1349.99, 10
4, 11:36:00-000, 88, 40, 48, 40, 1348.89, 45, 1349.03, 3
4, 11:37:00-000, 82, 43, 39, 38, 1350.76, 34, 1351.29, 6
4, 11:38:00-000, 92, 48, 44, 49, 1350.85, 46, 1351.80, 1
4, 11:39:00-000, 88, 42, 46, 45, 1350.95, 39, 1350.92, 8
4, 11:40:00-000, 75, 45, 30, 45, 1352.24, 31, 1352.35, 0
4, 11:41:00-000, 84, 33, 51, 33, 1350.90, 40, 1350.89, 1
4, 11:42:00-000, 90, 32, 58, 32, 1350.03, 56, 1349.76, 7
4, 11:43:00-000, 76, 33, 43, 31, 1349.77, 37, 1350.05, 8
4, 11:44:00-000, 79, 40, 39, 37, 1349.72, 43, 1350.11, 2
4, 11:45:00-000, 109, 63, 46, 61, 1351.71, 46, 1351.56, 2
4, 11:46:00-000, 77, 33, 44, 36, 1350.41, 38, 1350.31, 0
4, 11:47:00-000, 117, 84, 33, 68, 1351.16, 30, 1350.96, 13
4, 11:48:00-000, 80, 42, 38, 47, 1351.06, 43, 1351.43, 0
4, 11:49:00-000, 81, 33, 48, 31, 1351.90, 23, 1349.34, 14
4, 11:50:00-000, 101, 51, 50, 52, 1353.13, 52, 1352.82, 10
4, 11:51:00-000, 92, 33, 59, 33, 1351.66, 36, 1350.99, 6
4, 11:52:00-000, 75, 20, 55, 16, 1349.00, 64, 1349.94, 8
4, 11:53:00-000, 113, 41, 72, 45, 1349.79, 49, 1349.34, 4
4, 11:54:00-000, 67, 31, 36, 27, 1349.85, 51, 1350.21, 0
4, 11:55:00-000, 94, 50, 44, 44, 1350.83, 35, 1350.11, 11
4, 11:56:00-000, 102, 47, 55, 41, 1350.97, 62, 1351.57, 12
4, 11:57:00-000, 75, 41, 34, 41, 1349.82, 33, 1350.30, 1
4, 11:58:00-000, 83, 43, 40, 31, 1351.54, 29, 1351.20, 11
4, 11:59:00-000, 66, 34, 32, 31, 1354.06, 26, 1353.92, 10
4, 12:00:00-000, 113, 46, 67, 50, 1351.87, 66, 1350.90, 6
4, 12:01:00-000, 88, 48, 40, 44, 1351.22, 31, 1351.77, 9
4, 12:02:00-000, 89, 43, 46, 46, 1352.56, 36, 1352.41, 4
4, 12:03:00-000, 87, 46, 41, 41, 1350.11, 44, 1350.74, 3
4, 12:04:00-000, 65, 32, 33, 34, 1349.73, 23, 1349.95, 5
4, 12:05:00-000, 86, 38, 48, 37, 1349.32, 40, 1349.44, 7
4, 12:06:00-000, 91, 59, 32, 61, 1351.15, 41, 1351.80, 3
4, 12:07:00-000, 91, 46, 45, 43, 1349.99, 37, 1350.07, 3
4, 12:08:00-000, 76, 49, 27, 42, 1351.52, 30, 1350.69, 3
4, 12:09:00-000, 72, 32, 40, 31, 1349.67, 34, 1349.32, 8
4, 12:10:00-000, 94, 54, 40, 53, 1349.54, 43, 1350.04, 4
4, 12:11:00-000, 72, 43, 29, 41, 1352.16, 22, 1352.27, 2
4, 12:12:00-000, 96, 40, 56, 41, 1350.43, 46, 1350.49, 2
4, 12:13:00-000, 62, 34, 28, 34, 1353.05, 29, 1351.99, 12
4, 12:14:00-000, 115, 51, 64, 51, 1350.89, 57, 1350.99, 10
4, 12:15:00-000, 72, 30, 42, 27, 1350.96, 40, 1350.72, 1
4, 12:16:00-000, 90, 42, 48, 45, 1349.55, 38, 1350.13, 0
4, 12:17:00-000, 85, 47, 38, 44, 1352.20, 36, 1352.77, 14
4, 12:18:00-000, 76, 29, 47, 29, 1352.03, 37, 1351.67, 11
4, 12:19:00-000, 83, 36, 47, 33, 1350.15, 42, 1350.61, 3
4, 12:20:00-000, 98, 38, 60, 38, 1349.86, 51, 1349.81, 12
4, 12:21:00-000, 102, 38, 64, 38, 1350.81, 48, 1350.97, 8
4, 12:22:00-000, 71, 38, 33, 33, 1350.24, 34, 1350.05, 7
4, 12:23:00-000, 80, 49, 31, 45, 1351.59, 22, 1350.90, 9
4, 12:24:00-000, 115, 67, 48, 67, 1351.06, 42, 1350.73, 7
4, 12:25:00-000, 92, 36, 56, 39, 1350.50, 37, 1350.62, 18
4, 12:26:00-000, 64, 25, 39, 25, 1350.64, 36, 1350.47, 2
4, 12:27:00-000, 85, 35, 50, 33, 1351.21, 50, 1350.83, 5
4, 12:28:00-000, 100, 38, 62, 40, 1349.69, 64, 1349.71, 1
4, 12:29:00-000, 65, 40, 25, 39, 1351.79, 22, 1351.81, 3
4, 12:30:00-000, 80, 33, 47, 31, 1350.12, 46, 1349.82, 2
4, 12:31:00-000, 85, 43, 42, 43, 1351.71, 27, 1350.33, 6
4, 12:32:00-000, 127, 51, 76, 47, 1349.80, 63, 1349.94, 10
4, 12:33:00-000, 73, 40, 33, 42, 1349.06, 23, 1350.08, 17
4, 12:34:00-000, 55, 31, 24, 31, 1351.96, 22, 1350.91, 2
4, 12:35:00-000, 90, 30, 60, 32, 1349.96, 56, 1349.56, 2
4, 12:36:00-000, 65, 30, 35, 26, 1349.03, 40, 1350.44, 4
4, 12:37:00-000, 92, 55, 37, 51, 1351.25, 36, 1351.41, 4
4, 12:38:00-000, 79, 29, 50, 32, 1350.43, 37, 1350.21, 2
4, 12:39:00-000, 113, 63, 50, 57, 1352.99, 46, 1351.81, 9
4, 12:40:00-000, 89, 39, 50, 44, 1351.60, 50, 1351.23, 11
4, 12:41:00-000, 69, 31, 38, 27, 1349.37, 27, 1349.92, 0
4, 12:42:00-000, 87, 44, 43, 46, 1350.05, 51, 1350.15, 3
4, 12:43:00-000, 84, 37, 47, 36, 1348.63, 38, 1349.02, 5
4, 12:44:00-000, 60, 24, 36, 22, 1349.31, 30, 1349.16, 7
4, 12:45:00-000, 94, 52, 42, 47, 1351.05, 47, 1350.82, 0
4, 12:46:00-000, 112, 54, 58, 52, 1349.72, 54, 1349.23, 3
4, 12:47:00-000, 67, 34, 33, 40, 1349.14, 30, 1348.73, 3
4, 12:48:00-000, 74, 35, 39, 36, 1350.22, 42, 1349.97, 0
4, 12:49:00-000, 64, 35, 29, 34, 1352.14, 28, 1351.78, 1
4, 12:50:00-000, 80, 40, 40, 38, 1350.15, 36, 1350.10, 2
4, 12:51:00-000, 82, 40, 42, 37, 1348.70, 36, 1349.19, 2
4, 12:52:00-000, 92, 45, 47, 44, 1348.95, 53, 1349.82, 6
4, 12:53:00-000, 77, 46, 31, 37, 1351.10, 31, 1351.09, 4
4, 12:54:00-000, 91, 43, 48, 47, 1349.86, 43, 1350.13, 3
4, 12:55:00-000, 84, 43, 41, 42, 1350.95, 41, 1351.14, 5
4, 12:56:00-000, 77, 35, 42, 36, 1349.30, 38, 1348.94, 4
4, 12:57:00-000, 77, 35, 42, 32, 1349.56, 32, 1349.96, 1
4, 12:58:00-000, 84, 38, 46, 33, 1350.36, 36, 1350.13, 17
4, 12:59:00-000, 83, 31, 52, 30, 1349.56, 48, 1350.14, 9
4, 13:00:00-000, 64, 34, 30, 34, 1350.08, 30, 1350.83, 2
4, 13:01:00-000, 75, 38, 37, 36, 1349.44, 36, 1349.72, 1
4, 13:02:00-000, 157, 84, 73, 75, 1349.44, 70, 1349.21, 1
4, 13:03:00-000, 46, 24, 22, 25, 1352.71, 19, 1352.05, 14
4, 13:04:00-000, 80, 29, 51, 31, 1349.87, 44, 1349.33, 5
4, 13:05:00-000, 115, 72, 43, 66, 1353.77, 39, 1353.45, 4
4, 13:06:00-000, 73, 43, 30, 45, 1351.44, 28, 1350.89, 9
4, 13:07:00-000, 83, 47, 36, 46, 1349.97, 36, 1350.35, 0
4, 13:08:00-000, 97, 50, 47, 51, 1353.13, 44, 1351.15, 0
4, 13:09:00-000, 77, 28, 49, 25, 1349.79, 37, 1350.45, 15
4, 13:10:00-000, 84, 35, 49, 36, 1349.49, 32, 1350.15, 7
4, 13:11:00-000, 85, 55, 30, 48, 1351.07, 36, 1350.33, 7
4, 13:12:00-000, 67, 28, 39, 35, 1350.42, 32, 1350.77, 1
4, 13:13:00-000, 97, 28, 69, 27, 1350.03, 49, 1349.42, 2
4, 13:14:00-000, 79, 48, 31, 45, 1351.06, 54, 1351.60, 6
4, 13:15:00-000, 69, 27, 42, 27, 1348.92, 33, 1349.15, 3
4, 13:16:00-000, 80, 38, 42, 36, 1349.41, 45, 1350.15, 3
4, 13:17:00-000, 92, 36, 56, 38, 1350.52, 47, 1350.63, 3
4, 13:18:00-000, 84, 34, 50, 27, 1349.55, 39, 1350.28, 5
4, 13:19:00-000, 85, 33, 52, 40, 1350.22, 44, 1350.28, 7
4, 13:20:00-000, 72, 38, 34, 32, 1351.12, 37, 1351.05, 3
4, 13:21:00-000, 69, 34, 35, 32, 1350.90, 29, 1351.20, 7
4, 13:22:00-000, 87, 48, 39, 55, 1350.79, 43, 1351.50, 1
4, 13:23:00-000, 85, 37, 48, 37, 1350.94, 44, 1352.04, 1
4, 13:24:00-000, 58, 29, 29, 29, 1349.34, 23, 1349.69, 4
4, 13:25:00-000, 74, 32, 42, 31, 1348.45, 35, 1348.71, 8
4, 13:26:00-000, 94, 51, 43, 49, 1350.85, 50, 1350.63, 2
4, 13:27:00-000, 78, 33, 45, 26, 1348.84, 45, 1348.59, 0
4, 13:28:00-000, 96, 40, 56, 45, 1349.70, 56, 1350.22, 0
4, 13:29:00-000, 53, 32, 21, 31, 1353.48, 11, 1352.82, 7
4, 13:30:00-000, 115, 50, 65, 51, 1350.30, 51, 1350.40, 1
4, 13:31:00-000, 80, 42, 38, 34, 1348.38, 38, 1349.28, 25
4, 13:32:00-000, 59, 22, 37, 22, 1348.72, 31, 1349.28, 1
4, 13:33:00-000, 99, 58, 41, 42, 1351.06, 43, 1350.87, 6
4, 13:34:00-000, 65, 33, 32, 44, 1349.99, 28, 1350.64, 4
4, 13:35:00-000, 88, 61, 27, 55, 1351.61, 26, 1350.84, 1
4, 13:36:00-000, 78, 48, 30, 51, 1352.11, 30, 1351.56, 4
4, 13:37:00-000, 80, 41, 39, 42, 1351.30, 37, 1351.51, 2
4, 13:38:00-000, 82, 46, 36, 46, 1350.40, 30, 1350.26, 1
4, 13:39:00-000, 59, 25, 34, 19, 1349.36, 26, 1349.77, 9
4, 13:40:00-000, 90, 39, 51, 45, 1348.92, 53, 1350.22, 1
4, 13:41:00-000, 97, 42, 55, 41, 1350.43, 47, 1351.18, 3
4, 13:42:00-000, 61, 26, 35, 27, 1349.18, 38, 1350.28, 3
4, 13:43:00-000, 64, 29, 35, 24, 1349.20, 27, 1349.74, 3
4, 13:44:00-000, 83, 41, 42, 35, 1350.56, 36, 1350.80, 11
4, 13:45:00-000, 89, 41, 48, 41, 1350.55, 51, 1350.68, 5
4, 13:46:00-000, 62, 35, 27, 30, 1351.93, 23, 1352.30, 1
4, 13:47:00-000, 88, 40, 48, 39, 1349.22, 41, 1349.75, 6
4, 13:48:00-000, 66, 40, 26, 41, 1350.99, 31, 1350.80, 2
4, 13:49:00-000, 87, 39, 48, 34, 1349.79, 44, 1350.92, 3
4, 13:50:00-000, 91, 28, 63, 32, 1347.93, 56, 1349.49, 12
4, 13:51:00-000, 102, 52, 50, 49, 1349.56, 40, 1349.72, 0
4, 13:52:00-000, 78, 52, 26, 53, 1351.22, 32, 1351.12, 5
4, 13:53:00-000, 72, 28, 44, 29, 1350.10, 37, 1350.37, 3
4, 13:54:00-000, 79, 40, 39, 39, 1350.12, 44, 1350.78, 0
4, 13:55:00-000, 96, 44, 52, 44, 1351.99, 48, 1351.95, 3
4, 13:56:00-000, 88, 49, 39, 42, 1351.75, 42, 1351.92, 1
4, 13:57:00-000, 79, 33, 46, 36, 1351.41, 37, 1351.48, 4
4, 13:58:00-000, 90, 46, 44, 45, 1352.21, 38, 1352.94, 1
4, 13:59:00-000, 90, 49, 41, 48, 1350.57, 46, 1350.55, 7
4, 14:00:00-000, 85, 34, 51, 34, 1349.11, 46, 1349.60, 6
4, 14:01:00-000, 73, 29, 44, 29, 1349.55, 36, 1349.97, 4
4, 14:02:00-000, 93, 62, 31, 59, 1351.92, 38, 1351.55, 0
4, 14:03:00-000, 88, 31, 57, 33, 1349.57, 30, 1349.83, 7
4, 14:04:00-000, 62, 35, 27, 36, 1350.66, 36, 1350.91, 4
4, 14:05:00-000, 103, 53, 50, 46, 1349.29, 48, 1349.43, 8
4, 14:06:00-000, 94, 45, 49, 50, 1349.91, 44, 1350.51, 2
4, 14:07:00-000, 94, 55, 39, 46, 1351.04, 40, 1350.89, 5
4, 14:08:00-000, 83, 47, 36, 52, 1350.64, 36, 1350.52, 0
4, 14:09:00-000, 91, 42, 49, 40, 1350.14, 34, 1350.43, 5
4, 14:10:00-000, 76, 42, 34, 46, 1350.84, 35, 1351.22, 1
4, 14:11:00-000, 71, 25, 46, 21, 1348.57, 33, 1348.87, 9
4, 14:12:00-000, 88, 34, 54, 34, 1348.49, 61, 1349.84, 7
4, 14:13:00-000, 69, 30, 39, 29, 1350.24, 38, 1350.33, 3
4, 14:14:00-000, 64, 28, 36, 24, 1350.24, 27, 1350.36, 1
4, 14:15:00-000, 103, 51, 52, 53, 1349.95, 47, 1349.95, 8
4, 14:16:00-000, 88, 47, 41, 48, 1352.20, 35, 1352.05, 3
4, 14:17:00-000, 65, 15, 50, 15, 1349.93, 28, 1350.53, 20
4, 14:18:00-000, 80, 41, 39, 40, 1351.24, 53, 1350.62, 1
4, 14:19:00-000, 92, 38, 54, 30, 1349.93, 48, 1350.01, 1
4, 14:20:00-000, 98, 56, 42, 61, 1350.60, 35, 1350.51, 0
4, 14:21:00-000, 75, 24, 51, 25, 1348.15, 41, 1348.75, 10
4, 14:22:00-000, 91, 43, 48, 32, 1350.84, 55, 1350.70, 5
4, 14:23:00-000, 76, 41, 35, 49, 1350.62, 25, 1350.75, 7
4, 14:24:00-000, 95, 59, 36, 55, 1352.84, 41, 1352.45, 2
4, 14:25:00-000, 83, 56, 27, 48, 1353.11, 24, 1353.08, 6
4, 14:26:00-000, 77, 26, 51, 29, 1351.34, 44, 1350.58, 3
4, 14:27:00-000, 100, 54, 46, 58, 1352.07, 51, 1350.99, 0
4, 14:28:00-000, 95, 32, 63, 34, 1352.29, 50, 1352.23, 4
4, 14:29:00-000, 65, 41, 24, 40, 1350.04, 19, 1350.31, 10
4, 14:30:00-000, 70, 32, 38, 33, 1349.96, 34, 1350.20, 1
4, 14:31:00-000, 117, 41, 76, 37, 1348.86, 80, 1349.35, 2
4, 14:32:00-000, 75, 28, 47, 32, 1350.06, 40, 1351.19, 0
4, 14:33:00-000, 73, 40, 33, 33, 1349.42, 29, 1349.48, 3
4, 14:34:00-000, 96, 48, 48, 36, 1349.44, 52, 1349.91, 11
4, 14:35:00-000, 82, 43, 39, 52, 1350.86, 34, 1350.94, 4
4, 14:36:00-000, 104, 59, 45, 55, 1350.41, 44, 1350.81, 6
4, 14:37:00-000, 68, 32, 36, 25, 1349.44, 26, 1350.46, 2
4, 14:38:00-000, 105, 57, 48, 60, 1351.99, 40, 1352.02, 14
4, 14:39:00-000, 88, 38, 50, 38, 1351.26, 39, 1350.99, 7
4, 14:40:00-000, 88, 36, 52, 37, 1349.88, 44, 1350.97, 6
4, 14:41:00-000, 97, 39, 58, 34, 1349.05, 48, 1349.72, 13
4, 14:42:00-000, 71, 37, 34, 38, 1350.34, 38, 1350.36, 4
4, 14:43:00-000, 85, 52, 33, 55, 1351.75, 27, 1351.59, 3
4, 14:44:00-000, 104, 64, 40, 62, 1351.76, 37, 1351.56, 7
4, 14:45:00-000, 105, 51, 54, 47, 1351.31, 42, 1351.40, 4
4, 14:46:00-000, 64, 22, 42, 25, 1349.04, 51, 1351.19, 0
4, 14:47:00-000, 93, 30, 63, 31, 1349.54, 43, 1349.78, 2
4, 14:48:00-000, 80, 37, 43, 37, 1350.75, 60, 1350.44, 0
4, 14:49:00-000, 85, 51, 34, 43, 1350.85, 36, 1350.80, 2
4, 14:50:00-000, 78, 35, 43, 42, 1350.44, 31, 1351.67, 0
4, 14:51:00-000, 106, 51, 55, 51, 1350.19, 44, 1349.86, 8
4, 14:52:00-000, 75, 39, 36, 40, 1350.59, 47, 1350.91, 4
4, 14:53:00-000, 81, 36, 45, 36, 1350.41, 39, 1350.25, 3
4, 14:54:00-000, 80, 44, 36, 40, 1350.04, 29, 1349.48, 4
4, 14:55:00-000, 83, 44, 39, 39, 1346.87, 33, 1347.54, 6
4, 14:56:00-000, 92, 38, 54, 43, 1347.06, 53, 1348.97, 7
4, 14:57:00-000, 93, 49, 44, 38, 1350.84, 46, 1350.47, 5
4, 14:58:00-000, 90, 38, 52, 42, 1349.82, 45, 1349.84, 6
4, 14:59:00-000, 82, 54, 28, 46, 1352.08, 28, 1351.64, 6
4, 15:00:00-000, 98, 52, 46, 49, 1350.15, 36, 1350.49, 8
4, 15:01:00-000, 71, 24, 47, 23, 1349.86, 35, 1350.36, 11
4, 15:02:00-000, 86, 47, 39, 46, 1350.21, 48, 1350.62, 1
4, 15:03:00-000, 75, 39, 36, 40, 1350.27, 32, 1349.62, 1
4, 15:04:00-000, 77, 35, 42, 34, 1348.35, 46, 1348.93, 4
4, 15:05:00-000, 104, 47, 57, 46, 1349.10, 51, 1349.26, 4
4, 15:06:00-000, 64, 32, 32, 32, 1349.87, 31, 1349.54, 2
4, 15:07:00-000, 74, 38, 36, 35, 1350.42, 28, 1349.74, 4
4, 15:08:00-000, 90, 45, 45, 46, 1350.82, 45, 1351.28, 2
4, 15:09:00-000, 65, 23, 42, 19, 1349.84, 28, 1351.14, 16
4, 15:10:00-000, 93, 59, 34, 57, 1351.25, 43, 1350.48, 3
4, 15:11:00-000, 85, 35, 50, 35, 1349.82, 50, 1350.77, 0
4, 15:12:00-000, 78, 46, 32, 41, 1351.34, 28, 1350.24, 1
4, 15:13:00-000, 78, 37, 41, 40, 1350.87, 35, 1351.68, 2
4, 15:14:00-000, 93, 50, 43, 50, 1351.01, 45, 1351.08, 0
4, 15:15:00-000, 93, 39, 54, 39, 1346.51, 42, 1347.42, 11
4, 15:16:00-000, 133, 72, 61, 63, 1351.05, 69, 1350.23, 0
4, 15:17:00-000, 74, 43, 31, 43, 1351.00, 28, 1350.28, 10
4, 15:18:00-000, 80, 27, 53, 29, 1350.58, 40, 1351.67, 8
4, 15:19:00-000, 90, 40, 50, 34, 1350.02, 42, 1349.73, 9
4, 15:20:00-000, 98, 56, 42, 55, 1351.57, 37, 1351.18, 2
4, 15:21:00-000, 81, 48, 33, 52, 1352.36, 32, 1352.74, 8
4, 15:22:00-000, 92, 44, 48, 42, 1350.11, 37, 1350.32, 3
4, 15:23:00-000, 95, 49, 46, 41, 1348.43, 42, 1348.97, 2
4, 15:24:00-000, 77, 38, 39, 41, 1350.24, 40, 1351.47, 5
4, 15:25:00-000, 74, 28, 46, 24, 1348.37, 44, 1348.54, 3
4, 15:26:00-000, 82, 32, 50, 38, 1350.86, 56, 1351.08, 2
4, 15:27:00-000, 113, 53, 60, 38, 1351.23, 31, 1350.61, 9
4, 15:28:00-000, 64, 24, 40, 33, 1350.93, 46, 1351.95, 11
4, 15:29:00-000, 81, 40, 41, 34, 1351.49, 45, 1350.81, 3
4, 15:30:00-000, 92, 50, 42, 53, 1351.08, 41, 1351.02, 6
4, 15:31:00-000, 91, 29, 62, 27, 1349.00, 40, 1349.49, 13
4, 15:32:00-000, 62, 30, 32, 29, 1350.44, 35, 1350.02, 4
4, 15:33:00-000, 95, 45, 50, 49, 1351.24, 34, 1351.64, 15
4, 15:34:00-000, 85, 26, 59, 26, 1350.84, 50, 1351.11, 5
4, 15:35:00-000, 90, 34, 56, 28, 1349.85, 48, 1349.97, 5
4, 15:36:00-000, 74, 34, 40, 34, 1350.41, 50, 1350.67, 0
4, 15:37:00-000, 102, 42, 60, 46, 1349.62, 56, 1349.81, 6
4, 15:38:00-000, 100, 62, 38, 57, 1351.34, 38, 1351.55, 0
4, 15:39:00-000, 76, 40, 36, 40, 1350.64, 26, 1351.42, 1
4, 15:40:00-000, 95, 59, 36, 58, 1351.47, 32, 1351.02, 9
4, 15:41:00-000, 63, 41, 22, 36, 1350.05, 27, 1350.25, 4
4, 15:42:00-000, 89, 50, 39, 50, 1351.81, 29, 1351.82, 6
4, 15:43:00-000, 88, 26, 62, 27, 1349.63, 42, 1350.09, 17
4, 15:44:00-000, 78, 36, 42, 39, 1349.27, 47, 1350.12, 5
4, 15:45:00-000, 99, 55, 44, 55, 1350.66, 44, 1351.36, 0
4, 15:46:00-000, 72, 42, 30, 38, 1351.33, 29, 1351.41, 2
4, 15:47:00-000, 106, 65, 41, 62, 1353.29, 25, 1352.48, 8
4, 15:48:00-000, 71, 23, 48, 23, 1349.52, 28, 1350.42, 27
4, 15:49:00-000, 95, 32, 63, 34, 1349.14, 53, 1349.40, 4
4, 15:50:00-000, 94, 45, 49, 46, 1350.47, 53, 1350.37, 5
4, 15:51:00-000, 58, 24, 34, 19, 1349.63, 32, 1350.71, 2
4, 15:52:00-000, 94, 41, 53, 39, 1350.12, 38, 1350.44, 6
4, 15:53:00-000, 73, 31, 42, 33, 1350.08, 32, 1350.43, 15
4, 15:54:00-000, 75, 42, 33, 37, 1349.43, 34, 1349.47, 1
4, 15:55:00-000, 77, 31, 46, 30, 1349.76, 43, 1350.08, 4
4, 15:56:00-000, 94, 45, 49, 48, 1350.18, 55, 1350.66, 0
4, 15:57:00-000, 85, 47, 38, 38, 1353.36, 37, 1351.80, 4
4, 15:58:00-000, 74, 36, 38, 39, 1350.40, 35, 1350.08, 6
4, 15:59:00-000, 92, 46, 46, 41, 1352.50, 47, 1352.46, 1
4, 16:00:00-000, 88, 41, 47, 48, 1350.26, 38, 1350.15, 1
4, 16:01:00-000, 71, 38, 33, 39, 1350.89, 33, 1350.87, 0
4, 16:02:00-000, 88, 39, 49, 36, 1347.38, 50, 1347.25, 1
4, 16:03:00-000, 91, 29, 62, 30, 1348.80, 37, 1349.18, 12
4, 16:04:00-000, 82, 46, 36, 41, 1349.94, 45, 1350.37, 9
4, 16:05:00-000, 98, 52, 46, 44, 1350.68, 47, 1350.71, 4
4, 16:06:00-000, 97, 46, 51, 46, 1348.79, 48, 1349.26, 5
4, 16:07:00-000, 63, 35, 28, 33, 1350.15, 27, 1350.03, 10
4, 16:08:00-000, 91, 33, 58, 32, 1352.15, 43, 1350.90, 10
4, 16:09:00-000, 89, 39, 50, 39, 1351.35, 33, 1351.14, 6
4, 16:10:00-000, 90, 45, 45, 40, 1350.42, 57, 1350.90, 1
4, 16:11:00-000, 79, 28, 51, 30, 1349.49, 52, 1349.59, 4
4, 16:12:00-000, 86, 59, 27, 51, 1351.58, 27, 1351.66, 3
4, 16:13:00-000, 71, 23, 48, 30, 1351.03, 33, 1350.36, 3
4, 16:14:00-000, 83, 42, 41, 42, 1350.56, 49, 1350.23, 6
4, 16:15:00-000, 66, 24, 42, 20, 1349.00, 30, 1350.39, 0
4, 16:16:00-000, 104, 65, 39, 65, 1351.14, 48, 1351.01, 2
4, 16:17:00-000, 83, 45, 38, 45, 1350.99, 38, 1351.12, 2
4, 16:18:00-000, 88, 61, 27, 52, 1352.62, 18, 1352.72, 5
4, 16:19:00-000, 80, 39, 41, 41, 1351.94, 32, 1352.12, 9
4, 16:20:00-000, 106, 47, 59, 45, 1348.55, 55, 1348.90, 5
4, 16:21:00-000, 67, 39, 28, 39, 1348.89, 29, 1349.06, 0
4, 16:22:00-000, 90, 42, 48, 46, 1348.41, 46, 1348.73, 9
4, 16:23:00-000, 97, 47, 50, 42, 1348.73, 44, 1349.74, 0
4, 16:24:00-000, 77, 29, 48, 32, 1349.78, 46, 1350.84, 1
4, 16:25:00-000, 82, 49, 33, 45, 1351.44, 37, 1351.86, 2
4, 16:26:00-000, 89, 45, 44, 50, 1351.39, 27, 1351.48, 6
4, 16:27:00-000, 98, 41, 57, 28, 1350.17, 49, 1349.99, 19
4, 16:28:00-000, 113, 45, 68, 47, 1350.52, 53, 1351.61, 15
4, 16:29:00-000, 68, 33, 35, 36, 1351.05, 38, 1351.36, 7
5, 09:13:00-000, 10329, 5483, 4846, 3959, 1348.03, 3938, 1349.22, 0
5, 09:14:00-000, 0, 0, 0, 0, 0.00, 4, 1357.00, 561
5, 09:15:00-000, 0, 0, 0, 0, 0.00, 49, 1357.00, 1816
5, 09:16:00-000, 0, 0, 0, 0, 0.00, 0, 0.00, 2
5, 09:26:00-000, 10341, 5572, 4769, 3724, 1348.45, 3840, 1348.57, 0
5, 09:27:00-000, 0, 0, 0, 58, 1348.00, 68, 1357.00, 0
5, 09:28:00-000, 9, 3, 6, 134, 1347.56, 118, 1356.55, 1799
5, 09:29:00-000, 12, 6, 6, 6, 1348.83, 5, 1349.80, 608
5, 09:30:00-000, 110, 44, 66, 40, 1349.82, 53, 1351.96, 0
5, 09:31:00-000, 0, 0, 0, 1, 1345.00, 14, 1359.57, 1
5, 09:32:00-000, 194, 108, 86, 78, 1348.87, 86, 1349.55, 2
5, 09:33:00-000, 434, 245, 189, 175, 1349.36, 167, 1350.14, 14
5, 09:34:00-000, 626, 351, 275, 278, 1349.50, 255, 1350.54, 27
5, 09:35:00-000, 0, 0, 0, 31, 1345.54, 0, 0.00, 54
5, 09:36:00-000, 935, 528, 407, 385, 1348.97, 382, 1350.11, 63
5, 09:37:00-000, 1130, 614, 516, 396, 1348.75, 399, 1349.27, 106
5, 09:38:00-000, 1282, 713, 569, 500, 1349.03, 539, 1350.52, 138
5, 09:39:00-000, 0, 0, 0, 9, 1348.00, 43, 1358.18, 183
5, 09:40:00-000, 1347, 665, 682, 509, 1348.47, 612, 1350.11, 190
5, 09:41:00-000, 1277, 633, 644, 539, 1348.14, 473, 1349.14, 183
5, 09:42:00-000, 1160, 635, 525, 455, 1349.34, 469, 1350.11, 172
5, 09:43:00-000, 1, 0, 1, 18, 1348.00, 31, 1356.74, 171
5, 09:44:00-000, 1030, 490, 540, 381, 1348.15, 437, 1349.19, 168
5, 09:45:00-000, 929, 498, 431, 333, 1349.09, 319, 1349.70, 217
5, 09:46:00-000, 917, 498, 419, 374, 1348.58, 386, 1350.06, 133
5, 09:47:00-000, 0, 0, 0, 3, 1346.00, 15, 1356.20, 153
5, 09:48:00-000, 992, 561, 431, 387, 1349.42, 348, 1350.08, 186
5, 09:49:00-000, 929, 464, 465, 360, 1348.52, 343, 1348.94, 132
5, 09:50:00-000, 904, 488, 416, 414, 1348.85, 331, 1350.02, 143
5, 09:51:00-000, 0, 0, 0, 16, 1346.44, 22, 1356.00, 171
5, 09:52:00-000, 1017, 512, 505, 350, 1348.84, 456, 1350.30, 136
5, 09:53:00-000, 1107, 601, 506, 383, 1349.31, 372, 1349.46, 159
5, 09:54:00-000, 1158, 644, 514, 443, 1348.57, 428, 1349.29, 159
5, 09:55:00-000, 1, 1, 0, 24, 1346.79, 27, 1356.15, 240
5, 09:56:00-000, 1159, 645, 514, 479, 1349.07, 441, 1349.80, 209
5, 09:57:00-000, 1060, 550, 510, 401, 1348.82, 379, 1349.15, 182
5, 09:58:00-000, 1042, 558, 484, 424, 1348.89, 381, 1349.66, 186
5, 09:59:00-000, 1, 1, 0, 15, 1346.00, 31, 1356.06, 173
5, 10:00:00-000, 1115, 569, 546, 451, 1348.85, 420, 1350.01, 154
5, 10:01:00-000, 1175, 633, 542, 461, 1348.80, 475, 1349.44, 201
5, 10:02:00-000, 928, 459, 469, 334, 1348.59, 376, 1349.27, 172
5, 10:03:00-000, 0, 0, 0, 19, 1346.00, 13, 1356.00, 174
5, 10:04:00-000, 1060, 537, 523, 444, 1347.86, 445, 1348.79, 133
5, 10:05:00-000, 962, 521, 441, 367, 1349.48, 360, 1349.55, 155
5, 10:06:00-000, 993, 465, 528, 377, 1347.71, 420, 1349.13, 145
5, 10:07:00-000, 0, 0, 0, 0, 0.00, 20, 1355.60, 154
5, 10:08:00-000, 1117, 605, 512, 455, 1348.91, 437, 1349.97, 148
5, 10:09:00-000, 995, 512, 483, 389, 1348.76, 394, 1349.44, 169
5, 10:10:00-000, 1063, 561, 502, 433, 1348.21, 385, 1349.08, 123
5, 10:11:00-000, 7, 6, 1, 17, 1348.53, 76, 1356.57, 135
5, 10:12:00-000, 1049, 502, 547, 431, 1348.26, 408, 1349.27, 155
5, 10:13:00-000, 1071, 534, 537, 415, 1348.50, 450, 1349.18, 201
5, 10:14:00-000, 1008, 490, 518, 445, 1347.96, 437, 1349.22, 104
5, 10:15:00-000, 0, 0, 0, 14, 1344.00, 25, 1356.28, 108
5, 10:16:00-000, 1025, 577, 448, 411, 1349.19, 404, 1350.34, 142
5, 10:17:00-000, 969, 484, 485, 377, 1348.95, 396, 1349.56, 128
5, 10:18:00-000, 1018, 552, 466, 421, 1349.08, 386, 1349.68, 143
5, 10:19:00-000, 0, 0, 0, 10, 1346.80, 2, 1356.00, 136
5, 10:20:00-000, 1018, 555, 463, 401, 1349.58, 373, 1351.03, 171
5, 10:21:00-000, 1017, 537, 480, 325, 1349.63, 396, 1350.13, 188
5, 10:22:00-000, 1046, 569, 477, 423, 1349.03, 416, 1349.99, 153
5, 10:23:00-000, 1, 0, 1, 0, 0.00, 26, 1357.57, 208
5, 10:24:00-000, 958, 462, 496, 368, 1347.96, 411, 1348.86, 144
5, 10:25:00-000, 945, 552, 393, 385, 1349.50, 357, 1350.26, 155
5, 10:26:00-000, 1050, 545, 505, 449, 1349.30, 418, 1350.70, 119
5, 10:27:00-000, 2, 2, 0, 2, 1346.00, 27, 1356.59, 113
5, 10:28:00-000, 1070, 524, 546, 397, 1348.67, 464, 1349.55, 186
5, 10:29:00-000, 951, 472, 479, 376, 1348.68, 353, 1349.12, 155
5, 10:30:00-000, 1118, 594, 524, 425, 1348.71, 398, 1349.42, 116
5, 10:31:00-000, 1, 0, 1, 17, 1347.00, 12, 1354.50, 167
5, 10:32:00-000, 1001, 541, 460, 364, 1348.77, 422, 1350.55, 199
5, 10:33:00-000, 1077, 531, 546, 401, 1348.76, 394, 1349.60, 173
5, 10:34:00-000, 1053, 513, 540, 417, 1348.86, 446, 1349.49, 195
5, 10:35:00-000, 1, 0, 1, 22, 1346.00, 18, 1355.72, 163
5, 10:36:00-000, 966, 496, 470, 396, 1348.83, 393, 1349.88, 163
5, 10:37:00-000, 1028, 553, 475, 434, 1348.72, 376, 1349.21, 128
5, 10:38:00-000, 1006, 513, 493, 422, 1348.71, 354, 1349.19, 152
5, 10:39:00-000, 0, 0, 0, 30, 1345.60, 33, 1354.21, 122
5, 10:40:00-000, 1072, 525, 547, 399, 1348.74, 426, 1349.24, 139
5, 10:41:00-000, 982, 506, 476, 388, 1349.40, 356, 1349.47, 198
5, 10:42:00-000, 1047, 505, 542, 376, 1348.80, 474, 1349.99, 193
5, 10:43:00-000, 2, 0, 2, 16, 1346.75, 25, 1355.68, 130
5, 10:44:00-000, 1034, 531, 503, 402, 1348.86, 411, 1349.85, 167
5, 10:45:00-000, 978, 479, 499, 351, 1348.99, 374, 1349.25, 155
5, 10:46:00-000, 1068, 556, 512, 426, 1348.25, 420, 1349.36, 145
5, 10:47:00-000, 0, 0, 0, 65, 1344.76, 8, 1356.00, 126
5, 10:48:00-000, 1090, 554, 536, 450, 1348.85, 481, 1350.03, 146
5, 10:49:00-000, 1083, 531, 552, 379, 1348.45, 411, 1348.55, 147
5, 10:50:00-000, 1032, 569, 463, 444, 1349.31, 457, 1350.65, 175
5, 10:51:00-000, 2, 2, 0, 14, 1346.14, 46, 1357.27, 139
5, 10:52:00-000, 978, 553, 425, 390, 1348.33, 345, 1349.43, 91
5, 10:53:00-000, 1081, 524, 557, 390, 1348.29, 423, 1349.34, 179
5, 10:54:00-000, 1133, 652, 481, 487, 1349.16, 421, 1349.67, 148
5, 10:55:00-000, 0, 0, 0, 17, 1347.70, 0, 0.00, 185
5, 10:56:00-000, 920, 491, 429, 367, 1348.95, 364, 1349.80, 181
5, 10:57:00-000, 1002, 480, 522, 362, 1347.99, 400, 1349.19, 145
5, 10:58:00-000, 1089, 561, 528, 468, 1348.62, 436, 1349.60, 122
5, 10:59:00-000, 1, 1, 0, 19, 1345.05, 37, 1356.29, 171
5, 11:00:00-000, 1013, 512, 501, 392, 1348.44, 443, 1350.08, 144
5, 11:01:00-000, 989, 543, 446, 364, 1349.14, 364, 1349.94, 169
5, 11:02:00-000, 1018, 508, 510, 452, 1348.65, 398, 1349.25, 123
5, 11:03:00-000, 0, 0, 0, 0, 0.00, 12, 1356.00, 148
5, 11:04:00-000, 1061, 559, 502, 360, 1348.94, 409, 1350.33, 176
5, 11:05:00-000, 947, 494, 453, 383, 1349.28, 364, 1349.82, 155
5, 11:06:00-000, 1092, 564, 528, 384, 1348.79, 363, 1349.17, 199
5, 11:07:00-000, 3, 3, 0, 42, 1345.76, 23, 1355.00, 146
5, 11:08:00-000, 984, 486, 498, 364, 1348.48, 424, 1349.40, 234
5, 11:09:00-000, 1025, 543, 482, 437, 1348.51, 406, 1349.17, 149
5, 11:10:00-000, 1041, 606, 435, 474, 1349.16, 395, 1350.38, 132
5, 11:11:00-000, 3, 0, 3, 11, 1346.00, 39, 1357.12, 113
5, 11:12:00-000, 1035, 495, 540, 387, 1348.34, 404, 1349.10, 130
5, 11:13:00-000, 992, 501, 491, 387, 1348.61, 387, 1349.05, 162
5, 11:14:00-000, 1035, 522, 513, 407, 1348.94, 416, 1350.36, 140
5, 11:15:00-000, 0, 0, 0, 18, 1346.00, 27, 1356.00, 164
5, 11:16:00-000, 1103, 576, 527, 447, 1348.98, 383, 1349.77, 174
5, 11:17:00-000, 1004, 505, 499, 431, 1347.75, 384, 1348.34, 151
5, 11:18:00-000, 929, 512, 417, 345, 1349.09, 350, 1350.20, 205
5, 11:19:00-000, 7, 0, 7, 10, 1346.00, 33, 1354.51, 115
5, 11:20:00-000, 961, 499, 462, 404, 1349.14, 411, 1350.32, 173
5, 11:21:00-000, 1060, 525, 535, 402, 1348.46, 414, 1348.83, 110
5, 11:22:00-000, 974, 493, 481, 406, 1348.10, 396, 1349.39, 139
5, 11:23:00-000, 2, 2, 0, 17, 1347.24, 43, 1356.48, 127
5, 11:24:00-000, 1013, 514, 499, 401, 1348.70, 433, 1349.66, 127
5, 11:25:00-000, 1002, 490, 512, 394, 1348.42, 426, 1349.16, 145
5, 11:26:00-000, 1083, 557, 526, 421, 1348.74, 431, 1349.37, 158
5, 11:27:00-000, 6, 6, 0, 11, 1347.64, 0, 0.00, 109
5, 11:28:00-000, 1151, 583, 568, 486, 1348.93, 496, 1350.31, 171
5, 11:29:00-000, 1006, 450, 556, 394, 1347.99, 396, 1348.67, 136
5, 11:30:00-000, 1022, 535, 487, 399, 1348.99, 348, 1349.17, 150
5, 11:31:00-000, 2, 2, 0, 0, 0.00, 15, 1355.07, 143
5, 11:32:00-000, 1019, 512, 507, 385, 1349.05, 417, 1350.17, 222
5, 11:33:00-000, 1023, 564, 459, 399, 1349.43, 398, 1350.18, 163
5, 11:34:00-000, 1093, 603, 490, 454, 1349.70, 423, 1350.32, 157
5, 11:35:00-000, 3, 3, 0, 26, 1347.00, 6, 1357.00, 150
5, 11:36:00-000, 979, 504, 475, 426, 1347.91, 375, 1349.13, 124
5, 11:37:00-000, 1020, 563, 457, 393, 1349.20, 318, 1349.25, 178
5, 11:38:00-000, 976, 530, 446, 409, 1349.40, 390, 1350.11, 167
5, 11:39:00-000, 4, 0, 4, 29, 1346.00, 29, 1355.48, 192
5, 11:40:00-000, 1083, 512, 571, 427, 1347.78, 438, 1349.11, 108
5, 11:41:00-000, 1083, 563, 520, 399, 1349.31, 437, 1349.99, 156
5, 11:42:00-000, 1004, 509, 495, 371, 1348.61, 425, 1349.50, 177
5, 11:43:00-000, 1, 0, 1, 12, 1346.00, 8, 1355.75, 173
5, 11:44:00-000, 1021, 493, 528, 404, 1348.34, 391, 1349.01, 163
5, 11:45:00-000, 957, 456, 501, 333, 1348.35, 377, 1349.18, 169
5, 11:46:00-000, 1022, 502, 520, 392, 1348.79, 371, 1349.06, 141
5, 11:47:00-000, 0, 0, 0, 68, 1345.57, 43, 1355.51, 156
5, 11:48:00-000, 895, 458, 437, 304, 1348.96, 343, 1349.92, 150
5, 11:49:00-000, 1101, 538, 563, 465, 1348.50, 498, 1349.28, 131
5, 11:50:00-000, 1141, 599, 542, 445, 1349.32, 438, 1350.10, 159
5, 11:51:00-000, 1, 0, 1, 34, 1346.00, 71, 1356.54, 121
5, 11:52:00-000, 1083, 562, 521, 452, 1348.66, 443, 1349.35, 147
5, 11:53:00-000, 983, 536, 447, 381, 1348.66, 363, 1349.29, 124
5, 11:54:00-000, 1010, 541, 469, 414, 1347.89, 399, 1349.02, 150
5, 11:55:00-000, 7, 1, 6, 2, 1347.00, 11, 1351.18, 160
5, 11:56:00-000, 1095, 536, 559, 453, 1348.01, 449, 1349.70, 162
5, 11:57:00-000, 1000, 547, 453, 372, 1349.93, 352, 1350.58, 162
5, 11:58:00-000, 1098, 570, 528, 417, 1348.88, 452, 1350.19, 132
5, 11:59:00-000, 4, 3, 1, 18, 1346.67, 16, 1356.81, 185
5, 12:00:00-000, 941, 493, 448, 339, 1349.36, 335, 1349.95, 188
5, 12:01:00-000, 1008, 471, 537, 347, 1348.76, 394, 1349.20, 186
5, 12:02:00-000, 1024, 512, 512, 383, 1348.78, 401, 1349.64, 186
5, 12:03:00-000, 7, 2, 5, 25, 1346.44, 13, 1353.85, 169
5, 12:04:00-000, 1006, 503, 503, 412, 1349.59, 459, 1350.90, 189
5, 12:05:00-000, 985, 517, 468, 349, 1348.97, 359, 1349.76, 112
5, 12:06:00-000, 987, 498, 489, 410, 1348.71, 387, 1349.94, 149
5, 12:07:00-000, 0, 0, 0, 12, 1344.00, 7, 1356.00, 184
5, 12:08:00-000, 1100, 558, 542, 487, 1348.90, 431, 1350.07, 155
5, 12:09:00-000, 1015, 499, 516, 377, 1348.65, 387, 1349.65, 143
5, 12:10:00-000, 1003, 524, 479, 429, 1348.26, 454, 1349.79, 139
5, 12:11:00-000, 2, 2, 0, 5, 1346.60, 20, 1356.25, 131
5, 12:12:00-000, 980, 496, 484, 373, 1348.99, 391, 1349.88, 124
5, 12:13:00-000, 983, 520, 463, 373, 1349.01, 360, 1349.79, 163
5, 12:14:00-000, 962, 467, 495, 394, 1348.81, 420, 1349.45, 160
5, 12:15:00-000, 2, 1, 1, 33, 1345.15, 17, 1355.47, 129
5, 12:16:00-000, 1007, 486, 521, 396, 1349.11, 399, 1349.40, 116
5, 12:17:00-000, 1130, 553, 577, 453, 1347.99, 474, 1348.84, 144
5, 12:18:00-000, 986, 482, 504, 360, 1348.89, 410, 1350.07, 107
5, 12:19:00-000, 1, 1, 0, 23, 1345.87, 47, 1354.65, 177
5, 12:20:00-000, 1132, 535, 597, 342, 1348.79, 366, 1348.60, 149
5, 12:21:00-000, 1050, 535, 515, 407, 1348.71, 373, 1348.88, 241
5, 12:22:00-000, 1032, 540, 492, 409, 1349.45, 352, 1349.24, 227
5, 12:23:00-000, 3, 3, 0, 0, 0.00, 0, 0.00, 229
5, 12:24:00-000, 1098, 579, 519, 446, 1348.79, 451, 1349.16, 208
5, 12:25:00-000, 985, 477, 508, 340, 1348.49, 381, 1348.16, 161
5, 12:26:00-000, 960, 523, 437, 354, 1349.03, 348, 1349.21, 206
5, 12:27:00-000, 0, 0, 0, 8, 1347.00, 0, 0.00, 177
5, 12:28:00-000, 1003, 531, 472, 413, 1349.32, 353, 1349.55, 185
5, 12:29:00-000, 1054, 527, 527, 373, 1348.80, 408, 1349.09, 198
5, 12:30:00-000, 1053, 532, 521, 417, 1348.74, 391, 1348.74, 173
5, 12:31:00-000, 4, 3, 1, 10, 1346.30, 1, 1351.00, 184
5, 12:32:00-000, 997, 525, 472, 397, 1349.22, 391, 1349.98, 188
5, 12:33:00-000, 1080, 527, 553, 391, 1349.13, 408, 1349.59, 177
5, 12:34:00-000, 1039, 504, 535, 458, 1348.33, 394, 1349.31, 151
5, 12:35:00-000, 0, 0, 0, 0, 0.00, 8, 1354.00, 210
5, 12:36:00-000, 1070, 538, 532, 435, 1348.87, 445, 1349.05, 163
5, 12:37:00-000, 951, 565, 386, 368, 1349.73, 295, 1349.61, 172
5, 12:38:00-000, 1085, 566, 519, 437, 1348.62, 422, 1349.22, 143
5, 12:39:00-000, 0, 0, 0, 23, 1346.00, 11, 1356.00, 170
5, 12:40:00-000, 1082, 521, 561, 363, 1348.61, 411, 1349.32, 156
5, 12:41:00-000, 1028, 544, 484, 411, 1348.95, 365, 1349.60, 218
5, 12:42:00-000, 1095, 534, 561, 449, 1348.38, 387, 1349.23, 194
5, 12:43:00-000, 2, 0, 2, 13, 1345.15, 9, 1354.00, 165
5, 12:44:00-000, 991, 515, 476, 389, 1348.22, 399, 1349.59, 189
5, 12:45:00-000, 991, 494, 497, 410, 1348.88, 403, 1349.06, 182
5, 12:46:00-000, 1022, 539, 483, 420, 1348.36, 382, 1348.71, 164
5, 12:47:00-000, 1, 0, 1, 0, 0.00, 19, 1355.10, 141
5, 12:48:00-000, 1110, 543, 567, 403, 1348.80, 430, 1349.53, 150
5, 12:49:00-000, 1020, 523, 497, 413, 1348.55, 417, 1348.60, 186
5, 12:50:00-000, 1038, 551, 487, 423, 1349.49, 432, 1350.00, 150
5, 12:51:00-000, 2, 1, 1, 27, 1345.62, 16, 1355.31, 149
5, 12:52:00-000, 1030, 509, 521, 416, 1348.69, 389, 1349.40, 135
5, 12:53:00-000, 1036, 542, 494, 414, 1349.19, 399, 1349.98, 156
5, 12:54:00-000, 976, 488, 488, 401, 1348.50, 401, 1349.24, 151
5, 12:55:00-000, 4, 0, 4, 0, 0.00, 19, 1355.00, 161
5, 12:56:00-000, 1003, 486, 517, 399, 1348.28, 447, 1349.50, 128
5, 12:57:00-000, 1045, 553, 492, 395, 1348.97, 430, 1350.01, 104
5, 12:58:00-000, 1048, 541, 507, 453, 1348.38, 329, 1349.26, 160
5, 12:59:00-000, 1, 0, 1, 17, 1344.88, 33, 1355.00, 122
5, 13:00:00-000, 977, 483, 494, 376, 1348.74, 403, 1349.83, 210
5, 13:01:00-000, 1018, 558, 460, 389, 1349.38, 376, 1349.13, 167
5, 13:02:00-000, 997, 483, 514, 388, 1347.95, 397, 1349.07, 151
5, 13:03:00-000, 2, 1, 1, 33, 1344.17, 21, 1355.52, 171
5, 13:04:00-000, 1041, 541, 500, 383, 1349.02, 426, 1350.11, 139
5, 13:05:00-000, 1034, 558, 476, 383, 1349.19, 393, 1349.85, 155
5, 13:06:00-000, 1089, 528, 561, 449, 1348.52, 430, 1349.75, 153
5, 13:07:00-000, 1, 0, 1, 19, 1345.00, 18, 1355.77, 169
5, 13:08:00-000, 1013, 496, 517, 396, 1349.08, 411, 1349.72, 164
5, 13:09:00-000, 984, 458, 526, 331, 1347.75, 390, 1348.49, 170
5, 13:10:00-000, 1005, 525, 480, 387, 1348.51, 428, 1349.87, 165
5, 13:11:00-000, 0, 0, 0, 0, 0.00, 48, 1356.74, 125
5, 13:12:00-000, 1022, 579, 443, 411, 1349.42, 373, 1350.07, 168
5, 13:13:00-000, 1020, 492, 528, 383, 1348.42, 388, 1348.85, 170
5, 13:14:00-000, 997, 501, 496, 398, 1348.46, 393, 1349.34, 150
5, 13:15:00-000, 5, 2, 3, 42, 1344.90, 33, 1355.06, 156
5, 13:16:00-000, 1034, 557, 477, 412, 1349.50, 402, 1350.48, 135
5, 13:17:00-000, 978, 512, 466, 400, 1349.36, 342, 1349.66, 167
5, 13:18:00-000, 1091, 549, 542, 424, 1348.71, 398, 1349.50, 165
5, 13:19:00-000, 0, 0, 0, 23, 1345.04, 12, 1355.50, 152
5, 13:20:00-000, 973, 492, 481, 391, 1348.94, 402, 1350.38, 194
5, 13:21:00-000, 1023, 510, 513, 395, 1349.00, 439, 1349.60, 115
5, 13:22:00-000, 943, 510, 433, 343, 1349.31, 361, 1350.53, 159
5, 13:23:00-000, 6, 2, 4, 15, 1346.00, 24, 1355.50, 143
5, 13:24:00-000, 1081, 489, 592, 429, 1348.32, 493, 1349.02, 167
5, 13:25:00-000, 1030, 528, 502, 396, 1349.00, 362, 1349.25, 124
5, 13:26:00-000, 1035, 524, 511, 420, 1348.53, 432, 1349.44, 128
5, 13:27:00-000, 3, 3, 0, 23, 1344.78, 11, 1355.55, 182
5, 13:28:00-000, 1040, 524, 516, 422, 1348.16, 398, 1349.29, 137
5, 13:29:00-000, 1043, 545, 498, 389, 1350.03, 378, 1351.01, 171
5, 13:30:00-000, 1033, 560, 473, 476, 1348.56, 362, 1349.35, 165
5, 13:31:00-000, 0, 0, 0, 11, 1344.00, 0, 0.00, 169
5, 13:32:00-000, 1043, 525, 518, 454, 1348.01, 458, 1349.43, 161
5, 13:33:00-000, 1087, 574, 513, 441, 1348.82, 397, 1348.74, 156
5, 13:34:00-000, 1056, 526, 530, 372, 1349.08, 413, 1350.47, 113
5, 13:35:00-000, 1, 0, 1, 27, 1345.00, 5, 1355.00, 159
5, 13:36:00-000, 1043, 524, 519, 381, 1348.31, 415, 1349.59, 209
5, 13:37:00-000, 1006, 488, 518, 418, 1348.52, 425, 1348.84, 159
5, 13:38:00-000, 1004, 493, 511, 403, 1348.76, 473, 1349.92, 130
5, 13:39:00-000, 3, 1, 2, 4, 1345.75, 7, 1355.14, 119
5, 13:40:00-000, 1034, 521, 513, 425, 1348.10, 395, 1349.31, 144
5, 13:41:00-000, 1097, 602, 495, 435, 1349.40, 401, 1349.78, 118
5, 13:42:00-000, 1017, 510, 507, 400, 1348.87, 397, 1349.84, 169
5, 13:43:00-000, 1, 1, 0, 19, 1346.42, 39, 1355.69, 186
5, 13:44:00-000, 947, 538, 409, 353, 1349.30, 342, 1350.11, 177
5, 13:45:00-000, 1057, 539, 518, 382, 1348.69, 378, 1348.78, 121
5, 13:46:00-000, 1024, 521, 503, 436, 1348.47, 430, 1349.98, 212
5, 13:47:00-000, 5, 1, 4, 1, 1350.00, 2, 1356.00, 205
5, 13:48:00-000, 1054, 584, 470, 445, 1349.18, 377, 1349.43, 157
5, 13:49:00-000, 965, 480, 485, 340, 1349.19, 354, 1349.82, 183
5, 13:50:00-000, 1058, 516, 542, 432, 1348.47, 424, 1348.88, 150
5, 13:51:00-000, 3, 1, 2, 21, 1345.00, 15, 1354.93, 168
5, 13:52:00-000, 985, 538, 447, 399, 1349.11, 366, 1349.69, 171
5, 13:53:00-000, 1056, 559, 497, 397, 1348.37, 414, 1348.99, 151
5, 13:54:00-000, 942, 469, 473, 387, 1348.18, 443, 1349.71, 139
5, 13:55:00-000, 0, 0, 0, 32, 1345.00, 40, 1356.52, 154
5, 13:56:00-000, 1047, 483, 564, 377, 1348.39, 444, 1349.93, 98
5, 13:57:00-000, 949, 477, 472, 353, 1348.78, 398, 1349.64, 130
5, 13:58:00-000, 1134, 616, 518, 417, 1349.17, 388, 1349.34, 159
5, 13:59:00-000, 7, 3, 4, 29, 1347.34, 45, 1355.46, 140
5, 14:00:00-000, 1050, 559, 491, 427, 1349.30, 353, 1349.78, 206
5, 14:01:00-000, 936, 469, 467, 390, 1348.60, 316, 1349.09, 185
5, 14:02:00-000, 1058, 579, 479, 438, 1350.05, 413, 1350.66, 194
5, 14:03:00-000, 0, 0, 0, 11, 1346.00, 37, 1356.48, 146
5, 14:04:00-000, 978, 488, 490, 336, 1348.87, 384, 1350.20, 156
5, 14:05:00-000, 1071, 577, 494, 431, 1348.44, 405, 1349.02, 151
5, 14:06:00-000, 1065, 540, 525, 396, 1348.77, 412, 1349.76, 138
5, 14:07:00-000, 1, 0, 1, 19, 1346.00, 34, 1354.82, 198
5, 14:08:00-000, 1067, 556, 511, 412, 1349.13, 442, 1350.01, 208
5, 14:09:00-000, 962, 508, 454, 409, 1349.01, 364, 1349.59, 140
5, 14:10:00-000, 1028, 498, 530, 382, 1349.36, 431, 1350.24, 130
5, 14:11:00-000, 18, 12, 6, 66, 1344.75, 8, 1356.00, 132
5, 14:12:00-000, 1096, 528, 568, 404, 1347.91, 437, 1349.04, 145
5, 14:13:00-000, 972, 488, 484, 392, 1349.16, 364, 1349.88, 170
5, 14:14:00-000, 1081, 565, 516, 400, 1349.03, 404, 1349.65, 164
5, 14:15:00-000, 0, 0, 0, 20, 1346.00, 0, 0.00, 176
5, 14:16:00-000, 1067, 542, 525, 387, 1348.87, 480, 1349.96, 181
5, 14:17:00-000, 986, 556, 430, 371, 1350.29, 332, 1350.64, 186
5, 14:18:00-000, 992, 499, 493, 394, 1348.63, 384, 1349.85, 162
5, 14:19:00-000, 2, 0, 2, 27, 1345.00, 31, 1355.80, 152
5, 14:20:00-000, 1184, 651, 533, 465, 1349.30, 450, 1350.01, 171
5, 14:21:00-000, 1036, 501, 535, 365, 1348.47, 386, 1348.93, 209
5, 14:22:00-000, 892, 464, 428, 425, 1348.35, 331, 1349.46, 164
5, 14:23:00-000, 8, 1, 7, 1, 1353.00, 32, 1355.74, 178
5, 14:24:00-000, 1096, 571, 525, 440, 1348.70, 463, 1349.86, 136
5, 14:25:00-000, 934, 507, 427, 347, 1349.37, 343, 1350.03, 127
5, 14:26:00-000, 1062, 594, 468, 480, 1349.42, 390, 1349.95, 147
5, 14:27:00-000, 2, 0, 2, 30, 1346.00, 30, 1355.46, 151
5, 14:28:00-000, 983, 494, 489, 351, 1349.11, 402, 1349.80, 169
5, 14:29:00-000, 1105, 528, 577, 394, 1348.43, 484, 1349.31, 133
5, 14:30:00-000, 992, 484, 508, 384, 1348.35, 374, 1349.34, 158
5, 14:31:00-000, 5, 2, 3, 1, 1351.00, 34, 1355.20, 150
5, 14:32:00-000, 1026, 558, 468, 415, 1349.17, 382, 1349.81, 168
5, 14:33:00-000, 1114, 532, 582, 451, 1348.78, 449, 1349.41, 170
5, 14:34:00-000, 1069, 492, 577, 384, 1347.06, 456, 1348.24, 116
5, 14:35:00-000, 3, 3, 0, 23, 1344.52, 57, 1355.69, 165
5, 14:36:00-000, 1011, 462, 549, 399, 1347.70, 405, 1348.42, 156
5, 14:37:00-000, 991, 480, 511, 372, 1348.76, 410, 1349.49, 136
5, 14:38:00-000, 982, 458, 524, 296, 1348.72, 365, 1349.40, 180
5, 14:39:00-000, 1, 1, 0, 44, 1345.88, 0, 0.00, 157
5, 14:40:00-000, 1220, 623, 597, 463, 1348.51, 486, 1349.65, 170
5, 14:41:00-000, 1067, 537, 530, 428, 1348.15, 424, 1348.27, 180
5, 14:42:00-000, 994, 445, 549, 387, 1347.65, 423, 1348.47, 179
5, 14:43:00-000, 1, 0, 1, 34, 1344.00, 30, 1353.60, 202
5, 14:44:00-000, 1008, 467, 541, 370, 1347.65, 436, 1348.91, 110
5, 14:45:00-000, 1074, 578, 496, 416, 1349.04, 397, 1349.37, 147
5, 14:46:00-000, 991, 478, 513, 376, 1348.81, 377, 1349.81, 150
5, 14:47:00-000, 9, 5, 4, 57, 1345.10, 2, 1349.50, 163
5, 14:48:00-000, 1107, 504, 603, 400, 1348.06, 441, 1349.01, 201
5, 14:49:00-000, 960, 497, 463, 411, 1349.41, 383, 1350.04, 157
5, 14:50:00-000, 1006, 487, 519, 409, 1348.75, 410, 1349.74, 164
5, 14:51:00-000, 2, 1, 1, 34, 1343.97, 31, 1355.81, 105
5, 14:52:00-000, 998, 545, 453, 414, 1349.75, 338, 1350.27, 132
5, 14:53:00-000, 1065, 607, 458, 429, 1349.38, 329, 1350.05, 164
5, 14:54:00-000, 1092, 546, 546, 477, 1349.73, 425, 1350.85, 158
5, 14:55:00-000, 4, 3, 1, 33, 1344.39, 3, 1356.00, 175
5, 14:56:00-000, 977, 505, 472, 415, 1348.35, 418, 1349.78, 160
5, 14:57:00-000, 1029, 498, 531, 408, 1348.50, 402, 1349.51, 141
5, 14:58:00-000, 918, 518, 400, 389, 1349.46, 365, 1350.62, 139
5, 14:59:00-000, 2, 2, 0, 2, 1353.50, 45, 1357.00, 121
5, 15:00:00-000, 971, 468, 503, 407, 1347.96, 416, 1348.82, 131
5, 15:01:00-000, 983, 472, 511, 338, 1348.67, 385, 1349.49, 103
5, 15:02:00-000, 1063, 584, 479, 474, 1348.66, 428, 1350.03, 125
5, 15:03:00-000, 2, 1, 1, 5, 1345.20, 23, 1355.82, 144
5, 15:04:00-000, 1020, 522, 498, 423, 1348.67, 391, 1349.50, 144
5, 15:05:00-000, 1107, 530, 577, 429, 1349.07, 442, 1349.56, 156
5, 15:06:00-000, 986, 474, 512, 363, 1348.44, 475, 1350.29, 137
5, 15:07:00-000, 1, 1, 0, 10, 1345.10, 18, 1357.00, 162
5, 15:08:00-000, 1076, 560, 516, 435, 1348.87, 481, 1349.78, 138
5, 15:09:00-000, 1025, 475, 550, 352, 1348.49, 373, 1349.17, 93
5, 15:10:00-000, 1043, 489, 554, 424, 1348.57, 435, 1349.30, 135
5, 15:11:00-000, 8, 2, 6, 38, 1344.78, 32, 1353.81, 181
5, 15:12:00-000, 1005, 496, 509, 435, 1348.69, 404, 1349.89, 139
5, 15:13:00-000, 1002, 528, 474, 396, 1349.75, 378, 1350.37, 127
5, 15:14:00-000, 990, 504, 486, 403, 1348.41, 387, 1349.15, 131
5, 15:15:00-000, 3, 1, 2, 44, 1344.72, 0, 0.00, 155
5, 15:16:00-000, 1018, 529, 489, 461, 1347.41, 393, 1348.98, 152
5, 15:17:00-000, 969, 477, 492, 374, 1349.09, 344, 1349.68, 110
5, 15:18:00-000, 1074, 516, 558, 426, 1348.34, 493, 1349.67, 165
5, 15:19:00-000, 3, 3, 0, 3, 1349.67, 22, 1356.00, 135
5, 15:20:00-000, 1002, 518, 484, 442, 1348.71, 357, 1349.12, 125
5, 15:21:00-000, 1081, 541, 540, 401, 1349.13, 395, 1349.51, 156
5, 15:22:00-000, 1069, 585, 484, 473, 1349.12, 425, 1349.91, 161
5, 15:23:00-000, 1, 0, 1, 26, 1344.96, 1, 1349.00, 171
5, 15:24:00-000, 963, 501, 462, 378, 1348.89, 409, 1349.96, 167
5, 15:25:00-000, 1027, 506, 521, 393, 1348.33, 376, 1349.17, 120
5, 15:26:00-000, 1102, 541, 561, 420, 1348.71, 482, 1349.68, 169
5, 15:27:00-000, 7, 2, 5, 1, 1349.00, 5, 1349.60, 152
5, 15:28:00-000, 1079, 578, 501, 434, 1349.26, 423, 1350.13, 154
5, 15:29:00-000, 904, 449, 455, 323, 1349.01, 340, 1349.46, 190
5, 15:30:00-000, 1101, 599, 502, 402, 1349.42, 396, 1349.99, 158
5, 15:31:00-000, 2, 1, 1, 39, 1346.33, 10, 1354.00, 172
5, 15:32:00-000, 1017, 531, 486, 415, 1349.20, 387, 1350.19, 206
5, 15:33:00-000, 948, 461, 487, 369, 1348.83, 365, 1349.04, 174
5, 15:34:00-000, 1022, 505, 517, 425, 1348.90, 392, 1349.24, 143
5, 15:35:00-000, 1, 1, 0, 0, 0.00, 12, 1355.00, 145
5, 15:36:00-000, 1048, 539, 509, 391, 1348.74, 426, 1350.25, 174
5, 15:37:00-000, 1068, 568, 500, 383, 1349.22, 408, 1349.68, 150
5, 15:38:00-000, 1021, 537, 484, 443, 1348.95, 452, 1350.18, 176
5, 15:39:00-000, 6, 2, 4, 35, 1346.17, 1, 1354.00, 178
5, 15:40:00-000, 1114, 608, 506, 406, 1349.38, 355, 1348.62, 120
5, 15:41:00-000, 1059, 498, 561, 362, 1348.54, 389, 1348.43, 196
5, 15:42:00-000, 1010, 528, 482, 378, 1348.49, 376, 1348.54, 262
5, 15:43:00-000, 1, 1, 0, 0, 0.00, 30, 1354.00, 210
5, 15:44:00-000, 961, 528, 433, 367, 1349.52, 324, 1349.31, 214
5, 15:45:00-000, 1025, 519, 506, 358, 1349.28, 366, 1348.50, 185
5, 15:46:00-000, 1050, 534, 516, 396, 1350.05, 369, 1349.65, 204
5, 15:47:00-000, 1, 0, 1, 0, 0.00, 32, 1354.87, 231
5, 15:48:00-000, 1074, 492, 582, 389, 1348.44, 449, 1348.75, 156
5, 15:49:00-000, 961, 470, 491, 338, 1349.27, 365, 1349.29, 213
5, 15:50:00-000, 981, 491, 490, 325, 1349.14, 414, 1349.96, 181
5, 15:51:00-000, 2, 1, 1, 26, 1346.65, 5, 1353.80, 194
5, 15:52:00-000, 1015, 496, 519, 402, 1348.70, 387, 1349.34, 143
5, 15:53:00-000, 1061, 574, 487, 394, 1349.84, 358, 1350.28, 197
5, 15:54:00-000, 958, 455, 503, 392, 1348.43, 360, 1348.93, 186
5, 15:55:00-000, 5, 5, 0, 42, 1345.61, 0, 0.00, 180
5, 15:56:00-000, 1026, 544, 482, 397, 1349.00, 389, 1350.06, 147
5, 15:57:00-000, 1009, 551, 458, 399, 1349.40, 337, 1349.56, 200
5, 15:58:00-000, 1005, 530, 475, 381, 1349.25, 359, 1349.64, 185
5, 15:59:00-000, 2, 1, 1, 30, 1346.03, 1, 1352.00, 184
5, 16:00:00-000, 1012, 499, 513, 358, 1348.66, 361, 1349.72, 194
5, 16:01:00-000, 1061, 491, 570, 383, 1348.32, 414, 1348.69, 219
5, 16:02:00-000, 1053, 493, 560, 409, 1347.93, 438, 1348.75, 169
5, 16:03:00-000, 3, 3, 0, 3, 1348.33, 0, 0.00, 184
5, 16:04:00-000, 1075, 524, 551, 421, 1347.99, 459, 1348.74, 165
5, 16:05:00-000, 1036, 556, 480, 363, 1349.69, 350, 1350.08, 166
5, 16:06:00-000, 922, 475, 447, 361, 1349.17, 414, 1350.41, 145
5, 16:07:00-000, 3, 3, 0, 44, 1346.15, 17, 1356.00, 221
5, 16:08:00-000, 1049, 495, 554, 401, 1348.48, 411, 1349.17, 102
5, 16:09:00-000, 1059, 520, 539, 408, 1348.89, 448, 1349.58, 158
5, 16:10:00-000, 1091, 526, 565, 409, 1348.08, 443, 1348.92, 192
5, 16:11:00-000, 3, 2, 1, 13, 1344.92, 16, 1355.81, 114
5, 16:12:00-000, 940, 438, 502, 369, 1347.77, 385, 1349.42, 195
5, 16:13:00-000, 998, 480, 518, 408, 1349.49, 404, 1349.91, 126
5, 16:14:00-000, 1004, 494, 510, 344, 1348.64, 379, 1348.95, 144
5, 16:15:00-000, 7, 2, 5, 45, 1344.77, 7, 1347.57, 160
5, 16:16:00-000, 1077, 589, 488, 427, 1348.12, 386, 1348.62, 165
5, 16:17:00-000, 1018, 496, 522, 393, 1348.37, 377, 1348.72, 201
5, 16:18:00-000, 1038, 548, 490, 418, 1349.11, 455, 1350.64, 152
5, 16:19:00-000, 4, 0, 4, 11, 1346.00, 51, 1356.27, 128
5, 16:20:00-000, 1062, 520, 542, 439, 1348.38, 412, 1349.02, 159
5, 16:21:00-000, 1050, 518, 532, 443, 1348.20, 413, 1348.57, 118
5, 16:22:00-000, 977, 476, 501, 393, 1348.09, 408, 1349.20, 171
5, 16:23:00-000, 9, 6, 3, 3, 1348.00, 13, 1355.00, 122
5, 16:24:00-000, 1087, 537, 550, 459, 1348.64, 448, 1349.74, 136
5, 16:25:00-000, 1032, 525, 507, 362, 1348.76, 393, 1349.76, 136
5, 16:26:00-000, 950, 545, 405, 386, 1349.38, 317, 1350.36, 161
5, 16:27:00-000, 10, 9, 1, 17, 1347.76, 28, 1354.35, 199
5, 16:28:00-000, 999, 485, 514, 413, 1348.43, 431, 1350.05, 156
5, 16:29:00-000, 965, 477, 488, 381, 1348.56, 375, 1349.13, 150
6, 12:20:00-000, 6957, 3480, 3477, 1644, 1347.65, 1652, 1348.31, 0
6, 12:21:00-000, 0, 0, 0, 9, 1347.00, 28, 1353.00, 0
6, 12:22:00-000, 0, 0, 0, 106, 1346.00, 72, 1354.00, 0
6, 12:23:00-000, 0, 0, 0, 65, 1346.00, 76, 1354.00, 0
6, 12:24:00-000, 0, 0, 0, 95, 1346.00, 118, 1354.00, 0
6, 12:25:00-000, 0, 0, 0, 99, 1345.00, 0, 0.00, 0
6, 12:26:00-000, 0, 0, 0, 24, 1345.00, 12, 1355.00, 0
6, 12:27:00-000, 0, 0, 0, 0, 0.00, 11, 1355.00, 0
6, 12:28:00-000, 0, 0, 0, 0, 0.00, 24, 1355.00, 0
6, 12:29:00-000, 0, 0, 0, 0, 0.00, 37, 1355.00, 0
6, 12:30:00-000, 0, 0, 0, 0, 0.00, 70, 1355.00, 0
6, 12:31:00-000, 0, 0, 0, 72, 1345.00, 43, 1355.00, 0
6, 12:32:00-000, 0, 0, 0, 53, 1345.00, 67, 1355.50, 0
6, 12:33:00-000, 0, 0, 0, 11, 1345.00, 18, 1356.00, 0
6, 12:34:00-000, 0, 0, 0, 0, 0.00, 23, 1356.00, 0
6, 12:35:00-000, 0, 0, 0, 10, 1344.00, 0, 0.00, 0
6, 12:36:00-000, 0, 0, 0, 20, 1344.00, 0, 0.00, 0
6, 12:37:00-000, 0, 0, 0, 0, 0.00, 85, 1356.00, 0
6, 12:38:00-000, 0, 0, 0, 0, 0.00, 59, 1356.00, 0
6, 12:39:00-000, 0, 0, 0, 0, 0.00, 18, 1356.00, 0
6, 12:40:00-000, 0, 0, 0, 0, 0.00, 0, 0.00, 114
6, 12:41:00-000, 0, 0, 0, 0, 0.00, 0, 0.00, 100
6, 12:42:00-000, 0, 0, 0, 0, 0.00, 0, 0.00, 114
6, 12:43:00-000, 0, 0, 0, 37, 1344.00, 0, 0.00, 132
6, 12:44:00-000, 0, 0, 0, 37, 1344.00, 0, 0.00, 131
6, 12:45:00-000, 0, 0, 0, 2, 1344.00, 0, 0.00, 104
6, 12:46:00-000, 0, 0, 0, 24, 1344.00, 0, 0.00, 135
6, 12:47:00-000, 0, 0, 0, 1, 1344.00, 0, 0.00, 114
6, 12:48:00-000, 0, 0, 0, 0, 0.00, 0, 0.00, 91
6, 12:49:00-000, 0, 0, 0, 0, 0.00, 0, 0.00, 124
6, 12:50:00-000, 0, 0, 0, 0, 0.00, 0, 0.00, 112
6, 12:51:00-000, 0, 0, 0, 0, 0.00, 0, 0.00, 115
6, 12:52:00-000, 0, 0, 0, 0, 0.00, 0, 0.00, 118
6, 12:53:00-000, 0, 0, 0, 0, 0.00, 0, 0.00, 117
6, 12:54:00-000, 0, 0, 0, 0, 0.00, 0, 0.00, 102
6, 12:55:00-000, 0, 0, 0, 0, 0.00, 0, 0.00, 84
6, 12:56:00-000, 0, 0, 0, 0, 0.00, 0, 0.00, 101
6, 12:57:00-000, 0, 0, 0, 0, 0.00, 16, 1357.00, 97
6, 12:58:00-000, 0, 0, 0, 9, 1344.00, 0, 0.00, 90
6, 12:59:00-000, 0, 0, 0, 0, 0.00, 0, 0.00, 114
6, 13:00:00-000, 0, 0, 0, 0, 0.00, 0, 0.00, 1
6, 15:40:00-000, 6974, 3452, 3522, 1627, 1347.74, 1695, 1348.42, 0
6, 15:41:00-000, 0, 0, 0, 58, 1347.00, 49, 1354.00, 0
6, 15:42:00-000, 0, 0, 0, 10, 1346.00, 168, 1354.00, 0
6, 15:43:00-000, 0, 0, 0, 73, 1346.00, 24, 1354.00, 0
6, 15:44:00-000, 0, 0, 0, 20, 1346.00, 20, 1355.00, 0
6, 15:45:00-000, 0, 0, 0, 48, 1346.00, 65, 1355.00, 0
6, 15:46:00-000, 0, 0, 0, 56, 1346.00, 121, 1355.00, 0
6, 15:47:00-000, 0, 0, 0, 20, 1346.00, 52, 1355.00, 0
6, 15:48:00-000, 0, 0, 0, 45, 1345.32, 0, 0.00, 0
6, 15:49:00-000, 0, 0, 0, 16, 1345.00, 0, 0.00, 0
6, 15:50:00-000, 0, 0, 0, 87, 1345.00, 20, 1356.00, 0
6, 15:51:00-000, 0, 0, 0, 51, 1345.00, 0, 0.00, 0
6, 15:52:00-000, 0, 0, 0, 39, 1345.00, 10, 1356.00, 0
6, 15:53:00-000, 0, 0, 0, 0, 0.00, 17, 1356.00, 0
6, 15:54:00-000, 0, 0, 0, 10, 1345.00, 0, 0.00, 0
6, 15:56:00-000, 0, 0, 0, 0, 0.00, 22, 1356.00, 0
6, 15:57:00-000, 0, 0, 0, 0, 0.00, 56, 1356.00, 0
6, 15:58:00-000, 0, 0, 0, 0, 0.00, 51, 1356.00, 0
6, 15:59:00-000, 0, 0, 0, 0, 0.00, 6, 1356.00, 0
6, 16:00:00-000, 0, 0, 0, 0, 0.00, 50, 1356.00, 97
6, 16:01:00-000, 0, 0, 0, 0, 0.00, 0, 0.00, 115
6, 16:02:00-000, 0, 0, 0, 18, 1344.00, 0, 0.00, 112
6, 16:03:00-000, 0, 0, 0, 1, 1344.00, 0, 0.00, 130
6, 16:04:00-000, 0, 0, 0, 9, 1344.00, 0, 0.00, 115
6, 16:05:00-000, 0, 0, 0, 0, 0.00, 0, 0.00, 136
6, 16:06:00-000, 1, 1, 0, 1, 1348.00, 6, 1356.00, 122
6, 16:07:00-000, 0, 0, 0, 0, 0.00, 0, 0.00, 128
6, 16:08:00-000, 0, 0, 0, 68, 1344.00, 0, 0.00, 101
6, 16:09:00-000, 0, 0, 0, 0, 0.00, 0, 0.00, 110
6, 16:10:00-000, 0, 0, 0, 42, 1344.00, 0, 0.00, 109
6, 16:11:00-000, 0, 0, 0, 0, 0.00, 0, 0.00, 103
6, 16:12:00-000, 0, 0, 0, 0, 0.00, 0, 0.00, 117
6, 16:13:00-000, 0, 0, 0, 0, 0.00, 0, 0.00, 100
6, 16:14:00-000, 0, 0, 0, 41, 1343.00, 0, 0.00, 108
6, 16:15:00-000, 0, 0, 0, 0, 0.00, 0, 0.00, 97
6, 16:16:00-000, 0, 0, 0, 0, 0.00, 0, 0.00, 106
6, 16:17:00-000, 0, 0, 0, 0, 0.00, 0, 0.00, 99
6, 16:18:00-000, 0, 0, 0, 0, 0.00, 0, 0.00, 97
6, 16:19:00-000, 0, 0, 0, 0, 0.00, 4, 1357.00, 96
6, 16:20:00-000, 11, 7, 4, 5, 1348.60, 4, 1350.50, 1
7, 09:07:00-000, 4168, 2403, 1765, 0, 0.00, 0, 0.00, 3435
7, 09:08:00-000, 70, 0, 70, 0, 0.00, 0, 0.00, 803
7, 09:21:00-000, 1755, 1750, 5, 0, 0.00, 0, 0.00, 1755
7, 09:22:00-000, 1297, 1293, 4, 3, 1362.00, 3, 1351.00, 1291
7, 09:24:00-000, 852, 102, 750, 18, 1352.66, 102, 1352.00, 732
7, 09:25:00-000, 333, 333, 0, 50, 1353.92, 0, 0.00, 249
7, 09:26:00-000, 158, 158, 0, 34, 1357.67, 0, 0.00, 158
7, 09:29:00-000, 8590, 6327, 2263, 26, 1349.15, 26, 1351.38, 8538
7, 09:30:00-000, 1427, 1410, 17, 0, 0.00, 0, 0.00, 1427
7, 09:31:00-000, 2092, 2083, 9, 3, 1358.00, 3, 1350.00, 2086
7, 09:32:00-000, 4447, 1283, 3164, 0, 0.00, 0, 0.00, 4447
7, 09:33:00-000, 6130, 3737, 2393, 0, 0.00, 0, 0.00, 6130
7, 09:42:00-000, 3417, 2013, 1404, 0, 0.00, 0, 0.00, 3417
7, 09:44:00-000, 6169, 2360, 3809, 7, 1349.71, 7, 1349.71, 6155
7, 09:49:00-000, 9471, 2643, 6828, 0, 0.00, 0, 0.00, 9452
7, 09:50:00-000, 2997, 2220, 777, 0, 0.00, 0, 0.00, 3016
7, 09:57:00-000, 4850, 2165, 2685, 0, 0.00, 0, 0.00, 4850
7, 09:58:00-000, 10469, 6116, 4353, 0, 0.00, 0, 0.00, 10469
7, 09:59:00-000, 1254, 4, 1250, 0, 0.00, 0, 0.00, 1254
7, 10:00:00-000, 10209, 2975, 7234, 0, 0.00, 0, 0.00, 10209
7, 10:01:00-000, 14207, 5084, 9123, 3, 1350.00, 3, 1349.33, 14201
7, 10:03:00-000, 6255, 1356, 4899, 0, 0.00, 0, 0.00, 6255
7, 10:04:00-000, 12266, 5809, 6457, 0, 0.00, 0, 0.00, 12266
7, 10:05:00-000, 10414, 7439, 2975, 9, 1348.00, 9, 1351.33, 10396
7, 10:06:00-000, 2360, 1047, 1313, 0, 0.00, 0, 0.00, 1489
7, 10:07:00-000, 1310, 1300, 10, 0, 0.00, 0, 0.00, 2181
7, 10:09:00-000, 7188, 3607, 3581, 21, 1350.14, 21, 1348.33, 7146
7, 10:10:00-000, 13039, 5555, 7484, 7, 1348.00, 7, 1350.29, 13025
7, 10:12:00-000, 5964, 4532, 1432, 0, 0.00, 0, 0.00, 5964
7, 10:14:00-000, 15868, 9327, 6541, 67, 1347.46, 45, 1348.80, 15756
7, 10:15:00-000, 6645, 4471, 2174, 2, 1347.00, 24, 1345.29, 6619
7, 10:16:00-000, 5116, 3570, 1546, 24, 1349.00, 24, 1348.12, 5068
7, 10:18:00-000, 910, 900, 10, 10, 1355.00, 10, 1352.00, 890
7, 10:24:00-000, 2789, 38, 2751, 3, 1351.33, 3, 1352.00, 2783
7, 10:29:00-000, 7353, 3444, 3909, 1, 1350.00, 1, 1348.00, 7351
7, 10:30:00-000, 7517, 3548, 3969, 8, 1353.75, 8, 1352.00, 7501
7, 10:31:00-000, 4900, 4865, 35, 9, 1353.33, 9, 1351.44, 4882
7, 10:33:00-000, 1843, 1013, 830, 20, 1348.15, 20, 1349.25, 1803
7, 10:34:00-000, 2015, 931, 1084, 24, 1345.13, 24, 1348.62, 1967
7, 10:35:00-000, 1020, 10, 1010, 0, 0.00, 0, 0.00, 1020
7, 10:36:00-000, 4089, 1434, 2655, 4, 1349.00, 4, 1351.25, 4081
7, 10:37:00-000, 6331, 2557, 3774, 55, 1353.72, 55, 1351.00, 6221
7, 10:38:00-000, 6618, 2753, 3865, 17, 1349.00, 18, 1349.78, 6583
7, 10:39:00-000, 11909, 4344, 7565, 1, 1353.00, 0, 0.00, 11908
7, 10:40:00-000, 4399, 4362, 37, 11, 1351.73, 18, 1351.11, 4370
7, 10:41:00-000, 1321, 1318, 3, 10, 1352.20, 3, 1352.00, 1308
7, 10:42:00-000, 2474, 1284, 1190, 0, 0.00, 0, 0.00, 2474
7, 10:43:00-000, 9989, 4711, 5278, 7, 1352.43, 7, 1349.00, 9975
7, 10:44:00-000, 13138, 7250, 5888, 0, 0.00, 0, 0.00, 13138
7, 10:45:00-000, 1943, 1166, 777, 2, 1350.00, 2, 1351.00, 1939
7, 10:46:00-000, 7469, 2490, 4979, 0, 0.00, 0, 0.00, 7469
7, 10:47:00-000, 866, 16, 850, 10, 1352.10, 10, 1352.00, 846
7, 10:48:00-000, 14540, 10513, 4027, 0, 0.00, 0, 0.00, 14540
7, 10:49:00-000, 5475, 820, 4655, 2, 1349.00, 2, 1347.50, 5471
7, 10:50:00-000, 7958, 3338, 4620, 0, 0.00, 0, 0.00, 7958
7, 10:53:00-000, 8639, 6176, 2463, 0, 0.00, 0, 0.00, 8639
7, 10:54:00-000, 1410, 10, 1400, 0, 0.00, 0, 0.00, 1410
7, 10:58:00-000, 10051, 4656, 5395, 8, 1348.75, 8, 1350.00, 10035
7, 10:59:00-000, 7461, 4202, 3259, 0, 0.00, 0, 0.00, 6357
7, 11:00:00-000, 2858, 1787, 1071, 18, 1346.61, 18, 1350.33, 3926
7, 11:01:00-000, 6750, 4194, 2556, 0, 0.00, 0, 0.00, 6750
7, 11:02:00-000, 870, 10, 860, 0, 0.00, 0, 0.00, 870
7, 11:03:00-000, 9804, 5075, 4729, 0, 0.00, 0, 0.00, 9804
7, 11:04:00-000, 3982, 3951, 31, 21, 1353.90, 21, 1351.43, 3940
7, 11:05:00-000, 6016, 5029, 987, 0, 0.00, 0, 0.00, 6016
7, 11:06:00-000, 9070, 3761, 5309, 24, 1346.58, 22, 1349.77, 9024
7, 11:07:00-000, 10793, 5057, 5736, 3, 1350.00, 6, 1349.33, 10784
7, 11:08:00-000, 13919, 5364, 8555, 49, 1347.42, 56, 1349.59, 13814
7, 11:09:00-000, 12080, 4754, 7326, 13, 1350.31, 6, 1346.17, 12061
7, 11:10:00-000, 8031, 3473, 4558, 44, 1355.04, 43, 1352.00, 7944
7, 11:12:00-000, 7856, 3168, 4688, 100, 1350.71, 139, 1350.30, 7617
7, 11:13:00-000, 2734, 1750, 984, 66, 1351.10, 27, 1350.33, 2641
7, 11:14:00-000, 1177, 17, 1160, 9, 1350.33, 12, 1353.00, 1156
7, 11:15:00-000, 4486, 993, 3493, 14, 1351.78, 11, 1353.00, 4461
7, 11:16:00-000, 9324, 6976, 2348, 51, 1349.74, 47, 1351.28, 9226
7, 11:17:00-000, 4, 0, 4, 0, 0.00, 4, 1350.75, 0
7, 11:18:00-000, 3742, 1872, 1870, 28, 1353.60, 28, 1352.00, 3686
7, 11:19:00-000, 14029, 5771, 8258, 1, 1349.00, 1, 1350.00, 14027
7, 11:21:00-000, 6187, 3955, 2232, 0, 0.00, 0, 0.00, 6187
7, 11:24:00-000, 5661, 3653, 2008, 19, 1350.68, 19, 1350.00, 5617
7, 11:25:00-000, 22008, 12560, 9448, 9, 1352.56, 9, 1351.00, 21269
7, 11:26:00-000, 9868, 4888, 4980, 1, 1348.00, 1, 1347.00, 10593
7, 11:27:00-000, 9137, 3771, 5366, 34, 1351.35, 34, 1350.94, 9069
7, 11:28:00-000, 6654, 3759, 2895, 10, 1354.40, 10, 1351.00, 6634
7, 11:29:00-000, 18210, 7753, 10457, 0, 0.00, 0, 0.00, 16736
7, 11:30:00-000, 13192, 6353, 6839, 3, 1347.00, 3, 1350.00, 14660
7, 11:31:00-000, 2356, 2335, 21, 0, 0.00, 0, 0.00, 2356
7, 11:32:00-000, 7105, 5654, 1451, 45, 1351.80, 45, 1352.18, 7015
7, 11:33:00-000, 4441, 1344, 3097, 0, 0.00, 0, 0.00, 4441
7, 11:36:00-000, 5472, 2939, 2533, 18, 1347.83, 18, 1345.44, 5436
7, 11:37:00-000, 5429, 2877, 2552, 31, 1349.48, 31, 1350.00, 5367
7, 11:38:00-000, 1462, 29, 1433, 15, 1350.73, 15, 1351.27, 1432
7, 11:39:00-000, 7402, 4778, 2624, 0, 0.00, 0, 0.00, 7402
7, 11:40:00-000, 2700, 1156, 1544, 18, 1348.00, 18, 1350.17, 2664
7, 11:41:00-000, 8346, 1524, 6822, 0, 0.00, 0, 0.00, 8346
7, 11:42:00-000, 8624, 4958, 3666, 3, 1351.00, 3, 1351.00, 8601
7, 11:43:00-000, 5788, 2768, 3020, 0, 0.00, 0, 0.00, 5805
7, 11:44:00-000, 8615, 2786, 5829, 29, 1352.20, 29, 1352.20, 8557
7, 11:45:00-000, 4377, 177, 4200, 64, 1354.73, 64, 1352.00, 4249
7, 11:46:00-000, 9531, 5340, 4191, 23, 1349.26, 14, 1350.86, 9494
7, 11:47:00-000, 21, 0, 21, 0, 0.00, 9, 1350.55, 12
7, 11:48:00-000, 5949, 2163, 3786, 5, 1349.20, 5, 1351.00, 5939
7, 11:49:00-000, 5139, 3139, 2000, 0, 0.00, 0, 0.00, 4316
7, 11:50:00-000, 2696, 46, 2650, 31, 1349.87, 36, 1351.97, 3452
7, 11:51:00-000, 5, 5, 0, 5, 1356.00, 0, 0.00, 0
7, 11:52:00-000, 4658, 4573, 85, 6, 1348.67, 6, 1348.33, 4646
7, 11:53:00-000, 4018, 1388, 2630, 1, 1350.00, 1, 1348.00, 4016
7, 11:54:00-000, 4991, 896, 4095, 0, 0.00, 0, 0.00, 4991
7, 11:55:00-000, 5906, 1746, 4160, 0, 0.00, 0, 0.00, 5906
7, 11:56:00-000, 7771, 2812, 4959, 7, 1352.00, 7, 1350.71, 6666
7, 11:57:00-000, 7472, 2589, 4883, 1, 1348.00, 1, 1346.00, 8561
7, 11:58:00-000, 3032, 3003, 29, 13, 1354.62, 13, 1351.92, 3006
7, 12:00:00-000, 9590, 4384, 5206, 52, 1350.00, 78, 1351.82, 9460
7, 12:01:00-000, 1270, 35, 1235, 35, 1352.42, 9, 1351.11, 1226
7, 12:02:00-000, 4986, 1953, 3033, 11, 1355.00, 11, 1351.18, 4943
7, 12:03:00-000, 2214, 2200, 14, 0, 0.00, 0, 0.00, 2235
7, 12:04:00-000, 1768, 25, 1743, 3, 1348.00, 3, 1346.00, 1762
7, 12:06:00-000, 11600, 3538, 8062, 17, 1351.23, 17, 1351.18, 11566
7, 12:07:00-000, 3346, 720, 2626, 0, 0.00, 0, 0.00, 3346
7, 12:08:00-000, 2172, 1077, 1095, 0, 0.00, 0, 0.00, 2172
7, 12:09:00-000, 12966, 7738, 5228, 4, 1348.00, 4, 1350.50, 12958
7, 12:10:00-000, 5524, 4044, 1480, 22, 1349.41, 22, 1347.22, 5480
7, 12:11:00-000, 1258, 1231, 27, 11, 1355.54, 11, 1351.27, 1236
7, 12:12:00-000, 31019, 15626, 15393, 8, 1349.00, 8, 1353.00, 29989
7, 12:13:00-000, 13393, 7361, 6032, 14, 1355.00, 14, 1351.79, 14379
7, 12:14:00-000, 2920, 1862, 1058, 0, 0.00, 0, 0.00, 2920
7, 12:15:00-000, 6453, 3943, 2510, 0, 0.00, 0, 0.00, 5345
7, 12:16:00-000, 5278, 2842, 2436, 25, 1345.96, 25, 1348.68, 6336
7, 12:17:00-000, 7882, 3293, 4589, 16, 1345.00, 13, 1352.31, 7413
7, 12:18:00-000, 2252, 1103, 1149, 10, 1350.90, 13, 1351.31, 2669
7, 12:19:00-000, 2815, 1127, 1688, 6, 1349.00, 6, 1348.67, 2803
7, 12:20:00-000, 3024, 1648, 1376, 6, 1350.00, 6, 1352.00, 3012
7, 12:21:00-000, 7741, 6777, 964, 10, 1351.40, 10, 1352.00, 7721
7, 12:22:00-000, 7770, 2466, 5304, 0, 0.00, 0, 0.00, 6613
7, 12:23:00-000, 1881, 825, 1056, 25, 1349.99, 25, 1350.00, 2988
7, 12:24:00-000, 1126, 16, 1110, 5, 1352.20, 5, 1352.00, 1116
7, 12:26:00-000, 11628, 5510, 6118, 0, 0.00, 0, 0.00, 11612
7, 12:27:00-000, 402, 2, 400, 0, 0.00, 0, 0.00, 418
7, 12:28:00-000, 2167, 914, 1253, 12, 1348.67, 5, 1352.00, 2150
7, 12:29:00-000, 5638, 4569, 1069, 0, 0.00, 7, 1346.00, 5631
7, 12:31:00-000, 4834, 3028, 1806, 0, 0.00, 0, 0.00, 4526
7, 12:32:00-000, 2901, 1268, 1633, 9, 1348.89, 9, 1350.55, 3191
7, 12:34:00-000, 3462, 2699, 763, 0, 0.00, 0, 0.00, 3462
7, 12:35:00-000, 2760, 1839, 921, 1, 1349.00, 1, 1348.00, 2758
7, 12:36:00-000, 1256, 108, 1148, 8, 1351.00, 8, 1353.00, 1240
7, 12:40:00-000, 15725, 9091, 6634, 11, 1348.91, 25, 1351.76, 15689
7, 12:41:00-000, 14, 14, 0, 14, 1354.00, 0, 0.00, 0
7, 12:45:00-000, 873, 870, 3, 0, 0.00, 0, 0.00, 873
7, 12:46:00-000, 8146, 2715, 5431, 5, 1350.00, 5, 1351.00, 7184
7, 12:47:00-000, 8210, 5267, 2943, 0, 0.00, 0, 0.00, 9162
7, 12:48:00-000, 3769, 1125, 2644, 4, 1351.00, 4, 1350.00, 3761
7, 12:49:00-000, 6414, 3119, 3295, 0, 0.00, 0, 0.00, 6414
7, 12:52:00-000, 252, 251, 1, 1, 1349.00, 1, 1346.00, 250
7, 12:54:00-000, 4491, 4450, 41, 0, 0.00, 0, 0.00, 4491
7, 12:55:00-000, 5226, 3126, 2100, 19, 1351.10, 19, 1352.58, 5188
7, 12:56:00-000, 7220, 2474, 4746, 22, 1350.41, 22, 1349.09, 7176
7, 12:58:00-000, 18995, 10308, 8687, 6, 1348.00, 0, 0.00, 18989
7, 12:59:00-000, 6, 0, 6, 0, 0.00, 6, 1348.17, 0
7, 13:00:00-000, 3846, 2623, 1223, 5, 1349.80, 5, 1350.00, 3836
7, 13:01:00-000, 10712, 7081, 3631, 20, 1348.90, 20, 1350.15, 10672
7, 13:02:00-000, 2475, 686, 1789, 11, 1349.18, 11, 1348.36, 2453
7, 13:03:00-000, 3658, 1389, 2269, 0, 0.00, 0, 0.00, 3658
7, 13:04:00-000, 3990, 2619, 1371, 9, 1349.67, 9, 1350.89, 3972
7, 13:05:00-000, 771, 770, 1, 0, 0.00, 0, 0.00, 771
7, 13:06:00-000, 10679, 8185, 2494, 7, 1349.43, 5, 1350.60, 10667
7, 13:07:00-000, 14494, 4906, 9588, 0, 0.00, 2, 1348.00, 14492
7, 13:08:00-000, 2203, 1396, 807, 11, 1349.73, 11, 1351.18, 2181
7, 13:09:00-000, 12658, 4982, 7676, 2, 1349.00, 0, 0.00, 11612
7, 13:10:00-000, 9253, 7277, 1976, 1, 1350.00, 3, 1348.00, 10293
7, 13:11:00-000, 2200, 858, 1342, 3, 1349.00, 3, 1349.00, 2194
7, 13:12:00-000, 6915, 3325, 3590, 3, 1350.00, 3, 1350.00, 6909
7, 13:13:00-000, 5778, 1435, 4343, 11, 1348.27, 11, 1350.64, 5756
7, 13:14:00-000, 6017, 3284, 2733, 21, 1346.62, 16, 1349.69, 5980
7, 13:15:00-000, 11649, 7304, 4345, 38, 1347.53, 40, 1346.15, 11571
7, 13:16:00-000, 7900, 5238, 2662, 19, 1347.21, 29, 1351.55, 7852
7, 13:17:00-000, 12866, 6516, 6350, 26, 1348.81, 19, 1349.89, 12821
7, 13:18:00-000, 16653, 7259, 9394, 0, 0.00, 0, 0.00, 16653
7, 13:19:00-000, 13716, 4553, 9163, 0, 0.00, 0, 0.00, 13716
7, 13:20:00-000, 4144, 1157, 2987, 0, 0.00, 0, 0.00, 4144
7, 13:21:00-000, 6497, 2337, 4160, 10, 1347.40, 10, 1351.00, 6477
7, 13:22:00-000, 6197, 2741, 3456, 27, 1352.63, 27, 1350.66, 6143
7, 13:23:00-000, 6043, 2867, 3176, 0, 0.00, 0, 0.00, 6043
7, 13:24:00-000, 11628, 7231, 4397, 61, 1350.91, 61, 1347.85, 11506
7, 13:25:00-000, 5460, 1819, 3641, 31, 1348.74, 31, 1352.74, 5398
7, 13:26:00-000, 17548, 7446, 10102, 46, 1347.15, 46, 1349.84, 17456
7, 13:27:00-000, 4251, 754, 3497, 0, 0.00, 0, 0.00, 4251
7, 13:28:00-000, 10647, 4199, 6448, 34, 1351.56, 35, 1351.40, 10578
7, 13:29:00-000, 2166, 2153, 13, 3, 1355.33, 2, 1352.00, 2161
7, 13:30:00-000, 3113, 1596, 1517, 27, 1346.78, 27, 1345.44, 3059
7, 13:31:00-000, 3468, 3430, 38, 0, 0.00, 0, 0.00, 3468
7, 13:32:00-000, 3271, 3240, 31, 3, 1346.00, 3, 1346.00, 3265
7, 13:33:00-000, 5129, 907, 4222, 4, 1354.50, 4, 1351.00, 5121
7, 13:34:00-000, 5877, 3909, 1968, 19, 1353.26, 19, 1350.73, 5839
7, 13:35:00-000, 3913, 3038, 875, 0, 0.00, 0, 0.00, 3913
7, 13:36:00-000, 3247, 3213, 34, 11, 1347.00, 23, 1351.83, 3213
7, 13:37:00-000, 11262, 5664, 5598, 20, 1353.10, 8, 1352.00, 11234
7, 13:38:00-000, 9715, 3497, 6218, 21, 1348.57, 21, 1347.19, 9673
7, 13:39:00-000, 18287, 8282, 10005, 1, 1349.00, 1, 1349.00, 17341
7, 13:40:00-000, 2826, 2797, 29, 17, 1351.12, 17, 1349.41, 3736
7, 13:41:00-000, 13535, 7461, 6074, 20, 1349.00, 20, 1350.15, 13489
7, 13:42:00-000, 7995, 6314, 1681, 30, 1348.03, 30, 1349.33, 7941
7, 13:43:00-000, 17110, 7264, 9846, 11, 1350.91, 11, 1351.00, 17088
7, 13:45:00-000, 3559, 2981, 578, 0, 0.00, 0, 0.00, 3559
7, 13:46:00-000, 10034, 4987, 5047, 7, 1351.00, 7, 1352.00, 10020
7, 13:47:00-000, 10080, 4326, 5754, 11, 1347.27, 11, 1348.91, 10058
7, 13:48:00-000, 2921, 1566, 1355, 5, 1351.20, 5, 1351.00, 2911
7, 13:49:00-000, 5533, 5490, 43, 0, 0.00, 0, 0.00, 5524
7, 13:50:00-000, 7881, 3229, 4652, 19, 1347.63, 18, 1349.44, 7853
7, 13:51:00-000, 7841, 2352, 5489, 2, 1350.00, 3, 1348.33, 7836
7, 13:52:00-000, 10647, 7241, 3406, 12, 1351.25, 12, 1350.00, 10621
7, 13:53:00-000, 8795, 7472, 1323, 12, 1351.50, 12, 1351.00, 8773
7, 13:54:00-000, 609, 600, 9, 0, 0.00, 0, 0.00, 609
7, 13:55:00-000, 891, 890, 1, 0, 0.00, 0, 0.00, 891
7, 13:56:00-000, 5649, 2064, 3585, 2, 1348.00, 1, 1353.00, 5646
7, 13:57:00-000, 7638, 1004, 6634, 47, 1353.53, 48, 1351.16, 7543
7, 13:58:00-000, 7154, 4515, 2639, 14, 1349.07, 14, 1352.00, 7126
7, 13:59:00-000, 9139, 2102, 7037, 4, 1351.00, 4, 1352.00, 9131
7, 14:01:00-000, 9453, 3505, 5948, 0, 0.00, 0, 0.00, 8637
7, 14:02:00-000, 7429, 4134, 3295, 7, 1348.00, 7, 1350.86, 7268
7, 14:03:00-000, 1629, 853, 776, 0, 0.00, 0, 0.00, 2592
7, 14:04:00-000, 2634, 2550, 84, 30, 1348.87, 30, 1349.96, 2574
7, 14:05:00-000, 4967, 2175, 2792, 0, 0.00, 0, 0.00, 4967
7, 14:06:00-000, 8830, 2797, 6033, 6, 1349.67, 6, 1351.50, 8818
7, 14:07:00-000, 3905, 2013, 1892, 2, 1350.00, 2, 1351.00, 3901
7, 14:08:00-000, 1538, 1318, 220, 15, 1347.67, 15, 1351.60, 1508
7, 14:09:00-000, 1585, 1560, 25, 0, 0.00, 0, 0.00, 1585
7, 14:10:00-000, 1526, 36, 1490, 20, 1354.90, 20, 1352.00, 1486
7, 14:11:00-000, 3919, 3027, 892, 0, 0.00, 0, 0.00, 3912
7, 14:12:00-000, 7280, 2961, 4319, 0, 0.00, 0, 0.00, 7287
7, 14:13:00-000, 2208, 2201, 7, 1, 1353.00, 1, 1351.00, 2206
7, 14:14:00-000, 19983, 9312, 10671, 1, 1348.00, 1, 1348.00, 18651
7, 14:15:00-000, 14511, 8033, 6478, 10, 1348.10, 10, 1348.70, 14828
7, 14:16:00-000, 2109, 2050, 59, 22, 1346.45, 22, 1350.91, 3058
7, 14:17:00-000, 648, 14, 634, 4, 1350.00, 4, 1349.00, 640
7, 14:18:00-000, 6076, 2329, 3747, 11, 1351.82, 16, 1351.69, 6049
7, 14:19:00-000, 7682, 3120, 4562, 10, 1353.20, 5, 1350.00, 7661
7, 14:20:00-000, 2537, 2510, 27, 22, 1348.63, 22, 1351.09, 2499
7, 14:22:00-000, 13806, 6823, 6983, 40, 1350.10, 40, 1349.22, 13726
7, 14:23:00-000, 1077, 7, 1070, 1, 1352.00, 1, 1351.00, 1075
7, 14:24:00-000, 8012, 5677, 2335, 16, 1355.19, 16, 1352.25, 7980
7, 14:25:00-000, 968, 950, 18, 0, 0.00, 0, 0.00, 968
7, 14:27:00-000, 2091, 1284, 807, 0, 0.00, 0, 0.00, 2091
7, 14:28:00-000, 9162, 4263, 4899, 8, 1355.13, 8, 1351.00, 9146
7, 14:30:00-000, 20604, 8023, 12581, 0, 0.00, 0, 0.00, 20604
7, 14:31:00-000, 15910, 12762, 3148, 18, 1349.78, 18, 1351.06, 15874
7, 14:32:00-000, 6440, 1699, 4741, 36, 1349.55, 36, 1352.14, 6368
7, 14:33:00-000, 11740, 5804, 5936, 0, 0.00, 1, 1351.00, 11739
7, 14:34:00-000, 7274, 3142, 4132, 28, 1351.17, 27, 1351.74, 7219
7, 14:35:00-000, 5264, 3026, 2238, 0, 0.00, 0, 0.00, 5264
7, 14:36:00-000, 12802, 6079, 6723, 5, 1348.60, 24, 1351.50, 12773
7, 14:37:00-000, 3299, 959, 2340, 22, 1350.50, 3, 1349.67, 3274
7, 14:38:00-000, 2929, 2901, 28, 9, 1346.33, 9, 1351.00, 2911
7, 14:39:00-000, 3115, 1157, 1958, 15, 1349.87, 15, 1351.00, 3085
7, 14:40:00-000, 1057, 22, 1035, 0, 0.00, 0, 0.00, 1057
7, 14:41:00-000, 3595, 2441, 1154, 4, 1348.75, 4, 1348.00, 3587
7, 14:42:00-000, 7116, 2925, 4191, 5, 1348.00, 5, 1349.60, 7106
7, 14:43:00-000, 3007, 2970, 37, 4, 1348.00, 4, 1352.50, 2999
7, 14:45:00-000, 11510, 4517, 6993, 6, 1351.67, 6, 1351.50, 11498
7, 14:46:00-000, 14880, 7641, 7239, 25, 1350.20, 25, 1350.96, 14830
7, 14:47:00-000, 11723, 7483, 4240, 0, 0.00, 0, 0.00, 11723
7, 14:48:00-000, 10157, 1960, 8197, 29, 1348.00, 31, 1347.51, 10097
7, 14:49:00-000, 10954, 5641, 5313, 51, 1348.37, 49, 1347.30, 10854
7, 14:50:00-000, 7085, 1895, 5190, 1, 1352.00, 1, 1351.00, 7073
7, 14:51:00-000, 18883, 6593, 12290, 5, 1349.20, 3, 1349.33, 18885
7, 14:52:00-000, 14838, 8394, 6444, 0, 0.00, 2, 1349.00, 14836
7, 14:53:00-000, 12065, 6202, 5863, 10, 1352.10, 10, 1351.10, 12045
7, 14:54:00-000, 4647, 3675, 972, 20, 1346.30, 20, 1347.60, 4607
7, 14:55:00-000, 4880, 3344, 1536, 29, 1348.00, 29, 1346.06, 4822
7, 14:56:00-000, 6264, 3373, 2891, 23, 1347.96, 23, 1347.82, 6218
7, 14:58:00-000, 4111, 3377, 734, 22, 1351.04, 22, 1349.63, 4067
7, 14:59:00-000, 8577, 5599, 2978, 0, 0.00, 0, 0.00, 8577
7, 15:00:00-000, 15751, 10078, 5673, 6, 1351.50, 6, 1351.00, 14293
7, 15:01:00-000, 13037, 2495, 10542, 15, 1348.87, 15, 1347.40, 14453
7, 15:02:00-000, 12297, 9447, 2850, 9, 1348.44, 9, 1350.67, 12279
7, 15:03:00-000, 15174, 10278, 4896, 3, 1352.00, 3, 1351.33, 15168
7, 15:04:00-000, 3220, 30, 3190, 8, 1349.75, 8, 1352.00, 3204
7, 15:05:00-000, 6600, 6570, 30, 0, 0.00, 2, 1350.00, 6581
7, 15:06:00-000, 2747, 2567, 180, 11, 1349.00, 9, 1349.33, 2671
7, 15:07:00-000, 13623, 9971, 3652, 1, 1349.00, 1, 1351.00, 13694
7, 15:08:00-000, 3441, 2341, 1100, 6, 1354.67, 6, 1350.33, 3429
7, 15:09:00-000, 1268, 8, 1260, 0, 0.00, 0, 0.00, 1268
7, 15:10:00-000, 6037, 3730, 2307, 7, 1349.00, 12, 1352.00, 6018
7, 15:11:00-000, 13846, 4693, 9153, 53, 1350.81, 51, 1351.05, 13742
7, 15:12:00-000, 11998, 4869, 7129, 9, 1352.67, 6, 1351.00, 11983
7, 15:13:00-000, 6672, 4553, 2119, 0, 0.00, 0, 0.00, 6672
7, 15:14:00-000, 7986, 4379, 3607, 8, 1352.25, 6, 1350.50, 7972
7, 15:15:00-000, 1467, 3, 1464, 2, 1346.00, 4, 1345.00, 1461
7, 15:16:00-000, 10348, 5412, 4936, 0, 0.00, 0, 0.00, 10348
7, 15:17:00-000, 10810, 2923, 7887, 0, 0.00, 4, 1351.00, 10806
7, 15:18:00-000, 8703, 4123, 4580, 28, 1350.00, 26, 1350.50, 8649
7, 15:19:00-000, 6107, 2593, 3514, 12, 1349.50, 10, 1350.00, 6085
7, 15:20:00-000, 10342, 4665, 5677, 18, 1351.22, 18, 1351.67, 10306
7, 15:21:00-000, 10696, 3664, 7032, 18, 1348.28, 18, 1350.78, 10657
7, 15:22:00-000, 15411, 5414, 9997, 33, 1348.24, 38, 1349.47, 15343
7, 15:23:00-000, 7758, 3152, 4606, 25, 1347.20, 20, 1345.40, 7713
7, 15:24:00-000, 8026, 4369, 3657, 8, 1350.87, 8, 1351.25, 8005
7, 15:25:00-000, 8737, 5389, 3348, 3, 1348.00, 3, 1345.67, 7341
7, 15:26:00-000, 13777, 10094, 3683, 4, 1351.25, 4, 1352.00, 15164
7, 15:27:00-000, 8564, 4811, 3753, 2, 1351.50, 2, 1351.00, 8560
7, 15:28:00-000, 7366, 3926, 3440, 72, 1352.20, 72, 1351.24, 6367
7, 15:29:00-000, 7741, 3959, 3782, 5, 1347.00, 5, 1348.60, 8586
7, 15:30:00-000, 8839, 3858, 4981, 17, 1351.41, 17, 1351.53, 7646
7, 15:31:00-000, 10354, 3481, 6873, 19, 1346.74, 19, 1348.79, 11475
7, 15:32:00-000, 2525, 2472, 53, 48, 1347.04, 48, 1347.81, 2429
7, 15:33:00-000, 6710, 3725, 2985, 11, 1348.18, 11, 1348.82, 5427
7, 15:34:00-000, 10682, 3651, 7031, 3, 1349.33, 3, 1350.33, 11927
7, 15:35:00-000, 10751, 7222, 3529, 5, 1351.00, 5, 1351.60, 10751
7, 15:36:00-000, 7866, 3452, 4414, 21, 1352.81, 21, 1349.42, 7824
7, 15:37:00-000, 7933, 3828, 4105, 6, 1347.00, 6, 1347.67, 7921
7, 15:38:00-000, 82, 2, 80, 1, 1354.00, 1, 1354.00, 80
7, 15:39:00-000, 9128, 1690, 7438, 0, 0.00, 0, 0.00, 7765
7, 15:40:00-000, 19, 19, 0, 13, 1351.54, 13, 1351.46, 1356
7, 15:42:00-000, 1840, 523, 1317, 1, 1348.00, 1, 1352.00, 1838
7, 15:44:00-000, 2746, 2730, 16, 0, 0.00, 1, 1350.00, 2745
7, 15:45:00-000, 1422, 5, 1417, 5, 1349.80, 4, 1348.25, 1413
7, 15:46:00-000, 2483, 2470, 13, 2, 1348.00, 2, 1352.00, 2479
7, 15:48:00-000, 2935, 2920, 15, 0, 0.00, 0, 0.00, 2924
7, 15:49:00-000, 7286, 4160, 3126, 8, 1350.00, 8, 1352.63, 7281
7, 15:50:00-000, 2633, 521, 2112, 1, 1351.00, 1, 1352.00, 2627
7, 15:51:00-000, 5243, 4161, 1082, 1, 1349.00, 1, 1348.00, 5245
7, 15:54:00-000, 1603, 1590, 13, 0, 0.00, 0, 0.00, 1603
7, 15:55:00-000, 1548, 8, 1540, 0, 0.00, 0, 0.00, 1548
7, 15:58:00-000, 2142, 1314, 828, 0, 0.00, 6, 1351.83, 2136
7, 15:59:00-000, 5524, 2120, 3404, 57, 1353.24, 51, 1352.86, 5416
7, 16:02:00-000, 1637, 76, 1561, 1, 1349.00, 1, 1351.00, 1635
7, 16:03:00-000, 1344, 4, 1340, 0, 0.00, 0, 0.00, 1344
7, 16:04:00-000, 5811, 3415, 2396, 1, 1351.00, 1, 1351.00, 5809
7, 16:05:00-000, 5009, 3697, 1312, 5, 1351.00, 5, 1351.00, 4999
7, 16:06:00-000, 778, 8, 770, 0, 0.00, 0, 0.00, 778
7, 16:07:00-000, 805, 790, 15, 0, 0.00, 0, 0.00, 805
7, 16:08:00-000, 204, 200, 4, 0, 0.00, 0, 0.00, 204
7, 16:09:00-000, 991, 981, 10, 9, 1347.78, 9, 1351.00, 973
7, 16:10:00-000, 2721, 943, 1778, 0, 0.00, 0, 0.00, 1828
7, 16:11:00-000, 8976, 5125, 3851, 0, 0.00, 0, 0.00, 9869
7, 16:12:00-000, 3926, 2128, 1798, 0, 0.00, 0, 0.00, 3926
7, 16:14:00-000, 3277, 901, 2376, 17, 1350.29, 17, 1352.00, 3243
7, 16:15:00-000, 5097, 4415, 682, 5, 1347.00, 5, 1346.40, 5087
7, 16:16:00-000, 5201, 5150, 51, 12, 1348.00, 12, 1350.50, 5177
7, 16:17:00-000, 4462, 779, 3683, 8, 1348.12, 8, 1350.00, 4446
7, 16:18:00-000, 758, 6, 752, 2, 1347.00, 2, 1355.00, 754
7, 16:20:00-000, 2802, 2137, 665, 0, 0.00, 0, 0.00, 1992
7, 16:21:00-000, 21527, 7043, 14484, 32, 1349.03, 32, 1349.44, 22273
7, 16:22:00-000, 8622, 5721, 2901, 10, 1349.70, 10, 1349.50, 8602
7, 16:23:00-000, 12154, 5465, 6689, 1, 1347.00, 4, 1350.25, 12149
7, 16:24:00-000, 4449, 3183, 1266, 13, 1351.69, 10, 1351.00, 4426
7, 16:25:00-000, 3018, 2643, 375, 18, 1347.78, 19, 1348.89, 2981
7, 16:26:00-000, 6959, 1035, 5924, 4, 1350.75, 3, 1350.00, 6952
7, 16:28:00-000, 7095, 3410, 3685, 11, 1350.00, 11, 1350.18, 7073
7, 16:29:00-000, 9282, 6463, 2819, 0, 0.00, 1, 1351.00, 8297
7, 16:30:00-000, 90, 90, 0, 0, 0.00, 0, 0.00, 0
8, 09:07:00-000, 781, 685, 96, 0, 0.00, 0, 0.00, 781
8, 09:21:00-000, 758, 750, 8, 0, 0.00, 0, 0.00, 758
8, 09:22:00-000, 1459, 9, 1450, 0, 0.00, 0, 0.00, 1459
8, 09:29:00-000, 205, 130, 75, 0, 0.00, 0, 0.00, 142
8, 09:30:00-000, 11, 1, 10, 8, 1346.00, 8, 1349.50, 57
8, 09:31:00-000, 0, 0, 0, 0, 0.00, 0, 0.00, 1
8, 09:32:00-000, 172, 32, 140, 0, 0.00, 0, 0.00, 172
8, 09:33:00-000, 904, 110, 794, 0, 0.00, 0, 0.00, 904
8, 09:42:00-000, 902, 870, 32, 14, 1349.00, 14, 1351.28, 874
8, 09:44:00-000, 509, 203, 306, 15, 1348.93, 15, 1348.47, 479
8, 09:49:00-000, 21, 1, 20, 0, 0.00, 0, 0.00, 21
8, 09:50:00-000, 120, 59, 61, 4, 1350.00, 4, 1346.50, 112
8, 09:56:00-000, 1938, 748, 1190, 0, 0.00, 0, 0.00, 730
8, 09:57:00-000, 0, 0, 0, 0, 0.00, 0, 0.00, 1208
8, 09:58:00-000, 2278, 2207, 71, 42, 1352.54, 58, 1352.89, 2178
8, 09:59:00-000, 16, 16, 0, 16, 1356.00, 0, 0.00, 0
8, 10:00:00-000, 1907, 1018, 889, 30, 1351.00, 30, 1350.17, 1830
8, 10:01:00-000, 3107, 2010, 1097, 1, 1350.00, 1, 1349.00, 3042
8, 10:02:00-000, 0, 0, 0, 0, 0.00, 0, 0.00, 80
8, 10:03:00-000, 171, 110, 61, 3, 1349.00, 3, 1349.33, 165
8, 10:04:00-000, 1940, 1803, 137, 0, 0.00, 0, 0.00, 1940
8, 10:05:00-000, 4736, 2458, 2278, 2, 1355.00, 2, 1354.00, 4732
8, 10:06:00-000, 109, 92, 17, 2, 1351.00, 2, 1351.00, 105
8, 10:09:00-000, 771, 770, 1, 0, 0.00, 0, 0.00, 771
8, 10:10:00-000, 161, 154, 7, 1, 1347.00, 4, 1351.00, 156
8, 10:11:00-000, 3, 3, 0, 3, 1353.00, 0, 0.00, 0
8, 10:12:00-000, 1258, 142, 1116, 5, 1349.00, 5, 1350.00, 1248
8, 10:14:00-000, 190, 89, 101, 1, 1349.00, 0, 0.00, 189
8, 10:15:00-000, 104, 3, 101, 0, 0.00, 1, 1344.00, 103
8, 10:16:00-000, 896, 107, 789, 7, 1348.14, 7, 1348.86, 882
8, 10:17:00-000, 7, 6, 1, 1, 1354.00, 1, 1351.00, 5
8, 10:24:00-000, 189, 101, 88, 0, 0.00, 0, 0.00, 189
8, 10:25:00-000, 53, 3, 50, 0, 0.00, 0, 0.00, 53
8, 10:30:00-000, 444, 78, 366, 1, 1351.00, 1, 1354.00, 442
8, 10:31:00-000, 1415, 5, 1410, 0, 0.00, 0, 0.00, 1415
8, 10:34:00-000, 663, 653, 10, 10, 1353.10, 10, 1352.00, 643
8, 10:36:00-000, 61, 20, 41, 19, 1345.00, 19, 1348.00, 23
8, 10:37:00-000, 724, 710, 14, 0, 0.00, 0, 0.00, 724
8, 10:38:00-000, 1658, 1600, 58, 57, 1349.00, 57, 1344.73, 1544
8, 10:39:00-000, 1055, 15, 1040, 0, 0.00, 0, 0.00, 1055
8, 10:40:00-000, 904, 153, 751, 0, 0.00, 0, 0.00, 904
8, 10:41:00-000, 185, 153, 32, 2, 1353.00, 2, 1351.00, 181
8, 10:42:00-000, 62, 60, 2, 0, 0.00, 0, 0.00, 62
8, 10:43:00-000, 1508, 1482, 26, 0, 0.00, 0, 0.00, 1508
8, 10:44:00-000, 3167, 1661, 1506, 18, 1349.67, 18, 1350.67, 3130
8, 10:45:00-000, 0, 0, 0, 0, 0.00, 0, 0.00, 1
8, 10:46:00-000, 2327, 1508, 819, 0, 0.00, 0, 0.00, 2327
8, 10:47:00-000, 205, 5, 200, 0, 0.00, 0, 0.00, 205
8, 10:48:00-000, 3416, 1761, 1655, 29, 1350.58, 29, 1352.76, 3358
8, 10:49:00-000, 797, 13, 784, 4, 1345.00, 4, 1349.00, 789
8, 10:50:00-000, 437, 107, 330, 0, 0.00, 0, 0.00, 437
8, 10:53:00-000, 2816, 49, 2767, 0, 0.00, 0, 0.00, 2816
8, 10:57:00-000, 94, 14, 80, 14, 1353.43, 14, 1352.00, 66
8, 10:58:00-000, 108, 25, 83, 2, 1351.00, 2, 1351.00, 104
8, 10:59:00-000, 2559, 1645, 914, 0, 0.00, 0, 0.00, 2559
8, 11:01:00-000, 2588, 911, 1677, 0, 0.00, 0, 0.00, 2588
8, 11:03:00-000, 1586, 747, 839, 0, 0.00, 0, 0.00, 1302
8, 11:04:00-000, 0, 0, 0, 0, 0.00, 0, 0.00, 284
8, 11:05:00-000, 1248, 1240, 8, 0, 0.00, 0, 0.00, 1248
8, 11:06:00-000, 2541, 1633, 908, 30, 1349.73, 28, 1350.18, 2483
8, 11:07:00-000, 1058, 1040, 18, 0, 0.00, 2, 1347.50, 1056
8, 11:08:00-000, 603, 28, 575, 2, 1349.00, 0, 0.00, 601
8, 11:09:00-000, 967, 882, 85, 0, 0.00, 2, 1346.50, 965
8, 11:10:00-000, 990, 20, 970, 0, 0.00, 0, 0.00, 990
8, 11:12:00-000, 228, 210, 18, 0, 0.00, 4, 1352.00, 224
8, 11:13:00-000, 4, 4, 0, 4, 1354.00, 0, 0.00, 0
8, 11:15:00-000, 1617, 17, 1600, 0, 0.00, 0, 0.00, 1617
8, 11:16:00-000, 1767, 1676, 91, 2, 1352.00, 2, 1350.00, 1763
8, 11:17:00-000, 1469, 9, 1460, 0, 0.00, 0, 0.00, 1469
8, 11:18:00-000, 165, 30, 135, 20, 1355.50, 20, 1353.00, 125
8, 11:19:00-000, 2900, 1150, 1750, 0, 0.00, 0, 0.00, 2900
8, 11:21:00-000, 874, 77, 797, 0, 0.00, 0, 0.00, 874
8, 11:23:00-000, 102, 101, 1, 1, 1357.00, 1, 1351.00, 100
8, 11:24:00-000, 804, 604, 200, 0, 0.00, 0, 0.00, 795
8, 11:25:00-000, 1084, 953, 131, 0, 0.00, 0, 0.00, 1093
8, 11:26:00-000, 1768, 977, 791, 11, 1349.00, 11, 1350.09, 1746
8, 11:27:00-000, 4569, 2913, 1656, 0, 0.00, 0, 0.00, 4569
8, 11:28:00-000, 22, 21, 1, 1, 1351.00, 1, 1351.00, 20
8, 11:29:00-000, 3975, 2400, 1575, 7, 1345.57, 7, 1348.43, 3959
8, 11:30:00-000, 1255, 929, 326, 3, 1353.00, 3, 1351.00, 1251
8, 11:31:00-000, 2186, 6, 2180, 0, 0.00, 0, 0.00, 2186
8, 11:32:00-000, 21, 1, 20, 0, 0.00, 0, 0.00, 21
8, 11:33:00-000, 472, 84, 388, 0, 0.00, 0, 0.00, 472
8, 11:36:00-000, 937, 173, 764, 20, 1348.35, 20, 1350.40, 897
8, 11:37:00-000, 3214, 2365, 849, 23, 1352.56, 23, 1352.78, 3168
8, 11:39:00-000, 2019, 932, 1087, 0, 0.00, 0, 0.00, 2019
8, 11:41:00-000, 4000, 3045, 955, 1, 1351.00, 1, 1351.00, 3998
8, 11:42:00-000, 1968, 1438, 530, 0, 0.00, 0, 0.00, 1968
8, 11:43:00-000, 2176, 22, 2154, 4, 1350.00, 4, 1349.00, 2168
8, 11:44:00-000, 3815, 2093, 1722, 4, 1353.00, 4, 1351.00, 3807
8, 11:45:00-000, 256, 147, 109, 3, 1352.00, 3, 1351.00, 250
8, 11:46:00-000, 477, 33, 444, 4, 1352.00, 4, 1352.00, 469
8, 11:47:00-000, 22, 1, 21, 1, 1351.00, 1, 1350.00, 20
8, 11:48:00-000, 1652, 12, 1640, 6, 1349.00, 6, 1350.33, 1640
8, 11:49:00-000, 186, 96, 90, 0, 0.00, 0, 0.00, 186
8, 11:52:00-000, 100, 100, 0, 0, 0.00, 0, 0.00, 100
8, 11:53:00-000, 766, 750, 16, 0, 0.00, 0, 0.00, 766
8, 11:54:00-000, 2624, 1668, 956, 5, 1349.60, 5, 1349.40, 2614
8, 11:56:00-000, 2147, 1851, 296, 13, 1351.77, 13, 1351.77, 2121
8, 11:57:00-000, 2608, 2533, 75, 9, 1350.89, 9, 1350.78, 2590
8, 11:58:00-000, 1338, 525, 813, 0, 0.00, 0, 0.00, 1338
8, 12:00:00-000, 1049, 66, 983, 0, 0.00, 0, 0.00, 1049
8, 12:01:00-000, 170, 107, 63, 3, 1354.00, 3, 1352.00, 164
8, 12:02:00-000, 1115, 1053, 62, 0, 0.00, 0, 0.00, 1115
8, 12:03:00-000, 412, 285, 127, 0, 0.00, 0, 0.00, 412
8, 12:04:00-000, 1102, 80, 1022, 10, 1349.00, 10, 1345.70, 1082
8, 12:05:00-000, 58, 49, 9, 3, 1351.67, 3, 1351.00, 52
8, 12:06:00-000, 3651, 150, 3501, 19, 1348.47, 19, 1353.47, 3613
8, 12:07:00-000, 1939, 779, 1160, 0, 0.00, 0, 0.00, 1939
8, 12:08:00-000, 155, 150, 5, 0, 0.00, 0, 0.00, 155
8, 12:09:00-000, 1881, 1030, 851, 1, 1350.00, 1, 1350.00, 1879
8, 12:10:00-000, 630, 549, 81, 10, 1349.70, 15, 1352.60, 605
8, 12:11:00-000, 141, 26, 115, 14, 1353.78, 9, 1353.00, 118
8, 12:12:00-000, 3862, 1594, 2268, 3, 1350.33, 3, 1349.33, 3856
8, 12:13:00-000, 1700, 1496, 204, 4, 1349.00, 4, 1353.00, 1692
8, 12:15:00-000, 545, 15, 530, 0, 0.00, 0, 0.00, 545
8, 12:16:00-000, 3138, 1521, 1617, 13, 1347.62, 13, 1346.54, 3112
8, 12:17:00-000, 1643, 1528, 115, 7, 1355.00, 7, 1350.00, 1629
8, 12:19:00-000, 716, 710, 6, 0, 0.00, 0, 0.00, 716
8, 12:20:00-000, 1165, 1041, 124, 0, 0.00, 0, 0.00, 1165
8, 12:21:00-000, 939, 747, 192, 11, 1353.00, 11, 1351.55, 917
8, 12:22:00-000, 332, 263, 69, 2, 1353.00, 2, 1351.00, 328
8, 12:23:00-000, 96, 90, 6, 0, 0.00, 0, 0.00, 96
8, 12:26:00-000, 863, 850, 13, 0, 0.00, 0, 0.00, 863
8, 12:27:00-000, 101, 95, 6, 5, 1351.00, 5, 1352.00, 91
8, 12:28:00-000, 282, 14, 268, 8, 1347.63, 8, 1348.13, 266
8, 12:29:00-000, 296, 183, 113, 7, 1349.29, 7, 1351.00, 282
8, 12:31:00-000, 1448, 8, 1440, 0, 0.00, 0, 0.00, 1443
8, 12:32:00-000, 0, 0, 0, 0, 0.00, 0, 0.00, 5
8, 12:36:00-000, 96, 66, 30, 30, 1350.23, 30, 1352.00, 36
8, 12:37:00-000, 22, 1, 21, 1, 1350.00, 1, 1351.00, 20
8, 12:40:00-000, 2324, 407, 1917, 4, 1348.00, 4, 1349.75, 2316
8, 12:47:00-000, 1670, 1604, 66, 1, 1350.00, 1, 1352.00, 1668
8, 12:48:00-000, 56, 6, 50, 0, 0.00, 0, 0.00, 56
8, 12:49:00-000, 736, 6, 730, 0, 0.00, 0, 0.00, 736
8, 12:53:00-000, 107, 47, 60, 44, 1355.68, 44, 1351.00, 19
8, 12:54:00-000, 1009, 175, 834, 7, 1351.29, 7, 1352.43, 995
8, 12:55:00-000, 2623, 1936, 687, 0, 0.00, 0, 0.00, 2623
8, 12:56:00-000, 107, 7, 100, 6, 1345.00, 6, 1346.50, 95
8, 12:57:00-000, 60, 5, 55, 5, 1350.00, 5, 1346.20, 50
8, 12:58:00-000, 611, 275, 336, 7, 1348.00, 7, 1351.43, 597
8, 12:59:00-000, 2308, 2239, 69, 5, 1349.60, 5, 1348.20, 2298
8, 13:00:00-000, 118, 13, 105, 3, 1346.67, 3, 1348.67, 112
8, 13:01:00-000, 3851, 1487, 2364, 15, 1351.13, 15, 1353.00, 3821
8, 13:03:00-000, 852, 840, 12, 0, 0.00, 0, 0.00, 852
8, 13:04:00-000, 786, 3, 783, 3, 1348.00, 3, 1347.00, 780
8, 13:05:00-000, 79, 70, 9, 0, 0.00, 0, 0.00, 79
8, 13:06:00-000, 2750, 1890, 860, 4, 1350.50, 4, 1349.25, 2742
8, 13:07:00-000, 414, 267, 147, 5, 1349.00, 5, 1349.00, 404
8, 13:08:00-000, 176, 11, 165, 5, 1350.00, 5, 1349.00, 166
8, 13:09:00-000, 1532, 65, 1467, 0, 0.00, 0, 0.00, 1532
8, 13:10:00-000, 1135, 1120, 15, 0, 0.00, 0, 0.00, 1135
8, 13:12:00-000, 130, 75, 55, 0, 0.00, 0, 0.00, 130
8, 13:13:00-000, 1951, 775, 1176, 0, 0.00, 0, 0.00, 1951
8, 13:14:00-000, 851, 70, 781, 3, 1349.00, 3, 1348.67, 845
8, 13:15:00-000, 217, 17, 200, 0, 0.00, 0, 0.00, 217
8, 13:16:00-000, 795, 5, 790, 0, 0.00, 0, 0.00, 795
8, 13:17:00-000, 1039, 122, 917, 0, 0.00, 0, 0.00, 1039
8, 13:18:00-000, 2725, 967, 1758, 0, 0.00, 0, 0.00, 2725
8, 13:19:00-000, 2943, 1857, 1086, 0, 0.00, 0, 0.00, 2943
8, 13:20:00-000, 1512, 1510, 2, 0, 0.00, 0, 0.00, 1512
8, 13:21:00-000, 1567, 1560, 7, 0, 0.00, 0, 0.00, 1567
8, 13:22:00-000, 2145, 1909, 236, 0, 0.00, 0, 0.00, 2145
8, 13:23:00-000, 1137, 814, 323, 0, 0.00, 0, 0.00, 1137
8, 13:24:00-000, 3477, 1763, 1714, 2, 1350.50, 2, 1353.00, 3473
8, 13:25:00-000, 132, 12, 120, 6, 1348.50, 3, 1348.00, 123
8, 13:26:00-000, 4528, 2180, 2348, 4, 1349.75, 10, 1350.90, 4514
8, 13:27:00-000, 361, 18, 343, 9, 1352.44, 3, 1346.00, 349
8, 13:28:00-000, 269, 105, 164, 4, 1351.50, 7, 1351.29, 258
8, 13:29:00-000, 1714, 4, 1710, 1, 1355.00, 1, 1354.00, 1712
8, 13:30:00-000, 1432, 1, 1431, 1, 1347.00, 1, 1346.00, 1430
8, 13:32:00-000, 1432, 91, 1341, 6, 1349.00, 6, 1350.00, 1420
8, 13:33:00-000, 965, 120, 845, 25, 1350.00, 25, 1351.60, 915
8, 13:34:00-000, 2882, 1247, 1635, 8, 1349.00, 8, 1348.38, 2866
8, 13:35:00-000, 2589, 48, 2541, 7, 1351.71, 7, 1353.57, 2575
8, 13:36:00-000, 92, 90, 2, 0, 0.00, 0, 0.00, 92
8, 13:37:00-000, 413, 109, 304, 0, 0.00, 0, 0.00, 413
8, 13:38:00-000, 1955, 793, 1162, 2, 1350.00, 2, 1355.00, 1951
8, 13:39:00-000, 2889, 2518, 371, 0, 0.00, 0, 0.00, 2889
8, 13:40:00-000, 1333, 1213, 120, 44, 1349.56, 44, 1351.47, 1245
8, 13:41:00-000, 2966, 2145, 821, 0, 0.00, 2, 1352.00, 2709
8, 13:42:00-000, 3039, 400, 2639, 9, 1349.89, 9, 1350.33, 3276
8, 13:43:00-000, 4016, 2376, 1640, 2, 1350.00, 0, 0.00, 4007
8, 13:44:00-000, 0, 0, 0, 0, 0.00, 0, 0.00, 7
8, 13:46:00-000, 1760, 803, 957, 0, 0.00, 0, 0.00, 1755
8, 13:47:00-000, 1652, 859, 793, 0, 0.00, 0, 0.00, 1657
8, 13:48:00-000, 831, 827, 4, 4, 1352.50, 4, 1351.00, 823
8, 13:49:00-000, 924, 94, 830, 0, 0.00, 0, 0.00, 924
8, 13:51:00-000, 688, 247, 441, 1, 1349.00, 1, 1350.00, 686
8, 13:52:00-000, 3325, 70, 3255, 26, 1352.11, 26, 1351.62, 3273
8, 13:53:00-000, 2607, 889, 1718, 0, 0.00, 0, 0.00, 2607
8, 13:56:00-000, 1865, 228, 1637, 10, 1349.80, 10, 1349.50, 1845
8, 13:57:00-000, 123, 59, 64, 0, 0.00, 0, 0.00, 123
8, 13:58:00-000, 1544, 1540, 4, 0, 0.00, 0, 0.00, 1544
8, 13:59:00-000, 21, 20, 1, 0, 0.00, 0, 0.00, 21
8, 14:01:00-000, 242, 98, 144, 0, 0.00, 0, 0.00, 242
8, 14:02:00-000, 1092, 45, 1047, 6, 1349.00, 6, 1349.83, 1080
8, 14:03:00-000, 63, 50, 13, 0, 0.00, 0, 0.00, 63
8, 14:05:00-000, 491, 261, 230, 0, 0.00, 0, 0.00, 491
8, 14:06:00-000, 2459, 2345, 114, 13, 1349.00, 14, 1349.29, 2432
8, 14:07:00-000, 158, 8, 150, 5, 1352.00, 4, 1352.00, 149
8, 14:08:00-000, 776, 750, 26, 26, 1348.00, 26, 1348.27, 724
8, 14:10:00-000, 110, 14, 96, 6, 1347.33, 6, 1350.83, 98
8, 14:12:00-000, 1723, 89, 1634, 13, 1348.61, 13, 1349.46, 1697
8, 14:13:00-000, 155, 5, 150, 0, 0.00, 0, 0.00, 0
8, 14:14:00-000, 1398, 164, 1234, 0, 0.00, 0, 0.00, 1553
8, 14:15:00-000, 3801, 1674, 2127, 0, 0.00, 0, 0.00, 3801
8, 14:16:00-000, 1034, 24, 1010, 0, 0.00, 0, 0.00, 1034
8, 14:18:00-000, 1550, 1434, 116, 6, 1354.50, 6, 1350.33, 1538
8, 14:19:00-000, 558, 453, 105, 0, 0.00, 0, 0.00, 558
8, 14:20:00-000, 1036, 1015, 21, 0, 0.00, 0, 0.00, 1036
8, 14:21:00-000, 886, 880, 6, 0, 0.00, 0, 0.00, 886
8, 14:22:00-000, 1851, 855, 996, 14, 1354.14, 14, 1351.71, 1823
8, 14:23:00-000, 117, 100, 17, 9, 1349.00, 9, 1348.00, 99
8, 14:24:00-000, 189, 9, 180, 6, 1357.00, 6, 1353.00, 177
8, 14:27:00-000, 70, 0, 70, 0, 0.00, 0, 0.00, 70
8, 14:28:00-000, 1058, 51, 1007, 1, 1351.00, 1, 1351.00, 1056
8, 14:29:00-000, 85, 36, 49, 17, 1347.17, 17, 1349.47, 51
8, 14:30:00-000, 1854, 910, 944, 0, 0.00, 0, 0.00, 1854
8, 14:31:00-000, 144, 74, 70, 0, 0.00, 0, 0.00, 144
8, 14:32:00-000, 84, 55, 29, 4, 1352.75, 4, 1351.00, 76
8, 14:33:00-000, 883, 108, 775, 0, 0.00, 0, 0.00, 883
8, 14:34:00-000, 2052, 507, 1545, 9, 1352.78, 9, 1351.00, 2034
8, 14:35:00-000, 1663, 13, 1650, 0, 0.00, 0, 0.00, 1663
8, 14:36:00-000, 1065, 30, 1035, 0, 0.00, 0, 0.00, 1044
8, 14:37:00-000, 1146, 1067, 79, 26, 1353.08, 26, 1351.31, 1115
8, 14:38:00-000, 2963, 803, 2160, 3, 1352.00, 3, 1352.00, 2957
8, 14:39:00-000, 58, 54, 4, 4, 1352.25, 4, 1351.00, 50
8, 14:40:00-000, 130, 9, 121, 1, 1349.00, 1, 1347.00, 128
8, 14:41:00-000, 825, 750, 75, 0, 0.00, 0, 0.00, 825
8, 14:42:00-000, 1109, 963, 146, 0, 0.00, 0, 0.00, 1109
8, 14:43:00-000, 69, 60, 9, 0, 0.00, 0, 0.00, 69
8, 14:45:00-000, 1277, 1098, 179, 4, 1350.00, 4, 1348.25, 959
8, 14:46:00-000, 275, 203, 72, 2, 1351.00, 2, 1350.00, 581
8, 14:47:00-000, 2250, 1953, 297, 0, 0.00, 0, 0.00, 2250
8, 14:48:00-000, 305, 74, 231, 16, 1348.00, 16, 1349.06, 273
8, 14:49:00-000, 1453, 630, 823, 1, 1356.00, 1, 1352.00, 1451
8, 14:50:00-000, 74, 72, 2, 2, 1352.00, 2, 1349.00, 70
8, 14:51:00-000, 4281, 2394, 1887, 2, 1352.00, 2, 1350.00, 4277
8, 14:52:00-000, 3042, 967, 2075, 12, 1351.08, 12, 1350.67, 3018
8, 14:53:00-000, 3505, 985, 2520, 0, 0.00, 0, 0.00, 3505
8, 14:54:00-000, 1611, 13, 1598, 8, 1349.00, 8, 1345.75, 1595
8, 14:55:00-000, 322, 175, 147, 5, 1347.40, 5, 1349.00, 312
8, 14:56:00-000, 156, 96, 60, 0, 0.00, 0, 0.00, 156
8, 14:58:00-000, 541, 177, 364, 2, 1348.00, 5, 1349.40, 534
8, 14:59:00-000, 2443, 1562, 881, 3, 1356.00, 0, 0.00, 2440
8, 15:00:00-000, 4557, 3135, 1422, 0, 0.00, 0, 0.00, 4557
8, 15:01:00-000, 3388, 2513, 875, 9, 1348.89, 9, 1349.44, 3370
8, 15:02:00-000, 3410, 1761, 1649, 2, 1348.00, 2, 1350.00, 3406
8, 15:03:00-000, 2242, 877, 1365, 3, 1349.00, 6, 1351.00, 2233
8, 15:04:00-000, 4, 4, 0, 3, 1349.33, 0, 0.00, 1
8, 15:05:00-000, 23, 3, 20, 2, 1350.00, 2, 1350.00, 19
8, 15:06:00-000, 167, 150, 17, 0, 0.00, 0, 0.00, 81
8, 15:07:00-000, 2425, 863, 1562, 0, 0.00, 0, 0.00, 2511
8, 15:08:00-000, 262, 67, 195, 3, 1348.00, 3, 1349.00, 256
8, 15:10:00-000, 141, 105, 36, 36, 1346.25, 24, 1350.42, 81
8, 15:11:00-000, 301, 197, 104, 10, 1352.30, 22, 1348.82, 269
8, 15:12:00-000, 276, 103, 173, 6, 1351.00, 6, 1352.00, 264
8, 15:13:00-000, 2952, 115, 2837, 2, 1353.00, 2, 1351.00, 2947
8, 15:14:00-000, 83, 22, 61, 1, 1355.00, 1, 1351.00, 82
8, 15:16:00-000, 1204, 138, 1066, 5, 1354.60, 5, 1350.60, 1194
8, 15:17:00-000, 171, 21, 150, 2, 1348.00, 0, 0.00, 169
8, 15:18:00-000, 3868, 2135, 1733, 5, 1354.00, 7, 1348.43, 3856
8, 15:19:00-000, 1492, 62, 1430, 0, 0.00, 0, 0.00, 1492
8, 15:20:00-000, 869, 27, 842, 2, 1345.00, 2, 1350.00, 865
8, 15:21:00-000, 1644, 1630, 14, 0, 0.00, 0, 0.00, 1644
8, 15:22:00-000, 2526, 266, 2260, 8, 1349.37, 7, 1348.57, 2511
8, 15:23:00-000, 2412, 93, 2319, 0, 0.00, 1, 1345.00, 2411
8, 15:24:00-000, 160, 150, 10, 0, 0.00, 0, 0.00, 160
8, 15:25:00-000, 337, 321, 16, 0, 0.00, 1, 1350.00, 336
8, 15:26:00-000, 354, 104, 250, 3, 1351.00, 2, 1353.00, 349
8, 15:27:00-000, 1718, 1614, 104, 6, 1352.17, 6, 1351.33, 1706
8, 15:28:00-000, 2212, 2140, 72, 6, 1351.33, 6, 1350.83, 2200
8, 15:29:00-000, 2756, 2627, 129, 0, 0.00, 0, 0.00, 2756
8, 15:30:00-000, 6, 1, 5, 0, 0.00, 0, 0.00, 6
8, 15:31:00-000, 1062, 241, 821, 9, 1348.56, 9, 1350.33, 1044
8, 15:32:00-000, 978, 8, 970, 8, 1349.00, 8, 1348.50, 962
8, 15:33:00-000, 1079, 931, 148, 2, 1351.00, 2, 1350.00, 1071
8, 15:34:00-000, 112, 58, 54, 0, 0.00, 0, 0.00, 116
8, 15:35:00-000, 59, 9, 50, 0, 0.00, 0, 0.00, 59
8, 15:36:00-000, 97, 31, 66, 0, 0.00, 0, 0.00, 97
8, 15:39:00-000, 1293, 147, 1146, 0, 0.00, 0, 0.00, 1293
8, 15:40:00-000, 22, 1, 21, 1, 1350.00, 1, 1348.00, 20
8, 15:45:00-000, 115, 9, 106, 9, 1349.00, 9, 1347.33, 97
8, 15:49:00-000, 1559, 1132, 427, 4, 1349.00, 4, 1347.25, 1551
8, 15:50:00-000, 806, 36, 770, 0, 0.00, 0, 0.00, 806
8, 15:51:00-000, 1272, 1129, 143, 0, 0.00, 0, 0.00, 1272
8, 15:55:00-000, 836, 64, 772, 2, 1346.00, 2, 1351.00, 832
8, 15:56:00-000, 22, 1, 21, 1, 1349.00, 1, 1349.00, 20
8, 16:02:00-000, 268, 206, 62, 0, 0.00, 0, 0.00, 268
8, 16:04:00-000, 2598, 906, 1692, 0, 0.00, 0, 0.00, 2598
8, 16:05:00-000, 49, 8, 41, 1, 1350.00, 1, 1349.00, 47
8, 16:07:00-000, 48, 8, 40, 0, 0.00, 0, 0.00, 48
8, 16:10:00-000, 87, 80, 7, 0, 0.00, 0, 0.00, 87
8, 16:11:00-000, 2541, 955, 1586, 13, 1349.54, 15, 1351.73, 2513
8, 16:12:00-000, 943, 921, 22, 6, 1351.00, 4, 1351.00, 933
8, 16:14:00-000, 1164, 970, 194, 6, 1349.00, 5, 1351.40, 1153
8, 16:15:00-000, 542, 407, 135, 5, 1348.20, 6, 1345.33, 531
8, 16:16:00-000, 2599, 1660, 939, 9, 1348.00, 9, 1349.55, 2581
8, 16:17:00-000, 3255, 1721, 1534, 1, 1353.00, 1, 1351.00, 3253
8, 16:18:00-000, 1491, 10, 1481, 10, 1349.00, 10, 1353.10, 1471
8, 16:20:00-000, 2372, 2360, 12, 10, 1346.50, 10, 1348.90, 2352
8, 16:21:00-000, 5047, 3675, 1372, 5, 1350.80, 5, 1350.00, 4935
8, 16:22:00-000, 921, 38, 883, 12, 1348.17, 12, 1346.42, 999
8, 16:23:00-000, 318, 83, 235, 3, 1349.00, 0, 0.00, 315
8, 16:24:00-000, 2837, 34, 2803, 5, 1349.00, 3, 1348.00, 2829
8, 16:25:00-000, 6, 0, 6, 0, 0.00, 5, 1350.20, 1
8, 16:26:00-000, 125, 65, 60, 10, 1354.00, 10, 1352.00, 105
8, 16:28:00-000, 1619, 1368, 251, 10, 1350.00, 10, 1350.00, 1599
8, 16:29:00-000, 886, 111, 775, 0, 0.00, 0, 0.00, 886
9, 09:07:00-000, 4530, 2980, 1550, 0, 0.00, 0, 0.00, 4530
9, 09:21:00-000, 2999, 219, 2780, 31, 1353.96, 67, 1349.00, 2901
9, 09:22:00-000, 93, 93, 0, 36, 1354.77, 0, 0.00, 57
9, 09:29:00-000, 8040, 7240, 800, 0, 0.00, 0, 0.00, 8040
9, 09:30:00-000, 2840, 2840, 0, 0, 0.00, 0, 0.00, 2840
9, 09:31:00-000, 2633, 23, 2610, 13, 1357.38, 13, 1351.00, 2607
9, 09:32:00-000, 2573, 2570, 3, 3, 1349.00, 3, 1348.00, 2567
9, 09:33:00-000, 3481, 2730, 751, 16, 1349.00, 8, 1351.87, 3457
9, 09:34:00-000, 8, 0, 8, 0, 0.00, 8, 1349.88, 0
9, 09:42:00-000, 4140, 3320, 820, 0, 0.00, 0, 0.00, 4140
9, 09:44:00-000, 4030, 1850, 2180, 0, 0.00, 0, 0.00, 4030
9, 09:49:00-000, 3050, 3050, 0, 0, 0.00, 0, 0.00, 3050
9, 09:50:00-000, 1515, 15, 1500, 15, 1353.47, 15, 1352.00, 1485
9, 09:57:00-000, 2490, 1030, 1460, 0, 0.00, 0, 0.00, 2490
9, 09:58:00-000, 5470, 2780, 2690, 0, 0.00, 0, 0.00, 5470
9, 10:00:00-000, 7500, 3910, 3590, 0, 0.00, 0, 0.00, 6140
9, 10:01:00-000, 4910, 2480, 2430, 0, 0.00, 0, 0.00, 6270
9, 10:03:00-000, 2920, 900, 2020, 0, 0.00, 0, 0.00, 2920
9, 10:04:00-000, 2120, 2120, 0, 0, 0.00, 0, 0.00, 2120
9, 10:05:00-000, 3536, 16, 3520, 16, 1353.62, 16, 1352.81, 3504
9, 10:07:00-000, 2370, 1320, 1050, 0, 0.00, 0, 0.00, 2370
9, 10:09:00-000, 2200, 740, 1460, 0, 0.00, 0, 0.00, 2200
9, 10:10:00-000, 3666, 66, 3600, 7, 1349.86, 66, 1351.00, 3593
9, 10:11:00-000, 144, 144, 0, 59, 1356.37, 0, 0.00, 85
9, 10:12:00-000, 4070, 2530, 1540, 0, 0.00, 0, 0.00, 4070
9, 10:13:00-000, 1141, 41, 1100, 20, 1353.40, 20, 1353.00, 1101
9, 10:14:00-000, 5710, 2320, 3390, 0, 0.00, 0, 0.00, 5710
9, 10:15:00-000, 4520, 3470, 1050, 0, 0.00, 0, 0.00, 4520
9, 10:16:00-000, 3446, 1016, 2430, 26, 1353.84, 26, 1352.00, 3394
9, 10:24:00-000, 2170, 1270, 900, 0, 0.00, 0, 0.00, 2170
9, 10:28:00-000, 1280, 0, 1280, 0, 0.00, 0, 0.00, 1280
9, 10:29:00-000, 4810, 2560, 2250, 0, 0.00, 0, 0.00, 4810
9, 10:30:00-000, 6498, 3098, 3400, 58, 1354.05, 58, 1352.00, 6382
9, 10:31:00-000, 4013, 3220, 793, 2, 1347.00, 2, 1348.00, 4009
9, 10:35:00-000, 1342, 2, 1340, 2, 1350.00, 2, 1351.00, 1338
9, 10:36:00-000, 1342, 2, 1340, 2, 1356.00, 2, 1352.00, 1338
9, 10:37:00-000, 1910, 800, 1110, 0, 0.00, 0, 0.00, 1910
9, 10:38:00-000, 9353, 6060, 3293, 63, 1346.68, 63, 1349.02, 9227
9, 10:39:00-000, 6300, 6300, 0, 0, 0.00, 0, 0.00, 6300
9, 10:40:00-000, 4946, 2416, 2530, 6, 1353.67, 6, 1352.00, 4934
9, 10:41:00-000, 772, 12, 760, 12, 1353.50, 12, 1354.00, 748
9, 10:44:00-000, 5812, 1762, 4050, 2, 1350.00, 2, 1352.00, 5808
9, 10:45:00-000, 1400, 0, 1400, 0, 0.00, 0, 0.00, 1400
9, 10:46:00-000, 6470, 5280, 1190, 0, 0.00, 0, 0.00, 5520
9, 10:47:00-000, 2920, 2920, 0, 0, 0.00, 0, 0.00, 3870
9, 10:48:00-000, 1740, 1050, 690, 0, 0.00, 0, 0.00, 1740
9, 10:49:00-000, 2927, 1507, 1420, 18, 1351.00, 18, 1353.00, 2891
9, 10:50:00-000, 7110, 3470, 3640, 0, 0.00, 0, 0.00, 7110
9, 10:53:00-000, 5079, 1859, 3220, 6, 1351.17, 6, 1353.00, 5067
9, 10:58:00-000, 3330, 1350, 1980, 0, 0.00, 0, 0.00, 3330
9, 10:59:00-000, 6060, 2640, 3420, 0, 0.00, 0, 0.00, 6060
9, 11:00:00-000, 1859, 1710, 149, 53, 1348.00, 53, 1346.92, 1753
9, 11:01:00-000, 3380, 1280, 2100, 0, 0.00, 0, 0.00, 3380
9, 11:02:00-000, 1160, 0, 1160, 0, 0.00, 0, 0.00, 1160
9, 11:03:00-000, 8333, 4920, 3413, 3, 1348.00, 3, 1351.33, 8327
9, 11:04:00-000, 840, 840, 0, 0, 0.00, 0, 0.00, 840
9, 11:05:00-000, 4550, 1430, 3120, 0, 0.00, 0, 0.00, 4550
9, 11:06:00-000, 6020, 2410, 3610, 0, 0.00, 0, 0.00, 6020
9, 11:07:00-000, 4950, 2240, 2710, 0, 0.00, 0, 0.00, 4950
9, 11:08:00-000, 7120, 2570, 4550, 0, 0.00, 0, 0.00, 7120
9, 11:09:00-000, 5840, 1640, 4200, 0, 0.00, 0, 0.00, 5500
9, 11:10:00-000, 5397, 4620, 777, 7, 1350.00, 7, 1351.14, 5723
9, 11:12:00-000, 5800, 1750, 4050, 0, 0.00, 0, 0.00, 5800
9, 11:13:00-000, 2450, 1040, 1410, 0, 0.00, 0, 0.00, 2450
9, 11:15:00-000, 4720, 2340, 2380, 0, 0.00, 0, 0.00, 4720
9, 11:16:00-000, 3280, 1150, 2130, 0, 0.00, 0, 0.00, 3280
9, 11:17:00-000, 1181, 1180, 1, 1, 1348.00, 1, 1344.00, 1179
9, 11:18:00-000, 5612, 2640, 2972, 2, 1350.00, 2, 1350.50, 5608
9, 11:19:00-000, 5330, 980, 4350, 0, 0.00, 0, 0.00, 5330
9, 11:21:00-000, 6405, 1355, 5050, 5, 1347.40, 5, 1352.00, 6395
9, 11:22:00-000, 2242, 862, 1380, 2, 1347.00, 2, 1352.00, 2238
9, 11:25:00-000, 10791, 3631, 7160, 1, 1354.00, 1, 1353.00, 10789
9, 11:26:00-000, 3310, 1130, 2180, 0, 0.00, 0, 0.00, 3310
9, 11:27:00-000, 3658, 8, 3650, 8, 1352.75, 8, 1352.00, 3642
9, 11:28:00-000, 1200, 1200, 0, 0, 0.00, 0, 0.00, 1200
9, 11:29:00-000, 8130, 3780, 4350, 0, 0.00, 0, 0.00, 8130
9, 11:30:00-000, 9867, 4640, 5227, 10, 1348.00, 6, 1348.17, 9851
9, 11:31:00-000, 2135, 8, 2127, 5, 1351.00, 9, 1349.78, 2121
9, 11:32:00-000, 3577, 2207, 1370, 17, 1352.06, 17, 1352.00, 3543
9, 11:36:00-000, 4180, 2690, 1490, 0, 0.00, 0, 0.00, 4180
9, 11:37:00-000, 5740, 2130, 3610, 0, 0.00, 0, 0.00, 5740
9, 11:40:00-000, 1858, 1105, 753, 11, 1352.18, 11, 1352.91, 1836
9, 11:41:00-000, 7216, 2741, 4475, 20, 1349.15, 20, 1348.20, 7176
9, 11:42:00-000, 4350, 2560, 1790, 0, 0.00, 0, 0.00, 4350
9, 11:43:00-000, 2340, 2340, 0, 0, 0.00, 0, 0.00, 2340
9, 11:44:00-000, 11250, 4890, 6360, 0, 0.00, 6, 1351.00, 11244
9, 11:45:00-000, 5315, 4458, 857, 85, 1351.48, 79, 1350.84, 5151
9, 11:46:00-000, 5540, 2070, 3470, 0, 0.00, 0, 0.00, 5540
9, 11:48:00-000, 3300, 810, 2490, 0, 0.00, 0, 0.00, 3300
9, 11:49:00-000, 4200, 1460, 2740, 0, 0.00, 0, 0.00, 4200
9, 11:53:00-000, 2041, 2040, 1, 1, 1349.00, 1, 1349.00, 2039
9, 11:54:00-000, 11530, 4320, 7210, 0, 0.00, 0, 0.00, 11530
9, 11:55:00-000, 3130, 1930, 1200, 0, 0.00, 0, 0.00, 2250
9, 11:56:00-000, 4910, 1420, 3490, 0, 0.00, 0, 0.00, 5790
9, 11:57:00-000, 4655, 4590, 65, 36, 1349.00, 36, 1346.55, 4583
9, 11:58:00-000, 2450, 0, 2450, 0, 0.00, 0, 0.00, 2450
9, 12:00:00-000, 5247, 27, 5220, 27, 1351.33, 27, 1352.00, 5193
9, 12:01:00-000, 1740, 740, 1000, 0, 0.00, 0, 0.00, 1740
9, 12:03:00-000, 4721, 1, 4720, 1, 1353.00, 1, 1352.00, 4719
9, 12:04:00-000, 2540, 2460, 80, 54, 1348.44, 54, 1347.10, 2432
9, 12:06:00-000, 9560, 5450, 4110, 0, 0.00, 0, 0.00, 8520
9, 12:07:00-000, 2320, 2320, 0, 0, 0.00, 0, 0.00, 3360
9, 12:09:00-000, 7540, 4220, 3320, 0, 0.00, 0, 0.00, 7540
9, 12:12:00-000, 5340, 2870, 2470, 0, 0.00, 0, 0.00, 5340
9, 12:13:00-000, 4931, 2361, 2570, 11, 1355.00, 11, 1352.00, 4909
9, 12:14:00-000, 1208, 28, 1180, 4, 1352.25, 28, 1352.00, 1176
9, 12:15:00-000, 3608, 1088, 2520, 57, 1352.68, 36, 1352.00, 3515
9, 12:16:00-000, 3405, 3404, 1, 4, 1351.00, 1, 1349.00, 3400
9, 12:17:00-000, 5171, 1461, 3710, 1, 1355.00, 1, 1351.00, 5169
9, 12:18:00-000, 2744, 24, 2720, 13, 1350.77, 24, 1352.00, 2707
9, 12:19:00-000, 2281, 1461, 820, 11, 1353.91, 0, 0.00, 2270
9, 12:20:00-000, 860, 860, 0, 0, 0.00, 0, 0.00, 0
9, 12:21:00-000, 5200, 3160, 2040, 0, 0.00, 0, 0.00, 6060
9, 12:22:00-000, 3410, 2040, 1370, 0, 0.00, 0, 0.00, 3410
9, 12:23:00-000, 1380, 1380, 0, 0, 0.00, 0, 0.00, 1380
9, 12:26:00-000, 3880, 1340, 2540, 0, 0.00, 0, 0.00, 3880
9, 12:27:00-000, 1230, 1230, 0, 0, 0.00, 0, 0.00, 1230
9, 12:28:00-000, 2745, 5, 2740, 5, 1353.00, 5, 1352.00, 2735
9, 12:29:00-000, 3600, 2190, 1410, 0, 0.00, 0, 0.00, 3600
9, 12:31:00-000, 2300, 1210, 1090, 0, 0.00, 0, 0.00, 2300
9, 12:34:00-000, 4870, 2110, 2760, 0, 0.00, 0, 0.00, 4870
9, 12:40:00-000, 4970, 2290, 2680, 0, 0.00, 0, 0.00, 4970
9, 12:46:00-000, 1170, 1170, 0, 0, 0.00, 0, 0.00, 1170
9, 12:47:00-000, 2608, 1290, 1318, 8, 1347.00, 8, 1347.88, 2592
9, 12:48:00-000, 3610, 2330, 1280, 0, 0.00, 0, 0.00, 3610
9, 12:49:00-000, 1960, 0, 1960, 0, 0.00, 0, 0.00, 1960
9, 12:50:00-000, 1279, 1250, 29, 29, 1346.34, 14, 1350.21, 1236
9, 12:51:00-000, 1106, 0, 1106, 0, 0.00, 15, 1349.06, 1091
9, 12:52:00-000, 2414, 1104, 1310, 3, 1350.00, 14, 1353.00, 2397
9, 12:53:00-000, 20, 20, 0, 11, 1351.82, 0, 0.00, 9
9, 12:54:00-000, 5666, 4560, 1106, 6, 1347.00, 6, 1348.67, 5654
9, 12:55:00-000, 950, 950, 0, 0, 0.00, 0, 0.00, 950
9, 12:56:00-000, 2430, 2430, 0, 0, 0.00, 0, 0.00, 2430
9, 12:57:00-000, 1140, 10, 1130, 10, 1350.40, 10, 1352.00, 1120
9, 12:58:00-000, 11589, 6370, 5219, 9, 1347.00, 7, 1350.86, 11573
9, 12:59:00-000, 5252, 1730, 3522, 0, 0.00, 2, 1346.00, 5250
9, 13:00:00-000, 3200, 790, 2410, 0, 0.00, 0, 0.00, 3200
9, 13:01:00-000, 2870, 2070, 800, 0, 0.00, 0, 0.00, 2870
9, 13:02:00-000, 960, 0, 960, 0, 0.00, 0, 0.00, 960
9, 13:03:00-000, 2890, 1010, 1880, 0, 0.00, 0, 0.00, 2130
9, 13:04:00-000, 5270, 2770, 2500, 0, 0.00, 0, 0.00, 6030
9, 13:06:00-000, 9470, 5210, 4260, 0, 0.00, 0, 0.00, 9470
9, 13:07:00-000, 12391, 6880, 5511, 11, 1347.00, 11, 1350.27, 12369
9, 13:08:00-000, 1330, 0, 1330, 0, 0.00, 0, 0.00, 1330
9, 13:09:00-000, 15450, 10750, 4700, 0, 0.00, 0, 0.00, 15450
9, 13:10:00-000, 5339, 1129, 4210, 9, 1349.00, 9, 1353.00, 5321
9, 13:12:00-000, 2470, 2470, 0, 0, 0.00, 0, 0.00, 2470
9, 13:13:00-000, 1420, 1420, 0, 0, 0.00, 0, 0.00, 1420
9, 13:14:00-000, 6641, 3500, 3141, 11, 1347.00, 3, 1351.00, 6627
9, 13:15:00-000, 5767, 3700, 2067, 19, 1346.47, 27, 1346.52, 5721
9, 13:16:00-000, 3360, 1120, 2240, 0, 0.00, 0, 0.00, 3360
9, 13:17:00-000, 3570, 3570, 0, 0, 0.00, 0, 0.00, 3570
9, 13:18:00-000, 12146, 6810, 5336, 6, 1348.00, 6, 1347.67, 12134
9, 13:19:00-000, 8910, 7740, 1170, 0, 0.00, 0, 0.00, 7350
9, 13:20:00-000, 3140, 1550, 1590, 0, 0.00, 0, 0.00, 4700
9, 13:21:00-000, 6168, 4068, 2100, 15, 1356.13, 15, 1353.00, 6138
9, 13:22:00-000, 2310, 890, 1420, 0, 0.00, 0, 0.00, 2310
9, 13:23:00-000, 2550, 1450, 1100, 0, 0.00, 0, 0.00, 2550
9, 13:24:00-000, 3940, 0, 3940, 0, 0.00, 0, 0.00, 3940
9, 13:25:00-000, 900, 0, 900, 0, 0.00, 0, 0.00, 900
9, 13:26:00-000, 10240, 5750, 4490, 0, 0.00, 0, 0.00, 10240
9, 13:27:00-000, 4920, 700, 4220, 0, 0.00, 0, 0.00, 4130
9, 13:28:00-000, 4733, 943, 3790, 3, 1355.00, 3, 1350.00, 5517
9, 13:29:00-000, 1040, 0, 1040, 0, 0.00, 0, 0.00, 1040
9, 13:30:00-000, 5080, 1390, 3690, 0, 0.00, 0, 0.00, 5080
9, 13:31:00-000, 6330, 2570, 3760, 0, 0.00, 0, 0.00, 6330
9, 13:32:00-000, 1880, 730, 1150, 0, 0.00, 0, 0.00, 1880
9, 13:33:00-000, 3240, 2380, 860, 0, 0.00, 0, 0.00, 3240
9, 13:34:00-000, 5280, 1370, 3910, 0, 0.00, 0, 0.00, 5280
9, 13:35:00-000, 2360, 2360, 0, 0, 0.00, 0, 0.00, 2360
9, 13:36:00-000, 1340, 0, 1340, 0, 0.00, 0, 0.00, 1340
9, 13:37:00-000, 2450, 0, 2450, 0, 0.00, 0, 0.00, 2450
9, 13:38:00-000, 11364, 3700, 7664, 4, 1347.00, 4, 1349.00, 11356
9, 13:39:00-000, 4300, 1420, 2880, 0, 0.00, 0, 0.00, 4300
9, 13:40:00-000, 6451, 4581, 1870, 1, 1351.00, 1, 1350.00, 6449
9, 13:41:00-000, 4380, 4380, 0, 0, 0.00, 0, 0.00, 4380
9, 13:42:00-000, 7610, 5300, 2310, 0, 0.00, 0, 0.00, 7610
9, 13:43:00-000, 9800, 4250, 5550, 0, 0.00, 0, 0.00, 9800
9, 13:45:00-000, 2175, 1435, 740, 24, 1352.87, 24, 1352.00, 2127
9, 13:46:00-000, 2340, 0, 2340, 0, 0.00, 0, 0.00, 2340
9, 13:47:00-000, 5300, 1160, 4140, 0, 0.00, 0, 0.00, 5300
9, 13:48:00-000, 1130, 1130, 0, 0, 0.00, 0, 0.00, 1130
9, 13:49:00-000, 3700, 1360, 2340, 0, 0.00, 0, 0.00, 2710
9, 13:50:00-000, 2605, 933, 1672, 15, 1348.40, 15, 1348.07, 3565
9, 13:51:00-000, 13000, 6030, 6970, 0, 0.00, 0, 0.00, 12120
9, 13:52:00-000, 3554, 2170, 1384, 14, 1348.00, 14, 1348.14, 4406
9, 13:53:00-000, 6629, 4839, 1790, 9, 1351.00, 9, 1352.00, 6611
9, 13:55:00-000, 1340, 0, 1340, 0, 0.00, 0, 0.00, 1340
9, 13:56:00-000, 2931, 1, 2930, 1, 1353.00, 1, 1352.00, 2929
9, 13:57:00-000, 1550, 1550, 0, 0, 0.00, 0, 0.00, 1550
9, 13:58:00-000, 2533, 2530, 3, 3, 1345.00, 3, 1349.67, 2527
9, 13:59:00-000, 1300, 0, 1300, 0, 0.00, 0, 0.00, 1300
9, 14:01:00-000, 6540, 2420, 4120, 0, 0.00, 0, 0.00, 6540
9, 14:02:00-000, 2520, 2520, 0, 0, 0.00, 0, 0.00, 2520
9, 14:03:00-000, 2240, 2240, 0, 0, 0.00, 0, 0.00, 2240
9, 14:05:00-000, 5700, 1950, 3750, 0, 0.00, 0, 0.00, 5700
9, 14:06:00-000, 5282, 4151, 1131, 2, 1349.50, 2, 1349.50, 5278
9, 14:07:00-000, 1240, 1240, 0, 0, 0.00, 0, 0.00, 1240
9, 14:09:00-000, 4121, 4120, 1, 1, 1347.00, 1, 1347.00, 4119
9, 14:10:00-000, 1190, 0, 1190, 0, 0.00, 0, 0.00, 1190
9, 14:11:00-000, 7070, 670, 6400, 0, 0.00, 0, 0.00, 5680
9, 14:12:00-000, 8804, 3784, 5020, 1, 1347.00, 4, 1352.00, 10189
9, 14:13:00-000, 3, 3, 0, 3, 1349.33, 0, 0.00, 0
9, 14:14:00-000, 5062, 2500, 2562, 2, 1349.00, 2, 1348.00, 5058
9, 14:15:00-000, 7662, 4560, 3102, 2, 1349.00, 2, 1348.00, 7658
9, 14:16:00-000, 1320, 1320, 0, 0, 0.00, 0, 0.00, 1320
9, 14:18:00-000, 8195, 5495, 2700, 22, 1348.18, 35, 1350.19, 8138
9, 14:19:00-000, 4583, 2893, 1690, 13, 1355.54, 0, 0.00, 4570
9, 14:22:00-000, 11810, 3620, 8190, 0, 0.00, 0, 0.00, 11810
9, 14:24:00-000, 2002, 2, 2000, 2, 1354.00, 2, 1351.00, 1998
9, 14:26:00-000, 1390, 1390, 0, 0, 0.00, 0, 0.00, 1390
9, 14:27:00-000, 2346, 6, 2340, 2, 1353.00, 6, 1352.00, 2338
9, 14:28:00-000, 3767, 787, 2980, 4, 1354.00, 0, 0.00, 3763
9, 14:29:00-000, 1350, 0, 1350, 0, 0.00, 0, 0.00, 1350
9, 14:30:00-000, 8287, 6110, 2177, 7, 1348.00, 7, 1349.57, 8273
9, 14:31:00-000, 6490, 4140, 2350, 0, 0.00, 0, 0.00, 6490
9, 14:32:00-000, 2540, 1420, 1120, 0, 0.00, 0, 0.00, 2540
9, 14:33:00-000, 11630, 6500, 5130, 0, 0.00, 0, 0.00, 10350
9, 14:34:00-000, 3580, 0, 3580, 0, 0.00, 0, 0.00, 4860
9, 14:35:00-000, 7491, 1091, 6400, 1, 1352.00, 1, 1352.00, 6769
9, 14:36:00-000, 2155, 35, 2120, 35, 1352.08, 35, 1351.54, 2805
9, 14:37:00-000, 1170, 1170, 0, 0, 0.00, 0, 0.00, 1170
9, 14:39:00-000, 1570, 0, 1570, 0, 0.00, 0, 0.00, 1570
9, 14:40:00-000, 2130, 0, 2130, 0, 0.00, 0, 0.00, 2130
9, 14:41:00-000, 2525, 1670, 855, 25, 1347.28, 7, 1347.86, 2493
9, 14:42:00-000, 5883, 2770, 3113, 1, 1350.00, 19, 1348.00, 5863
9, 14:43:00-000, 2080, 1200, 880, 0, 0.00, 0, 0.00, 2080
9, 14:44:00-000, 890, 0, 890, 0, 0.00, 0, 0.00, 890
9, 14:45:00-000, 5550, 1140, 4410, 0, 0.00, 0, 0.00, 5550
9, 14:46:00-000, 3292, 1172, 2120, 2, 1354.50, 2, 1352.00, 3288
9, 14:47:00-000, 10480, 6200, 4280, 0, 0.00, 0, 0.00, 10480
9, 14:48:00-000, 4222, 4220, 2, 2, 1347.00, 2, 1345.50, 4218
9, 14:49:00-000, 6740, 2870, 3870, 0, 0.00, 0, 0.00, 6740
9, 14:50:00-000, 2440, 0, 2440, 0, 0.00, 0, 0.00, 2440
9, 14:51:00-000, 7100, 1160, 5940, 0, 0.00, 0, 0.00, 5880
9, 14:52:00-000, 14872, 7790, 7082, 2, 1348.00, 2, 1348.00, 15228
9, 14:53:00-000, 7390, 4480, 2910, 0, 0.00, 0, 0.00, 8250
9, 14:54:00-000, 2559, 1270, 1289, 9, 1349.00, 9, 1347.11, 2541
9, 14:55:00-000, 3510, 1990, 1520, 0, 0.00, 0, 0.00, 3510
9, 14:56:00-000, 2141, 1401, 740, 1, 1348.00, 1, 1352.00, 2139
9, 14:57:00-000, 1470, 1470, 0, 0, 0.00, 0, 0.00, 1470
9, 14:58:00-000, 2390, 2390, 0, 0, 0.00, 0, 0.00, 2390
9, 15:00:00-000, 9580, 4740, 4840, 0, 0.00, 0, 0.00, 9580
9, 15:01:00-000, 6540, 3810, 2730, 0, 0.00, 0, 0.00, 6540
9, 15:02:00-000, 9180, 4680, 4500, 0, 0.00, 0, 0.00, 9180
9, 15:03:00-000, 8530, 1690, 6840, 0, 0.00, 0, 0.00, 8530
9, 15:05:00-000, 4773, 2483, 2290, 3, 1349.00, 3, 1351.00, 4767
9, 15:06:00-000, 2360, 2360, 0, 0, 0.00, 0, 0.00, 2360
9, 15:07:00-000, 9082, 6430, 2652, 7, 1351.00, 7, 1346.57, 9068
9, 15:08:00-000, 6215, 4895, 1320, 21, 1352.81, 21, 1352.00, 6173
9, 15:09:00-000, 1280, 0, 1280, 0, 0.00, 0, 0.00, 1280
9, 15:10:00-000, 3377, 17, 3360, 17, 1352.00, 17, 1352.00, 3343
9, 15:11:00-000, 1486, 6, 1480, 6, 1353.00, 6, 1351.00, 1474
9, 15:12:00-000, 1950, 0, 1950, 0, 0.00, 0, 0.00, 1950
9, 15:13:00-000, 8271, 4741, 3530, 1, 1352.00, 1, 1352.00, 8269
9, 15:14:00-000, 6236, 4810, 1426, 12, 1346.50, 12, 1349.50, 6212
9, 15:16:00-000, 3960, 2160, 1800, 0, 0.00, 0, 0.00, 3960
9, 15:17:00-000, 8701, 4261, 4440, 1, 1350.00, 1, 1352.00, 8699
9, 15:18:00-000, 1490, 1490, 0, 0, 0.00, 0, 0.00, 1490
9, 15:19:00-000, 3920, 2980, 940, 0, 0.00, 0, 0.00, 2860
9, 15:20:00-000, 5400, 2120, 3280, 0, 0.00, 0, 0.00, 6460
9, 15:21:00-000, 4820, 3340, 1480, 0, 0.00, 0, 0.00, 4820
9, 15:22:00-000, 8680, 6460, 2220, 0, 0.00, 0, 0.00, 8680
9, 15:23:00-000, 2060, 2060, 0, 0, 0.00, 0, 0.00, 1330
9, 15:24:00-000, 2390, 2390, 0, 0, 0.00, 0, 0.00, 3120
9, 15:25:00-000, 8610, 6620, 1990, 0, 0.00, 0, 0.00, 8610
9, 15:26:00-000, 13021, 7171, 5850, 21, 1352.52, 21, 1352.00, 12979
9, 15:27:00-000, 8901, 4131, 4770, 1, 1354.00, 1, 1353.00, 8899
9, 15:28:00-000, 3720, 1420, 2300, 0, 0.00, 0, 0.00, 3720
9, 15:29:00-000, 5510, 1820, 3690, 0, 0.00, 0, 0.00, 5510
9, 15:30:00-000, 5322, 2324, 2998, 50, 1350.00, 25, 1351.96, 5247
9, 15:31:00-000, 2107, 1422, 685, 2, 1353.00, 27, 1348.89, 2078
9, 15:32:00-000, 1080, 0, 1080, 0, 0.00, 0, 0.00, 1080
9, 15:33:00-000, 3350, 0, 3350, 0, 0.00, 0, 0.00, 3350
9, 15:34:00-000, 2470, 1280, 1190, 0, 0.00, 0, 0.00, 2470
9, 15:35:00-000, 2670, 0, 2670, 0, 0.00, 0, 0.00, 2670
9, 15:36:00-000, 7852, 1082, 6770, 22, 1353.95, 22, 1352.00, 7808
9, 15:37:00-000, 3420, 930, 2490, 0, 0.00, 0, 0.00, 3420
9, 15:39:00-000, 1220, 1220, 0, 0, 0.00, 0, 0.00, 1220
9, 15:44:00-000, 890, 880, 10, 10, 1348.00, 10, 1349.10, 870
9, 15:49:00-000, 2210, 0, 2210, 0, 0.00, 0, 0.00, 2210
9, 15:50:00-000, 2870, 1620, 1250, 0, 0.00, 0, 0.00, 2870
9, 15:51:00-000, 950, 0, 950, 0, 0.00, 0, 0.00, 950
9, 15:59:00-000, 5120, 2620, 2500, 0, 0.00, 0, 0.00, 5120
9, 16:02:00-000, 2100, 0, 2100, 0, 0.00, 0, 0.00, 2100
9, 16:03:00-000, 1275, 160, 1115, 3, 1347.00, 3, 1346.00, 1269
9, 16:04:00-000, 3172, 2005, 1167, 12, 1349.25, 12, 1350.25, 3148
9, 16:05:00-000, 3670, 3670, 0, 0, 0.00, 0, 0.00, 3670
9, 16:06:00-000, 2583, 3, 2580, 3, 1351.00, 3, 1352.00, 2577
9, 16:07:00-000, 4810, 2680, 2130, 0, 0.00, 0, 0.00, 4810
9, 16:08:00-000, 930, 0, 930, 0, 0.00, 0, 0.00, 930
9, 16:09:00-000, 2630, 1630, 1000, 0, 0.00, 0, 0.00, 2630
9, 16:10:00-000, 2330, 0, 2330, 0, 0.00, 0, 0.00, 2330
9, 16:11:00-000, 4870, 1150, 3720, 0, 0.00, 0, 0.00, 4870
9, 16:12:00-000, 3750, 2650, 1100, 0, 0.00, 0, 0.00, 3750
9, 16:13:00-000, 1170, 0, 1170, 0, 0.00, 0, 0.00, 1170
9, 16:14:00-000, 2250, 840, 1410, 0, 0.00, 0, 0.00, 2250
9, 16:15:00-000, 2020, 1100, 920, 0, 0.00, 0, 0.00, 2020
9, 16:16:00-000, 6090, 840, 5250, 0, 0.00, 2, 1353.00, 6088
9, 16:17:00-000, 2234, 14, 2220, 14, 1353.14, 12, 1353.00, 2208
9, 16:20:00-000, 2330, 860, 1470, 0, 0.00, 0, 0.00, 2330
9, 16:21:00-000, 7840, 3440, 4400, 0, 0.00, 0, 0.00, 7840
9, 16:22:00-000, 2939, 2040, 899, 9, 1346.11, 9, 1347.67, 2921
9, 16:23:00-000, 9477, 2697, 6780, 15, 1350.40, 15, 1353.00, 9447
9, 16:24:00-000, 4440, 0, 4440, 0, 0.00, 0, 0.00, 4440
9, 16:25:00-000, 1925, 1105, 820, 3, 1351.00, 3, 1353.00, 1919
9, 16:26:00-000, 813, 810, 3, 3, 1349.00, 2, 1349.00, 808
9, 16:27:00-000, 81, 70, 11, 10, 1346.00, 11, 1346.18, 60
9, 16:28:00-000, 5627, 4710, 917, 11, 1347.09, 11, 1346.91, 5605
9, 16:29:00-000, 5150, 3540, 1610, 0, 0.00, 0, 0.00, 5150
