TraderType,Time,EnterQty,BuyEnterQty,SellEnterQty,BuyExecutedQty,BuyExecutedPx,SellExecutedQty,SellExecutedPx,CanceledQty
1, 09:06:00-000, 3015, 3015, 0, 901, 1347.84, 0, 0.00, 0
1, 09:07:00-000, 0, 0, 0, 0, 0.00, 0, 0.00, 2104
1, 09:08:00-000, 0, 0, 0, 0, 0.00, 0, 0.00, 10
1, 09:13:00-000, 3119, 2218, 901, 1064, 1348.18, 901, 1347.61, 0
1, 09:14:00-000, 2, 0, 2, 0, 0.00, 2, 1356.00, 1154
1, 09:15:00-000, 20, 16, 4, 7, 1351.43, 4, 1348.25, 0
1, 09:16:00-000, 167, 94, 73, 38, 1349.15, 71, 1353.27, 16
1, 09:17:00-000, 171, 106, 65, 38, 1348.18, 65, 1355.62, 45
1, 09:18:00-000, 525, 348, 177, 53, 1350.93, 179, 1365.33, 109
1, 09:19:00-000, 443, 315, 128, 110, 1350.34, 128, 1357.63, 201
1, 09:20:00-000, 837, 551, 286, 313, 1349.48, 286, 1350.39, 195
1, 09:21:00-000, 322, 207, 115, 139, 1348.41, 114, 1348.49, 228
1, 09:22:00-000, 597, 400, 197, 206, 1347.86, 198, 1349.31, 152
1, 09:23:00-000, 304, 235, 69, 112, 1350.21, 69, 1351.95, 167
1, 09:24:00-000, 444, 305, 139, 202, 1348.25, 139, 1348.06, 138
1, 09:25:00-000, 320, 250, 70, 48, 1350.16, 67, 1356.23, 100
1, 09:26:00-000, 654, 417, 237, 282, 1348.87, 240, 1349.57, 170
1, 09:27:00-000, 349, 252, 97, 99, 1348.12, 97, 1347.96, 166
1, 09:28:00-000, 636, 425, 211, 175, 1348.02, 211, 1348.46, 215
1, 09:29:00-000, 304, 214, 90, 135, 1348.64, 90, 1348.04, 148
1, 09:30:00-000, 678, 412, 266, 243, 1347.36, 264, 1349.03, 122
1, 09:31:00-000, 299, 202, 97, 84, 1349.57, 97, 1354.17, 160
1, 09:32:00-000, 558, 377, 181, 236, 1347.80, 181, 1348.16, 124
1, 09:33:00-000, 321, 180, 141, 168, 1348.12, 141, 1348.27, 90
1, 09:34:00-000, 619, 411, 208, 249, 1347.65, 208, 1348.17, 114
1, 09:35:00-000, 381, 251, 130, 158, 1347.86, 130, 1346.95, 96
1, 09:36:00-000, 615, 395, 220, 234, 1348.44, 220, 1348.30, 148
1, 09:37:00-000, 262, 161, 101, 89, 1347.53, 101, 1347.54, 127
1, 09:38:00-000, 587, 374, 213, 253, 1348.38, 213, 1347.73, 98
1, 09:39:00-000, 264, 150, 114, 118, 1347.71, 114, 1347.80, 84
1, 09:40:00-000, 655, 381, 274, 247, 1348.21, 274, 1347.31, 70
1, 09:41:00-000, 287, 160, 127, 120, 1347.92, 127, 1347.11, 87
1, 09:42:00-000, 567, 311, 256, 186, 1347.49, 256, 1347.20, 85
1, 09:43:00-000, 269, 168, 101, 125, 1347.74, 101, 1347.88, 88
1, 09:44:00-000, 625, 373, 252, 227, 1348.52, 252, 1348.42, 95
1, 09:45:00-000, 280, 171, 109, 113, 1347.89, 109, 1347.72, 98
1, 09:46:00-000, 587, 335, 252, 228, 1347.60, 252, 1347.62, 79
1, 09:47:00-000, 260, 152, 108, 120, 1347.59, 108, 1347.71, 63
1, 09:48:00-000, 709, 437, 272, 281, 1347.57, 272, 1346.97, 101
1, 09:49:00-000, 304, 214, 90, 116, 1348.26, 90, 1348.42, 108
1, 09:50:00-000, 549, 329, 220, 206, 1348.79, 220, 1348.18, 116
1, 09:51:00-000, 339, 226, 113, 103, 1347.71, 113, 1347.06, 112
1, 09:52:00-000, 618, 412, 206, 239, 1348.58, 206, 1347.76, 158
1, 09:53:00-000, 352, 217, 135, 164, 1347.23, 135, 1346.86, 100
1, 09:54:00-000, 652, 401, 251, 223, 1347.91, 251, 1348.41, 107
1, 09:55:00-000, 258, 156, 102, 113, 1347.74, 102, 1347.24, 144
1, 09:56:00-000, 634, 419, 215, 266, 1347.68, 215, 1347.53, 99
1, 09:57:00-000, 337, 223, 114, 129, 1348.29, 114, 1347.70, 113
1, 09:58:00-000, 643, 384, 259, 246, 1347.67, 259, 1347.29, 126
1, 09:59:00-000, 252, 146, 106, 101, 1346.95, 106, 1347.06, 107
1, 10:00:00-000, 656, 397, 259, 244, 1348.47, 259, 1348.00, 72
1, 10:01:00-000, 297, 152, 145, 128, 1347.87, 145, 1346.97, 106
1, 10:02:00-000, 680, 444, 236, 295, 1348.01, 236, 1347.30, 80
1, 10:03:00-000, 309, 186, 123, 144, 1347.95, 123, 1346.51, 109
1, 10:04:00-000, 604, 374, 230, 234, 1348.63, 230, 1348.48, 88
1, 10:05:00-000, 300, 183, 117, 112, 1349.04, 117, 1348.75, 90
1, 10:06:00-000, 553, 324, 229, 179, 1348.54, 229, 1348.48, 94
1, 10:07:00-000, 238, 143, 95, 110, 1347.94, 95, 1347.14, 107
1, 10:08:00-000, 589, 297, 292, 216, 1348.25, 292, 1347.25, 79
1, 10:09:00-000, 314, 182, 132, 120, 1348.49, 132, 1347.69, 58
1, 10:10:00-000, 613, 339, 274, 240, 1347.41, 274, 1347.66, 106
1, 10:11:00-000, 322, 190, 132, 138, 1349.22, 132, 1349.00, 58
1, 10:12:00-000, 630, 447, 183, 235, 1348.37, 183, 1348.43, 77
1, 10:13:00-000, 318, 213, 105, 145, 1348.37, 105, 1347.68, 138
1, 10:14:00-000, 657, 433, 224, 263, 1348.33, 224, 1347.88, 126
1, 10:15:00-000, 293, 195, 98, 128, 1347.97, 98, 1348.45, 147
1, 10:16:00-000, 608, 358, 250, 218, 1347.87, 250, 1347.22, 109
1, 10:17:00-000, 347, 258, 89, 118, 1348.76, 89, 1348.11, 113
1, 10:18:00-000, 623, 315, 308, 259, 1347.80, 308, 1347.22, 104
1, 10:19:00-000, 284, 143, 141, 93, 1347.39, 141, 1347.26, 82
1, 10:20:00-000, 629, 371, 258, 252, 1347.68, 258, 1347.30, 62
1, 10:21:00-000, 268, 151, 117, 124, 1348.25, 117, 1347.41, 107
1, 10:22:00-000, 595, 348, 247, 264, 1348.34, 247, 1347.73, 52
1, 10:23:00-000, 285, 181, 104, 121, 1348.73, 102, 1348.00, 61
1, 10:24:00-000, 539, 327, 212, 246, 1347.46, 214, 1347.30, 81
1, 10:25:00-000, 293, 162, 131, 106, 1347.62, 131, 1347.19, 68
1, 10:26:00-000, 609, 362, 247, 234, 1347.65, 247, 1346.68, 69
1, 10:27:00-000, 365, 253, 112, 153, 1348.42, 112, 1347.55, 120
1, 10:28:00-000, 648, 371, 277, 281, 1347.33, 277, 1346.73, 90
1, 10:29:00-000, 298, 168, 130, 116, 1348.02, 130, 1347.39, 87
1, 10:30:00-000, 654, 391, 263, 263, 1347.77, 263, 1348.16, 84
1, 10:31:00-000, 261, 160, 101, 87, 1348.03, 101, 1348.08, 105
1, 10:32:00-000, 689, 430, 259, 311, 1347.37, 259, 1346.93, 82
1, 10:33:00-000, 289, 182, 107, 110, 1347.45, 107, 1347.06, 104
1, 10:34:00-000, 599, 317, 282, 246, 1347.77, 282, 1347.40, 83
1, 10:35:00-000, 342, 192, 150, 126, 1346.99, 150, 1346.70, 52
1, 10:36:00-000, 569, 349, 220, 236, 1347.80, 220, 1347.83, 77
1, 10:37:00-000, 346, 200, 146, 76, 1349.63, 146, 1349.09, 120
1, 10:38:00-000, 605, 350, 255, 243, 1348.57, 255, 1348.33, 103
1, 10:39:00-000, 304, 199, 105, 115, 1347.97, 105, 1347.61, 92
1, 10:40:00-000, 616, 365, 251, 280, 1348.29, 251, 1347.72, 110
1, 10:41:00-000, 329, 193, 136, 102, 1347.56, 136, 1347.24, 82
1, 10:42:00-000, 632, 405, 227, 245, 1348.19, 227, 1347.87, 122
1, 10:43:00-000, 296, 199, 97, 127, 1348.93, 97, 1348.79, 125
1, 10:44:00-000, 532, 298, 234, 273, 1348.10, 234, 1346.98, 58
1, 10:45:00-000, 382, 229, 153, 170, 1347.51, 153, 1347.36, 51
1, 10:46:00-000, 566, 379, 187, 193, 1347.79, 187, 1347.82, 86
1, 10:47:00-000, 253, 146, 107, 78, 1348.01, 107, 1348.42, 148
1, 10:48:00-000, 650, 349, 301, 258, 1347.31, 301, 1347.06, 72
1, 10:49:00-000, 309, 190, 119, 129, 1347.58, 119, 1347.06, 91
1, 10:50:00-000, 614, 347, 267, 253, 1347.85, 267, 1347.09, 78
1, 10:51:00-000, 289, 168, 121, 111, 1348.25, 121, 1348.35, 72
1, 10:52:00-000, 517, 267, 250, 183, 1347.32, 250, 1346.92, 72
1, 10:53:00-000, 282, 160, 122, 103, 1348.55, 122, 1348.21, 77
1, 10:54:00-000, 639, 407, 232, 252, 1348.00, 232, 1347.25, 81
1, 10:55:00-000, 305, 188, 117, 141, 1348.15, 117, 1347.15, 132
1, 10:56:00-000, 554, 344, 210, 214, 1347.54, 210, 1346.70, 75
1, 10:57:00-000, 322, 193, 129, 141, 1347.68, 129, 1347.59, 86
1, 10:58:00-000, 549, 365, 184, 203, 1348.60, 184, 1347.78, 103
1, 10:59:00-000, 269, 163, 106, 84, 1347.48, 106, 1348.27, 110
1, 11:00:00-000, 618, 402, 216, 292, 1348.64, 216, 1347.81, 116
1, 11:01:00-000, 313, 162, 151, 131, 1347.04, 151, 1346.48, 86
1, 11:02:00-000, 668, 404, 264, 258, 1347.93, 264, 1347.95, 62
1, 11:03:00-000, 255, 157, 98, 123, 1348.66, 98, 1348.31, 92
1, 11:04:00-000, 676, 388, 288, 272, 1347.79, 288, 1347.65, 76
1, 11:05:00-000, 316, 200, 116, 142, 1347.76, 116, 1347.57, 90
1, 11:06:00-000, 636, 349, 287, 287, 1347.93, 287, 1346.90, 87
1, 11:07:00-000, 334, 214, 120, 116, 1348.05, 120, 1347.92, 48
1, 11:08:00-000, 584, 365, 219, 256, 1348.35, 219, 1347.80, 122
1, 11:09:00-000, 265, 160, 105, 72, 1348.11, 105, 1347.50, 87
1, 11:10:00-000, 614, 313, 301, 249, 1347.88, 301, 1346.94, 88
1, 11:11:00-000, 293, 211, 82, 127, 1347.95, 82, 1347.66, 56
1, 11:12:00-000, 712, 425, 287, 307, 1348.12, 287, 1346.94, 102
1, 11:13:00-000, 288, 178, 110, 133, 1347.45, 110, 1347.13, 99
1, 11:14:00-000, 675, 404, 271, 267, 1348.01, 271, 1347.39, 77
1, 11:15:00-000, 265, 152, 113, 132, 1346.79, 113, 1346.00, 93
1, 11:16:00-000, 640, 418, 222, 271, 1348.11, 222, 1347.01, 74
1, 11:17:00-000, 287, 161, 126, 143, 1348.28, 126, 1347.04, 83
1, 11:18:00-000, 575, 329, 246, 225, 1348.14, 242, 1347.78, 62
1, 11:19:00-000, 321, 197, 124, 127, 1348.86, 128, 1348.02, 77
1, 11:20:00-000, 732, 475, 257, 281, 1348.14, 257, 1348.62, 105
1, 11:21:00-000, 313, 170, 143, 139, 1347.45, 143, 1347.15, 129
1, 11:22:00-000, 584, 290, 294, 229, 1347.13, 294, 1347.08, 58
1, 11:23:00-000, 331, 176, 155, 140, 1348.94, 155, 1348.05, 62
1, 11:24:00-000, 633, 374, 259, 290, 1347.31, 259, 1346.68, 66
1, 11:25:00-000, 341, 190, 151, 127, 1348.51, 151, 1347.28, 52
1, 11:26:00-000, 620, 376, 244, 268, 1347.92, 244, 1347.57, 112
1, 11:27:00-000, 240, 141, 99, 111, 1347.04, 99, 1345.98, 67
1, 11:28:00-000, 680, 401, 279, 260, 1347.81, 279, 1347.69, 47
1, 11:29:00-000, 361, 233, 128, 180, 1347.46, 128, 1347.56, 110
1, 11:30:00-000, 698, 402, 296, 305, 1347.82, 296, 1346.75, 75
1, 11:31:00-000, 248, 148, 100, 103, 1347.20, 100, 1346.42, 94
1, 11:32:00-000, 600, 337, 263, 245, 1347.62, 263, 1347.04, 73
1, 11:33:00-000, 263, 163, 100, 87, 1348.56, 100, 1348.75, 63
1, 11:34:00-000, 664, 347, 317, 261, 1347.58, 317, 1347.47, 82
1, 11:35:00-000, 265, 160, 105, 90, 1348.44, 105, 1347.49, 86
1, 11:36:00-000, 729, 423, 306, 329, 1347.64, 306, 1346.91, 62
1, 11:37:00-000, 351, 219, 132, 118, 1349.26, 132, 1349.37, 96
1, 11:38:00-000, 616, 342, 274, 271, 1348.21, 274, 1347.10, 108
1, 11:39:00-000, 311, 206, 105, 125, 1347.81, 105, 1347.89, 58
1, 11:40:00-000, 700, 405, 295, 300, 1347.54, 295, 1347.19, 73
1, 11:41:00-000, 302, 183, 119, 139, 1347.23, 119, 1346.56, 98
1, 11:42:00-000, 638, 388, 250, 252, 1348.21, 250, 1347.79, 78
1, 11:43:00-000, 328, 193, 135, 126, 1347.97, 135, 1347.46, 117
1, 11:44:00-000, 649, 383, 266, 229, 1348.05, 266, 1347.72, 111
1, 11:45:00-000, 296, 144, 152, 125, 1347.72, 152, 1347.56, 84
1, 11:46:00-000, 631, 376, 255, 261, 1347.81, 255, 1347.10, 67
1, 11:47:00-000, 300, 173, 127, 102, 1347.17, 127, 1346.39, 91
1, 11:48:00-000, 579, 346, 233, 236, 1347.78, 233, 1347.71, 97
1, 11:49:00-000, 309, 179, 130, 117, 1347.71, 130, 1346.95, 90
1, 11:50:00-000, 654, 408, 246, 275, 1348.12, 246, 1347.39, 92
1, 11:51:00-000, 287, 175, 112, 104, 1347.65, 112, 1347.49, 102
1, 11:52:00-000, 560, 362, 198, 231, 1348.75, 198, 1347.47, 68
1, 11:53:00-000, 324, 176, 148, 145, 1347.98, 148, 1347.39, 94
1, 11:54:00-000, 627, 347, 280, 260, 1347.77, 280, 1347.09, 81
1, 11:55:00-000, 324, 198, 126, 116, 1347.47, 125, 1347.70, 77
1, 11:56:00-000, 646, 388, 258, 282, 1348.28, 259, 1347.25, 77
1, 11:57:00-000, 251, 163, 88, 130, 1348.13, 88, 1347.35, 89
1, 11:58:00-000, 614, 355, 259, 247, 1347.95, 259, 1347.70, 76
1, 11:59:00-000, 313, 163, 150, 135, 1346.90, 150, 1346.82, 75
1, 12:00:00-000, 642, 363, 279, 257, 1347.65, 278, 1347.21, 70
1, 12:01:00-000, 278, 163, 115, 99, 1347.38, 116, 1347.22, 82
1, 12:02:00-000, 533, 314, 219, 206, 1348.03, 219, 1347.30, 88
1, 12:03:00-000, 292, 152, 140, 102, 1346.89, 140, 1346.90, 67
1, 12:04:00-000, 610, 356, 254, 234, 1347.24, 254, 1346.85, 91
1, 12:05:00-000, 345, 208, 137, 151, 1348.12, 137, 1347.43, 82
1, 12:06:00-000, 660, 405, 255, 267, 1348.28, 255, 1347.24, 102
1, 12:07:00-000, 316, 186, 130, 160, 1348.47, 130, 1347.85, 95
1, 12:08:00-000, 515, 307, 208, 238, 1347.91, 208, 1347.03, 51
1, 12:09:00-000, 301, 168, 133, 93, 1347.54, 133, 1347.24, 52
1, 12:10:00-000, 604, 378, 226, 239, 1348.30, 226, 1347.73, 100
1, 12:11:00-000, 374, 248, 126, 163, 1348.57, 126, 1347.67, 102
1, 12:12:00-000, 697, 447, 250, 329, 1348.23, 250, 1347.41, 115
1, 12:13:00-000, 361, 220, 141, 147, 1348.40, 141, 1348.22, 94
1, 12:14:00-000, 546, 336, 210, 263, 1348.02, 210, 1348.16, 86
1, 12:15:00-000, 284, 131, 153, 111, 1347.52, 153, 1347.33, 47
1, 12:16:00-000, 587, 350, 237, 198, 1347.62, 237, 1347.06, 80
1, 12:17:00-000, 319, 194, 125, 107, 1348.87, 125, 1348.12, 117
1, 12:18:00-000, 715, 391, 324, 291, 1347.84, 324, 1347.47, 100
1, 12:19:00-000, 271, 145, 126, 97, 1347.14, 126, 1346.28, 76
1, 12:20:00-000, 624, 345, 279, 212, 1348.42, 279, 1347.13, 86
1, 12:21:00-000, 333, 201, 132, 113, 1347.85, 132, 1347.72, 77
1, 12:22:00-000, 573, 330, 243, 241, 1348.23, 243, 1347.61, 107
1, 12:23:00-000, 286, 148, 138, 104, 1348.27, 138, 1347.10, 79
1, 12:24:00-000, 633, 384, 249, 220, 1348.30, 249, 1347.32, 87
1, 12:25:00-000, 278, 197, 81, 126, 1347.79, 80, 1347.69, 116
1, 12:26:00-000, 634, 358, 276, 269, 1348.45, 277, 1347.27, 84
1, 12:27:00-000, 277, 203, 74, 144, 1349.39, 74, 1347.45, 79
1, 12:28:00-000, 610, 406, 204, 244, 1348.16, 204, 1347.34, 115
1, 12:29:00-000, 267, 166, 101, 100, 1348.30, 101, 1347.75, 121
1, 12:30:00-000, 618, 364, 254, 236, 1347.83, 254, 1347.67, 81
1, 12:31:00-000, 303, 169, 134, 106, 1348.44, 134, 1347.39, 102
1, 12:32:00-000, 591, 313, 278, 202, 1348.02, 278, 1346.33, 97
1, 12:33:00-000, 316, 220, 96, 130, 1348.81, 96, 1347.91, 93
1, 12:34:00-000, 646, 380, 266, 270, 1348.77, 266, 1348.56, 58
1, 12:35:00-000, 284, 201, 83, 102, 1348.75, 83, 1348.40, 138
1, 12:36:00-000, 653, 383, 270, 252, 1347.83, 270, 1347.65, 90
1, 12:37:00-000, 281, 181, 100, 120, 1348.69, 100, 1347.85, 121
1, 12:38:00-000, 590, 359, 231, 251, 1348.16, 231, 1347.58, 107
1, 12:39:00-000, 277, 183, 94, 105, 1349.27, 94, 1347.80, 85
1, 12:40:00-000, 654, 414, 240, 282, 1348.84, 240, 1347.86, 65
1, 12:41:00-000, 319, 198, 121, 139, 1349.13, 121, 1348.68, 125
1, 12:42:00-000, 637, 370, 267, 258, 1348.48, 267, 1347.66, 96
1, 12:43:00-000, 256, 150, 106, 79, 1348.46, 106, 1348.30, 84
1, 12:44:00-000, 593, 337, 256, 241, 1348.03, 256, 1347.42, 99
1, 12:45:00-000, 291, 185, 106, 129, 1348.81, 106, 1348.62, 65
1, 12:46:00-000, 657, 408, 249, 308, 1348.37, 249, 1347.99, 82
1, 12:47:00-000, 255, 142, 113, 87, 1349.39, 113, 1347.73, 86
1, 12:48:00-000, 638, 394, 244, 267, 1347.74, 244, 1347.06, 83
1, 12:49:00-000, 315, 172, 143, 125, 1348.22, 143, 1347.29, 99
1, 12:50:00-000, 626, 355, 271, 251, 1347.97, 271, 1347.55, 56
1, 12:51:00-000, 271, 163, 108, 100, 1347.63, 108, 1347.58, 96
1, 12:52:00-000, 652, 387, 265, 259, 1347.87, 265, 1347.34, 92
1, 12:53:00-000, 347, 216, 131, 176, 1348.17, 131, 1347.77, 90
1, 12:54:00-000, 620, 394, 226, 189, 1348.67, 226, 1348.19, 81
1, 12:55:00-000, 361, 192, 169, 138, 1348.17, 169, 1347.89, 138
1, 12:56:00-000, 559, 343, 216, 260, 1347.98, 216, 1346.96, 94
1, 12:57:00-000, 371, 219, 152, 149, 1347.76, 152, 1347.31, 76
1, 12:58:00-000, 561, 339, 222, 212, 1348.28, 219, 1347.89, 66
1, 12:59:00-000, 309, 168, 141, 154, 1347.31, 141, 1347.17, 91
1, 13:00:00-000, 675, 398, 277, 274, 1348.30, 277, 1347.49, 91
1, 13:01:00-000, 329, 188, 141, 125, 1348.54, 141, 1347.50, 93
1, 13:02:00-000, 590, 366, 224, 233, 1348.96, 224, 1348.83, 64
1, 13:03:00-000, 294, 199, 95, 102, 1348.63, 95, 1348.12, 98
1, 13:04:00-000, 577, 294, 283, 273, 1347.07, 283, 1346.79, 97
1, 13:05:00-000, 290, 185, 105, 139, 1348.08, 105, 1347.67, 47
1, 13:06:00-000, 734, 470, 264, 270, 1348.17, 264, 1347.97, 79
1, 13:07:00-000, 261, 149, 112, 146, 1347.54, 112, 1347.22, 129
1, 13:08:00-000, 607, 350, 257, 191, 1348.47, 257, 1348.07, 85
1, 13:09:00-000, 350, 223, 127, 164, 1348.04, 127, 1347.56, 99
1, 13:10:00-000, 650, 343, 307, 275, 1347.93, 307, 1346.81, 78
1, 13:11:00-000, 284, 183, 101, 132, 1348.90, 101, 1347.19, 46
1, 13:12:00-000, 672, 409, 263, 307, 1348.32, 263, 1348.16, 97
1, 13:13:00-000, 290, 164, 126, 131, 1347.41, 126, 1346.78, 74
1, 13:14:00-000, 668, 373, 295, 271, 1347.79, 295, 1347.23, 76
1, 13:15:00-000, 271, 157, 114, 121, 1347.12, 114, 1346.08, 61
1, 13:16:00-000, 653, 429, 224, 277, 1348.48, 224, 1348.00, 68
1, 13:17:00-000, 363, 210, 153, 168, 1348.99, 153, 1348.26, 105
1, 13:18:00-000, 701, 393, 308, 276, 1347.76, 308, 1346.97, 66
1, 13:19:00-000, 256, 146, 110, 115, 1347.43, 110, 1347.54, 80
1, 13:20:00-000, 629, 347, 282, 222, 1347.84, 282, 1347.08, 98
1, 13:21:00-000, 297, 184, 113, 121, 1348.01, 113, 1347.45, 61
1, 13:22:00-000, 649, 402, 247, 253, 1348.18, 247, 1347.51, 122
1, 13:23:00-000, 306, 169, 137, 155, 1347.40, 137, 1347.83, 96
1, 13:24:00-000, 653, 350, 303, 267, 1347.66, 301, 1346.52, 62
1, 13:25:00-000, 309, 163, 146, 92, 1349.00, 148, 1348.44, 66
1, 13:26:00-000, 643, 375, 268, 213, 1348.79, 268, 1348.75, 113
1, 13:27:00-000, 325, 209, 116, 119, 1349.06, 116, 1349.15, 99
1, 13:28:00-000, 635, 393, 242, 274, 1347.81, 242, 1347.39, 146
1, 13:29:00-000, 315, 216, 99, 122, 1348.71, 99, 1348.18, 56
1, 13:30:00-000, 618, 381, 237, 285, 1347.52, 237, 1347.37, 117
1, 13:31:00-000, 335, 192, 143, 116, 1347.38, 143, 1347.19, 85
1, 13:32:00-000, 630, 381, 249, 265, 1348.55, 249, 1348.12, 109
1, 13:33:00-000, 298, 194, 104, 140, 1348.50, 104, 1347.82, 74
1, 13:34:00-000, 726, 402, 324, 284, 1348.86, 324, 1347.95, 87
1, 13:35:00-000, 262, 150, 112, 118, 1347.84, 112, 1347.32, 85
1, 13:36:00-000, 631, 363, 268, 270, 1347.40, 268, 1346.70, 79
1, 13:37:00-000, 333, 211, 122, 151, 1347.54, 122, 1346.81, 68
1, 13:38:00-000, 638, 343, 295, 266, 1348.14, 295, 1346.84, 64
1, 13:39:00-000, 289, 171, 118, 135, 1346.83, 118, 1346.13, 51
1, 13:40:00-000, 616, 371, 245, 275, 1348.05, 245, 1348.15, 41
1, 13:41:00-000, 313, 166, 147, 161, 1347.64, 147, 1347.18, 90
1, 13:42:00-000, 666, 364, 302, 255, 1347.41, 302, 1347.27, 47
1, 13:43:00-000, 340, 201, 139, 153, 1347.75, 139, 1347.35, 74
1, 13:44:00-000, 643, 360, 283, 260, 1347.67, 283, 1346.96, 87
1, 13:45:00-000, 333, 199, 134, 125, 1347.69, 134, 1347.44, 71
1, 13:46:00-000, 577, 338, 239, 223, 1348.46, 239, 1347.11, 94
1, 13:47:00-000, 275, 161, 114, 114, 1348.51, 114, 1347.76, 97
1, 13:48:00-000, 574, 338, 236, 243, 1347.86, 236, 1347.38, 56
1, 13:49:00-000, 341, 177, 164, 155, 1348.28, 164, 1346.87, 70
1, 13:50:00-000, 658, 419, 239, 289, 1347.83, 239, 1346.63, 84
1, 13:51:00-000, 288, 176, 112, 110, 1348.07, 112, 1346.70, 85
1, 13:52:00-000, 677, 417, 260, 291, 1349.26, 260, 1348.50, 66
1, 13:53:00-000, 346, 182, 164, 130, 1347.49, 164, 1346.73, 100
1, 13:54:00-000, 547, 323, 224, 235, 1347.93, 224, 1346.91, 83
1, 13:55:00-000, 351, 198, 153, 158, 1347.85, 153, 1347.06, 80
1, 13:56:00-000, 606, 357, 249, 176, 1348.66, 249, 1348.07, 72
1, 13:57:00-000, 353, 195, 158, 203, 1347.66, 158, 1347.44, 95
1, 13:58:00-000, 663, 358, 305, 277, 1348.02, 305, 1346.76, 52
1, 13:59:00-000, 288, 184, 104, 121, 1347.94, 104, 1347.31, 73
1, 14:00:00-000, 622, 382, 240, 279, 1348.23, 240, 1347.47, 77
1, 14:01:00-000, 309, 170, 139, 136, 1347.80, 139, 1347.35, 77
1, 14:02:00-000, 479, 319, 160, 162, 1348.51, 160, 1348.01, 99
1, 14:03:00-000, 318, 195, 123, 141, 1348.46, 123, 1348.24, 82
1, 14:04:00-000, 691, 370, 321, 272, 1347.95, 321, 1346.81, 82
1, 14:05:00-000, 301, 174, 127, 130, 1347.71, 127, 1347.64, 83
1, 14:06:00-000, 731, 411, 320, 269, 1348.06, 320, 1348.17, 92
1, 14:07:00-000, 296, 182, 114, 104, 1348.29, 114, 1346.97, 97
1, 14:08:00-000, 582, 401, 181, 285, 1348.29, 181, 1348.18, 79
1, 14:09:00-000, 335, 149, 186, 156, 1347.19, 185, 1345.99, 90
1, 14:10:00-000, 672, 383, 289, 273, 1347.33, 290, 1346.85, 42
1, 14:11:00-000, 314, 181, 133, 157, 1347.46, 133, 1347.48, 66
1, 14:12:00-000, 626, 368, 258, 262, 1348.56, 258, 1347.78, 68
1, 14:13:00-000, 353, 187, 166, 155, 1347.89, 166, 1346.84, 52
1, 14:14:00-000, 584, 365, 219, 236, 1348.77, 219, 1347.26, 73
1, 14:15:00-000, 301, 179, 122, 149, 1348.22, 122, 1347.78, 75
1, 14:16:00-000, 678, 370, 308, 295, 1347.66, 308, 1346.74, 80
1, 14:17:00-000, 347, 188, 159, 123, 1347.01, 159, 1345.95, 57
1, 14:18:00-000, 611, 330, 281, 245, 1347.98, 281, 1347.19, 99
1, 14:19:00-000, 333, 216, 117, 115, 1348.31, 117, 1348.56, 55
1, 14:20:00-000, 543, 278, 265, 226, 1347.45, 265, 1347.09, 106
1, 14:21:00-000, 281, 188, 93, 120, 1349.35, 93, 1348.11, 62
1, 14:22:00-000, 602, 321, 281, 273, 1347.56, 281, 1347.40, 41
1, 14:23:00-000, 316, 154, 162, 131, 1347.60, 162, 1346.77, 49
1, 14:24:00-000, 661, 364, 297, 240, 1348.27, 294, 1347.78, 74
1, 14:25:00-000, 313, 202, 111, 98, 1348.79, 114, 1348.91, 109
1, 14:26:00-000, 606, 382, 224, 229, 1349.63, 224, 1349.24, 123
1, 14:27:00-000, 249, 130, 119, 102, 1348.27, 119, 1347.68, 94
1, 14:28:00-000, 520, 323, 197, 185, 1349.22, 197, 1348.17, 97
1, 14:29:00-000, 336, 221, 115, 136, 1349.05, 115, 1347.88, 86
1, 14:30:00-000, 637, 378, 259, 272, 1348.16, 259, 1347.53, 104
1, 14:31:00-000, 332, 213, 119, 156, 1348.22, 119, 1347.24, 93
1, 14:32:00-000, 609, 408, 201, 235, 1348.31, 201, 1347.93, 111
1, 14:33:00-000, 301, 163, 138, 137, 1348.05, 138, 1347.72, 106
1, 14:34:00-000, 634, 395, 239, 253, 1347.99, 239, 1347.67, 61
1, 14:35:00-000, 327, 174, 153, 136, 1347.42, 153, 1346.56, 110
1, 14:36:00-000, 559, 344, 215, 248, 1347.55, 215, 1346.90, 72
1, 14:37:00-000, 303, 176, 127, 127, 1348.50, 127, 1347.49, 70
1, 14:38:00-000, 588, 359, 229, 234, 1348.28, 229, 1347.93, 82
1, 14:39:00-000, 333, 201, 132, 124, 1347.41, 132, 1346.97, 98
1, 14:40:00-000, 622, 366, 256, 230, 1348.38, 256, 1348.30, 125
1, 14:41:00-000, 273, 168, 105, 114, 1348.14, 105, 1348.45, 74
1, 14:42:00-000, 637, 344, 293, 301, 1348.14, 293, 1347.50, 58
1, 14:43:00-000, 300, 174, 126, 95, 1348.73, 126, 1347.91, 61
1, 14:44:00-000, 692, 437, 255, 281, 1347.33, 255, 1346.91, 105
1, 14:45:00-000, 269, 144, 125, 120, 1347.23, 125, 1346.41, 102
1, 14:46:00-000, 604, 361, 243, 246, 1348.61, 243, 1347.95, 52
1, 14:47:00-000, 317, 173, 144, 131, 1347.66, 144, 1347.81, 83
1, 14:48:00-000, 569, 351, 218, 248, 1348.75, 218, 1348.10, 82
1, 14:49:00-000, 247, 120, 127, 101, 1347.25, 127, 1347.08, 78
1, 14:50:00-000, 657, 417, 240, 263, 1347.78, 240, 1346.78, 61
1, 14:51:00-000, 339, 187, 152, 155, 1347.22, 152, 1346.43, 83
1, 14:52:00-000, 668, 358, 310, 271, 1347.61, 310, 1347.11, 73
1, 14:53:00-000, 333, 193, 140, 158, 1347.22, 140, 1346.19, 72
1, 14:54:00-000, 632, 411, 221, 285, 1348.38, 221, 1346.74, 83
1, 14:55:00-000, 267, 167, 100, 119, 1348.43, 100, 1347.95, 96
1, 14:56:00-000, 577, 381, 196, 229, 1347.93, 196, 1347.81, 64
1, 14:57:00-000, 318, 174, 144, 122, 1347.82, 144, 1347.76, 121
1, 14:58:00-000, 648, 393, 255, 273, 1347.49, 255, 1347.08, 109
1, 14:59:00-000, 290, 160, 130, 125, 1346.74, 130, 1346.12, 54
1, 15:00:00-000, 697, 415, 282, 295, 1348.46, 282, 1347.78, 89
1, 15:01:00-000, 268, 123, 145, 120, 1347.42, 145, 1346.52, 68
1, 15:02:00-000, 686, 396, 290, 264, 1347.62, 290, 1346.75, 30
1, 15:03:00-000, 205, 131, 74, 106, 1348.11, 74, 1347.80, 107
1, 15:04:00-000, 593, 316, 277, 244, 1347.76, 277, 1347.33, 59
1, 15:05:00-000, 306, 183, 123, 123, 1348.02, 123, 1348.18, 52
1, 15:06:00-000, 691, 399, 292, 244, 1348.09, 292, 1347.74, 87
1, 15:07:00-000, 309, 158, 151, 138, 1347.94, 151, 1347.49, 123
1, 15:08:00-000, 564, 338, 226, 198, 1348.44, 226, 1347.96, 60
1, 15:09:00-000, 290, 153, 137, 103, 1348.00, 137, 1347.19, 93
1, 15:10:00-000, 543, 322, 221, 225, 1348.03, 221, 1348.25, 90
1, 15:11:00-000, 328, 206, 122, 121, 1348.05, 122, 1347.88, 77
1, 15:12:00-000, 559, 306, 253, 224, 1347.89, 253, 1348.04, 71
1, 15:13:00-000, 330, 212, 118, 166, 1347.68, 118, 1347.74, 64
1, 15:14:00-000, 598, 344, 254, 245, 1347.55, 254, 1347.37, 76
1, 15:15:00-000, 315, 206, 109, 149, 1348.38, 109, 1346.87, 80
1, 15:16:00-000, 591, 355, 236, 203, 1348.84, 236, 1348.66, 94
1, 15:17:00-000, 320, 182, 138, 148, 1347.92, 138, 1346.80, 86
1, 15:18:00-000, 592, 303, 289, 228, 1347.78, 289, 1347.47, 88
1, 15:19:00-000, 270, 165, 105, 104, 1347.52, 105, 1346.63, 65
1, 15:20:00-000, 632, 414, 218, 235, 1348.90, 218, 1347.89, 87
1, 15:21:00-000, 292, 177, 115, 139, 1347.85, 115, 1347.14, 134
1, 15:22:00-000, 584, 395, 189, 251, 1348.69, 189, 1348.27, 86
1, 15:23:00-000, 343, 180, 163, 171, 1347.94, 163, 1347.19, 83
1, 15:24:00-000, 559, 342, 217, 230, 1347.89, 217, 1346.67, 64
1, 15:25:00-000, 298, 178, 120, 99, 1349.54, 120, 1348.24, 86
1, 15:26:00-000, 593, 367, 226, 236, 1348.55, 226, 1348.00, 114
1, 15:27:00-000, 299, 165, 134, 128, 1347.67, 134, 1347.01, 78
1, 15:28:00-000, 553, 334, 219, 237, 1348.26, 219, 1347.64, 67
1, 15:29:00-000, 338, 172, 166, 114, 1347.50, 166, 1346.22, 84
1, 15:30:00-000, 589, 361, 228, 276, 1348.27, 228, 1347.19, 83
1, 15:31:00-000, 352, 215, 137, 168, 1347.37, 137, 1346.75, 63
1, 15:32:00-000, 653, 378, 275, 276, 1347.85, 275, 1347.74, 65
1, 15:33:00-000, 364, 194, 170, 154, 1346.98, 170, 1346.13, 66
1, 15:34:00-000, 537, 350, 187, 202, 1348.70, 187, 1347.79, 83
1, 15:35:00-000, 281, 150, 131, 106, 1347.46, 131, 1347.41, 92
1, 15:36:00-000, 687, 365, 322, 281, 1348.13, 322, 1347.86, 67
1, 15:37:00-000, 291, 164, 127, 132, 1348.42, 127, 1347.67, 93
1, 15:38:00-000, 634, 368, 266, 203, 1348.01, 266, 1347.38, 49
1, 15:39:00-000, 293, 166, 127, 153, 1347.35, 127, 1347.10, 117
1, 15:40:00-000, 587, 355, 232, 212, 1348.65, 232, 1347.88, 86
1, 15:41:00-000, 337, 203, 134, 106, 1348.54, 134, 1347.57, 108
1, 15:42:00-000, 599, 385, 214, 250, 1348.74, 214, 1347.77, 112
1, 15:43:00-000, 281, 165, 116, 90, 1348.07, 116, 1348.14, 104
1, 15:44:00-000, 649, 394, 255, 238, 1347.95, 255, 1347.15, 95
1, 15:45:00-000, 375, 231, 144, 160, 1348.54, 144, 1347.51, 141
1, 15:46:00-000, 621, 410, 211, 275, 1348.75, 211, 1347.80, 91
1, 15:47:00-000, 309, 206, 103, 101, 1348.89, 103, 1347.26, 109
1, 15:48:00-000, 648, 387, 261, 279, 1347.70, 261, 1347.50, 93
1, 15:49:00-000, 361, 226, 135, 161, 1348.66, 135, 1347.39, 96
1, 15:50:00-000, 675, 427, 248, 298, 1348.66, 248, 1347.90, 113
1, 15:51:00-000, 239, 149, 90, 108, 1348.59, 90, 1348.24, 85
1, 15:52:00-000, 553, 323, 230, 241, 1348.30, 228, 1346.76, 86
1, 15:53:00-000, 330, 168, 162, 116, 1348.78, 164, 1347.23, 62
1, 15:54:00-000, 617, 346, 271, 233, 1348.56, 271, 1347.50, 80
1, 15:55:00-000, 285, 165, 120, 128, 1347.38, 120, 1346.74, 73
1, 15:56:00-000, 735, 438, 297, 249, 1348.07, 297, 1347.45, 90
1, 15:57:00-000, 292, 182, 110, 127, 1348.99, 110, 1347.68, 124
1, 15:58:00-000, 632, 344, 288, 278, 1347.50, 287, 1346.97, 82
1, 15:59:00-000, 272, 186, 86, 107, 1348.07, 87, 1348.41, 76
1, 16:00:00-000, 668, 431, 237, 326, 1347.90, 237, 1346.90, 80
1, 16:01:00-000, 294, 176, 118, 137, 1349.19, 118, 1347.84, 89
1, 16:02:00-000, 614, 351, 263, 283, 1347.78, 263, 1347.13, 62
1, 16:03:00-000, 310, 174, 136, 154, 1347.59, 136, 1346.23, 46
1, 16:04:00-000, 626, 332, 294, 272, 1347.70, 294, 1346.94, 48
1, 16:05:00-000, 366, 219, 147, 150, 1348.75, 147, 1348.04, 30
1, 16:06:00-000, 704, 376, 328, 294, 1347.18, 328, 1346.79, 77
1, 16:07:00-000, 363, 213, 150, 145, 1347.94, 150, 1347.64, 64
1, 16:08:00-000, 551, 300, 251, 230, 1348.00, 251, 1347.05, 78
1, 16:09:00-000, 271, 146, 125, 112, 1347.95, 125, 1346.13, 74
1, 16:10:00-000, 626, 343, 283, 253, 1347.97, 283, 1347.08, 39
1, 16:11:00-000, 236, 133, 103, 93, 1349.23, 103, 1349.44, 85
1, 16:12:00-000, 707, 391, 316, 306, 1347.62, 316, 1347.10, 63
1, 16:13:00-000, 304, 189, 115, 91, 1347.94, 115, 1348.01, 66
1, 16:14:00-000, 713, 422, 291, 311, 1347.65, 291, 1347.26, 103
1, 16:15:00-000, 218, 115, 103, 102, 1348.66, 103, 1347.83, 92
1, 16:16:00-000, 606, 335, 271, 241, 1347.47, 271, 1347.23, 33
1, 16:17:00-000, 310, 186, 124, 141, 1348.46, 124, 1348.42, 78
1, 16:18:00-000, 619, 385, 234, 264, 1347.05, 234, 1346.79, 67
1, 16:19:00-000, 295, 164, 131, 150, 1347.08, 131, 1346.64, 76
1, 16:20:00-000, 586, 354, 232, 235, 1348.96, 232, 1347.74, 69
1, 16:21:00-000, 310, 197, 113, 128, 1348.91, 113, 1348.38, 91
1, 16:22:00-000, 597, 404, 193, 244, 1348.66, 193, 1347.91, 97
1, 16:23:00-000, 351, 184, 167, 121, 1347.35, 167, 1347.05, 121
1, 16:24:00-000, 699, 383, 316, 337, 1347.74, 316, 1346.06, 96
1, 16:25:00-000, 313, 164, 149, 86, 1348.94, 149, 1349.27, 39
1, 16:26:00-000, 599, 359, 240, 248, 1348.46, 240, 1348.19, 86
1, 16:27:00-000, 307, 197, 110, 143, 1348.23, 110, 1347.12, 72
1, 16:28:00-000, 604, 372, 232, 285, 1348.11, 232, 1346.94, 77
1, 16:29:00-000, 312, 164, 148, 130, 1347.87, 148, 1347.58, 65
2, 09:06:00-000, 3176, 0, 3176, 0, 0.00, 1181, 1348.50, 0
2, 09:07:00-000, 0, 0, 0, 0, 0.00, 0, 0.00, 1987
2, 09:08:00-000, 0, 0, 0, 0, 0.00, 0, 0.00, 8
2, 09:13:00-000, 3101, 1181, 1920, 1181, 1352.68, 1591, 1351.45, 0
2, 09:14:00-000, 11, 8, 3, 8, 1357.00, 3, 1356.00, 329
2, 09:15:00-000, 41, 26, 15, 24, 1355.46, 15, 1353.20, 0
2, 09:16:00-000, 162, 94, 68, 96, 1354.99, 68, 1354.03, 0
2, 09:17:00-000, 187, 102, 85, 102, 1355.98, 85, 1352.99, 0
2, 09:18:00-000, 574, 331, 243, 331, 1359.23, 243, 1352.87, 0
2, 09:19:00-000, 412, 206, 206, 206, 1356.11, 201, 1351.86, 0
2, 09:20:00-000, 763, 365, 398, 365, 1353.85, 397, 1352.83, 0
2, 09:21:00-000, 347, 138, 209, 138, 1352.39, 173, 1351.83, 0
2, 09:22:00-000, 698, 350, 348, 350, 1354.20, 355, 1353.30, 5
2, 09:23:00-000, 274, 132, 142, 132, 1355.40, 172, 1353.67, 0
2, 09:24:00-000, 592, 284, 308, 284, 1352.73, 301, 1352.08, 0
2, 09:25:00-000, 287, 137, 150, 137, 1354.55, 151, 1352.28, 0
2, 09:26:00-000, 703, 321, 382, 321, 1353.15, 321, 1352.29, 4
2, 09:27:00-000, 369, 174, 195, 174, 1353.10, 175, 1351.08, 45
2, 09:28:00-000, 600, 305, 295, 305, 1353.33, 226, 1351.09, 54
2, 09:29:00-000, 279, 110, 169, 110, 1352.05, 141, 1351.46, 45
2, 09:30:00-000, 718, 392, 326, 392, 1354.24, 361, 1353.16, 1
2, 09:31:00-000, 339, 166, 173, 166, 1355.37, 153, 1352.70, 0
2, 09:32:00-000, 653, 314, 339, 313, 1353.50, 331, 1352.55, 20
2, 09:33:00-000, 377, 192, 185, 193, 1354.53, 158, 1352.97, 0
2, 09:34:00-000, 592, 278, 314, 278, 1353.25, 296, 1351.29, 0
2, 09:35:00-000, 331, 131, 200, 131, 1352.96, 169, 1352.00, 31
2, 09:36:00-000, 571, 272, 299, 272, 1353.57, 274, 1352.01, 59
2, 09:37:00-000, 288, 157, 131, 157, 1353.48, 106, 1352.06, 19
2, 09:38:00-000, 670, 329, 341, 329, 1353.55, 266, 1351.06, 43
2, 09:39:00-000, 356, 185, 171, 185, 1353.46, 176, 1352.58, 30
2, 09:40:00-000, 585, 266, 319, 266, 1352.26, 278, 1351.28, 43
2, 09:41:00-000, 303, 143, 160, 143, 1352.32, 139, 1351.66, 14
2, 09:42:00-000, 622, 282, 340, 282, 1352.29, 255, 1351.50, 40
2, 09:43:00-000, 324, 156, 168, 156, 1353.34, 149, 1351.08, 50
2, 09:44:00-000, 476, 191, 285, 191, 1353.66, 266, 1351.85, 28
2, 09:45:00-000, 399, 178, 221, 178, 1352.34, 203, 1350.90, 25
2, 09:46:00-000, 593, 293, 300, 293, 1353.54, 254, 1351.96, 32
2, 09:47:00-000, 350, 184, 166, 184, 1353.06, 169, 1352.18, 30
2, 09:48:00-000, 653, 284, 369, 284, 1352.23, 277, 1351.07, 39
2, 09:49:00-000, 292, 136, 156, 136, 1353.71, 139, 1351.75, 38
2, 09:50:00-000, 705, 357, 348, 357, 1353.55, 305, 1352.52, 27
2, 09:51:00-000, 337, 133, 204, 133, 1353.50, 157, 1351.64, 41
2, 09:52:00-000, 547, 221, 326, 221, 1353.02, 228, 1351.63, 80
2, 09:53:00-000, 329, 172, 157, 172, 1352.11, 133, 1351.92, 61
2, 09:54:00-000, 668, 314, 354, 314, 1353.08, 310, 1351.71, 36
2, 09:55:00-000, 320, 121, 199, 121, 1352.10, 123, 1351.39, 42
2, 09:56:00-000, 658, 281, 377, 281, 1352.49, 318, 1351.09, 66
2, 09:57:00-000, 329, 138, 191, 138, 1353.03, 177, 1351.36, 50
2, 09:58:00-000, 624, 275, 349, 275, 1351.91, 293, 1351.16, 34
2, 09:59:00-000, 332, 126, 206, 126, 1351.29, 154, 1350.17, 62
2, 10:00:00-000, 632, 309, 323, 309, 1353.07, 296, 1352.30, 36
2, 10:01:00-000, 356, 134, 222, 134, 1351.77, 130, 1351.31, 42
2, 10:02:00-000, 687, 302, 385, 302, 1353.14, 333, 1351.27, 75
2, 10:03:00-000, 288, 128, 160, 128, 1352.07, 151, 1351.29, 52
2, 10:04:00-000, 656, 345, 311, 345, 1354.28, 289, 1352.55, 15
2, 10:05:00-000, 254, 106, 148, 106, 1354.11, 141, 1352.24, 16
2, 10:06:00-000, 577, 283, 294, 283, 1354.29, 268, 1352.49, 23
2, 10:07:00-000, 368, 176, 192, 176, 1355.08, 187, 1352.26, 20
2, 10:08:00-000, 649, 271, 378, 271, 1352.07, 268, 1351.04, 38
2, 10:09:00-000, 301, 150, 151, 150, 1352.81, 115, 1351.55, 73
2, 10:10:00-000, 631, 353, 278, 353, 1353.25, 243, 1351.52, 51
2, 10:11:00-000, 276, 159, 117, 159, 1354.36, 112, 1352.62, 17
2, 10:12:00-000, 716, 304, 412, 304, 1352.29, 328, 1351.41, 30
2, 10:13:00-000, 271, 99, 172, 99, 1352.22, 127, 1351.10, 69
2, 10:14:00-000, 564, 272, 292, 272, 1353.08, 257, 1351.81, 44
2, 10:15:00-000, 308, 133, 175, 133, 1353.52, 140, 1351.27, 35
2, 10:16:00-000, 586, 273, 313, 273, 1352.67, 255, 1351.26, 32
2, 10:17:00-000, 312, 100, 212, 100, 1352.37, 148, 1351.94, 31
2, 10:18:00-000, 611, 264, 347, 264, 1352.19, 277, 1351.11, 111
2, 10:19:00-000, 300, 155, 145, 155, 1351.79, 117, 1350.93, 51
2, 10:20:00-000, 653, 292, 361, 292, 1351.66, 271, 1350.76, 62
2, 10:21:00-000, 303, 165, 138, 165, 1354.22, 144, 1352.17, 29
2, 10:22:00-000, 610, 236, 374, 236, 1352.51, 262, 1351.32, 50
2, 10:23:00-000, 314, 120, 194, 120, 1352.88, 143, 1351.09, 77
2, 10:24:00-000, 606, 257, 349, 257, 1351.70, 273, 1350.63, 81
2, 10:25:00-000, 366, 175, 191, 175, 1352.14, 142, 1350.53, 60
2, 10:26:00-000, 570, 221, 349, 221, 1352.27, 268, 1351.28, 56
2, 10:27:00-000, 300, 128, 172, 128, 1352.12, 144, 1351.27, 60
2, 10:28:00-000, 613, 250, 363, 250, 1352.18, 264, 1351.08, 55
2, 10:29:00-000, 305, 144, 161, 144, 1353.07, 151, 1351.73, 56
2, 10:30:00-000, 668, 306, 362, 306, 1352.87, 299, 1351.12, 33
2, 10:31:00-000, 315, 166, 149, 166, 1354.20, 147, 1352.14, 45
2, 10:32:00-000, 633, 285, 348, 285, 1352.78, 329, 1351.33, 26
2, 10:33:00-000, 321, 117, 204, 117, 1352.33, 138, 1350.48, 17
2, 10:34:00-000, 666, 323, 343, 323, 1352.71, 326, 1351.44, 47
2, 10:35:00-000, 338, 159, 179, 157, 1352.45, 149, 1351.62, 38
2, 10:36:00-000, 603, 275, 328, 277, 1353.01, 261, 1351.18, 44
2, 10:37:00-000, 310, 145, 165, 145, 1352.41, 143, 1352.31, 37
2, 10:38:00-000, 655, 353, 302, 353, 1353.17, 267, 1351.54, 21
2, 10:39:00-000, 308, 126, 182, 126, 1352.76, 159, 1351.48, 33
2, 10:40:00-000, 613, 240, 373, 240, 1352.08, 287, 1351.10, 45
2, 10:41:00-000, 291, 121, 170, 121, 1352.06, 137, 1351.45, 71
2, 10:42:00-000, 580, 317, 263, 317, 1353.16, 233, 1351.87, 46
2, 10:43:00-000, 373, 160, 213, 160, 1353.45, 158, 1351.54, 22
2, 10:44:00-000, 648, 284, 364, 284, 1352.54, 284, 1351.10, 75
2, 10:45:00-000, 294, 139, 155, 139, 1353.23, 140, 1350.83, 54
2, 10:46:00-000, 598, 273, 325, 273, 1353.82, 290, 1352.23, 34
2, 10:47:00-000, 313, 172, 141, 172, 1353.14, 135, 1352.46, 17
2, 10:48:00-000, 646, 290, 356, 290, 1352.20, 257, 1351.12, 26
2, 10:49:00-000, 303, 130, 173, 130, 1352.12, 144, 1351.24, 75
2, 10:50:00-000, 649, 267, 382, 267, 1351.66, 314, 1350.45, 41
2, 10:51:00-000, 279, 152, 127, 152, 1353.19, 119, 1352.55, 42
2, 10:52:00-000, 538, 248, 290, 248, 1352.97, 231, 1351.16, 51
2, 10:53:00-000, 276, 125, 151, 125, 1352.17, 114, 1352.28, 42
2, 10:54:00-000, 636, 275, 361, 275, 1351.91, 305, 1351.11, 37
2, 10:55:00-000, 317, 155, 162, 155, 1353.24, 159, 1351.70, 44
2, 10:56:00-000, 668, 301, 367, 301, 1352.26, 295, 1351.46, 28
2, 10:57:00-000, 278, 75, 203, 75, 1351.10, 93, 1350.64, 61
2, 10:58:00-000, 581, 244, 337, 244, 1351.78, 272, 1351.33, 106
2, 10:59:00-000, 280, 133, 147, 133, 1353.06, 115, 1351.25, 55
2, 11:00:00-000, 699, 284, 415, 284, 1352.78, 369, 1351.75, 37
2, 11:01:00-000, 316, 142, 174, 142, 1352.53, 114, 1351.30, 56
2, 11:02:00-000, 634, 278, 356, 278, 1352.57, 258, 1351.48, 66
2, 11:03:00-000, 295, 150, 145, 150, 1353.42, 124, 1352.25, 60
2, 11:04:00-000, 670, 317, 353, 317, 1352.32, 296, 1351.49, 42
2, 11:05:00-000, 366, 170, 196, 170, 1353.38, 169, 1351.38, 44
2, 11:06:00-000, 648, 265, 383, 265, 1352.16, 272, 1351.39, 72
2, 11:07:00-000, 316, 140, 176, 140, 1352.29, 145, 1352.15, 77
2, 11:08:00-000, 658, 318, 340, 318, 1352.77, 291, 1351.15, 30
2, 11:09:00-000, 274, 116, 158, 116, 1351.83, 109, 1350.94, 64
2, 11:10:00-000, 631, 234, 397, 234, 1351.43, 272, 1350.97, 51
2, 11:11:00-000, 295, 114, 181, 114, 1352.28, 143, 1350.97, 92
2, 11:12:00-000, 601, 274, 327, 274, 1352.35, 239, 1351.06, 82
2, 11:13:00-000, 277, 141, 136, 141, 1352.86, 139, 1350.99, 53
2, 11:14:00-000, 692, 305, 387, 305, 1351.94, 286, 1350.92, 30
2, 11:15:00-000, 306, 120, 186, 120, 1351.99, 147, 1350.77, 67
2, 11:16:00-000, 699, 316, 383, 316, 1352.20, 324, 1351.62, 52
2, 11:17:00-000, 256, 115, 141, 115, 1352.01, 87, 1349.77, 65
2, 11:18:00-000, 570, 260, 310, 260, 1352.51, 238, 1351.36, 53
2, 11:19:00-000, 266, 116, 150, 116, 1352.77, 108, 1351.80, 68
2, 11:20:00-000, 622, 313, 309, 313, 1352.72, 260, 1351.73, 48
2, 11:21:00-000, 390, 156, 234, 156, 1351.98, 186, 1351.48, 36
2, 11:22:00-000, 642, 233, 409, 233, 1351.72, 280, 1350.95, 107
2, 11:23:00-000, 287, 128, 159, 128, 1352.61, 105, 1351.98, 57
2, 11:24:00-000, 598, 275, 323, 275, 1352.41, 294, 1350.22, 74
2, 11:25:00-000, 295, 135, 160, 135, 1352.05, 99, 1351.60, 39
2, 11:26:00-000, 633, 273, 360, 273, 1352.99, 314, 1351.81, 50
2, 11:27:00-000, 347, 118, 229, 118, 1350.69, 160, 1349.83, 57
2, 11:28:00-000, 582, 320, 262, 320, 1353.50, 235, 1351.71, 63
2, 11:29:00-000, 317, 148, 169, 148, 1352.60, 138, 1350.75, 25
2, 11:30:00-000, 603, 255, 348, 255, 1352.29, 322, 1351.33, 34
2, 11:31:00-000, 277, 106, 171, 106, 1352.29, 99, 1351.83, 26
2, 11:32:00-000, 626, 298, 328, 298, 1352.28, 277, 1351.53, 76
2, 11:33:00-000, 339, 178, 161, 178, 1353.20, 128, 1351.59, 41
2, 11:34:00-000, 619, 282, 337, 282, 1352.89, 273, 1351.20, 27
2, 11:35:00-000, 317, 142, 175, 142, 1352.89, 146, 1352.35, 56
2, 11:36:00-000, 625, 261, 364, 261, 1352.32, 284, 1351.39, 51
2, 11:37:00-000, 319, 119, 200, 119, 1352.99, 156, 1351.84, 57
2, 11:38:00-000, 576, 259, 317, 259, 1352.58, 242, 1351.25, 79
2, 11:39:00-000, 355, 145, 210, 145, 1352.01, 168, 1350.23, 61
2, 11:40:00-000, 613, 252, 361, 252, 1352.09, 281, 1350.73, 45
2, 11:41:00-000, 351, 156, 195, 156, 1352.08, 145, 1350.71, 62
2, 11:42:00-000, 653, 279, 374, 279, 1352.47, 277, 1351.69, 80
2, 11:43:00-000, 288, 118, 170, 118, 1351.84, 126, 1351.69, 59
2, 11:44:00-000, 640, 266, 374, 266, 1352.03, 279, 1350.88, 94
2, 11:45:00-000, 286, 116, 170, 116, 1352.05, 103, 1351.36, 68
2, 11:46:00-000, 603, 227, 376, 227, 1351.38, 271, 1350.99, 69
2, 11:47:00-000, 254, 114, 140, 114, 1352.12, 113, 1351.28, 90
2, 11:48:00-000, 637, 307, 330, 307, 1352.58, 283, 1351.38, 47
2, 11:49:00-000, 331, 145, 186, 145, 1351.37, 114, 1350.71, 44
2, 11:50:00-000, 642, 310, 332, 310, 1352.98, 306, 1352.11, 43
2, 11:51:00-000, 303, 126, 177, 126, 1352.40, 123, 1351.67, 46
2, 11:52:00-000, 694, 295, 399, 295, 1352.12, 336, 1351.91, 56
2, 11:53:00-000, 310, 150, 160, 150, 1352.70, 115, 1351.43, 63
2, 11:54:00-000, 615, 252, 363, 252, 1351.60, 263, 1351.21, 71
2, 11:55:00-000, 356, 162, 194, 162, 1351.38, 155, 1350.89, 65
2, 11:56:00-000, 559, 241, 318, 241, 1352.62, 230, 1351.40, 62
2, 11:57:00-000, 291, 114, 177, 114, 1352.92, 136, 1351.14, 61
2, 11:58:00-000, 618, 297, 321, 297, 1352.56, 280, 1351.17, 61
2, 11:59:00-000, 344, 154, 190, 154, 1352.94, 149, 1351.48, 37
2, 12:00:00-000, 642, 312, 330, 312, 1352.20, 218, 1350.68, 68
2, 12:01:00-000, 297, 112, 185, 112, 1351.71, 134, 1351.12, 60
2, 12:02:00-000, 550, 256, 294, 256, 1352.37, 226, 1351.22, 86
2, 12:03:00-000, 329, 191, 138, 191, 1352.86, 127, 1350.82, 60
2, 12:04:00-000, 512, 202, 310, 202, 1351.83, 216, 1350.75, 41
2, 12:05:00-000, 288, 107, 181, 107, 1351.49, 144, 1350.64, 54
2, 12:06:00-000, 648, 256, 392, 256, 1351.93, 299, 1350.98, 54
2, 12:07:00-000, 286, 128, 158, 128, 1352.48, 146, 1351.55, 63
2, 12:08:00-000, 690, 291, 399, 291, 1351.81, 301, 1350.00, 60
2, 12:09:00-000, 283, 109, 174, 109, 1352.02, 104, 1351.18, 69
2, 12:10:00-000, 642, 307, 335, 307, 1351.95, 276, 1350.99, 80
2, 12:11:00-000, 279, 100, 179, 100, 1352.04, 147, 1351.41, 43
2, 12:12:00-000, 640, 241, 399, 241, 1352.20, 323, 1350.71, 61
2, 12:13:00-000, 329, 161, 168, 161, 1352.93, 157, 1351.41, 45
2, 12:14:00-000, 600, 252, 348, 252, 1353.20, 262, 1351.41, 39
2, 12:15:00-000, 336, 133, 203, 133, 1351.66, 141, 1351.17, 46
2, 12:16:00-000, 606, 246, 360, 246, 1351.92, 314, 1351.10, 81
2, 12:17:00-000, 307, 166, 141, 166, 1353.65, 144, 1352.63, 28
2, 12:18:00-000, 647, 295, 352, 295, 1352.00, 267, 1351.10, 22
2, 12:19:00-000, 284, 127, 157, 127, 1351.86, 118, 1351.70, 76
2, 12:20:00-000, 596, 283, 313, 283, 1351.96, 161, 1349.92, 72
2, 12:21:00-000, 307, 164, 143, 164, 1352.25, 90, 1350.89, 107
2, 12:22:00-000, 708, 309, 399, 309, 1352.42, 224, 1350.32, 109
2, 12:23:00-000, 342, 141, 201, 141, 1351.88, 105, 1349.81, 129
2, 12:24:00-000, 571, 242, 329, 242, 1351.78, 234, 1351.08, 104
2, 12:25:00-000, 239, 81, 158, 81, 1351.75, 109, 1349.68, 86
2, 12:26:00-000, 602, 226, 376, 226, 1351.89, 294, 1350.45, 59
2, 12:27:00-000, 327, 103, 224, 103, 1352.59, 139, 1350.50, 84
2, 12:28:00-000, 686, 264, 422, 264, 1351.80, 288, 1351.07, 106
2, 12:29:00-000, 290, 111, 179, 111, 1351.22, 145, 1350.95, 102
2, 12:30:00-000, 597, 197, 400, 197, 1351.75, 236, 1350.87, 89
2, 12:31:00-000, 334, 139, 195, 139, 1351.98, 132, 1350.92, 107
2, 12:32:00-000, 556, 192, 364, 192, 1351.41, 211, 1350.97, 94
2, 12:33:00-000, 298, 129, 169, 129, 1352.12, 155, 1351.03, 94
2, 12:34:00-000, 643, 318, 325, 318, 1353.34, 257, 1351.50, 73
2, 12:35:00-000, 319, 156, 163, 156, 1353.51, 126, 1351.70, 49
2, 12:36:00-000, 677, 266, 411, 266, 1351.98, 268, 1351.13, 54
2, 12:37:00-000, 317, 151, 166, 151, 1352.83, 159, 1351.72, 98
2, 12:38:00-000, 583, 206, 377, 206, 1352.57, 249, 1351.51, 53
2, 12:39:00-000, 327, 148, 179, 148, 1353.01, 157, 1352.02, 91
2, 12:40:00-000, 591, 219, 372, 219, 1351.72, 278, 1351.21, 66
2, 12:41:00-000, 316, 125, 191, 125, 1352.47, 142, 1351.37, 61
2, 12:42:00-000, 560, 264, 296, 264, 1352.84, 247, 1351.79, 62
2, 12:43:00-000, 304, 144, 160, 144, 1353.07, 126, 1351.59, 37
2, 12:44:00-000, 615, 277, 338, 277, 1352.02, 278, 1351.48, 36
2, 12:45:00-000, 324, 165, 159, 165, 1352.95, 129, 1351.07, 59
2, 12:46:00-000, 634, 299, 335, 299, 1353.18, 277, 1351.54, 44
2, 12:47:00-000, 326, 142, 184, 142, 1351.97, 160, 1351.28, 43
2, 12:48:00-000, 603, 226, 377, 226, 1351.88, 270, 1350.95, 65
2, 12:49:00-000, 309, 142, 167, 142, 1352.83, 136, 1351.71, 55
2, 12:50:00-000, 566, 236, 330, 236, 1351.87, 207, 1350.69, 55
2, 12:51:00-000, 352, 152, 200, 152, 1351.47, 151, 1350.79, 88
2, 12:52:00-000, 635, 274, 361, 274, 1352.47, 279, 1351.05, 82
2, 12:53:00-000, 320, 127, 193, 127, 1352.23, 138, 1350.59, 54
2, 12:54:00-000, 649, 285, 364, 285, 1352.24, 252, 1351.55, 84
2, 12:55:00-000, 317, 149, 168, 149, 1352.18, 154, 1351.68, 71
2, 12:56:00-000, 665, 300, 365, 300, 1352.04, 300, 1351.01, 47
2, 12:57:00-000, 257, 120, 137, 120, 1352.71, 120, 1351.46, 64
2, 12:58:00-000, 617, 283, 334, 283, 1352.49, 274, 1351.13, 31
2, 12:59:00-000, 319, 121, 198, 121, 1351.83, 149, 1350.93, 45
2, 13:00:00-000, 582, 248, 334, 248, 1352.82, 276, 1352.14, 34
2, 13:01:00-000, 335, 156, 179, 156, 1352.40, 140, 1351.69, 57
2, 13:02:00-000, 615, 288, 327, 288, 1352.66, 255, 1351.40, 65
2, 13:03:00-000, 313, 124, 189, 124, 1353.26, 121, 1351.77, 48
2, 13:04:00-000, 712, 330, 382, 330, 1353.00, 306, 1351.43, 62
2, 13:05:00-000, 313, 124, 189, 124, 1352.09, 134, 1350.83, 90
2, 13:06:00-000, 619, 272, 347, 272, 1352.28, 256, 1351.61, 68
2, 13:07:00-000, 311, 130, 181, 130, 1352.83, 158, 1350.97, 70
2, 13:08:00-000, 565, 274, 291, 274, 1353.09, 237, 1351.49, 51
2, 13:09:00-000, 354, 140, 214, 140, 1352.40, 163, 1351.78, 29
2, 13:10:00-000, 608, 240, 368, 240, 1351.72, 276, 1351.31, 86
2, 13:11:00-000, 408, 159, 249, 159, 1352.70, 182, 1351.83, 56
2, 13:12:00-000, 621, 268, 353, 268, 1352.34, 269, 1351.15, 87
2, 13:13:00-000, 280, 88, 192, 88, 1351.02, 104, 1350.34, 79
2, 13:14:00-000, 577, 255, 322, 255, 1351.97, 226, 1351.02, 75
2, 13:15:00-000, 304, 144, 160, 144, 1352.09, 154, 1351.68, 73
2, 13:16:00-000, 659, 309, 350, 309, 1352.22, 291, 1351.49, 41
2, 13:17:00-000, 305, 151, 154, 151, 1352.52, 132, 1351.50, 52
2, 13:18:00-000, 576, 242, 334, 242, 1351.97, 258, 1350.82, 33
2, 13:19:00-000, 347, 160, 187, 160, 1352.50, 166, 1351.44, 44
2, 13:20:00-000, 614, 237, 377, 237, 1351.40, 261, 1350.74, 59
2, 13:21:00-000, 314, 146, 168, 146, 1352.41, 133, 1351.49, 76
2, 13:22:00-000, 555, 221, 334, 221, 1351.56, 253, 1351.16, 63
2, 13:23:00-000, 321, 178, 143, 178, 1353.28, 148, 1351.36, 52
2, 13:24:00-000, 694, 308, 386, 308, 1352.33, 286, 1351.50, 50
2, 13:25:00-000, 274, 124, 150, 124, 1352.39, 118, 1351.72, 71
2, 13:26:00-000, 644, 306, 338, 306, 1353.43, 279, 1351.83, 50
2, 13:27:00-000, 351, 159, 192, 159, 1354.16, 152, 1352.72, 26
2, 13:28:00-000, 564, 235, 329, 235, 1351.78, 253, 1350.87, 60
2, 13:29:00-000, 247, 115, 132, 115, 1352.64, 91, 1351.36, 62
2, 13:30:00-000, 641, 270, 371, 270, 1351.68, 255, 1350.30, 70
2, 13:31:00-000, 309, 164, 145, 164, 1352.68, 115, 1351.61, 70
2, 13:32:00-000, 643, 285, 358, 285, 1352.62, 320, 1351.74, 55
2, 13:33:00-000, 331, 156, 175, 156, 1352.36, 143, 1350.82, 47
2, 13:34:00-000, 585, 241, 344, 241, 1352.27, 264, 1351.63, 30
2, 13:35:00-000, 243, 83, 160, 83, 1352.38, 111, 1350.87, 75
2, 13:36:00-000, 579, 254, 325, 252, 1351.90, 234, 1350.34, 62
2, 13:37:00-000, 277, 102, 175, 104, 1351.56, 124, 1351.38, 61
2, 13:38:00-000, 635, 281, 354, 281, 1351.91, 277, 1351.04, 50
2, 13:39:00-000, 305, 116, 189, 116, 1351.60, 151, 1350.78, 86
2, 13:40:00-000, 633, 286, 347, 286, 1352.51, 295, 1351.57, 37
2, 13:41:00-000, 294, 117, 177, 117, 1353.05, 138, 1351.60, 57
2, 13:42:00-000, 636, 315, 321, 315, 1352.45, 267, 1351.50, 27
2, 13:43:00-000, 297, 149, 148, 149, 1352.45, 116, 1351.57, 71
2, 13:44:00-000, 617, 235, 382, 235, 1351.12, 237, 1350.30, 78
2, 13:45:00-000, 309, 141, 168, 141, 1352.65, 153, 1351.93, 80
2, 13:46:00-000, 629, 306, 323, 306, 1353.11, 266, 1351.57, 43
2, 13:47:00-000, 281, 122, 159, 122, 1351.78, 132, 1351.56, 55
2, 13:48:00-000, 529, 231, 298, 231, 1352.77, 242, 1350.92, 30
2, 13:49:00-000, 315, 140, 175, 138, 1351.64, 144, 1351.19, 35
2, 13:50:00-000, 589, 233, 356, 235, 1351.56, 286, 1350.59, 33
2, 13:51:00-000, 301, 129, 172, 129, 1351.84, 166, 1351.70, 45
2, 13:52:00-000, 624, 295, 329, 295, 1352.67, 279, 1351.49, 41
2, 13:53:00-000, 291, 104, 187, 104, 1351.68, 105, 1350.06, 43
2, 13:54:00-000, 562, 204, 358, 204, 1352.15, 236, 1350.98, 97
2, 13:55:00-000, 391, 196, 195, 196, 1351.73, 180, 1351.23, 82
2, 13:56:00-000, 696, 318, 378, 315, 1353.03, 322, 1352.35, 55
2, 13:57:00-000, 282, 136, 146, 139, 1351.62, 102, 1350.26, 55
2, 13:58:00-000, 625, 260, 365, 260, 1351.69, 271, 1350.94, 49
2, 13:59:00-000, 347, 169, 178, 169, 1352.52, 145, 1351.46, 75
2, 14:00:00-000, 589, 218, 371, 218, 1352.54, 276, 1351.14, 71
2, 14:01:00-000, 329, 148, 181, 148, 1352.67, 117, 1350.91, 48
2, 14:02:00-000, 698, 316, 382, 316, 1352.37, 315, 1351.63, 96
2, 14:03:00-000, 273, 115, 158, 115, 1352.47, 134, 1350.93, 46
2, 14:04:00-000, 642, 291, 351, 291, 1351.85, 262, 1351.26, 34
2, 14:05:00-000, 345, 150, 195, 150, 1352.88, 142, 1351.35, 70
2, 14:06:00-000, 639, 283, 356, 283, 1352.51, 278, 1351.71, 85
2, 14:07:00-000, 271, 109, 162, 109, 1351.50, 106, 1351.30, 52
2, 14:08:00-000, 612, 284, 328, 284, 1352.61, 254, 1350.76, 79
2, 14:09:00-000, 322, 147, 175, 147, 1352.08, 129, 1350.40, 62
2, 14:10:00-000, 646, 313, 333, 313, 1351.91, 261, 1350.88, 52
2, 14:11:00-000, 281, 117, 164, 117, 1352.34, 127, 1351.42, 59
2, 14:12:00-000, 526, 199, 327, 199, 1352.50, 227, 1350.70, 54
2, 14:13:00-000, 352, 130, 222, 130, 1351.88, 130, 1351.23, 61
2, 14:14:00-000, 688, 266, 422, 266, 1351.99, 328, 1351.01, 109
2, 14:15:00-000, 339, 135, 204, 135, 1352.32, 155, 1351.19, 100
2, 14:16:00-000, 718, 254, 464, 254, 1352.15, 341, 1350.92, 58
2, 14:17:00-000, 273, 115, 158, 115, 1350.36, 120, 1349.94, 112
2, 14:18:00-000, 623, 255, 368, 255, 1351.56, 263, 1350.93, 51
2, 14:19:00-000, 304, 200, 104, 200, 1353.55, 113, 1351.83, 58
2, 14:20:00-000, 641, 282, 359, 282, 1351.64, 272, 1350.97, 39
2, 14:21:00-000, 303, 116, 187, 116, 1351.87, 148, 1351.28, 70
2, 14:22:00-000, 694, 303, 391, 303, 1352.69, 300, 1350.74, 54
2, 14:23:00-000, 333, 163, 170, 163, 1351.99, 157, 1351.95, 54
2, 14:24:00-000, 598, 274, 324, 274, 1352.13, 210, 1350.99, 56
2, 14:25:00-000, 236, 129, 107, 129, 1353.44, 89, 1352.64, 80
2, 14:26:00-000, 547, 267, 280, 267, 1353.34, 243, 1352.08, 43
2, 14:27:00-000, 346, 159, 187, 159, 1353.40, 148, 1352.58, 29
2, 14:28:00-000, 612, 256, 356, 256, 1352.23, 295, 1352.01, 51
2, 14:29:00-000, 326, 117, 209, 117, 1351.41, 154, 1351.37, 54
2, 14:30:00-000, 543, 237, 306, 237, 1352.40, 261, 1350.69, 57
2, 14:31:00-000, 332, 115, 217, 115, 1352.48, 159, 1351.14, 48
2, 14:32:00-000, 593, 274, 319, 274, 1351.58, 216, 1350.36, 62
2, 14:33:00-000, 336, 164, 172, 164, 1352.84, 147, 1351.48, 60
2, 14:34:00-000, 650, 294, 356, 294, 1352.25, 291, 1350.97, 57
2, 14:35:00-000, 257, 108, 149, 108, 1352.37, 115, 1351.64, 51
2, 14:36:00-000, 620, 284, 336, 284, 1352.57, 257, 1350.38, 58
2, 14:37:00-000, 321, 134, 187, 134, 1351.56, 120, 1351.11, 70
2, 14:38:00-000, 620, 258, 362, 258, 1351.86, 258, 1351.03, 75
2, 14:39:00-000, 267, 99, 168, 99, 1351.33, 109, 1350.73, 91
2, 14:40:00-000, 624, 297, 327, 296, 1352.45, 289, 1351.04, 71
2, 14:41:00-000, 327, 128, 199, 129, 1352.25, 133, 1350.70, 37
2, 14:42:00-000, 608, 271, 337, 271, 1352.77, 241, 1351.78, 74
2, 14:43:00-000, 285, 134, 151, 134, 1352.98, 98, 1351.95, 77
2, 14:44:00-000, 637, 257, 380, 257, 1352.04, 263, 1350.75, 59
2, 14:45:00-000, 352, 108, 244, 108, 1350.72, 168, 1350.70, 96
2, 14:46:00-000, 525, 227, 298, 227, 1352.46, 237, 1351.31, 103
2, 14:47:00-000, 280, 110, 170, 110, 1351.23, 117, 1350.60, 55
2, 14:48:00-000, 684, 314, 370, 314, 1352.97, 330, 1351.81, 60
2, 14:49:00-000, 355, 169, 186, 169, 1353.11, 158, 1351.58, 21
2, 14:50:00-000, 583, 218, 365, 218, 1351.59, 288, 1350.67, 27
2, 14:51:00-000, 254, 105, 149, 105, 1351.63, 94, 1350.57, 83
2, 14:52:00-000, 683, 329, 354, 329, 1352.56, 309, 1351.64, 56
2, 14:53:00-000, 349, 150, 199, 150, 1351.58, 139, 1350.15, 54
2, 14:54:00-000, 519, 190, 329, 190, 1351.64, 212, 1351.01, 74
2, 14:55:00-000, 332, 151, 181, 151, 1351.36, 157, 1351.32, 85
2, 14:56:00-000, 693, 289, 404, 289, 1352.45, 292, 1350.85, 53
2, 14:57:00-000, 335, 171, 164, 171, 1353.38, 171, 1351.71, 63
2, 14:58:00-000, 639, 267, 372, 267, 1352.15, 295, 1350.83, 32
2, 14:59:00-000, 313, 149, 164, 149, 1352.67, 147, 1351.30, 53
2, 15:00:00-000, 608, 251, 357, 251, 1352.27, 277, 1351.47, 39
2, 15:01:00-000, 397, 156, 241, 156, 1351.71, 160, 1350.77, 81
2, 15:02:00-000, 632, 305, 327, 305, 1352.35, 284, 1351.67, 72
2, 15:03:00-000, 357, 132, 225, 132, 1352.89, 167, 1351.05, 45
2, 15:04:00-000, 593, 279, 314, 279, 1352.13, 261, 1351.09, 48
2, 15:05:00-000, 311, 139, 172, 139, 1352.41, 114, 1351.21, 64
2, 15:06:00-000, 568, 262, 306, 262, 1352.48, 242, 1351.51, 70
2, 15:07:00-000, 317, 140, 177, 140, 1352.68, 132, 1351.51, 46
2, 15:08:00-000, 734, 341, 393, 341, 1352.68, 332, 1351.42, 60
2, 15:09:00-000, 273, 113, 160, 113, 1352.17, 126, 1350.95, 38
2, 15:10:00-000, 663, 312, 351, 312, 1352.84, 260, 1351.87, 59
2, 15:11:00-000, 362, 166, 196, 166, 1352.87, 138, 1351.64, 57
2, 15:12:00-000, 650, 285, 365, 285, 1352.72, 288, 1351.42, 104
2, 15:13:00-000, 334, 140, 194, 140, 1351.86, 137, 1350.50, 59
2, 15:14:00-000, 635, 285, 350, 285, 1351.93, 274, 1350.89, 65
2, 15:15:00-000, 308, 121, 187, 121, 1352.78, 138, 1351.78, 62
2, 15:16:00-000, 611, 286, 325, 286, 1353.06, 258, 1352.06, 72
2, 15:17:00-000, 255, 106, 149, 106, 1352.87, 97, 1351.82, 40
2, 15:18:00-000, 691, 277, 414, 277, 1352.07, 320, 1351.52, 71
2, 15:19:00-000, 279, 119, 160, 119, 1351.86, 143, 1351.69, 63
2, 15:20:00-000, 599, 251, 348, 251, 1351.99, 254, 1351.38, 66
2, 15:21:00-000, 326, 132, 194, 132, 1352.59, 134, 1351.30, 48
2, 15:22:00-000, 558, 261, 297, 261, 1352.69, 256, 1351.56, 63
2, 15:23:00-000, 298, 106, 192, 106, 1352.54, 139, 1350.91, 61
2, 15:24:00-000, 631, 203, 428, 203, 1351.17, 256, 1350.27, 84
2, 15:25:00-000, 319, 175, 144, 175, 1352.95, 155, 1352.69, 81
2, 15:26:00-000, 641, 295, 346, 295, 1352.62, 281, 1351.55, 59
2, 15:27:00-000, 361, 149, 212, 149, 1352.60, 144, 1351.90, 55
2, 15:28:00-000, 646, 279, 367, 279, 1352.38, 292, 1351.27, 77
2, 15:29:00-000, 248, 105, 143, 105, 1351.87, 108, 1351.00, 44
2, 15:30:00-000, 603, 262, 341, 262, 1352.68, 272, 1351.24, 54
2, 15:31:00-000, 364, 158, 206, 158, 1352.46, 186, 1351.40, 56
2, 15:32:00-000, 638, 327, 311, 327, 1352.86, 264, 1351.55, 44
2, 15:33:00-000, 309, 138, 171, 138, 1351.22, 134, 1350.77, 28
2, 15:34:00-000, 653, 279, 374, 279, 1352.12, 302, 1351.65, 44
2, 15:35:00-000, 262, 133, 129, 133, 1352.98, 113, 1351.34, 59
2, 15:36:00-000, 653, 287, 366, 287, 1352.75, 277, 1351.76, 63
2, 15:37:00-000, 286, 104, 182, 104, 1351.44, 99, 1351.45, 55
2, 15:38:00-000, 589, 301, 288, 301, 1351.63, 230, 1351.52, 82
2, 15:39:00-000, 288, 115, 173, 115, 1352.85, 128, 1350.96, 50
2, 15:40:00-000, 652, 313, 339, 313, 1352.07, 168, 1350.42, 74
2, 15:41:00-000, 351, 149, 202, 149, 1351.97, 150, 1350.51, 114
2, 15:42:00-000, 568, 257, 311, 257, 1352.66, 184, 1350.61, 121
2, 15:43:00-000, 269, 112, 157, 112, 1351.19, 110, 1350.98, 86
2, 15:44:00-000, 597, 235, 362, 235, 1351.99, 271, 1351.19, 50
2, 15:45:00-000, 322, 107, 215, 107, 1351.23, 173, 1351.01, 84
2, 15:46:00-000, 602, 238, 364, 238, 1351.73, 275, 1350.15, 73
2, 15:47:00-000, 291, 110, 181, 110, 1352.69, 128, 1350.20, 61
2, 15:48:00-000, 550, 216, 334, 216, 1351.68, 193, 1350.63, 95
2, 15:49:00-000, 310, 129, 181, 129, 1352.38, 147, 1350.68, 73
2, 15:50:00-000, 602, 262, 340, 262, 1352.15, 236, 1350.80, 102
2, 15:51:00-000, 291, 101, 190, 101, 1351.55, 120, 1351.02, 73
2, 15:52:00-000, 662, 259, 403, 259, 1352.31, 307, 1351.09, 75
2, 15:53:00-000, 289, 125, 164, 125, 1352.19, 100, 1351.23, 87
2, 15:54:00-000, 622, 263, 359, 263, 1352.55, 254, 1351.25, 79
2, 15:55:00-000, 326, 136, 190, 136, 1351.22, 159, 1350.57, 63
2, 15:56:00-000, 677, 226, 451, 226, 1351.23, 271, 1350.75, 80
2, 15:57:00-000, 239, 100, 139, 100, 1352.12, 75, 1351.36, 143
2, 15:58:00-000, 598, 229, 369, 229, 1351.63, 270, 1350.24, 96
2, 15:59:00-000, 313, 124, 189, 124, 1352.52, 124, 1351.01, 69
2, 16:00:00-000, 606, 239, 367, 239, 1352.33, 278, 1351.41, 80
2, 16:01:00-000, 273, 122, 151, 122, 1352.75, 118, 1351.57, 77
2, 16:02:00-000, 681, 293, 388, 293, 1351.90, 289, 1350.86, 78
2, 16:03:00-000, 332, 110, 222, 110, 1351.53, 146, 1350.59, 71
2, 16:04:00-000, 539, 230, 309, 230, 1351.64, 261, 1351.29, 42
2, 16:05:00-000, 345, 169, 176, 169, 1351.92, 174, 1351.49, 51
2, 16:06:00-000, 689, 295, 394, 295, 1352.22, 293, 1350.69, 44
2, 16:07:00-000, 275, 108, 167, 108, 1352.74, 114, 1351.59, 71
2, 16:08:00-000, 660, 274, 386, 274, 1351.43, 271, 1351.01, 90
2, 16:09:00-000, 292, 142, 150, 142, 1352.19, 121, 1351.77, 77
2, 16:10:00-000, 621, 267, 354, 267, 1352.64, 269, 1351.37, 62
2, 16:11:00-000, 322, 160, 162, 160, 1353.14, 120, 1351.97, 61
2, 16:12:00-000, 572, 292, 280, 292, 1352.47, 211, 1351.37, 65
2, 16:13:00-000, 285, 145, 140, 145, 1352.47, 95, 1351.91, 42
2, 16:14:00-000, 613, 253, 360, 253, 1352.64, 300, 1351.00, 62
2, 16:15:00-000, 271, 120, 151, 120, 1352.46, 122, 1352.59, 45
2, 16:16:00-000, 668, 320, 348, 320, 1352.67, 280, 1351.40, 52
2, 16:17:00-000, 359, 152, 207, 152, 1353.43, 176, 1351.33, 35
2, 16:18:00-000, 563, 204, 359, 204, 1351.75, 270, 1350.47, 51
2, 16:19:00-000, 304, 124, 180, 124, 1351.55, 140, 1349.84, 56
2, 16:20:00-000, 570, 256, 314, 256, 1352.58, 233, 1351.79, 66
2, 16:21:00-000, 301, 174, 127, 174, 1353.07, 104, 1351.66, 70
2, 16:22:00-000, 586, 217, 369, 217, 1352.55, 279, 1351.65, 51
2, 16:23:00-000, 313, 148, 165, 148, 1353.07, 147, 1351.43, 56
2, 16:24:00-000, 590, 228, 362, 228, 1351.79, 276, 1350.97, 58
2, 16:25:00-000, 261, 129, 132, 129, 1353.77, 115, 1351.78, 50
2, 16:26:00-000, 658, 305, 353, 305, 1352.66, 305, 1351.75, 32
2, 16:27:00-000, 278, 99, 179, 99, 1352.39, 129, 1351.20, 28
2, 16:28:00-000, 677, 276, 401, 276, 1352.08, 349, 1351.22, 72
2, 16:29:00-000, 321, 144, 177, 144, 1352.56, 121, 1351.37, 46
3, 09:00:00-000, 170, 165, 5, 2, 1349.00, 2, 1349.00, 162
3, 09:01:00-000, 199, 199, 0, 0, 0.00, 0, 0.00, 199
3, 09:02:00-000, 190, 190, 0, 0, 0.00, 0, 0.00, 187
3, 09:03:00-000, 215, 215, 0, 0, 0.00, 0, 0.00, 213
3, 09:04:00-000, 199, 199, 0, 0, 0.00, 0, 0.00, 204
3, 09:05:00-000, 158, 158, 0, 0, 0.00, 0, 0.00, 162
3, 09:06:00-000, 190, 190, 0, 0, 0.00, 0, 0.00, 188
3, 09:07:00-000, 233, 233, 0, 0, 0.00, 0, 0.00, 230
3, 09:08:00-000, 192, 192, 0, 0, 0.00, 0, 0.00, 196
3, 09:09:00-000, 203, 203, 0, 0, 0.00, 0, 0.00, 194
3, 09:10:00-000, 197, 197, 0, 0, 0.00, 0, 0.00, 196
3, 09:11:00-000, 199, 199, 0, 1, 1457.00, 0, 0.00, 208
3, 09:12:00-000, 223, 223, 0, 0, 0.00, 0, 0.00, 220
3, 09:13:00-000, 188, 181, 7, 16, 1465.31, 7, 1355.14, 169
3, 09:14:00-000, 192, 192, 0, 0, 0.00, 0, 0.00, 190
3, 09:15:00-000, 175, 175, 0, 0, 0.00, 0, 0.00, 174
3, 09:16:00-000, 189, 182, 7, 8, 1361.25, 4, 1358.75, 175
3, 09:17:00-000, 165, 149, 16, 8, 1357.75, 6, 1359.17, 156
3, 09:18:00-000, 213, 198, 15, 12, 1360.58, 14, 1357.35, 184
3, 09:19:00-000, 193, 176, 17, 6, 1356.33, 4, 1354.00, 185
3, 09:20:00-000, 219, 213, 6, 3, 1350.67, 3, 1353.00, 213
3, 09:21:00-000, 177, 162, 15, 4, 1352.00, 3, 1352.33, 167
3, 09:22:00-000, 200, 200, 0, 0, 0.00, 0, 0.00, 196
3, 09:23:00-000, 196, 185, 11, 4, 1351.00, 0, 0.00, 191
3, 09:24:00-000, 199, 179, 20, 3, 1349.33, 5, 1351.60, 199
3, 09:25:00-000, 215, 186, 29, 21, 1352.05, 2, 1350.50, 187
3, 09:26:00-000, 232, 193, 39, 11, 1348.54, 18, 1355.05, 205
3, 09:27:00-000, 191, 156, 35, 2, 1349.50, 1, 1351.00, 190
3, 09:28:00-000, 170, 143, 27, 12, 1349.92, 4, 1351.25, 141
3, 09:29:00-000, 177, 135, 42, 5, 1350.20, 4, 1350.50, 176
3, 09:30:00-000, 177, 139, 38, 15, 1352.47, 16, 1355.00, 148
3, 09:31:00-000, 214, 184, 30, 2, 1350.50, 4, 1351.25, 209
3, 09:32:00-000, 182, 164, 18, 4, 1350.25, 6, 1352.83, 175
3, 09:33:00-000, 223, 185, 38, 7, 1348.57, 3, 1353.00, 210
3, 09:34:00-000, 206, 153, 53, 8, 1347.00, 4, 1352.25, 194
3, 09:35:00-000, 204, 134, 70, 12, 1349.00, 2, 1351.50, 191
3, 09:36:00-000, 193, 123, 70, 2, 1348.00, 4, 1350.75, 181
3, 09:37:00-000, 184, 128, 56, 7, 1350.14, 7, 1352.86, 176
3, 09:38:00-000, 200, 156, 44, 6, 1347.67, 5, 1351.20, 187
3, 09:39:00-000, 190, 142, 48, 3, 1351.00, 11, 1351.45, 177
3, 09:40:00-000, 217, 154, 63, 17, 1347.76, 5, 1351.40, 196
3, 09:41:00-000, 179, 109, 70, 4, 1349.00, 4, 1350.50, 172
3, 09:42:00-000, 213, 117, 96, 4, 1347.00, 11, 1350.00, 197
3, 09:43:00-000, 244, 161, 83, 11, 1352.18, 20, 1353.55, 215
3, 09:44:00-000, 192, 135, 57, 4, 1349.00, 2, 1350.00, 186
3, 09:45:00-000, 213, 197, 16, 0, 0.00, 7, 1351.43, 200
3, 09:46:00-000, 199, 173, 26, 9, 1351.22, 5, 1350.40, 189
3, 09:47:00-000, 193, 158, 35, 3, 1348.00, 3, 1350.00, 185
3, 09:48:00-000, 234, 162, 72, 7, 1348.00, 7, 1351.29, 209
3, 09:49:00-000, 174, 151, 23, 3, 1351.67, 6, 1353.50, 176
3, 09:50:00-000, 171, 168, 3, 1, 1352.00, 5, 1352.00, 163
3, 09:51:00-000, 206, 200, 6, 8, 1348.13, 1, 1351.00, 184
3, 09:52:00-000, 208, 157, 51, 20, 1350.55, 2, 1351.50, 195
3, 09:53:00-000, 244, 196, 48, 4, 1347.25, 19, 1351.68, 221
3, 09:54:00-000, 204, 150, 54, 17, 1350.88, 2, 1350.00, 194
3, 09:55:00-000, 210, 116, 94, 5, 1348.60, 3, 1349.33, 194
3, 09:56:00-000, 180, 98, 82, 7, 1348.43, 5, 1350.40, 177
3, 09:57:00-000, 212, 125, 87, 2, 1350.50, 21, 1351.24, 189
3, 09:58:00-000, 197, 180, 17, 2, 1347.00, 8, 1352.25, 180
3, 09:59:00-000, 221, 178, 43, 14, 1348.50, 9, 1351.33, 197
3, 10:00:00-000, 183, 138, 45, 3, 1349.67, 15, 1351.80, 169
3, 10:01:00-000, 186, 158, 28, 10, 1347.20, 4, 1352.50, 169
3, 10:02:00-000, 199, 156, 43, 4, 1347.00, 3, 1351.00, 188
3, 10:03:00-000, 200, 161, 39, 0, 0.00, 6, 1350.17, 203
3, 10:04:00-000, 169, 150, 19, 13, 1351.15, 5, 1353.00, 150
3, 10:05:00-000, 176, 136, 40, 5, 1348.60, 4, 1352.75, 162
3, 10:06:00-000, 225, 166, 59, 11, 1348.82, 8, 1351.12, 213
3, 10:07:00-000, 178, 127, 51, 4, 1349.25, 4, 1350.00, 170
3, 10:08:00-000, 219, 158, 61, 2, 1348.50, 8, 1350.62, 202
3, 10:09:00-000, 216, 173, 43, 7, 1348.00, 10, 1350.30, 205
3, 10:10:00-000, 210, 164, 46, 13, 1346.15, 2, 1350.50, 194
3, 10:11:00-000, 203, 101, 102, 7, 1348.86, 2, 1350.00, 190
3, 10:12:00-000, 212, 161, 51, 12, 1350.00, 32, 1351.81, 164
3, 10:13:00-000, 168, 161, 7, 3, 1350.33, 6, 1352.83, 163
3, 10:14:00-000, 205, 175, 30, 14, 1351.28, 8, 1352.12, 185
3, 10:15:00-000, 216, 205, 11, 3, 1353.00, 6, 1351.67, 207
3, 10:16:00-000, 183, 151, 32, 10, 1348.40, 4, 1350.75, 171
3, 10:17:00-000, 187, 171, 16, 4, 1348.75, 6, 1351.17, 180
3, 10:18:00-000, 211, 185, 26, 7, 1349.14, 5, 1350.00, 195
3, 10:19:00-000, 225, 178, 47, 6, 1349.33, 12, 1350.67, 207
3, 10:20:00-000, 221, 179, 42, 18, 1349.50, 11, 1350.64, 197
3, 10:21:00-000, 214, 165, 49, 3, 1349.33, 2, 1351.50, 200
3, 10:22:00-000, 196, 139, 57, 22, 1348.00, 10, 1351.00, 173
3, 10:23:00-000, 215, 105, 110, 16, 1348.56, 1, 1353.00, 189
3, 10:24:00-000, 229, 104, 125, 6, 1348.67, 37, 1351.10, 185
3, 10:25:00-000, 221, 156, 65, 7, 1346.00, 2, 1350.50, 216
3, 10:26:00-000, 193, 128, 65, 14, 1346.28, 7, 1352.00, 172
3, 10:27:00-000, 200, 123, 77, 4, 1346.75, 12, 1351.25, 189
3, 10:28:00-000, 191, 164, 27, 3, 1350.67, 6, 1350.67, 183
3, 10:29:00-000, 190, 169, 21, 11, 1348.27, 11, 1350.73, 161
3, 10:30:00-000, 179, 157, 22, 7, 1348.71, 1, 1351.00, 174
3, 10:31:00-000, 252, 176, 76, 8, 1352.75, 12, 1352.58, 230
3, 10:32:00-000, 202, 129, 73, 21, 1349.28, 23, 1352.65, 150
3, 10:33:00-000, 206, 184, 22, 0, 0.00, 9, 1351.22, 207
3, 10:34:00-000, 157, 126, 31, 12, 1348.16, 5, 1351.20, 139
3, 10:35:00-000, 201, 165, 36, 10, 1350.80, 14, 1352.07, 179
3, 10:36:00-000, 195, 181, 14, 5, 1350.80, 2, 1352.00, 191
3, 10:37:00-000, 191, 171, 20, 2, 1350.50, 3, 1353.67, 183
3, 10:38:00-000, 173, 139, 34, 6, 1350.17, 2, 1350.00, 166
3, 10:39:00-000, 224, 192, 32, 3, 1351.00, 5, 1352.40, 207
3, 10:40:00-000, 202, 177, 25, 19, 1347.94, 7, 1350.71, 183
3, 10:41:00-000, 207, 150, 57, 16, 1347.50, 8, 1350.62, 184
3, 10:42:00-000, 180, 120, 60, 11, 1347.09, 12, 1351.17, 158
3, 10:43:00-000, 186, 136, 50, 1, 1352.00, 12, 1351.92, 174
3, 10:44:00-000, 227, 148, 79, 10, 1347.10, 3, 1351.00, 207
3, 10:45:00-000, 198, 171, 27, 0, 0.00, 11, 1352.54, 182
3, 10:46:00-000, 177, 162, 15, 8, 1351.12, 13, 1353.77, 161
3, 10:47:00-000, 211, 199, 12, 2, 1352.50, 5, 1353.00, 206
3, 10:48:00-000, 199, 173, 26, 10, 1347.80, 2, 1350.50, 187
3, 10:49:00-000, 187, 141, 46, 9, 1351.11, 6, 1352.00, 170
3, 10:50:00-000, 185, 128, 57, 11, 1347.45, 3, 1351.33, 179
3, 10:51:00-000, 183, 133, 50, 5, 1348.40, 10, 1351.40, 160
3, 10:52:00-000, 180, 138, 42, 20, 1347.45, 18, 1351.28, 144
3, 10:53:00-000, 185, 150, 35, 7, 1349.71, 17, 1351.06, 161
3, 10:54:00-000, 207, 149, 58, 18, 1349.78, 11, 1351.09, 173
3, 10:55:00-000, 190, 127, 63, 11, 1347.00, 3, 1350.00, 183
3, 10:56:00-000, 227, 194, 33, 11, 1347.91, 12, 1351.08, 204
3, 10:57:00-000, 222, 188, 34, 19, 1348.58, 7, 1351.43, 192
3, 10:58:00-000, 191, 98, 93, 9, 1348.55, 10, 1350.00, 174
3, 10:59:00-000, 189, 122, 67, 4, 1350.50, 12, 1353.08, 168
3, 11:00:00-000, 192, 136, 56, 11, 1348.27, 4, 1350.75, 188
3, 11:01:00-000, 178, 120, 58, 4, 1348.00, 15, 1351.40, 159
3, 11:02:00-000, 211, 156, 55, 8, 1350.37, 6, 1351.67, 188
3, 11:03:00-000, 198, 112, 86, 11, 1349.45, 7, 1351.71, 187
3, 11:04:00-000, 208, 121, 87, 6, 1347.50, 11, 1351.00, 182
3, 11:05:00-000, 182, 105, 77, 10, 1348.80, 11, 1350.27, 163
3, 11:06:00-000, 221, 153, 68, 17, 1350.53, 26, 1352.84, 177
3, 11:07:00-000, 198, 144, 54, 3, 1351.00, 8, 1351.50, 194
3, 11:08:00-000, 193, 169, 24, 5, 1350.00, 9, 1349.78, 180
3, 11:09:00-000, 214, 175, 39, 12, 1347.50, 3, 1350.00, 201
3, 11:10:00-000, 256, 180, 76, 23, 1347.87, 9, 1350.33, 218
3, 11:11:00-000, 235, 151, 84, 1, 1346.00, 10, 1350.50, 223
3, 11:12:00-000, 177, 134, 43, 7, 1347.00, 10, 1351.80, 161
3, 11:13:00-000, 191, 150, 41, 15, 1347.67, 17, 1350.59, 163
3, 11:14:00-000, 218, 158, 60, 13, 1347.69, 10, 1351.70, 192
3, 11:15:00-000, 194, 134, 60, 5, 1347.80, 8, 1351.12, 184
3, 11:16:00-000, 193, 127, 66, 6, 1350.83, 11, 1351.54, 178
3, 11:17:00-000, 215, 176, 39, 13, 1346.69, 5, 1350.20, 195
3, 11:18:00-000, 200, 161, 39, 3, 1349.00, 4, 1350.75, 192
3, 11:19:00-000, 209, 164, 45, 1, 1351.00, 3, 1352.00, 205
3, 11:20:00-000, 195, 159, 36, 6, 1348.00, 10, 1352.20, 163
3, 11:21:00-000, 194, 169, 25, 17, 1351.82, 9, 1351.22, 184
3, 11:22:00-000, 189, 163, 26, 3, 1349.33, 7, 1352.71, 174
3, 11:23:00-000, 195, 165, 30, 5, 1348.40, 0, 0.00, 195
3, 11:24:00-000, 210, 160, 50, 12, 1348.83, 12, 1351.50, 184
3, 11:25:00-000, 175, 103, 72, 12, 1347.58, 2, 1352.00, 158
3, 11:26:00-000, 177, 76, 101, 5, 1347.80, 13, 1350.23, 163
3, 11:27:00-000, 215, 110, 105, 11, 1348.18, 3, 1348.67, 204
3, 11:28:00-000, 209, 126, 83, 4, 1348.00, 16, 1351.31, 183
3, 11:29:00-000, 211, 153, 58, 10, 1346.80, 6, 1351.50, 194
3, 11:30:00-000, 202, 111, 91, 22, 1348.41, 17, 1350.64, 158
3, 11:31:00-000, 201, 143, 58, 3, 1346.33, 3, 1350.33, 208
3, 11:32:00-000, 244, 194, 50, 3, 1347.67, 8, 1351.50, 221
3, 11:33:00-000, 208, 201, 7, 6, 1350.00, 5, 1353.40, 206
3, 11:34:00-000, 229, 162, 67, 15, 1349.66, 9, 1351.78, 197
3, 11:35:00-000, 197, 140, 57, 12, 1349.00, 6, 1350.50, 169
3, 11:36:00-000, 191, 111, 80, 15, 1347.93, 22, 1351.41, 173
3, 11:37:00-000, 222, 161, 61, 12, 1350.66, 14, 1351.36, 197
3, 11:38:00-000, 210, 160, 50, 13, 1349.77, 29, 1352.34, 161
3, 11:39:00-000, 204, 188, 16, 6, 1348.00, 0, 0.00, 199
3, 11:40:00-000, 201, 153, 48, 11, 1347.91, 5, 1350.60, 187
3, 11:41:00-000, 226, 178, 48, 7, 1351.00, 20, 1353.00, 202
3, 11:42:00-000, 150, 123, 27, 4, 1347.75, 3, 1352.33, 143
3, 11:43:00-000, 234, 200, 34, 1, 1345.00, 2, 1351.00, 225
3, 11:44:00-000, 174, 150, 24, 11, 1349.73, 5, 1352.00, 160
3, 11:45:00-000, 216, 180, 36, 8, 1350.00, 0, 0.00, 212
3, 11:46:00-000, 216, 130, 86, 12, 1347.33, 15, 1350.40, 181
3, 11:47:00-000, 214, 178, 36, 0, 0.00, 7, 1352.57, 216
3, 11:48:00-000, 193, 135, 58, 19, 1347.89, 10, 1350.80, 158
3, 11:49:00-000, 193, 131, 62, 9, 1348.89, 7, 1351.29, 181
3, 11:50:00-000, 209, 126, 83, 13, 1347.92, 13, 1350.77, 183
3, 11:51:00-000, 193, 161, 32, 3, 1350.33, 12, 1352.08, 179
3, 11:52:00-000, 211, 179, 32, 8, 1348.12, 4, 1349.25, 195
3, 11:53:00-000, 204, 177, 27, 7, 1348.00, 15, 1351.53, 183
3, 11:54:00-000, 203, 186, 17, 7, 1347.00, 2, 1350.00, 197
3, 11:55:00-000, 203, 157, 46, 11, 1347.09, 2, 1350.00, 190
3, 11:56:00-000, 196, 108, 88, 14, 1347.07, 9, 1350.33, 170
3, 11:57:00-000, 206, 161, 45, 0, 0.00, 9, 1350.22, 193
3, 11:58:00-000, 239, 200, 39, 19, 1349.00, 23, 1351.21, 201
3, 11:59:00-000, 189, 171, 18, 2, 1351.00, 5, 1354.00, 184
3, 12:00:00-000, 168, 132, 36, 8, 1348.25, 6, 1350.17, 148
3, 12:01:00-000, 219, 173, 46, 13, 1347.31, 14, 1350.86, 199
3, 12:02:00-000, 181, 142, 39, 9, 1350.44, 4, 1351.25, 167
3, 12:03:00-000, 183, 161, 22, 5, 1346.80, 3, 1350.67, 177
3, 12:04:00-000, 230, 190, 40, 28, 1347.43, 9, 1351.11, 193
3, 12:05:00-000, 175, 111, 64, 1, 1347.00, 13, 1350.61, 155
3, 12:06:00-000, 197, 118, 79, 15, 1348.66, 18, 1351.61, 170
3, 12:07:00-000, 162, 97, 65, 5, 1347.00, 6, 1351.67, 150
3, 12:08:00-000, 227, 156, 71, 4, 1346.75, 11, 1351.09, 208
3, 12:09:00-000, 222, 164, 58, 6, 1349.67, 20, 1351.30, 176
3, 12:10:00-000, 187, 169, 18, 16, 1348.81, 9, 1352.44, 186
3, 12:11:00-000, 225, 190, 35, 17, 1349.41, 6, 1351.83, 200
3, 12:12:00-000, 195, 148, 47, 4, 1349.00, 10, 1350.50, 178
3, 12:13:00-000, 202, 160, 42, 2, 1347.00, 10, 1350.30, 186
3, 12:14:00-000, 176, 125, 51, 9, 1348.33, 5, 1352.00, 172
3, 12:15:00-000, 180, 155, 25, 12, 1349.25, 4, 1351.00, 159
3, 12:16:00-000, 182, 126, 56, 12, 1347.83, 10, 1349.90, 161
3, 12:17:00-000, 208, 143, 65, 2, 1351.00, 17, 1351.76, 193
3, 12:18:00-000, 190, 162, 28, 29, 1347.45, 14, 1351.71, 146
3, 12:19:00-000, 214, 171, 43, 0, 0.00, 12, 1352.75, 198
3, 12:20:00-000, 177, 126, 51, 10, 1348.60, 3, 1352.00, 158
3, 12:21:00-000, 216, 156, 60, 0, 0.00, 7, 1351.00, 218
3, 12:22:00-000, 210, 185, 25, 11, 1349.00, 10, 1350.30, 181
3, 12:23:00-000, 186, 166, 20, 5, 1350.20, 5, 1351.80, 176
3, 12:24:00-000, 198, 161, 37, 5, 1348.80, 5, 1350.40, 193
3, 12:25:00-000, 242, 195, 47, 10, 1349.80, 1, 1351.00, 219
3, 12:26:00-000, 187, 141, 46, 8, 1348.13, 8, 1352.00, 187
3, 12:27:00-000, 229, 206, 23, 8, 1349.12, 9, 1351.67, 208
3, 12:28:00-000, 201, 183, 18, 7, 1349.00, 5, 1350.40, 195
3, 12:29:00-000, 257, 210, 47, 11, 1348.54, 8, 1351.75, 237
3, 12:30:00-000, 185, 131, 54, 10, 1347.00, 22, 1350.54, 152
3, 12:31:00-000, 229, 164, 65, 14, 1349.07, 10, 1350.70, 206
3, 12:32:00-000, 211, 169, 42, 8, 1346.25, 10, 1350.70, 187
3, 12:33:00-000, 208, 187, 21, 2, 1352.00, 4, 1350.75, 208
3, 12:34:00-000, 194, 165, 29, 11, 1348.45, 5, 1352.80, 175
3, 12:35:00-000, 232, 196, 36, 7, 1350.14, 13, 1351.23, 210
3, 12:36:00-000, 180, 137, 43, 17, 1349.76, 9, 1350.00, 155
3, 12:37:00-000, 199, 137, 62, 11, 1348.54, 14, 1350.71, 174
3, 12:38:00-000, 217, 117, 100, 9, 1346.67, 11, 1350.09, 199
3, 12:39:00-000, 214, 168, 46, 10, 1349.10, 10, 1351.20, 197
3, 12:40:00-000, 209, 205, 4, 2, 1348.00, 4, 1351.50, 198
3, 12:41:00-000, 203, 155, 48, 12, 1349.91, 2, 1350.00, 182
3, 12:42:00-000, 186, 131, 55, 9, 1349.44, 13, 1352.46, 174
3, 12:43:00-000, 226, 166, 60, 7, 1348.00, 10, 1350.40, 207
3, 12:44:00-000, 161, 120, 41, 15, 1349.13, 5, 1350.80, 142
3, 12:45:00-000, 233, 167, 66, 3, 1347.00, 5, 1350.60, 224
3, 12:46:00-000, 182, 111, 71, 6, 1348.00, 9, 1351.11, 167
3, 12:47:00-000, 217, 149, 68, 2, 1346.00, 5, 1349.80, 212
3, 12:48:00-000, 209, 180, 29, 3, 1347.00, 6, 1351.50, 196
3, 12:49:00-000, 212, 168, 44, 13, 1348.46, 1, 1351.00, 201
3, 12:50:00-000, 179, 103, 76, 14, 1348.14, 12, 1351.42, 150
3, 12:51:00-000, 187, 102, 85, 1, 1352.00, 11, 1350.54, 175
3, 12:52:00-000, 198, 175, 23, 5, 1348.80, 6, 1351.83, 185
3, 12:53:00-000, 156, 142, 14, 2, 1346.50, 9, 1350.67, 153
3, 12:54:00-000, 213, 167, 46, 11, 1348.36, 8, 1351.75, 181
3, 12:55:00-000, 225, 155, 70, 16, 1349.87, 12, 1350.58, 207
3, 12:56:00-000, 171, 137, 34, 9, 1348.67, 12, 1351.00, 146
3, 12:57:00-000, 226, 148, 78, 14, 1348.93, 17, 1351.06, 195
3, 12:58:00-000, 192, 169, 23, 6, 1350.50, 11, 1353.09, 180
3, 12:59:00-000, 182, 142, 40, 13, 1348.54, 0, 0.00, 166
3, 13:00:00-000, 180, 133, 47, 11, 1347.18, 16, 1351.12, 158
3, 13:01:00-000, 183, 134, 49, 22, 1350.41, 6, 1351.83, 146
3, 13:02:00-000, 198, 157, 41, 17, 1348.76, 7, 1350.71, 176
3, 13:03:00-000, 198, 109, 89, 7, 1348.43, 7, 1351.29, 190
3, 13:04:00-000, 223, 119, 104, 5, 1350.00, 19, 1352.36, 196
3, 13:05:00-000, 238, 157, 81, 8, 1347.12, 14, 1351.07, 214
3, 13:06:00-000, 175, 129, 46, 13, 1350.46, 7, 1351.86, 152
3, 13:07:00-000, 189, 126, 63, 7, 1348.86, 14, 1352.57, 165
3, 13:08:00-000, 203, 160, 43, 14, 1348.78, 6, 1351.17, 192
3, 13:09:00-000, 193, 126, 67, 5, 1348.80, 15, 1351.93, 173
3, 13:10:00-000, 199, 168, 31, 11, 1349.09, 10, 1351.40, 180
3, 13:11:00-000, 203, 171, 32, 12, 1349.33, 4, 1351.00, 185
3, 13:12:00-000, 212, 164, 48, 19, 1348.37, 20, 1351.85, 164
3, 13:13:00-000, 204, 148, 56, 10, 1347.70, 15, 1350.53, 178
3, 13:14:00-000, 241, 184, 57, 30, 1348.50, 21, 1350.62, 194
3, 13:15:00-000, 240, 159, 81, 1, 1347.00, 9, 1351.44, 236
3, 13:16:00-000, 198, 113, 85, 9, 1346.00, 17, 1351.65, 172
3, 13:17:00-000, 213, 172, 41, 10, 1350.70, 4, 1353.25, 199
3, 13:18:00-000, 181, 110, 71, 10, 1348.90, 17, 1351.94, 153
3, 13:19:00-000, 166, 122, 44, 13, 1349.92, 16, 1351.87, 137
3, 13:20:00-000, 174, 129, 45, 11, 1349.18, 3, 1352.00, 163
3, 13:21:00-000, 180, 134, 46, 12, 1350.33, 18, 1351.16, 148
3, 13:22:00-000, 201, 159, 42, 13, 1348.08, 11, 1350.73, 170
3, 13:23:00-000, 207, 179, 28, 5, 1349.60, 7, 1350.57, 191
3, 13:24:00-000, 213, 160, 53, 8, 1350.75, 9, 1354.00, 207
3, 13:25:00-000, 190, 165, 25, 11, 1349.45, 13, 1351.15, 159
3, 13:26:00-000, 203, 192, 11, 17, 1352.12, 3, 1351.00, 186
3, 13:27:00-000, 205, 146, 59, 12, 1350.58, 8, 1352.00, 188
3, 13:28:00-000, 178, 114, 64, 5, 1350.20, 10, 1349.70, 167
3, 13:29:00-000, 223, 142, 81, 10, 1348.50, 15, 1351.00, 193
3, 13:30:00-000, 218, 190, 28, 6, 1347.50, 12, 1351.50, 202
3, 13:31:00-000, 201, 198, 3, 0, 0.00, 2, 1352.00, 200
3, 13:32:00-000, 192, 172, 20, 13, 1348.23, 3, 1350.00, 171
3, 13:33:00-000, 223, 165, 58, 16, 1349.43, 9, 1353.66, 205
3, 13:34:00-000, 222, 175, 47, 9, 1347.11, 14, 1350.28, 199
3, 13:35:00-000, 225, 169, 56, 3, 1349.67, 3, 1350.00, 210
3, 13:36:00-000, 220, 140, 80, 10, 1348.20, 18, 1350.78, 185
3, 13:37:00-000, 205, 144, 61, 8, 1348.25, 3, 1350.67, 205
3, 13:38:00-000, 183, 140, 43, 10, 1346.90, 7, 1351.00, 171
3, 13:39:00-000, 185, 150, 35, 4, 1349.75, 16, 1350.56, 163
3, 13:40:00-000, 215, 201, 14, 23, 1350.35, 0, 0.00, 181
3, 13:41:00-000, 203, 135, 68, 14, 1348.43, 14, 1350.93, 187
3, 13:42:00-000, 217, 96, 121, 17, 1346.82, 14, 1351.78, 187
3, 13:43:00-000, 229, 139, 90, 0, 0.00, 27, 1351.11, 202
3, 13:44:00-000, 223, 154, 69, 13, 1347.77, 0, 0.00, 207
3, 13:45:00-000, 204, 144, 60, 6, 1348.50, 18, 1351.61, 176
3, 13:46:00-000, 203, 166, 37, 22, 1349.59, 8, 1352.88, 178
3, 13:47:00-000, 208, 150, 58, 10, 1347.50, 13, 1351.77, 168
3, 13:48:00-000, 230, 151, 79, 4, 1348.25, 17, 1351.06, 222
3, 13:49:00-000, 190, 156, 34, 4, 1350.25, 8, 1351.25, 181
3, 13:50:00-000, 214, 181, 33, 7, 1348.00, 5, 1352.80, 202
3, 13:51:00-000, 161, 128, 33, 16, 1348.69, 9, 1352.00, 139
3, 13:52:00-000, 158, 81, 77, 16, 1349.00, 15, 1350.86, 116
3, 13:53:00-000, 201, 120, 81, 15, 1348.00, 13, 1350.46, 174
3, 13:54:00-000, 201, 133, 68, 15, 1348.00, 8, 1351.12, 188
3, 13:55:00-000, 216, 133, 83, 5, 1353.20, 15, 1351.93, 184
3, 13:56:00-000, 185, 155, 30, 17, 1348.82, 19, 1353.52, 147
3, 13:57:00-000, 202, 162, 40, 15, 1349.00, 3, 1351.00, 190
3, 13:58:00-000, 187, 153, 34, 17, 1345.88, 12, 1352.25, 158
3, 13:59:00-000, 190, 119, 71, 2, 1345.50, 5, 1352.60, 189
3, 14:00:00-000, 195, 132, 63, 14, 1349.86, 12, 1351.58, 168
3, 14:01:00-000, 190, 96, 94, 3, 1348.00, 8, 1349.25, 177
3, 14:02:00-000, 192, 157, 35, 10, 1350.00, 15, 1352.26, 168
3, 14:03:00-000, 187, 149, 38, 10, 1349.70, 1, 1350.00, 177
3, 14:04:00-000, 183, 135, 48, 10, 1348.40, 15, 1352.20, 146
3, 14:05:00-000, 195, 123, 72, 5, 1348.60, 14, 1351.07, 189
3, 14:06:00-000, 229, 146, 83, 20, 1348.70, 7, 1351.14, 200
3, 14:07:00-000, 216, 130, 86, 6, 1346.67, 17, 1351.12, 195
3, 14:08:00-000, 192, 133, 59, 12, 1348.25, 15, 1352.46, 163
3, 14:09:00-000, 214, 184, 30, 5, 1349.20, 2, 1355.00, 203
3, 14:10:00-000, 201, 182, 19, 6, 1348.83, 9, 1351.55, 184
3, 14:11:00-000, 191, 171, 20, 4, 1347.00, 1, 1349.00, 188
3, 14:12:00-000, 231, 188, 43, 26, 1348.54, 15, 1351.93, 192
3, 14:13:00-000, 230, 179, 51, 7, 1348.29, 14, 1350.78, 214
3, 14:14:00-000, 239, 152, 87, 24, 1348.54, 15, 1351.00, 199
3, 14:15:00-000, 194, 120, 74, 8, 1350.87, 19, 1351.73, 168
3, 14:16:00-000, 216, 142, 74, 24, 1347.21, 8, 1350.00, 178
3, 14:17:00-000, 222, 147, 75, 14, 1346.21, 20, 1350.20, 187
3, 14:18:00-000, 226, 109, 117, 23, 1347.08, 17, 1351.00, 183
3, 14:19:00-000, 204, 154, 50, 3, 1347.00, 7, 1355.14, 197
3, 14:20:00-000, 180, 141, 39, 11, 1347.45, 18, 1351.39, 154
3, 14:21:00-000, 208, 146, 62, 31, 1349.00, 26, 1351.00, 149
3, 14:22:00-000, 225, 145, 80, 16, 1348.75, 7, 1351.14, 206
3, 14:23:00-000, 218, 119, 99, 9, 1348.55, 7, 1351.29, 203
3, 14:24:00-000, 197, 113, 84, 14, 1348.57, 11, 1351.82, 157
3, 14:25:00-000, 181, 109, 72, 1, 1346.00, 13, 1350.69, 184
3, 14:26:00-000, 217, 181, 36, 10, 1349.10, 11, 1351.82, 189
3, 14:27:00-000, 189, 154, 35, 10, 1349.60, 11, 1352.27, 165
3, 14:28:00-000, 211, 165, 46, 10, 1351.50, 8, 1351.37, 193
3, 14:29:00-000, 181, 129, 52, 13, 1349.08, 20, 1352.15, 152
3, 14:30:00-000, 199, 163, 36, 16, 1348.31, 14, 1350.50, 175
3, 14:31:00-000, 183, 152, 31, 4, 1350.50, 6, 1350.67, 167
3, 14:32:00-000, 231, 178, 53, 7, 1348.43, 2, 1350.00, 226
3, 14:33:00-000, 182, 128, 54, 7, 1348.71, 10, 1350.40, 163
3, 14:34:00-000, 239, 197, 42, 6, 1347.33, 9, 1351.33, 227
3, 14:35:00-000, 215, 169, 46, 24, 1349.50, 16, 1351.31, 174
3, 14:36:00-000, 196, 107, 89, 16, 1346.81, 11, 1350.45, 170
3, 14:37:00-000, 192, 114, 78, 13, 1350.31, 17, 1350.53, 163
3, 14:38:00-000, 191, 102, 89, 9, 1347.11, 14, 1350.71, 160
3, 14:39:00-000, 189, 142, 47, 9, 1348.67, 16, 1351.93, 163
3, 14:40:00-000, 205, 174, 31, 10, 1349.10, 5, 1352.80, 191
3, 14:41:00-000, 200, 169, 31, 2, 1352.00, 10, 1351.60, 194
3, 14:42:00-000, 216, 201, 15, 8, 1347.50, 4, 1349.00, 204
3, 14:43:00-000, 223, 191, 32, 6, 1347.50, 13, 1350.84, 205
3, 14:44:00-000, 203, 153, 50, 11, 1346.91, 5, 1349.60, 187
3, 14:45:00-000, 192, 135, 57, 17, 1350.41, 10, 1350.50, 160
3, 14:46:00-000, 218, 165, 53, 13, 1348.77, 11, 1350.45, 197
3, 14:47:00-000, 171, 139, 32, 4, 1350.25, 6, 1351.33, 161
3, 14:48:00-000, 221, 186, 35, 15, 1350.20, 17, 1354.00, 183
3, 14:49:00-000, 157, 113, 44, 6, 1348.33, 6, 1350.50, 151
3, 14:50:00-000, 206, 175, 31, 13, 1347.46, 3, 1351.67, 188
3, 14:51:00-000, 176, 110, 66, 12, 1348.41, 6, 1351.83, 160
3, 14:52:00-000, 187, 110, 77, 5, 1348.00, 12, 1351.08, 157
3, 14:53:00-000, 222, 156, 66, 11, 1348.91, 15, 1350.60, 207
3, 14:54:00-000, 240, 176, 64, 10, 1348.00, 12, 1350.75, 221
3, 14:55:00-000, 187, 123, 64, 6, 1348.67, 11, 1350.00, 167
3, 14:56:00-000, 221, 156, 65, 13, 1348.08, 22, 1350.54, 184
3, 14:57:00-000, 208, 165, 43, 13, 1349.69, 7, 1351.43, 188
3, 14:58:00-000, 212, 180, 32, 6, 1349.50, 9, 1350.44, 201
3, 14:59:00-000, 219, 209, 10, 2, 1348.00, 5, 1350.20, 206
3, 15:00:00-000, 219, 168, 51, 15, 1347.53, 3, 1351.33, 202
3, 15:01:00-000, 201, 135, 66, 22, 1349.82, 17, 1351.41, 166
3, 15:02:00-000, 200, 128, 72, 15, 1348.27, 5, 1350.80, 177
3, 15:03:00-000, 210, 113, 97, 7, 1348.86, 14, 1352.14, 191
3, 15:04:00-000, 204, 127, 77, 8, 1348.75, 19, 1350.95, 169
3, 15:05:00-000, 196, 143, 53, 19, 1348.89, 10, 1350.70, 177
3, 15:06:00-000, 183, 139, 44, 16, 1347.37, 18, 1351.94, 152
3, 15:07:00-000, 224, 144, 80, 13, 1350.00, 8, 1352.12, 200
3, 15:08:00-000, 187, 108, 79, 22, 1348.18, 23, 1351.00, 135
3, 15:09:00-000, 196, 112, 84, 7, 1347.71, 9, 1350.11, 182
3, 15:10:00-000, 210, 137, 73, 7, 1347.71, 12, 1352.00, 192
3, 15:11:00-000, 185, 145, 40, 2, 1346.50, 6, 1351.67, 175
3, 15:12:00-000, 188, 105, 83, 21, 1348.09, 11, 1350.91, 163
3, 15:13:00-000, 204, 129, 75, 6, 1349.50, 18, 1351.39, 180
3, 15:14:00-000, 237, 205, 32, 16, 1348.87, 11, 1351.36, 205
3, 15:15:00-000, 224, 169, 55, 4, 1347.75, 8, 1351.62, 217
3, 15:16:00-000, 199, 172, 27, 18, 1350.22, 5, 1352.60, 176
3, 15:17:00-000, 224, 154, 70, 2, 1349.00, 16, 1351.06, 204
3, 15:18:00-000, 197, 139, 58, 24, 1348.58, 17, 1352.23, 158
3, 15:19:00-000, 209, 152, 57, 5, 1348.00, 13, 1350.92, 178
3, 15:20:00-000, 210, 170, 40, 19, 1349.52, 19, 1351.89, 184
3, 15:21:00-000, 165, 123, 42, 4, 1347.75, 2, 1353.00, 154
3, 15:22:00-000, 216, 184, 32, 28, 1349.03, 16, 1353.00, 175
3, 15:23:00-000, 209, 134, 75, 3, 1348.00, 4, 1351.50, 205
3, 15:24:00-000, 230, 163, 67, 6, 1346.50, 16, 1350.19, 201
3, 15:25:00-000, 214, 152, 62, 3, 1348.00, 18, 1351.05, 201
3, 15:26:00-000, 202, 187, 15, 3, 1350.00, 6, 1350.50, 193
3, 15:27:00-000, 214, 212, 2, 2, 1350.00, 2, 1351.00, 209
3, 15:28:00-000, 209, 193, 16, 13, 1347.00, 6, 1351.00, 189
3, 15:29:00-000, 222, 149, 73, 18, 1347.94, 7, 1351.43, 192
3, 15:30:00-000, 185, 143, 42, 5, 1348.00, 6, 1350.83, 173
3, 15:31:00-000, 192, 151, 41, 8, 1345.13, 16, 1352.25, 169
3, 15:32:00-000, 193, 154, 39, 22, 1349.22, 6, 1351.00, 172
3, 15:33:00-000, 212, 169, 43, 5, 1346.60, 11, 1350.45, 194
3, 15:34:00-000, 225, 186, 39, 16, 1348.44, 4, 1350.00, 207
3, 15:35:00-000, 166, 118, 48, 2, 1350.50, 9, 1351.89, 152
3, 15:36:00-000, 199, 135, 64, 14, 1350.28, 12, 1351.92, 168
3, 15:37:00-000, 188, 128, 60, 14, 1349.86, 9, 1351.55, 174
3, 15:38:00-000, 199, 112, 87, 4, 1347.00, 3, 1351.33, 189
3, 15:39:00-000, 197, 95, 102, 2, 1350.50, 13, 1351.31, 176
3, 15:40:00-000, 200, 158, 42, 13, 1350.77, 5, 1350.80, 188
3, 15:41:00-000, 207, 163, 44, 8, 1348.37, 12, 1351.67, 183
3, 15:42:00-000, 209, 147, 62, 17, 1349.23, 19, 1350.74, 178
3, 15:43:00-000, 220, 133, 87, 5, 1348.60, 9, 1350.89, 202
3, 15:44:00-000, 184, 112, 72, 6, 1348.33, 15, 1350.86, 167
3, 15:45:00-000, 199, 155, 44, 4, 1348.50, 6, 1349.67, 187
3, 15:46:00-000, 215, 160, 55, 20, 1348.55, 13, 1350.38, 184
3, 15:47:00-000, 207, 181, 26, 3, 1347.33, 3, 1352.33, 201
3, 15:48:00-000, 187, 122, 65, 7, 1348.86, 9, 1350.78, 169
3, 15:49:00-000, 211, 189, 22, 5, 1348.20, 3, 1351.67, 197
3, 15:50:00-000, 196, 177, 19, 15, 1349.06, 8, 1350.88, 183
3, 15:51:00-000, 220, 171, 49, 10, 1351.00, 15, 1352.73, 191
3, 15:52:00-000, 169, 125, 44, 11, 1348.73, 13, 1351.23, 148
3, 15:53:00-000, 233, 192, 41, 11, 1348.27, 14, 1351.71, 201
3, 15:54:00-000, 193, 157, 36, 20, 1351.85, 12, 1352.08, 162
3, 15:55:00-000, 179, 135, 44, 3, 1348.33, 2, 1350.00, 167
3, 15:56:00-000, 187, 119, 68, 11, 1347.64, 16, 1350.31, 162
3, 15:57:00-000, 191, 137, 54, 7, 1350.00, 5, 1351.20, 185
3, 15:58:00-000, 226, 192, 34, 3, 1348.33, 6, 1351.33, 215
3, 15:59:00-000, 196, 168, 28, 7, 1348.14, 2, 1349.50, 193
3, 16:00:00-000, 172, 130, 42, 11, 1347.18, 2, 1350.50, 154
3, 16:01:00-000, 188, 129, 59, 14, 1349.07, 4, 1349.75, 174
3, 16:02:00-000, 191, 96, 95, 8, 1347.25, 14, 1351.28, 162
3, 16:03:00-000, 207, 162, 45, 2, 1346.50, 13, 1351.00, 197
3, 16:04:00-000, 198, 135, 63, 19, 1346.00, 1, 1347.00, 168
3, 16:05:00-000, 200, 105, 95, 1, 1347.00, 16, 1351.50, 197
3, 16:06:00-000, 188, 135, 53, 15, 1348.13, 7, 1350.43, 166
3, 16:07:00-000, 206, 118, 88, 14, 1348.00, 9, 1350.44, 182
3, 16:08:00-000, 219, 142, 77, 16, 1349.37, 24, 1351.62, 177
3, 16:09:00-000, 202, 104, 98, 8, 1346.12, 19, 1351.15, 176
3, 16:10:00-000, 194, 134, 60, 10, 1349.10, 18, 1350.94, 163
3, 16:11:00-000, 172, 123, 49, 8, 1348.13, 1, 1351.00, 168
3, 16:12:00-000, 197, 139, 58, 12, 1348.00, 13, 1351.00, 170
3, 16:13:00-000, 208, 194, 14, 2, 1347.50, 3, 1350.67, 203
3, 16:14:00-000, 216, 187, 29, 26, 1350.84, 5, 1351.60, 182
3, 16:15:00-000, 234, 148, 86, 5, 1349.80, 12, 1351.25, 216
3, 16:16:00-000, 177, 116, 61, 4, 1349.00, 2, 1351.50, 172
3, 16:17:00-000, 201, 131, 70, 13, 1347.46, 8, 1351.62, 183
3, 16:18:00-000, 183, 103, 80, 15, 1349.40, 30, 1351.63, 139
3, 16:19:00-000, 192, 122, 70, 1, 1350.00, 15, 1352.00, 177
3, 16:20:00-000, 162, 135, 27, 6, 1348.33, 12, 1351.58, 144
3, 16:21:00-000, 194, 161, 33, 3, 1349.67, 0, 0.00, 191
3, 16:22:00-000, 194, 161, 33, 10, 1350.20, 7, 1352.57, 173
3, 16:23:00-000, 182, 156, 26, 8, 1351.62, 4, 1352.00, 165
3, 16:24:00-000, 154, 143, 11, 5, 1345.60, 4, 1351.25, 155
3, 16:25:00-000, 206, 180, 26, 26, 1348.61, 8, 1352.37, 171
3, 16:26:00-000, 186, 147, 39, 10, 1348.00, 8, 1351.87, 164
3, 16:27:00-000, 181, 132, 49, 2, 1348.50, 8, 1350.25, 176
3, 16:28:00-000, 216, 127, 89, 27, 1347.66, 24, 1351.75, 164
3, 16:29:00-000, 172, 96, 76, 12, 1347.00, 14, 1351.21, 145
4, 09:03:00-000, 275, 275, 0, 0, 0.00, 0, 0.00, 274
4, 09:04:00-000, 0, 0, 0, 0, 0.00, 0, 0.00, 1
4, 09:06:00-000, 281, 281, 0, 280, 1351.00, 0, 0.00, 0
4, 09:07:00-000, 1, 1, 0, 0, 0.00, 0, 0.00, 1
4, 09:08:00-000, 32, 22, 10, 10, 1352.10, 10, 1352.10, 6
4, 09:09:00-000, 88, 74, 14, 14, 1368.07, 14, 1368.07, 32
4, 09:10:00-000, 91, 76, 15, 15, 1397.66, 15, 1397.66, 77
4, 09:11:00-000, 58, 42, 16, 15, 1401.20, 16, 1404.68, 33
4, 09:12:00-000, 67, 62, 5, 4, 1483.25, 4, 1483.25, 43
4, 09:13:00-000, 101, 83, 18, 71, 1415.69, 19, 1452.84, 34
4, 09:14:00-000, 62, 58, 4, 48, 1356.86, 1, 1356.00, 18
4, 09:15:00-000, 85, 60, 25, 60, 1356.89, 18, 1356.00, 3
4, 09:16:00-000, 85, 51, 34, 34, 1359.14, 33, 1359.30, 3
4, 09:17:00-000, 63, 42, 21, 23, 1359.91, 15, 1360.40, 22
4, 09:18:00-000, 77, 59, 18, 66, 1358.47, 26, 1359.69, 8
4, 09:19:00-000, 82, 49, 33, 42, 1353.40, 31, 1353.51, 4
4, 09:20:00-000, 86, 48, 38, 41, 1352.21, 36, 1352.49, 3
4, 09:21:00-000, 84, 42, 42, 43, 1353.32, 34, 1353.17, 14
4, 09:22:00-000, 60, 23, 37, 22, 1350.09, 25, 1350.08, 13
4, 09:23:00-000, 110, 42, 68, 43, 1351.45, 50, 1350.71, 9
4, 09:24:00-000, 83, 32, 51, 28, 1350.92, 56, 1350.94, 9
4, 09:25:00-000, 79, 39, 40, 36, 1351.99, 38, 1352.15, 2
4, 09:26:00-000, 83, 45, 38, 48, 1354.37, 33, 1353.81, 1
4, 09:27:00-000, 78, 38, 40, 34, 1350.05, 45, 1349.81, 1
4, 09:28:00-000, 95, 43, 52, 47, 1351.18, 37, 1351.40, 1
4, 09:29:00-000, 90, 32, 58, 32, 1350.40, 43, 1350.65, 20
4, 09:30:00-000, 71, 46, 25, 38, 1356.12, 28, 1354.78, 1
4, 09:31:00-000, 82, 39, 43, 41, 1351.75, 39, 1352.68, 11
4, 09:32:00-000, 74, 36, 38, 36, 1351.13, 35, 1350.31, 4
4, 09:33:00-000, 90, 33, 57, 33, 1350.96, 43, 1351.60, 6
4, 09:34:00-000, 68, 26, 42, 26, 1352.15, 43, 1350.69, 4
4, 09:35:00-000, 102, 49, 53, 41, 1349.70, 50, 1349.49, 7
4, 09:36:00-000, 86, 42, 44, 39, 1350.30, 41, 1350.58, 7
4, 09:37:00-000, 81, 44, 37, 41, 1351.58, 25, 1351.15, 13
4, 09:38:00-000, 83, 28, 55, 28, 1348.85, 49, 1349.54, 4
4, 09:39:00-000, 73, 32, 41, 30, 1351.09, 27, 1350.81, 15
4, 09:40:00-000, 89, 41, 48, 36, 1351.44, 54, 1351.49, 10
4, 09:41:00-000, 90, 44, 46, 41, 1350.85, 33, 1350.81, 6
4, 09:42:00-000, 74, 40, 34, 36, 1349.58, 40, 1350.19, 9
4, 09:43:00-000, 62, 35, 27, 31, 1354.57, 24, 1351.41, 2
4, 09:44:00-000, 81, 41, 40, 45, 1350.68, 36, 1351.33, 0
4, 09:45:00-000, 81, 55, 26, 50, 1354.07, 23, 1353.13, 4
4, 09:46:00-000, 74, 32, 42, 37, 1350.64, 35, 1351.33, 0
4, 09:47:00-000, 100, 48, 52, 44, 1349.06, 48, 1348.78, 16
4, 09:48:00-000, 69, 27, 42, 31, 1349.80, 41, 1351.24, 2
4, 09:49:00-000, 99, 57, 42, 54, 1350.93, 31, 1349.61, 7
4, 09:50:00-000, 65, 27, 38, 21, 1350.47, 23, 1351.43, 15
4, 09:51:00-000, 64, 29, 35, 28, 1351.49, 23, 1351.47, 13
4, 09:52:00-000, 100, 33, 67, 37, 1350.18, 55, 1350.01, 6
4, 09:53:00-000, 82, 45, 37, 40, 1351.24, 38, 1350.07, 11
4, 09:54:00-000, 89, 40, 49, 39, 1350.53, 39, 1350.68, 1
4, 09:55:00-000, 90, 35, 55, 32, 1348.65, 41, 1348.99, 24
4, 09:56:00-000, 82, 40, 42, 43, 1349.90, 42, 1350.09, 3
4, 09:57:00-000, 65, 38, 27, 35, 1350.65, 22, 1349.90, 9
4, 09:58:00-000, 67, 36, 31, 30, 1351.76, 34, 1351.67, 0
4, 09:59:00-000, 83, 41, 42, 40, 1350.14, 35, 1350.37, 9
4, 10:00:00-000, 104, 56, 48, 42, 1351.61, 41, 1351.07, 5
4, 10:01:00-000, 60, 31, 29, 28, 1351.46, 31, 1352.12, 20
4, 10:02:00-000, 67, 33, 34, 32, 1351.09, 33, 1351.14, 0
4, 10:03:00-000, 85, 35, 50, 37, 1349.43, 35, 1349.45, 11
4, 10:04:00-000, 76, 49, 27, 38, 1353.47, 34, 1352.96, 3
4, 10:05:00-000, 65, 33, 32, 37, 1353.40, 29, 1351.55, 5
4, 10:06:00-000, 76, 39, 37, 36, 1350.52, 27, 1350.59, 4
4, 10:07:00-000, 91, 42, 49, 36, 1350.05, 47, 1349.97, 10
4, 10:08:00-000, 103, 45, 58, 46, 1351.69, 60, 1351.77, 4
4, 10:09:00-000, 63, 32, 31, 31, 1349.67, 23, 1349.74, 5
4, 10:10:00-000, 81, 35, 46, 34, 1349.49, 46, 1349.41, 4
4, 10:11:00-000, 83, 28, 55, 25, 1350.07, 44, 1349.72, 7
4, 10:12:00-000, 89, 51, 38, 47, 1351.71, 46, 1351.84, 0
4, 10:13:00-000, 96, 52, 44, 43, 1352.60, 32, 1351.37, 18
4, 10:14:00-000, 75, 35, 40, 32, 1352.93, 40, 1353.39, 6
4, 10:15:00-000, 72, 44, 28, 41, 1352.33, 29, 1352.65, 2
4, 10:16:00-000, 82, 41, 41, 42, 1349.44, 39, 1350.10, 4
4, 10:17:00-000, 81, 47, 34, 43, 1351.62, 32, 1351.03, 2
4, 10:18:00-000, 83, 46, 37, 42, 1349.76, 27, 1349.33, 13
4, 10:19:00-000, 95, 46, 49, 41, 1351.24, 40, 1351.14, 8
4, 10:20:00-000, 86, 44, 42, 49, 1351.56, 47, 1352.20, 0
4, 10:21:00-000, 91, 39, 52, 38, 1351.02, 38, 1350.89, 8
4, 10:22:00-000, 100, 36, 64, 35, 1349.05, 66, 1348.99, 6
4, 10:23:00-000, 66, 27, 39, 25, 1348.32, 34, 1348.55, 3
4, 10:24:00-000, 83, 38, 45, 42, 1350.80, 37, 1351.02, 4
4, 10:25:00-000, 77, 33, 44, 33, 1348.81, 33, 1348.81, 13
4, 10:26:00-000, 92, 43, 49, 43, 1350.27, 51, 1349.46, 1
4, 10:27:00-000, 85, 38, 47, 37, 1350.59, 42, 1350.97, 3
4, 10:28:00-000, 95, 32, 63, 29, 1350.24, 54, 1350.62, 13
4, 10:29:00-000, 83, 50, 33, 47, 1351.01, 29, 1351.10, 6
4, 10:30:00-000, 74, 27, 47, 25, 1349.63, 43, 1349.20, 5
4, 10:31:00-000, 89, 49, 40, 48, 1351.68, 40, 1352.07, 5
4, 10:32:00-000, 86, 54, 32, 53, 1353.97, 29, 1353.62, 4
4, 10:33:00-000, 63, 33, 30, 30, 1351.00, 23, 1351.73, 11
4, 10:34:00-000, 103, 50, 53, 41, 1349.73, 49, 1350.18, 13
4, 10:35:00-000, 73, 36, 37, 35, 1352.19, 25, 1352.72, 3
4, 10:36:00-000, 105, 59, 46, 55, 1351.83, 52, 1351.76, 1
4, 10:37:00-000, 80, 53, 27, 47, 1351.20, 31, 1351.16, 4
4, 10:38:00-000, 86, 31, 55, 36, 1350.85, 37, 1351.18, 12
4, 10:39:00-000, 81, 32, 49, 32, 1353.90, 31, 1351.80, 13
4, 10:40:00-000, 88, 36, 52, 33, 1350.72, 57, 1351.74, 1
4, 10:41:00-000, 88, 40, 48, 38, 1350.57, 49, 1350.52, 2
4, 10:42:00-000, 72, 30, 42, 32, 1350.68, 36, 1351.10, 5
4, 10:43:00-000, 70, 42, 28, 40, 1351.54, 26, 1351.69, 10
4, 10:44:00-000, 83, 37, 46, 29, 1349.06, 31, 1349.57, 8
4, 10:45:00-000, 95, 51, 44, 39, 1351.66, 42, 1350.59, 20
4, 10:46:00-000, 82, 61, 21, 57, 1353.85, 24, 1353.87, 2
4, 10:47:00-000, 67, 22, 45, 25, 1352.12, 32, 1351.96, 17
4, 10:48:00-000, 88, 39, 49, 39, 1350.30, 45, 1350.53, 4
4, 10:49:00-000, 74, 41, 33, 41, 1351.82, 32, 1351.37, 2
4, 10:50:00-000, 66, 29, 37, 24, 1349.41, 36, 1349.11, 5
4, 10:51:00-000, 91, 46, 45, 42, 1350.52, 36, 1350.55, 4
4, 10:52:00-000, 58, 32, 26, 33, 1350.45, 30, 1351.33, 5
4, 10:53:00-000, 96, 46, 50, 46, 1351.51, 47, 1351.71, 0
4, 10:54:00-000, 90, 40, 50, 38, 1352.36, 37, 1351.86, 7
4, 10:55:00-000, 67, 23, 44, 23, 1349.43, 43, 1349.85, 11
4, 10:56:00-000, 102, 51, 51, 52, 1351.51, 42, 1351.87, 0
4, 10:57:00-000, 101, 54, 47, 47, 1350.63, 39, 1350.81, 11
4, 10:58:00-000, 83, 36, 47, 40, 1348.99, 46, 1349.86, 8
4, 10:59:00-000, 80, 39, 41, 42, 1352.09, 38, 1351.52, 3
4, 11:00:00-000, 84, 33, 51, 31, 1349.87, 45, 1349.61, 3
4, 11:01:00-000, 110, 69, 41, 58, 1351.40, 42, 1350.94, 3
4, 11:02:00-000, 74, 35, 39, 47, 1350.56, 29, 1349.75, 0
4, 11:03:00-000, 96, 44, 52, 43, 1350.29, 43, 1349.59, 11
4, 11:04:00-000, 90, 44, 46, 43, 1349.88, 45, 1350.13, 2
4, 11:05:00-000, 80, 33, 47, 33, 1349.11, 45, 1349.04, 8
4, 11:06:00-000, 112, 58, 54, 53, 1353.03, 40, 1351.47, 11
4, 11:07:00-000, 71, 36, 35, 35, 1351.17, 27, 1350.85, 12
4, 11:08:00-000, 77, 27, 50, 26, 1349.34, 48, 1349.97, 5
4, 11:09:00-000, 74, 32, 42, 32, 1351.12, 36, 1351.21, 10
4, 11:10:00-000, 80, 39, 41, 39, 1351.45, 41, 1351.58, 2
4, 11:11:00-000, 68, 32, 36, 30, 1350.29, 26, 1350.61, 7
4, 11:12:00-000, 95, 39, 56, 41, 1349.04, 53, 1350.07, 1
4, 11:13:00-000, 68, 38, 30, 34, 1351.29, 31, 1350.64, 5
4, 11:14:00-000, 62, 32, 30, 35, 1352.85, 20, 1352.65, 4
4, 11:15:00-000, 94, 43, 51, 43, 1349.04, 47, 1348.57, 5
4, 11:16:00-000, 90, 36, 54, 37, 1350.34, 55, 1350.04, 3
4, 11:17:00-000, 74, 31, 43, 26, 1350.38, 39, 1350.35, 1
4, 11:18:00-000, 107, 54, 53, 56, 1350.85, 43, 1351.11, 3
4, 11:19:00-000, 64, 32, 32, 31, 1349.83, 29, 1349.44, 9
4, 11:20:00-000, 82, 54, 28, 47, 1352.99, 35, 1351.22, 0
4, 11:21:00-000, 102, 51, 51, 51, 1352.54, 33, 1351.42, 19
4, 11:22:00-000, 114, 51, 63, 47, 1351.72, 57, 1351.90, 14
4, 11:23:00-000, 63, 22, 41, 21, 1350.85, 30, 1350.86, 6
4, 11:24:00-000, 87, 38, 49, 37, 1350.69, 50, 1351.33, 6
4, 11:25:00-000, 83, 37, 46, 33, 1349.42, 34, 1349.64, 12
4, 11:26:00-000, 103, 52, 51, 54, 1349.03, 43, 1348.85, 6
4, 11:27:00-000, 75, 32, 43, 29, 1349.82, 41, 1349.63, 5
4, 11:28:00-000, 75, 38, 37, 38, 1350.60, 35, 1350.68, 5
4, 11:29:00-000, 84, 36, 48, 34, 1350.23, 45, 1350.72, 3
4, 11:30:00-000, 77, 47, 30, 44, 1349.36, 32, 1349.99, 3
4, 11:31:00-000, 88, 32, 56, 28, 1350.64, 34, 1350.64, 22
4, 11:32:00-000, 78, 41, 37, 39, 1348.81, 40, 1349.22, 6
4, 11:33:00-000, 82, 43, 39, 35, 1353.28, 28, 1352.74, 7
4, 11:34:00-000, 69, 35, 34, 38, 1349.60, 34, 1350.46, 7
4, 11:35:00-000, 84, 41, 43, 42, 1350.35, 33, 1350.09, 3
4, 11:36:00-000, 88, 45, 43, 45, 1351.26, 48, 1351.51, 4
4, 11:37:00-000, 82, 33, 49, 33, 1351.36, 25, 1350.20, 7
4, 11:38:00-000, 77, 32, 45, 32, 1352.40, 51, 1351.01, 7
4, 11:39:00-000, 78, 26, 52, 26, 1349.57, 35, 1349.88, 15
4, 11:40:00-000, 70, 34, 36, 30, 1350.76, 42, 1350.85, 1
4, 11:41:00-000, 84, 52, 32, 46, 1352.62, 19, 1352.57, 7
4, 11:42:00-000, 101, 45, 56, 50, 1350.41, 49, 1351.01, 1
4, 11:43:00-000, 66, 40, 26, 34, 1350.46, 29, 1350.27, 17
4, 11:44:00-000, 78, 41, 37, 35, 1349.68, 32, 1349.78, 5
4, 11:45:00-000, 80, 33, 47, 37, 1350.59, 31, 1350.61, 17
4, 11:46:00-000, 63, 27, 36, 22, 1349.95, 36, 1350.13, 4
4, 11:47:00-000, 95, 51, 44, 48, 1351.14, 34, 1350.73, 4
4, 11:48:00-000, 100, 49, 51, 46, 1350.38, 46, 1350.99, 5
4, 11:49:00-000, 71, 34, 37, 35, 1350.02, 39, 1349.81, 8
4, 11:50:00-000, 89, 37, 52, 38, 1350.02, 45, 1349.50, 9
4, 11:51:00-000, 84, 49, 35, 46, 1351.38, 27, 1351.03, 5
4, 11:52:00-000, 87, 38, 49, 37, 1349.48, 35, 1350.39, 10
4, 11:53:00-000, 82, 27, 55, 26, 1350.23, 60, 1351.01, 5
4, 11:54:00-000, 95, 34, 61, 35, 1349.48, 34, 1349.46, 17
4, 11:55:00-000, 88, 35, 53, 32, 1349.18, 29, 1349.06, 22
4, 11:56:00-000, 96, 50, 46, 40, 1349.37, 57, 1349.62, 7
4, 11:57:00-000, 87, 36, 51, 37, 1348.75, 34, 1349.11, 6
4, 11:58:00-000, 97, 58, 39, 59, 1351.09, 49, 1351.19, 2
4, 11:59:00-000, 86, 41, 45, 44, 1352.47, 37, 1352.24, 6
4, 12:00:00-000, 85, 44, 41, 41, 1351.31, 45, 1352.04, 0
4, 12:01:00-000, 89, 37, 52, 31, 1349.48, 37, 1349.64, 16
4, 12:02:00-000, 87, 33, 54, 34, 1349.82, 44, 1350.61, 7
4, 12:03:00-000, 80, 40, 40, 42, 1351.78, 43, 1351.83, 4
4, 12:04:00-000, 97, 52, 45, 47, 1350.86, 42, 1351.30, 2
4, 12:05:00-000, 88, 45, 43, 49, 1350.68, 28, 1350.89, 7
4, 12:06:00-000, 70, 34, 36, 34, 1351.08, 50, 1351.41, 0
4, 12:07:00-000, 91, 49, 42, 44, 1348.65, 40, 1349.29, 2
4, 12:08:00-000, 93, 38, 55, 32, 1349.09, 49, 1350.13, 7
4, 12:09:00-000, 71, 36, 35, 36, 1350.02, 21, 1349.85, 8
4, 12:10:00-000, 77, 47, 30, 42, 1351.25, 40, 1351.22, 3
4, 12:11:00-000, 79, 37, 42, 40, 1351.52, 36, 1351.83, 6
4, 12:12:00-000, 99, 46, 53, 43, 1350.39, 44, 1350.58, 1
4, 12:13:00-000, 62, 30, 32, 32, 1349.21, 29, 1349.37, 9
4, 12:14:00-000, 70, 37, 33, 33, 1350.45, 32, 1350.28, 4
4, 12:15:00-000, 90, 50, 40, 38, 1350.07, 29, 1350.30, 13
4, 12:16:00-000, 76, 27, 49, 37, 1348.75, 48, 1349.86, 2
4, 12:17:00-000, 78, 33, 45, 33, 1349.69, 33, 1350.08, 4
4, 12:18:00-000, 75, 46, 29, 37, 1351.02, 41, 1351.11, 5
4, 12:19:00-000, 92, 56, 36, 53, 1351.57, 31, 1351.48, 8
4, 12:20:00-000, 94, 41, 53, 39, 1349.35, 47, 1349.63, 2
4, 12:21:00-000, 84, 35, 49, 28, 1351.46, 28, 1351.60, 17
4, 12:22:00-000, 89, 37, 52, 42, 1350.52, 55, 1351.43, 12
4, 12:23:00-000, 91, 39, 52, 35, 1350.88, 46, 1349.73, 0
4, 12:24:00-000, 92, 48, 44, 47, 1350.29, 46, 1350.38, 2
4, 12:25:00-000, 58, 22, 36, 25, 1349.83, 31, 1349.90, 6
4, 12:26:00-000, 74, 34, 40, 33, 1350.72, 33, 1350.51, 3
4, 12:27:00-000, 78, 51, 27, 51, 1351.24, 35, 1350.96, 3
4, 12:28:00-000, 80, 36, 44, 29, 1349.89, 38, 1350.04, 5
4, 12:29:00-000, 99, 51, 48, 45, 1351.77, 37, 1351.45, 9
4, 12:30:00-000, 67, 36, 31, 40, 1350.89, 33, 1350.96, 9
4, 12:31:00-000, 96, 58, 38, 50, 1350.97, 37, 1351.48, 2
4, 12:32:00-000, 68, 23, 45, 27, 1348.99, 28, 1350.03, 11
4, 12:33:00-000, 76, 29, 47, 29, 1350.79, 38, 1349.41, 12
4, 12:34:00-000, 95, 36, 59, 36, 1353.24, 47, 1353.35, 16
4, 12:35:00-000, 69, 38, 31, 34, 1351.11, 21, 1350.80, 7
4, 12:36:00-000, 95, 50, 45, 51, 1350.29, 48, 1350.70, 2
4, 12:37:00-000, 72, 35, 37, 36, 1351.16, 34, 1351.40, 6
4, 12:38:00-000, 86, 29, 57, 24, 1348.00, 53, 1348.23, 5
4, 12:39:00-000, 94, 50, 44, 45, 1351.26, 36, 1351.77, 6
4, 12:40:00-000, 75, 39, 36, 45, 1351.51, 39, 1351.33, 2
4, 12:41:00-000, 85, 44, 41, 45, 1350.88, 36, 1350.77, 3
4, 12:42:00-000, 77, 39, 38, 39, 1352.48, 30, 1351.96, 0
4, 12:43:00-000, 67, 39, 28, 36, 1350.24, 25, 1350.35, 13
4, 12:44:00-000, 77, 33, 44, 28, 1350.21, 41, 1350.62, 5
4, 12:45:00-000, 85, 36, 49, 35, 1351.36, 42, 1351.83, 3
4, 12:46:00-000, 74, 23, 51, 23, 1349.30, 44, 1349.85, 9
4, 12:47:00-000, 79, 36, 43, 30, 1350.23, 36, 1350.35, 11
4, 12:48:00-000, 79, 37, 42, 38, 1350.44, 43, 1350.78, 1
4, 12:49:00-000, 85, 48, 37, 48, 1348.83, 39, 1348.48, 1
4, 12:50:00-000, 80, 45, 35, 43, 1350.34, 34, 1350.29, 4
4, 12:51:00-000, 103, 54, 49, 56, 1350.64, 38, 1350.52, 4
4, 12:52:00-000, 94, 37, 57, 35, 1350.05, 58, 1350.94, 1
4, 12:53:00-000, 78, 33, 45, 34, 1350.11, 32, 1350.59, 6
4, 12:54:00-000, 100, 39, 61, 35, 1350.14, 56, 1351.21, 9
4, 12:55:00-000, 91, 43, 48, 44, 1350.22, 35, 1349.99, 6
4, 12:56:00-000, 78, 31, 47, 29, 1348.68, 52, 1349.89, 7
4, 12:57:00-000, 92, 56, 36, 54, 1351.03, 46, 1350.69, 3
4, 12:58:00-000, 83, 46, 37, 41, 1353.19, 28, 1352.46, 6
4, 12:59:00-000, 111, 45, 66, 43, 1349.57, 47, 1349.84, 12
4, 13:00:00-000, 89, 41, 48, 42, 1350.99, 57, 1350.64, 5
4, 13:01:00-000, 77, 45, 32, 41, 1351.38, 25, 1352.03, 7
4, 13:02:00-000, 70, 38, 32, 34, 1351.29, 32, 1351.78, 3
4, 13:03:00-000, 77, 37, 40, 37, 1350.67, 37, 1350.32, 4
4, 13:04:00-000, 81, 42, 39, 40, 1350.22, 33, 1350.51, 5
4, 13:05:00-000, 92, 51, 41, 52, 1349.74, 40, 1349.84, 3
4, 13:06:00-000, 100, 28, 72, 28, 1349.75, 72, 1350.11, 4
4, 13:07:00-000, 104, 49, 55, 41, 1348.80, 47, 1349.50, 2
4, 13:08:00-000, 103, 46, 57, 54, 1350.31, 47, 1350.48, 3
4, 13:09:00-000, 69, 45, 24, 44, 1351.42, 34, 1351.26, 1
4, 13:10:00-000, 82, 46, 36, 35, 1352.05, 38, 1351.62, 4
4, 13:11:00-000, 80, 37, 43, 37, 1350.99, 38, 1351.12, 11
4, 13:12:00-000, 79, 39, 40, 38, 1352.12, 41, 1350.70, 1
4, 13:13:00-000, 100, 50, 50, 45, 1349.43, 45, 1349.04, 2
4, 13:14:00-000, 102, 49, 53, 47, 1350.72, 44, 1350.99, 0
4, 13:15:00-000, 65, 33, 32, 35, 1349.36, 33, 1349.66, 16
4, 13:16:00-000, 65, 38, 27, 30, 1352.40, 22, 1351.45, 7
4, 13:17:00-000, 73, 29, 44, 30, 1351.96, 26, 1351.19, 11
4, 13:18:00-000, 98, 56, 42, 55, 1350.72, 51, 1350.84, 8
4, 13:19:00-000, 90, 49, 41, 49, 1352.01, 35, 1351.65, 1
4, 13:20:00-000, 94, 46, 48, 44, 1349.70, 47, 1349.04, 1
4, 13:21:00-000, 95, 40, 55, 42, 1351.01, 51, 1350.93, 0
4, 13:22:00-000, 72, 31, 41, 30, 1349.66, 38, 1350.07, 7
4, 13:23:00-000, 74, 37, 37, 37, 1350.67, 35, 1350.56, 5
4, 13:24:00-000, 71, 39, 32, 39, 1351.07, 31, 1350.32, 4
4, 13:25:00-000, 87, 52, 35, 51, 1352.44, 29, 1351.79, 1
4, 13:26:00-000, 68, 31, 37, 29, 1351.03, 35, 1351.56, 4
4, 13:27:00-000, 102, 56, 46, 55, 1351.05, 46, 1350.80, 0
4, 13:28:00-000, 81, 34, 47, 32, 1350.71, 49, 1350.89, 0
4, 13:29:00-000, 98, 34, 64, 33, 1350.33, 49, 1350.46, 8
4, 13:30:00-000, 102, 50, 52, 41, 1349.85, 61, 1349.83, 3
4, 13:31:00-000, 84, 40, 44, 39, 1351.48, 36, 1351.30, 10
4, 13:32:00-000, 76, 38, 38, 42, 1350.42, 38, 1350.75, 6
4, 13:33:00-000, 106, 53, 53, 52, 1351.41, 43, 1350.53, 8
4, 13:34:00-000, 71, 41, 30, 37, 1350.32, 31, 1350.57, 6
4, 13:35:00-000, 99, 45, 54, 42, 1349.71, 44, 1349.49, 3
4, 13:36:00-000, 83, 52, 31, 46, 1351.47, 38, 1351.52, 5
4, 13:37:00-000, 75, 34, 41, 34, 1350.44, 28, 1350.46, 4
4, 13:38:00-000, 95, 59, 36, 56, 1352.74, 46, 1351.16, 0
4, 13:39:00-000, 72, 42, 30, 45, 1350.75, 30, 1350.83, 4
4, 13:40:00-000, 70, 35, 35, 30, 1352.49, 33, 1352.60, 2
4, 13:41:00-000, 86, 41, 45, 39, 1349.30, 39, 1348.66, 2
4, 13:42:00-000, 84, 37, 47, 38, 1348.15, 45, 1348.99, 7
4, 13:43:00-000, 75, 36, 39, 34, 1351.11, 27, 1351.40, 11
4, 13:44:00-000, 99, 38, 61, 35, 1349.68, 53, 1350.01, 6
4, 13:45:00-000, 83, 40, 43, 38, 1349.97, 48, 1350.09, 5
4, 13:46:00-000, 90, 29, 61, 28, 1350.25, 51, 1351.64, 0
4, 13:47:00-000, 79, 44, 35, 43, 1351.57, 32, 1350.15, 10
4, 13:48:00-000, 78, 49, 29, 45, 1350.53, 36, 1351.41, 2
4, 13:49:00-000, 74, 37, 37, 39, 1351.04, 27, 1351.25, 6
4, 13:50:00-000, 81, 49, 32, 39, 1354.79, 34, 1353.82, 0
4, 13:51:00-000, 97, 54, 43, 55, 1352.25, 40, 1351.62, 10
4, 13:52:00-000, 74, 40, 34, 41, 1350.72, 33, 1351.24, 5
4, 13:53:00-000, 88, 38, 50, 38, 1350.36, 42, 1350.40, 0
4, 13:54:00-000, 79, 36, 43, 36, 1349.50, 43, 1350.55, 9
4, 13:55:00-000, 60, 37, 23, 31, 1350.35, 19, 1349.89, 3
4, 13:56:00-000, 110, 63, 47, 63, 1353.05, 40, 1353.29, 7
4, 13:57:00-000, 84, 28, 56, 28, 1350.56, 50, 1350.77, 0
4, 13:58:00-000, 98, 55, 43, 54, 1352.66, 50, 1352.17, 6
4, 13:59:00-000, 76, 38, 38, 32, 1351.21, 35, 1350.37, 2
4, 14:00:00-000, 71, 37, 34, 38, 1350.91, 21, 1350.47, 3
4, 14:01:00-000, 111, 41, 70, 39, 1348.02, 56, 1348.60, 16
4, 14:02:00-000, 82, 43, 39, 48, 1351.51, 44, 1351.56, 1
4, 14:03:00-000, 65, 21, 44, 21, 1349.66, 35, 1350.14, 11
4, 14:04:00-000, 109, 51, 58, 47, 1349.42, 59, 1349.28, 8
4, 14:05:00-000, 87, 44, 43, 38, 1350.44, 41, 1351.53, 0
4, 14:06:00-000, 63, 36, 27, 33, 1349.84, 16, 1349.93, 6
4, 14:07:00-000, 84, 28, 56, 32, 1350.24, 51, 1349.95, 8
4, 14:08:00-000, 92, 39, 53, 38, 1351.12, 60, 1350.55, 2
4, 14:09:00-000, 77, 31, 46, 27, 1350.40, 19, 1347.52, 15
4, 14:10:00-000, 85, 47, 38, 52, 1351.22, 37, 1351.94, 3
4, 14:11:00-000, 78, 33, 45, 32, 1349.90, 38, 1349.75, 11
4, 14:12:00-000, 87, 44, 43, 39, 1351.71, 36, 1351.77, 3
4, 14:13:00-000, 60, 29, 31, 31, 1350.51, 32, 1350.87, 5
4, 14:14:00-000, 70, 33, 37, 34, 1349.99, 44, 1350.15, 0
4, 14:15:00-000, 101, 56, 45, 54, 1351.49, 40, 1350.59, 0
4, 14:16:00-000, 84, 41, 43, 42, 1349.18, 38, 1349.23, 6
4, 14:17:00-000, 93, 54, 39, 54, 1349.18, 33, 1349.69, 1
4, 14:18:00-000, 91, 37, 54, 37, 1349.13, 57, 1349.97, 0
4, 14:19:00-000, 97, 34, 63, 34, 1350.32, 48, 1350.35, 17
4, 14:20:00-000, 94, 47, 47, 38, 1350.70, 43, 1351.18, 8
4, 14:21:00-000, 84, 38, 46, 38, 1351.68, 35, 1351.34, 7
4, 14:22:00-000, 84, 46, 38, 40, 1350.49, 35, 1351.51, 8
4, 14:23:00-000, 84, 47, 37, 39, 1349.97, 39, 1350.15, 6
4, 14:24:00-000, 79, 31, 48, 39, 1350.58, 42, 1351.78, 0
4, 14:25:00-000, 77, 45, 32, 44, 1349.38, 36, 1349.22, 7
4, 14:26:00-000, 92, 40, 52, 40, 1350.69, 48, 1350.83, 2
4, 14:27:00-000, 84, 53, 31, 44, 1352.38, 29, 1352.30, 6
4, 14:28:00-000, 82, 36, 46, 41, 1352.28, 38, 1351.57, 6
4, 14:29:00-000, 74, 42, 32, 36, 1352.44, 23, 1353.21, 7
4, 14:30:00-000, 94, 49, 45, 54, 1352.17, 47, 1352.46, 5
4, 14:31:00-000, 69, 32, 37, 32, 1350.62, 35, 1350.42, 0
4, 14:32:00-000, 86, 31, 55, 31, 1349.84, 42, 1350.52, 7
4, 14:33:00-000, 79, 33, 46, 32, 1348.62, 50, 1349.61, 1
4, 14:34:00-000, 89, 36, 53, 32, 1348.12, 53, 1348.57, 4
4, 14:35:00-000, 86, 40, 46, 45, 1350.48, 42, 1349.88, 1
4, 14:36:00-000, 90, 50, 40, 44, 1349.99, 35, 1350.45, 7
4, 14:37:00-000, 71, 40, 31, 40, 1351.19, 30, 1351.10, 7
4, 14:38:00-000, 85, 42, 43, 39, 1349.63, 42, 1350.13, 1
4, 14:39:00-000, 84, 43, 41, 42, 1351.63, 33, 1351.81, 4
4, 14:40:00-000, 85, 46, 39, 46, 1352.73, 37, 1350.48, 3
4, 14:41:00-000, 77, 40, 37, 42, 1351.66, 32, 1351.77, 3
4, 14:42:00-000, 78, 37, 41, 30, 1349.76, 46, 1350.40, 5
4, 14:43:00-000, 114, 60, 54, 59, 1350.09, 42, 1350.06, 7
4, 14:44:00-000, 90, 39, 51, 33, 1347.84, 57, 1348.41, 2
4, 14:45:00-000, 84, 44, 40, 44, 1350.99, 34, 1351.14, 6
4, 14:46:00-000, 86, 37, 49, 40, 1350.59, 52, 1351.37, 2
4, 14:47:00-000, 85, 42, 43, 40, 1351.12, 28, 1350.64, 5
4, 14:48:00-000, 83, 56, 27, 56, 1352.78, 35, 1351.68, 0
4, 14:49:00-000, 86, 49, 37, 39, 1349.97, 36, 1349.88, 2
4, 14:50:00-000, 97, 51, 46, 52, 1348.84, 37, 1349.51, 10
4, 14:51:00-000, 81, 44, 37, 48, 1350.55, 34, 1351.23, 0
4, 14:52:00-000, 68, 34, 34, 32, 1349.53, 34, 1350.67, 9
4, 14:53:00-000, 74, 31, 43, 33, 1351.09, 38, 1350.02, 3
4, 14:54:00-000, 101, 41, 60, 41, 1350.09, 54, 1350.32, 1
4, 14:55:00-000, 72, 31, 41, 27, 1349.77, 33, 1350.02, 18
4, 14:56:00-000, 71, 33, 38, 29, 1350.41, 35, 1350.68, 3
4, 14:57:00-000, 93, 39, 54, 42, 1352.30, 46, 1350.97, 2
4, 14:58:00-000, 85, 40, 45, 37, 1351.67, 47, 1351.35, 6
4, 14:59:00-000, 79, 35, 44, 36, 1349.71, 44, 1349.51, 4
4, 15:00:00-000, 102, 47, 55, 35, 1351.11, 47, 1351.54, 9
4, 15:01:00-000, 67, 38, 29, 36, 1351.63, 30, 1351.93, 8
4, 15:02:00-000, 89, 45, 44, 46, 1351.03, 43, 1351.55, 2
4, 15:03:00-000, 86, 45, 41, 44, 1350.70, 24, 1349.91, 1
4, 15:04:00-000, 78, 39, 39, 32, 1350.06, 56, 1349.47, 5
4, 15:05:00-000, 98, 47, 51, 49, 1350.77, 47, 1350.97, 3
4, 15:06:00-000, 87, 63, 24, 55, 1352.54, 27, 1352.92, 1
4, 15:07:00-000, 75, 35, 40, 40, 1351.04, 39, 1350.71, 3
4, 15:08:00-000, 66, 33, 33, 31, 1350.25, 24, 1350.33, 4
4, 15:09:00-000, 80, 27, 53, 29, 1349.79, 40, 1350.44, 16
4, 15:10:00-000, 79, 33, 46, 32, 1350.12, 40, 1350.34, 0
4, 15:11:00-000, 77, 31, 46, 29, 1350.58, 36, 1350.11, 9
4, 15:12:00-000, 80, 45, 35, 48, 1350.22, 42, 1351.09, 1
4, 15:13:00-000, 82, 39, 43, 37, 1350.61, 41, 1350.87, 3
4, 15:14:00-000, 99, 38, 61, 36, 1348.83, 56, 1348.63, 3
4, 15:15:00-000, 56, 25, 31, 25, 1350.68, 29, 1350.68, 5
4, 15:16:00-000, 88, 51, 37, 48, 1352.60, 39, 1351.58, 2
4, 15:17:00-000, 77, 41, 36, 34, 1349.82, 34, 1350.05, 3
4, 15:18:00-000, 93, 53, 40, 54, 1350.31, 38, 1350.81, 3
4, 15:19:00-000, 82, 49, 33, 47, 1350.82, 26, 1350.88, 3
4, 15:20:00-000, 72, 35, 37, 39, 1350.61, 42, 1350.90, 3
4, 15:21:00-000, 74, 33, 41, 27, 1349.29, 28, 1349.74, 0
4, 15:22:00-000, 85, 46, 39, 49, 1352.62, 45, 1351.95, 7
4, 15:23:00-000, 72, 28, 44, 26, 1348.65, 38, 1349.12, 0
4, 15:24:00-000, 75, 29, 46, 34, 1349.05, 45, 1349.43, 4
4, 15:25:00-000, 93, 46, 47, 44, 1350.74, 43, 1350.90, 4
4, 15:26:00-000, 82, 37, 45, 31, 1350.90, 45, 1350.75, 4
4, 15:27:00-000, 67, 32, 35, 29, 1351.17, 32, 1351.31, 5
4, 15:28:00-000, 71, 30, 41, 31, 1350.32, 33, 1350.99, 1
4, 15:29:00-000, 77, 42, 35, 39, 1350.94, 44, 1350.79, 3
4, 15:30:00-000, 68, 26, 42, 32, 1350.37, 34, 1350.73, 5
4, 15:31:00-000, 79, 46, 33, 44, 1351.67, 33, 1351.24, 4
4, 15:32:00-000, 72, 33, 39, 30, 1350.46, 35, 1351.02, 1
4, 15:33:00-000, 88, 46, 42, 46, 1350.01, 39, 1350.33, 6
4, 15:34:00-000, 89, 35, 54, 38, 1350.13, 53, 1350.39, 0
4, 15:35:00-000, 48, 30, 18, 27, 1350.74, 21, 1351.04, 1
4, 15:36:00-000, 101, 55, 46, 55, 1350.50, 35, 1351.02, 1
4, 15:37:00-000, 73, 38, 35, 38, 1350.10, 32, 1350.90, 3
4, 15:38:00-000, 106, 46, 60, 43, 1348.41, 62, 1349.38, 0
4, 15:39:00-000, 65, 38, 27, 37, 1349.51, 32, 1349.46, 3
4, 15:40:00-000, 82, 28, 54, 33, 1350.15, 49, 1350.24, 0
4, 15:41:00-000, 68, 38, 30, 35, 1350.22, 24, 1349.91, 4
4, 15:42:00-000, 79, 32, 47, 35, 1350.25, 45, 1349.75, 2
4, 15:43:00-000, 84, 44, 40, 41, 1350.24, 37, 1349.72, 3
4, 15:44:00-000, 93, 44, 49, 48, 1350.76, 48, 1351.01, 0
4, 15:45:00-000, 105, 47, 58, 43, 1349.67, 62, 1349.00, 2
4, 15:46:00-000, 88, 41, 47, 33, 1351.75, 39, 1352.46, 12
4, 15:47:00-000, 77, 49, 28, 47, 1352.03, 25, 1351.99, 5
4, 15:48:00-000, 71, 31, 40, 38, 1349.94, 34, 1349.97, 7
4, 15:49:00-000, 79, 42, 37, 40, 1351.07, 27, 1350.96, 7
4, 15:50:00-000, 67, 41, 26, 38, 1352.34, 26, 1352.23, 2
4, 15:51:00-000, 106, 65, 41, 63, 1352.24, 36, 1351.60, 6
4, 15:52:00-000, 67, 34, 33, 30, 1351.60, 31, 1351.83, 0
4, 15:53:00-000, 72, 39, 33, 40, 1351.57, 32, 1351.12, 6
4, 15:54:00-000, 86, 45, 41, 46, 1351.93, 36, 1352.41, 3
4, 15:55:00-000, 91, 36, 55, 36, 1349.22, 50, 1349.23, 8
4, 15:56:00-000, 78, 39, 39, 38, 1349.89, 36, 1350.27, 4
4, 15:57:00-000, 82, 32, 50, 31, 1350.48, 38, 1350.44, 4
4, 15:58:00-000, 89, 41, 48, 41, 1349.70, 50, 1350.31, 5
4, 15:59:00-000, 79, 31, 48, 26, 1349.38, 28, 1349.46, 13
4, 16:00:00-000, 72, 17, 55, 21, 1348.71, 48, 1349.05, 3
4, 16:01:00-000, 74, 28, 46, 28, 1349.46, 39, 1349.33, 18
4, 16:02:00-000, 77, 34, 43, 29, 1349.24, 47, 1349.37, 2
4, 16:03:00-000, 110, 48, 62, 46, 1351.32, 34, 1350.70, 14
4, 16:04:00-000, 60, 20, 40, 22, 1346.45, 46, 1349.08, 4
4, 16:05:00-000, 102, 64, 38, 59, 1353.06, 45, 1350.90, 8
4, 16:06:00-000, 88, 48, 40, 47, 1349.84, 40, 1350.54, 4
4, 16:07:00-000, 100, 57, 43, 55, 1350.59, 41, 1350.38, 0
4, 16:08:00-000, 78, 44, 34, 46, 1351.30, 34, 1351.41, 1
4, 16:09:00-000, 99, 40, 59, 39, 1351.15, 45, 1350.77, 1
4, 16:10:00-000, 81, 45, 36, 42, 1350.63, 33, 1351.48, 11
4, 16:11:00-000, 60, 20, 40, 24, 1350.16, 26, 1350.23, 5
4, 16:12:00-000, 85, 40, 45, 37, 1350.43, 56, 1350.45, 2
4, 16:13:00-000, 118, 69, 49, 61, 1351.43, 42, 1351.40, 1
4, 16:14:00-000, 70, 34, 36, 38, 1352.70, 33, 1353.42, 16
4, 16:15:00-000, 93, 47, 46, 43, 1351.78, 34, 1351.99, 0
4, 16:16:00-000, 64, 22, 42, 24, 1348.83, 42, 1349.63, 11
4, 16:17:00-000, 71, 21, 50, 21, 1350.00, 30, 1349.43, 3
4, 16:18:00-000, 109, 66, 43, 62, 1352.39, 48, 1351.53, 14
4, 16:19:00-000, 68, 36, 32, 37, 1350.86, 35, 1350.93, 2
4, 16:20:00-000, 74, 32, 42, 30, 1348.59, 38, 1348.44, 2
4, 16:21:00-000, 86, 28, 58, 29, 1348.13, 45, 1347.90, 0
4, 16:22:00-000, 74, 40, 34, 32, 1352.34, 40, 1351.44, 9
4, 16:23:00-000, 79, 39, 40, 35, 1350.60, 31, 1350.48, 7
4, 16:24:00-000, 110, 37, 73, 42, 1348.94, 52, 1349.61, 11
4, 16:25:00-000, 76, 45, 31, 46, 1351.32, 39, 1350.89, 2
4, 16:26:00-000, 101, 43, 58, 40, 1350.24, 52, 1350.47, 7
4, 16:27:00-000, 81, 45, 36, 40, 1350.04, 43, 1350.13, 6
4, 16:28:00-000, 92, 47, 45, 42, 1350.33, 35, 1350.39, 5
4, 16:29:00-000, 78, 33, 45, 31, 1348.67, 32, 1348.77, 11
5, 09:13:00-000, 10146, 5655, 4491, 3859, 1348.54, 3673, 1350.17, 0
5, 09:14:00-000, 0, 0, 0, 0, 0.00, 50, 1357.00, 615
5, 09:15:00-000, 0, 0, 0, 2, 1347.00, 56, 1357.14, 1872
5, 09:16:00-000, 0, 0, 0, 0, 0.00, 0, 0.00, 19
5, 09:26:00-000, 10146, 5590, 4556, 3528, 1348.25, 3578, 1348.30, 0
5, 09:27:00-000, 0, 0, 0, 59, 1348.00, 50, 1355.04, 0
5, 09:28:00-000, 4, 4, 0, 50, 1348.55, 111, 1356.12, 2093
5, 09:29:00-000, 13, 5, 8, 2, 1349.00, 6, 1350.17, 681
5, 09:30:00-000, 101, 57, 44, 27, 1349.33, 46, 1353.82, 1
5, 09:31:00-000, 0, 0, 0, 0, 0.00, 0, 0.00, 1
5, 09:32:00-000, 253, 124, 129, 93, 1348.77, 129, 1349.76, 23
5, 09:33:00-000, 375, 180, 195, 132, 1348.41, 188, 1350.35, 22
5, 09:34:00-000, 667, 363, 304, 249, 1348.38, 259, 1349.64, 20
5, 09:35:00-000, 0, 0, 0, 16, 1346.00, 7, 1356.00, 45
5, 09:36:00-000, 1013, 565, 448, 429, 1349.16, 437, 1350.11, 93
5, 09:37:00-000, 1099, 577, 522, 397, 1348.71, 452, 1349.67, 97
5, 09:38:00-000, 1284, 636, 648, 500, 1348.26, 583, 1350.10, 109
5, 09:39:00-000, 0, 0, 0, 9, 1346.00, 17, 1357.53, 164
5, 09:40:00-000, 1338, 739, 599, 578, 1348.60, 533, 1349.34, 180
5, 09:41:00-000, 1384, 716, 668, 550, 1348.90, 555, 1349.31, 192
5, 09:42:00-000, 1182, 636, 546, 504, 1348.68, 450, 1349.61, 139
5, 09:43:00-000, 0, 0, 0, 16, 1346.00, 45, 1356.24, 180
5, 09:44:00-000, 1041, 598, 443, 479, 1349.36, 390, 1349.86, 149
5, 09:45:00-000, 926, 501, 425, 350, 1349.04, 349, 1350.07, 158
5, 09:46:00-000, 809, 405, 404, 318, 1348.36, 339, 1350.16, 137
5, 09:47:00-000, 0, 0, 0, 0, 0.00, 23, 1357.17, 126
5, 09:48:00-000, 844, 424, 420, 317, 1348.57, 323, 1349.89, 155
5, 09:49:00-000, 907, 454, 453, 307, 1349.67, 350, 1350.40, 129
5, 09:50:00-000, 982, 533, 449, 390, 1349.09, 422, 1350.62, 154
5, 09:51:00-000, 0, 0, 0, 40, 1346.00, 18, 1357.50, 133
5, 09:52:00-000, 1103, 577, 526, 394, 1349.07, 420, 1350.14, 150
5, 09:53:00-000, 1101, 513, 588, 407, 1348.26, 462, 1348.64, 158
5, 09:54:00-000, 1073, 602, 471, 428, 1349.53, 419, 1350.41, 179
5, 09:55:00-000, 0, 0, 0, 9, 1347.00, 11, 1357.00, 171
5, 09:56:00-000, 1112, 587, 525, 411, 1348.76, 428, 1349.39, 182
5, 09:57:00-000, 1003, 547, 456, 388, 1349.62, 358, 1350.20, 193
5, 09:58:00-000, 982, 512, 470, 409, 1349.01, 368, 1349.69, 207
5, 09:59:00-000, 0, 0, 0, 23, 1345.69, 0, 0.00, 153
5, 10:00:00-000, 1009, 544, 465, 429, 1349.21, 416, 1350.17, 135
5, 10:01:00-000, 972, 485, 487, 410, 1348.87, 400, 1349.27, 124
5, 10:02:00-000, 1035, 503, 532, 409, 1348.19, 441, 1349.53, 146
5, 10:03:00-000, 2, 0, 2, 24, 1344.00, 14, 1355.29, 95
5, 10:04:00-000, 981, 518, 463, 391, 1349.15, 463, 1351.31, 125
5, 10:05:00-000, 985, 564, 421, 401, 1349.85, 370, 1350.45, 136
5, 10:06:00-000, 984, 555, 429, 411, 1349.51, 388, 1351.06, 91
5, 10:07:00-000, 0, 0, 0, 49, 1346.55, 42, 1358.26, 130
5, 10:08:00-000, 1103, 595, 508, 508, 1348.81, 406, 1349.99, 108
5, 10:09:00-000, 1082, 516, 566, 375, 1348.38, 412, 1349.38, 127
5, 10:10:00-000, 1006, 509, 497, 390, 1348.76, 465, 1350.59, 159
5, 10:11:00-000, 0, 0, 0, 11, 1345.00, 50, 1357.55, 157
5, 10:12:00-000, 999, 493, 506, 378, 1349.24, 387, 1349.44, 146
5, 10:13:00-000, 1008, 503, 505, 371, 1349.21, 391, 1349.60, 136
5, 10:14:00-000, 992, 478, 514, 385, 1348.75, 437, 1349.69, 158
5, 10:15:00-000, 0, 0, 0, 0, 0.00, 32, 1356.31, 151
5, 10:16:00-000, 995, 521, 474, 409, 1348.94, 404, 1350.40, 115
5, 10:17:00-000, 1020, 548, 472, 382, 1349.05, 372, 1349.02, 181
5, 10:18:00-000, 1139, 579, 560, 509, 1348.59, 464, 1349.67, 135
5, 10:19:00-000, 0, 0, 0, 36, 1345.00, 21, 1356.05, 132
5, 10:20:00-000, 1043, 539, 504, 386, 1348.35, 410, 1349.17, 164
5, 10:21:00-000, 950, 500, 450, 365, 1348.79, 390, 1350.05, 150
5, 10:22:00-000, 976, 489, 487, 404, 1348.42, 380, 1349.45, 154
5, 10:23:00-000, 0, 0, 0, 19, 1345.00, 21, 1356.00, 128
5, 10:24:00-000, 977, 494, 483, 368, 1348.48, 359, 1348.85, 148
5, 10:25:00-000, 1086, 551, 535, 408, 1348.30, 420, 1349.26, 153
5, 10:26:00-000, 882, 489, 393, 385, 1348.27, 324, 1349.14, 185
5, 10:27:00-000, 0, 0, 0, 6, 1346.00, 18, 1354.66, 183
5, 10:28:00-000, 1033, 554, 479, 432, 1348.96, 394, 1349.85, 125
5, 10:29:00-000, 949, 497, 452, 401, 1349.05, 398, 1349.78, 125
5, 10:30:00-000, 999, 556, 443, 378, 1349.41, 373, 1350.58, 130
5, 10:31:00-000, 0, 0, 0, 32, 1346.00, 41, 1356.51, 143
5, 10:32:00-000, 1105, 538, 567, 445, 1348.58, 475, 1349.43, 122
5, 10:33:00-000, 980, 542, 438, 383, 1348.69, 363, 1349.23, 138
5, 10:34:00-000, 1128, 599, 529, 486, 1348.70, 444, 1349.80, 167
5, 10:35:00-000, 8, 0, 8, 27, 1345.00, 19, 1356.47, 128
5, 10:36:00-000, 1042, 552, 490, 390, 1348.63, 428, 1349.87, 155
5, 10:37:00-000, 1053, 617, 436, 412, 1349.74, 359, 1350.13, 168
5, 10:38:00-000, 1017, 489, 528, 381, 1348.72, 458, 1350.61, 160
5, 10:39:00-000, 0, 0, 0, 35, 1346.48, 11, 1356.00, 146
5, 10:40:00-000, 1010, 512, 498, 407, 1348.80, 377, 1349.14, 163
5, 10:41:00-000, 1022, 539, 483, 418, 1349.11, 365, 1349.34, 154
5, 10:42:00-000, 1066, 517, 549, 400, 1349.24, 497, 1350.47, 163
5, 10:43:00-000, 0, 0, 0, 4, 1346.00, 39, 1357.00, 149
5, 10:44:00-000, 934, 455, 479, 365, 1348.64, 409, 1350.14, 137
5, 10:45:00-000, 1007, 509, 498, 412, 1348.67, 414, 1349.59, 111
5, 10:46:00-000, 1067, 607, 460, 420, 1348.99, 437, 1350.08, 119
5, 10:47:00-000, 0, 0, 0, 20, 1347.00, 18, 1358.00, 119
5, 10:48:00-000, 997, 487, 510, 440, 1348.08, 432, 1349.21, 128
5, 10:49:00-000, 984, 501, 483, 388, 1348.77, 396, 1349.21, 114
5, 10:50:00-000, 1042, 553, 489, 465, 1348.62, 400, 1349.79, 121
5, 10:51:00-000, 0, 0, 0, 0, 0.00, 24, 1355.91, 110
5, 10:52:00-000, 1071, 576, 495, 462, 1348.69, 417, 1350.11, 137
5, 10:53:00-000, 1012, 530, 482, 390, 1349.27, 371, 1349.47, 183
5, 10:54:00-000, 977, 495, 482, 416, 1348.38, 414, 1349.16, 148
5, 10:55:00-000, 0, 0, 0, 19, 1345.00, 27, 1356.33, 120
5, 10:56:00-000, 989, 471, 518, 371, 1348.17, 390, 1349.20, 132
5, 10:57:00-000, 944, 468, 476, 366, 1349.20, 380, 1349.57, 171
5, 10:58:00-000, 1042, 587, 455, 398, 1349.81, 382, 1350.02, 147
5, 10:59:00-000, 1, 1, 0, 33, 1347.54, 25, 1356.00, 127
5, 11:00:00-000, 1068, 570, 498, 432, 1349.26, 416, 1349.74, 165
5, 11:01:00-000, 1090, 535, 555, 428, 1348.10, 441, 1349.09, 178
5, 11:02:00-000, 1129, 578, 551, 409, 1348.53, 443, 1349.46, 119
5, 11:03:00-000, 5, 0, 5, 0, 0.00, 55, 1354.52, 173
5, 11:04:00-000, 1047, 531, 516, 407, 1348.66, 405, 1349.48, 177
5, 11:05:00-000, 1046, 553, 493, 393, 1348.94, 407, 1349.73, 205
5, 11:06:00-000, 1086, 567, 519, 429, 1348.40, 426, 1349.62, 149
5, 11:07:00-000, 0, 0, 0, 7, 1345.00, 1, 1355.00, 153
5, 11:08:00-000, 1090, 543, 547, 414, 1348.64, 452, 1350.04, 185
5, 11:09:00-000, 1028, 534, 494, 368, 1349.11, 347, 1349.64, 210
5, 11:10:00-000, 1124, 577, 547, 488, 1348.60, 410, 1349.32, 171
5, 11:11:00-000, 2, 0, 2, 0, 0.00, 11, 1353.27, 159
5, 11:12:00-000, 989, 512, 477, 396, 1348.75, 436, 1350.25, 197
5, 11:13:00-000, 1021, 527, 494, 392, 1348.98, 418, 1349.37, 165
5, 11:14:00-000, 993, 476, 517, 384, 1347.91, 417, 1349.28, 138
5, 11:15:00-000, 0, 0, 0, 22, 1344.13, 7, 1355.00, 120
5, 11:16:00-000, 999, 471, 528, 393, 1347.65, 411, 1348.53, 144
5, 11:17:00-000, 1017, 494, 523, 371, 1348.38, 411, 1349.34, 168
5, 11:18:00-000, 942, 495, 447, 370, 1348.77, 387, 1350.00, 158
5, 11:19:00-000, 0, 0, 0, 20, 1346.00, 27, 1356.00, 134
5, 11:20:00-000, 1065, 527, 538, 408, 1348.76, 493, 1349.70, 118
5, 11:21:00-000, 1034, 524, 510, 425, 1348.94, 418, 1349.37, 139
5, 11:22:00-000, 1048, 576, 472, 451, 1349.27, 324, 1349.66, 139
5, 11:23:00-000, 4, 4, 0, 27, 1346.44, 31, 1355.39, 107
5, 11:24:00-000, 963, 482, 481, 419, 1348.31, 418, 1349.74, 149
5, 11:25:00-000, 1094, 532, 562, 413, 1348.33, 434, 1349.13, 155
5, 11:26:00-000, 1002, 522, 480, 398, 1348.68, 384, 1349.25, 139
5, 11:27:00-000, 5, 5, 0, 34, 1344.97, 0, 0.00, 159
5, 11:28:00-000, 986, 496, 490, 404, 1349.01, 461, 1350.82, 127
5, 11:29:00-000, 956, 488, 468, 340, 1348.16, 395, 1348.66, 133
5, 11:30:00-000, 993, 496, 497, 428, 1348.02, 387, 1348.79, 116
5, 11:31:00-000, 1, 1, 0, 8, 1344.00, 12, 1356.00, 144
5, 11:32:00-000, 1074, 527, 547, 399, 1348.44, 399, 1349.45, 160
5, 11:33:00-000, 1093, 600, 493, 403, 1349.11, 445, 1350.07, 153
5, 11:34:00-000, 1039, 533, 506, 444, 1349.08, 407, 1350.49, 176
5, 11:35:00-000, 0, 0, 0, 20, 1345.00, 16, 1356.00, 164
5, 11:36:00-000, 934, 470, 464, 396, 1348.72, 386, 1349.44, 152
5, 11:37:00-000, 1073, 586, 487, 407, 1350.04, 362, 1350.32, 137
5, 11:38:00-000, 1018, 528, 490, 438, 1348.61, 417, 1350.06, 144
5, 11:39:00-000, 0, 0, 0, 21, 1345.00, 15, 1355.00, 139
5, 11:40:00-000, 1038, 540, 498, 417, 1348.94, 387, 1349.71, 170
5, 11:41:00-000, 1033, 462, 571, 394, 1348.02, 439, 1348.82, 161
5, 11:42:00-000, 990, 509, 481, 381, 1349.41, 387, 1350.14, 166
5, 11:43:00-000, 0, 0, 0, 17, 1346.00, 4, 1356.00, 158
5, 11:44:00-000, 1002, 529, 473, 418, 1348.56, 377, 1349.48, 153
5, 11:45:00-000, 895, 475, 420, 349, 1349.29, 349, 1349.84, 170
5, 11:46:00-000, 1206, 617, 589, 468, 1348.52, 413, 1348.70, 126
5, 11:47:00-000, 2, 1, 1, 41, 1345.53, 24, 1353.96, 135
5, 11:48:00-000, 1076, 553, 523, 411, 1349.08, 447, 1349.89, 209
5, 11:49:00-000, 965, 469, 496, 352, 1348.56, 368, 1349.25, 171
5, 11:50:00-000, 1114, 588, 526, 436, 1349.65, 462, 1350.51, 172
5, 11:51:00-000, 0, 0, 0, 11, 1346.00, 17, 1356.00, 156
5, 11:52:00-000, 992, 524, 468, 381, 1349.52, 378, 1349.97, 175
5, 11:53:00-000, 955, 509, 446, 363, 1348.80, 353, 1349.44, 171
5, 11:54:00-000, 1023, 476, 547, 396, 1348.26, 371, 1348.96, 151
5, 11:55:00-000, 0, 0, 0, 0, 0.00, 10, 1354.90, 169
5, 11:56:00-000, 1030, 543, 487, 422, 1348.79, 444, 1349.95, 178
5, 11:57:00-000, 1075, 517, 558, 388, 1348.70, 402, 1349.13, 173
5, 11:58:00-000, 1062, 562, 500, 460, 1349.60, 471, 1350.63, 152
5, 11:59:00-000, 0, 0, 0, 30, 1345.70, 24, 1357.00, 156
5, 12:00:00-000, 990, 455, 535, 371, 1348.24, 442, 1349.97, 112
5, 12:01:00-000, 996, 507, 489, 398, 1348.54, 352, 1348.52, 131
5, 12:02:00-000, 1039, 547, 492, 395, 1348.73, 407, 1349.96, 115
5, 12:03:00-000, 1, 0, 1, 33, 1345.03, 60, 1356.23, 164
5, 12:04:00-000, 1034, 525, 509, 408, 1349.20, 398, 1349.69, 162
5, 12:05:00-000, 935, 465, 470, 362, 1348.81, 348, 1349.16, 145
5, 12:06:00-000, 1069, 562, 507, 453, 1348.72, 403, 1349.48, 148
5, 12:07:00-000, 1, 0, 1, 1, 1345.00, 16, 1355.00, 150
5, 12:08:00-000, 1039, 512, 527, 427, 1348.17, 423, 1349.47, 155
5, 12:09:00-000, 1113, 586, 527, 441, 1348.60, 407, 1349.02, 174
5, 12:10:00-000, 963, 505, 458, 342, 1348.64, 395, 1349.82, 150
5, 12:11:00-000, 0, 0, 0, 0, 0.00, 5, 1356.00, 183
5, 12:12:00-000, 1016, 541, 475, 392, 1348.89, 382, 1349.75, 190
5, 12:13:00-000, 1067, 568, 499, 403, 1349.04, 408, 1349.65, 165
5, 12:14:00-000, 1062, 524, 538, 422, 1348.65, 470, 1349.40, 167
5, 12:15:00-000, 0, 0, 0, 35, 1344.94, 2, 1356.00, 185
5, 12:16:00-000, 1021, 570, 451, 456, 1349.08, 341, 1349.47, 145
5, 12:17:00-000, 1040, 566, 474, 423, 1349.17, 411, 1349.87, 137
5, 12:18:00-000, 976, 483, 493, 364, 1348.74, 370, 1349.65, 141
5, 12:19:00-000, 1, 1, 0, 28, 1345.00, 18, 1356.00, 168
5, 12:20:00-000, 1045, 498, 547, 348, 1349.19, 334, 1348.19, 158
5, 12:21:00-000, 1074, 565, 509, 368, 1348.96, 359, 1349.09, 217
5, 12:22:00-000, 1008, 504, 504, 383, 1348.95, 368, 1348.73, 245
5, 12:23:00-000, 0, 0, 0, 0, 0.00, 17, 1354.00, 289
5, 12:24:00-000, 1022, 514, 508, 361, 1349.19, 392, 1349.42, 163
5, 12:25:00-000, 1045, 498, 547, 372, 1349.11, 377, 1349.12, 213
5, 12:26:00-000, 977, 509, 468, 430, 1349.43, 343, 1349.92, 205
5, 12:27:00-000, 1, 1, 0, 7, 1346.00, 0, 0.00, 198
5, 12:28:00-000, 1047, 555, 492, 436, 1349.50, 383, 1349.29, 160
5, 12:29:00-000, 1090, 602, 488, 426, 1349.62, 364, 1349.19, 191
5, 12:30:00-000, 958, 499, 459, 382, 1348.87, 320, 1349.22, 170
5, 12:31:00-000, 1, 0, 1, 35, 1346.00, 31, 1355.00, 194
5, 12:32:00-000, 1015, 507, 508, 375, 1348.41, 395, 1348.54, 195
5, 12:33:00-000, 979, 451, 528, 315, 1347.84, 362, 1347.98, 171
5, 12:34:00-000, 1095, 599, 496, 419, 1349.41, 403, 1349.88, 180
5, 12:35:00-000, 1, 0, 1, 2, 1347.00, 1, 1350.00, 227
5, 12:36:00-000, 988, 491, 497, 387, 1348.67, 376, 1349.37, 209
5, 12:37:00-000, 1060, 540, 520, 383, 1349.63, 372, 1349.76, 200
5, 12:38:00-000, 1067, 549, 518, 446, 1348.70, 384, 1348.72, 175
5, 12:39:00-000, 0, 0, 0, 0, 0.00, 0, 0.00, 218
5, 12:40:00-000, 962, 495, 467, 362, 1348.98, 348, 1349.60, 188
5, 12:41:00-000, 984, 504, 480, 341, 1349.56, 357, 1349.96, 194
5, 12:42:00-000, 1043, 563, 480, 404, 1349.82, 391, 1350.80, 169
5, 12:43:00-000, 5, 0, 5, 32, 1347.00, 5, 1351.00, 192
5, 12:44:00-000, 1034, 552, 482, 425, 1348.98, 406, 1349.66, 190
5, 12:45:00-000, 1083, 531, 552, 396, 1348.73, 474, 1349.26, 165
5, 12:46:00-000, 1043, 525, 518, 369, 1348.86, 407, 1349.86, 155
5, 12:47:00-000, 1, 1, 0, 55, 1345.47, 0, 0.00, 163
5, 12:48:00-000, 1069, 532, 537, 420, 1348.61, 391, 1349.14, 146
5, 12:49:00-000, 1081, 562, 519, 423, 1348.79, 432, 1349.59, 145
5, 12:50:00-000, 928, 422, 506, 362, 1347.87, 366, 1348.72, 213
5, 12:51:00-000, 5, 0, 5, 16, 1345.00, 17, 1353.70, 171
5, 12:52:00-000, 1097, 567, 530, 449, 1348.24, 414, 1349.24, 142
5, 12:53:00-000, 1058, 510, 548, 366, 1348.75, 395, 1349.20, 155
5, 12:54:00-000, 920, 491, 429, 345, 1349.59, 323, 1350.53, 179
5, 12:55:00-000, 0, 0, 0, 31, 1346.19, 10, 1355.00, 247
5, 12:56:00-000, 1043, 496, 547, 416, 1348.40, 434, 1349.34, 153
5, 12:57:00-000, 1054, 574, 480, 403, 1349.04, 405, 1349.58, 123
5, 12:58:00-000, 1028, 540, 488, 432, 1349.16, 442, 1350.39, 165
5, 12:59:00-000, 3, 2, 1, 9, 1346.00, 3, 1350.33, 163
5, 13:00:00-000, 1023, 550, 473, 442, 1348.96, 391, 1349.61, 140
5, 13:01:00-000, 1116, 565, 551, 405, 1349.10, 437, 1349.81, 139
5, 13:02:00-000, 1025, 529, 496, 336, 1348.69, 390, 1349.77, 194
5, 13:03:00-000, 0, 0, 0, 18, 1347.00, 28, 1356.00, 177
5, 13:04:00-000, 1052, 518, 534, 439, 1348.15, 446, 1349.54, 199
5, 13:05:00-000, 1036, 518, 518, 379, 1348.78, 409, 1349.08, 129
5, 13:06:00-000, 1065, 558, 507, 415, 1349.03, 399, 1349.54, 173
5, 13:07:00-000, 0, 0, 0, 14, 1346.00, 7, 1356.00, 171
5, 13:08:00-000, 982, 521, 461, 415, 1348.99, 401, 1350.61, 133
5, 13:09:00-000, 1029, 530, 499, 376, 1349.26, 390, 1349.37, 182
5, 13:10:00-000, 1055, 514, 541, 467, 1348.46, 397, 1349.32, 143
5, 13:11:00-000, 0, 0, 0, 15, 1345.26, 30, 1354.76, 147
5, 13:12:00-000, 934, 447, 487, 364, 1349.02, 403, 1349.74, 165
5, 13:13:00-000, 1053, 521, 532, 351, 1348.35, 335, 1348.63, 143
5, 13:14:00-000, 1048, 552, 496, 417, 1349.92, 434, 1350.88, 128
5, 13:15:00-000, 1, 0, 1, 18, 1345.00, 9, 1354.11, 215
5, 13:16:00-000, 1071, 513, 558, 386, 1347.93, 457, 1348.80, 215
5, 13:17:00-000, 1025, 521, 504, 354, 1348.70, 398, 1349.59, 128
5, 13:18:00-000, 943, 508, 435, 416, 1348.55, 365, 1349.83, 159
5, 13:19:00-000, 0, 0, 0, 9, 1346.33, 19, 1356.00, 167
5, 13:20:00-000, 1125, 557, 568, 447, 1348.66, 368, 1349.62, 177
5, 13:21:00-000, 952, 513, 439, 354, 1349.30, 360, 1349.81, 187
5, 13:22:00-000, 944, 489, 455, 403, 1348.99, 371, 1349.35, 227
5, 13:23:00-000, 0, 0, 0, 1, 1345.00, 49, 1355.58, 156
5, 13:24:00-000, 1115, 539, 576, 471, 1347.90, 466, 1349.38, 105
5, 13:25:00-000, 1056, 591, 465, 414, 1349.54, 384, 1350.25, 96
5, 13:26:00-000, 1018, 552, 466, 423, 1349.48, 403, 1350.99, 162
5, 13:27:00-000, 2, 0, 2, 9, 1347.00, 32, 1356.81, 153
5, 13:28:00-000, 1084, 539, 545, 417, 1349.33, 409, 1349.85, 180
5, 13:29:00-000, 1045, 527, 518, 385, 1349.06, 411, 1349.45, 146
5, 13:30:00-000, 1002, 472, 530, 358, 1348.86, 395, 1349.68, 200
5, 13:31:00-000, 1, 1, 0, 29, 1346.10, 52, 1354.80, 173
5, 13:32:00-000, 1028, 569, 459, 422, 1349.20, 417, 1349.77, 143
5, 13:33:00-000, 1077, 513, 564, 364, 1348.87, 430, 1349.67, 154
5, 13:34:00-000, 1086, 609, 477, 456, 1349.35, 393, 1350.33, 173
5, 13:35:00-000, 1, 1, 0, 30, 1346.00, 6, 1356.00, 161
5, 13:36:00-000, 947, 451, 496, 369, 1348.41, 389, 1349.93, 162
5, 13:37:00-000, 948, 445, 503, 370, 1348.46, 390, 1348.61, 163
5, 13:38:00-000, 1098, 560, 538, 485, 1348.72, 473, 1350.27, 131
5, 13:39:00-000, 7, 7, 0, 18, 1345.55, 3, 1355.00, 95
5, 13:40:00-000, 1018, 530, 488, 382, 1349.40, 423, 1349.86, 146
5, 13:41:00-000, 1123, 552, 571, 449, 1348.48, 442, 1348.81, 151
5, 13:42:00-000, 1099, 555, 544, 452, 1348.32, 449, 1349.27, 159
5, 13:43:00-000, 2, 2, 0, 3, 1344.00, 30, 1355.73, 135
5, 13:44:00-000, 1049, 542, 507, 407, 1348.46, 377, 1349.40, 165
5, 13:45:00-000, 912, 532, 380, 386, 1349.93, 343, 1350.26, 212
5, 13:46:00-000, 993, 477, 516, 413, 1348.76, 428, 1350.36, 112
5, 13:47:00-000, 2, 1, 1, 10, 1345.60, 8, 1357.00, 140
5, 13:48:00-000, 1081, 572, 509, 442, 1348.40, 434, 1349.43, 132
5, 13:49:00-000, 1223, 635, 588, 479, 1349.17, 472, 1349.79, 135
5, 13:50:00-000, 1008, 483, 525, 401, 1348.25, 407, 1349.26, 170
5, 13:51:00-000, 0, 0, 0, 17, 1344.00, 0, 0.00, 180
5, 13:52:00-000, 1009, 522, 487, 377, 1349.16, 433, 1350.42, 161
5, 13:53:00-000, 1112, 580, 532, 443, 1348.36, 406, 1349.06, 148
5, 13:54:00-000, 1054, 554, 500, 437, 1348.05, 418, 1348.67, 130
5, 13:55:00-000, 1, 0, 1, 13, 1345.00, 34, 1354.97, 192
5, 13:56:00-000, 1068, 589, 479, 468, 1349.79, 409, 1350.79, 141
5, 13:57:00-000, 1121, 515, 606, 384, 1348.35, 456, 1348.79, 149
5, 13:58:00-000, 1006, 511, 495, 447, 1348.16, 417, 1349.37, 131
5, 13:59:00-000, 2, 1, 1, 12, 1345.00, 47, 1355.36, 166
5, 14:00:00-000, 973, 499, 474, 369, 1349.08, 369, 1350.05, 127
5, 14:01:00-000, 954, 474, 480, 377, 1348.44, 384, 1349.42, 156
5, 14:02:00-000, 1001, 536, 465, 385, 1349.75, 386, 1350.49, 146
5, 14:03:00-000, 0, 0, 0, 20, 1347.00, 14, 1356.00, 154
5, 14:04:00-000, 1012, 502, 510, 476, 1348.59, 439, 1349.96, 128
5, 14:05:00-000, 917, 458, 459, 350, 1349.19, 348, 1349.74, 100
5, 14:06:00-000, 1080, 543, 537, 425, 1348.78, 410, 1349.38, 140
5, 14:07:00-000, 3, 3, 0, 37, 1345.54, 0, 0.00, 126
5, 14:08:00-000, 1062, 513, 549, 389, 1348.96, 498, 1349.72, 150
5, 14:09:00-000, 977, 465, 512, 420, 1348.25, 420, 1349.67, 137
5, 14:10:00-000, 1071, 526, 545, 426, 1348.26, 473, 1349.51, 118
5, 14:11:00-000, 7, 1, 6, 0, 0.00, 11, 1352.27, 116
5, 14:12:00-000, 958, 502, 456, 390, 1348.87, 380, 1350.35, 157
5, 14:13:00-000, 1061, 563, 498, 384, 1349.33, 365, 1349.98, 168
5, 14:14:00-000, 1115, 588, 527, 464, 1348.55, 418, 1349.49, 120
5, 14:15:00-000, 2, 2, 0, 15, 1347.33, 25, 1355.00, 167
5, 14:16:00-000, 1018, 546, 472, 474, 1348.47, 394, 1349.39, 175
5, 14:17:00-000, 1014, 481, 533, 414, 1347.74, 388, 1348.20, 155
5, 14:18:00-000, 928, 479, 449, 394, 1348.60, 336, 1349.37, 137
5, 14:19:00-000, 0, 0, 0, 5, 1345.00, 72, 1355.63, 145
5, 14:20:00-000, 956, 494, 462, 388, 1348.92, 347, 1349.72, 91
5, 14:21:00-000, 1009, 498, 511, 383, 1348.65, 386, 1348.88, 177
5, 14:22:00-000, 1075, 566, 509, 460, 1348.69, 469, 1349.97, 144
5, 14:23:00-000, 1, 0, 1, 29, 1344.27, 6, 1354.83, 138
5, 14:24:00-000, 1208, 603, 605, 454, 1348.98, 464, 1350.15, 137
5, 14:25:00-000, 971, 488, 483, 366, 1349.80, 386, 1350.25, 160
5, 14:26:00-000, 1093, 570, 523, 415, 1349.67, 435, 1350.69, 200
5, 14:27:00-000, 4, 0, 4, 23, 1347.13, 31, 1356.45, 144
5, 14:28:00-000, 1000, 581, 419, 392, 1349.56, 346, 1350.17, 178
5, 14:29:00-000, 1103, 592, 511, 398, 1349.99, 388, 1350.06, 177
5, 14:30:00-000, 969, 500, 469, 387, 1349.12, 385, 1350.40, 217
5, 14:31:00-000, 0, 0, 0, 22, 1346.00, 11, 1356.00, 196
5, 14:32:00-000, 1044, 495, 549, 322, 1348.52, 386, 1349.48, 157
5, 14:33:00-000, 1061, 566, 495, 395, 1349.22, 411, 1350.02, 222
5, 14:34:00-000, 1005, 515, 490, 421, 1348.41, 414, 1349.39, 167
5, 14:35:00-000, 0, 0, 0, 29, 1345.06, 16, 1356.00, 163
5, 14:36:00-000, 1035, 495, 540, 371, 1348.27, 445, 1349.91, 141
5, 14:37:00-000, 953, 486, 467, 375, 1348.36, 395, 1348.97, 187
5, 14:38:00-000, 1043, 514, 529, 372, 1348.60, 369, 1349.21, 146
5, 14:39:00-000, 0, 0, 0, 17, 1345.23, 1, 1354.00, 141
5, 14:40:00-000, 1055, 624, 431, 426, 1349.62, 421, 1350.98, 180
5, 14:41:00-000, 1139, 595, 544, 414, 1349.62, 421, 1349.98, 213
5, 14:42:00-000, 1095, 522, 573, 405, 1348.52, 431, 1349.66, 170
5, 14:43:00-000, 1, 1, 0, 28, 1346.00, 43, 1355.06, 169
5, 14:44:00-000, 1022, 498, 524, 418, 1348.14, 420, 1348.96, 189
5, 14:45:00-000, 1018, 535, 483, 403, 1349.58, 355, 1349.79, 139
5, 14:46:00-000, 1014, 534, 480, 372, 1349.32, 355, 1350.23, 158
5, 14:47:00-000, 1, 0, 1, 18, 1347.00, 8, 1355.00, 185
5, 14:48:00-000, 1117, 562, 555, 446, 1349.45, 479, 1350.46, 179
5, 14:49:00-000, 1033, 540, 493, 419, 1348.92, 407, 1349.77, 164
5, 14:50:00-000, 963, 439, 524, 352, 1347.85, 354, 1348.22, 157
5, 14:51:00-000, 7, 0, 7, 24, 1344.75, 34, 1353.44, 159
5, 14:52:00-000, 943, 542, 401, 400, 1349.08, 372, 1350.41, 171
5, 14:53:00-000, 967, 445, 522, 372, 1348.34, 393, 1349.23, 158
5, 14:54:00-000, 1105, 527, 578, 410, 1348.74, 439, 1349.54, 112
5, 14:55:00-000, 0, 0, 0, 1, 1346.00, 0, 0.00, 141
5, 14:56:00-000, 1048, 539, 509, 404, 1348.69, 419, 1349.57, 227
5, 14:57:00-000, 1002, 558, 444, 423, 1349.04, 403, 1349.79, 141
5, 14:58:00-000, 1034, 506, 528, 402, 1347.91, 379, 1348.76, 167
5, 14:59:00-000, 3, 0, 3, 36, 1344.50, 22, 1355.00, 121
5, 15:00:00-000, 948, 484, 464, 375, 1349.48, 362, 1350.22, 154
5, 15:01:00-000, 1058, 532, 526, 434, 1348.89, 416, 1349.58, 147
5, 15:02:00-000, 986, 505, 481, 392, 1348.41, 400, 1349.71, 180
5, 15:03:00-000, 8, 7, 1, 11, 1345.36, 21, 1355.52, 145
5, 15:04:00-000, 933, 485, 448, 422, 1348.39, 372, 1349.52, 137
5, 15:05:00-000, 1069, 562, 507, 355, 1349.17, 391, 1349.60, 116
5, 15:06:00-000, 1009, 516, 493, 423, 1348.87, 421, 1349.91, 158
5, 15:07:00-000, 1, 0, 1, 23, 1345.39, 24, 1356.62, 165
5, 15:08:00-000, 1023, 519, 504, 421, 1348.86, 408, 1350.11, 146
5, 15:09:00-000, 956, 512, 444, 405, 1348.79, 349, 1349.29, 171
5, 15:10:00-000, 1114, 542, 572, 406, 1349.24, 445, 1349.97, 133
5, 15:11:00-000, 0, 0, 0, 18, 1345.83, 34, 1356.00, 124
5, 15:12:00-000, 1053, 525, 528, 409, 1348.42, 436, 1349.41, 176
5, 15:13:00-000, 938, 457, 481, 351, 1348.36, 343, 1348.76, 142
5, 15:14:00-000, 937, 459, 478, 384, 1348.24, 367, 1349.15, 174
5, 15:15:00-000, 5, 1, 4, 8, 1345.75, 27, 1355.26, 124
5, 15:16:00-000, 1001, 536, 465, 410, 1348.88, 427, 1350.05, 166
5, 15:17:00-000, 1129, 569, 560, 423, 1348.67, 428, 1349.23, 123
5, 15:18:00-000, 986, 544, 442, 439, 1348.38, 358, 1348.66, 158
5, 15:19:00-000, 0, 0, 0, 14, 1345.07, 0, 0.00, 175
5, 15:20:00-000, 942, 488, 454, 327, 1348.65, 340, 1349.57, 184
5, 15:21:00-000, 978, 499, 479, 377, 1349.20, 400, 1349.66, 176
5, 15:22:00-000, 1002, 508, 494, 330, 1349.11, 413, 1349.94, 157
5, 15:23:00-000, 7, 1, 6, 47, 1346.19, 9, 1356.00, 136
5, 15:24:00-000, 1029, 527, 502, 433, 1348.67, 372, 1349.47, 192
5, 15:25:00-000, 1011, 546, 465, 388, 1349.45, 373, 1350.07, 147
5, 15:26:00-000, 993, 530, 463, 393, 1349.22, 400, 1350.30, 160
5, 15:27:00-000, 0, 0, 0, 23, 1346.00, 19, 1356.00, 164
5, 15:28:00-000, 1056, 551, 505, 401, 1348.94, 411, 1349.75, 176
5, 15:29:00-000, 1081, 528, 553, 428, 1348.15, 379, 1348.93, 158
5, 15:30:00-000, 1025, 504, 521, 408, 1348.92, 443, 1350.13, 169
5, 15:31:00-000, 4, 3, 1, 9, 1348.00, 15, 1355.40, 169
5, 15:32:00-000, 1024, 510, 514, 386, 1348.79, 461, 1350.13, 161
5, 15:33:00-000, 986, 481, 505, 412, 1348.46, 401, 1348.98, 140
5, 15:34:00-000, 1073, 566, 507, 398, 1349.80, 383, 1350.35, 133
5, 15:35:00-000, 1, 1, 0, 33, 1346.15, 31, 1355.58, 130
5, 15:36:00-000, 1061, 545, 516, 450, 1348.57, 441, 1349.52, 169
5, 15:37:00-000, 1028, 485, 543, 363, 1348.69, 384, 1348.90, 160
5, 15:38:00-000, 1008, 552, 456, 426, 1349.08, 416, 1350.00, 136
5, 15:39:00-000, 2, 2, 0, 11, 1346.00, 18, 1356.00, 162
5, 15:40:00-000, 913, 464, 449, 326, 1349.82, 279, 1349.11, 164
5, 15:41:00-000, 880, 450, 430, 305, 1349.90, 266, 1348.82, 170
5, 15:42:00-000, 979, 486, 493, 357, 1349.71, 383, 1349.20, 255
5, 15:43:00-000, 0, 0, 0, 24, 1347.00, 0, 0.00, 186
5, 15:44:00-000, 997, 513, 484, 381, 1349.13, 366, 1349.01, 191
5, 15:45:00-000, 1097, 552, 545, 373, 1349.09, 349, 1348.84, 212
5, 15:46:00-000, 982, 476, 506, 293, 1349.02, 408, 1349.30, 169
5, 15:47:00-000, 14, 4, 10, 52, 1346.00, 10, 1351.50, 277
5, 15:48:00-000, 1114, 513, 601, 404, 1348.43, 446, 1349.09, 195
5, 15:49:00-000, 1027, 501, 526, 372, 1349.51, 377, 1350.20, 185
5, 15:50:00-000, 1006, 523, 483, 354, 1349.36, 339, 1348.98, 190
5, 15:51:00-000, 9, 0, 9, 0, 0.00, 3, 1351.33, 237
5, 15:52:00-000, 1031, 546, 485, 410, 1349.20, 397, 1349.37, 236
5, 15:53:00-000, 1011, 509, 502, 359, 1348.46, 364, 1349.47, 210
5, 15:54:00-000, 968, 452, 516, 319, 1348.85, 401, 1349.38, 144
5, 15:55:00-000, 1, 1, 0, 5, 1346.20, 0, 0.00, 241
5, 15:56:00-000, 1002, 500, 502, 381, 1348.70, 321, 1348.84, 200
5, 15:57:00-000, 1037, 518, 519, 383, 1349.16, 424, 1349.77, 193
5, 15:58:00-000, 1029, 539, 490, 458, 1348.28, 392, 1349.14, 195
5, 15:59:00-000, 1, 1, 0, 0, 0.00, 23, 1354.65, 140
5, 16:00:00-000, 958, 474, 484, 355, 1348.79, 371, 1349.11, 172
5, 16:01:00-000, 966, 503, 463, 336, 1348.63, 358, 1349.53, 140
5, 16:02:00-000, 1148, 573, 575, 470, 1348.12, 470, 1348.98, 182
5, 16:03:00-000, 1, 1, 0, 20, 1345.20, 14, 1355.00, 156
5, 16:04:00-000, 987, 526, 461, 439, 1348.64, 381, 1348.98, 147
5, 16:05:00-000, 1038, 542, 496, 418, 1348.71, 406, 1349.20, 158
5, 16:06:00-000, 1046, 556, 490, 447, 1348.78, 394, 1349.61, 135
5, 16:07:00-000, 1, 0, 1, 7, 1345.00, 1, 1350.00, 142
5, 16:08:00-000, 1095, 549, 546, 431, 1348.62, 410, 1349.37, 178
5, 16:09:00-000, 1064, 557, 507, 417, 1348.69, 416, 1349.31, 158
5, 16:10:00-000, 1032, 547, 485, 452, 1349.27, 410, 1350.02, 200
5, 16:11:00-000, 5, 4, 1, 4, 1348.00, 21, 1355.71, 155
5, 16:12:00-000, 1036, 501, 535, 382, 1348.55, 442, 1349.91, 125
5, 16:13:00-000, 929, 426, 503, 329, 1348.94, 372, 1349.69, 190
5, 16:14:00-000, 1068, 568, 500, 441, 1349.33, 433, 1350.15, 131
5, 16:15:00-000, 1, 1, 0, 6, 1346.00, 0, 0.00, 125
5, 16:16:00-000, 1108, 557, 551, 469, 1348.60, 457, 1349.78, 180
5, 16:17:00-000, 965, 533, 432, 380, 1349.70, 352, 1350.02, 123
5, 16:18:00-000, 1066, 513, 553, 436, 1348.64, 399, 1349.08, 144
5, 16:19:00-000, 9, 7, 2, 33, 1346.63, 24, 1353.29, 155
5, 16:20:00-000, 1039, 543, 496, 392, 1349.37, 397, 1350.65, 150
5, 16:21:00-000, 1130, 554, 576, 400, 1348.72, 471, 1349.82, 183
5, 16:22:00-000, 1036, 548, 488, 400, 1349.49, 384, 1349.91, 170
5, 16:23:00-000, 3, 2, 1, 61, 1345.47, 25, 1355.76, 178
5, 16:24:00-000, 1001, 500, 501, 436, 1348.25, 400, 1349.56, 149
5, 16:25:00-000, 1044, 587, 457, 417, 1349.54, 393, 1350.21, 144
5, 16:26:00-000, 955, 488, 467, 380, 1349.04, 376, 1349.72, 116
5, 16:27:00-000, 3, 3, 0, 22, 1346.54, 16, 1355.12, 166
5, 16:28:00-000, 1101, 564, 537, 442, 1348.94, 432, 1349.41, 169
5, 16:29:00-000, 1038, 513, 525, 411, 1348.66, 413, 1349.20, 146
5, 16:30:00-000, 0, 0, 0, 0, 0.00, 0, 0.00, 1
6, 12:20:00-000, 6932, 3368, 3564, 1644, 1347.66, 1712, 1348.49, 0
6, 12:21:00-000, 0, 0, 0, 10, 1347.00, 67, 1353.85, 0
6, 12:22:00-000, 0, 0, 0, 61, 1346.00, 147, 1354.00, 0
6, 12:23:00-000, 0, 0, 0, 72, 1346.00, 46, 1354.00, 0
6, 12:24:00-000, 0, 0, 0, 71, 1346.00, 20, 1355.00, 0
6, 12:25:00-000, 0, 0, 0, 0, 0.00, 16, 1355.00, 0
6, 12:26:00-000, 0, 0, 0, 34, 1345.00, 45, 1355.00, 0
6, 12:27:00-000, 0, 0, 0, 0, 0.00, 56, 1355.00, 0
6, 12:28:00-000, 0, 0, 0, 0, 0.00, 62, 1355.00, 0
6, 12:29:00-000, 0, 0, 0, 0, 0.00, 38, 1355.00, 0
6, 12:32:00-000, 0, 0, 0, 118, 1345.00, 0, 0.00, 0
6, 12:33:00-000, 0, 0, 0, 50, 1345.00, 0, 0.00, 0
6, 12:34:00-000, 0, 0, 0, 1, 1345.00, 77, 1356.00, 0
6, 12:35:00-000, 0, 0, 0, 0, 0.00, 57, 1356.00, 0
6, 12:36:00-000, 0, 0, 0, 0, 0.00, 2, 1356.00, 0
6, 12:37:00-000, 0, 0, 0, 0, 0.00, 22, 1356.00, 0
6, 12:38:00-000, 0, 0, 0, 12, 1345.00, 20, 1356.00, 0
6, 12:39:00-000, 0, 0, 0, 15, 1345.00, 26, 1356.00, 0
6, 12:40:00-000, 0, 0, 0, 0, 0.00, 1, 1356.00, 112
6, 12:41:00-000, 0, 0, 0, 0, 0.00, 4, 1356.00, 114
6, 12:42:00-000, 0, 0, 0, 0, 0.00, 26, 1356.27, 120
6, 12:43:00-000, 0, 0, 0, 0, 0.00, 26, 1357.00, 110
6, 12:44:00-000, 0, 0, 0, 0, 0.00, 0, 0.00, 116
6, 12:45:00-000, 0, 0, 0, 28, 1345.00, 0, 0.00, 94
6, 12:46:00-000, 0, 0, 0, 0, 0.00, 19, 1357.00, 111
6, 12:47:00-000, 0, 0, 0, 0, 0.00, 2, 1357.00, 124
6, 12:48:00-000, 0, 0, 0, 0, 0.00, 0, 0.00, 128
6, 12:49:00-000, 0, 0, 0, 0, 0.00, 0, 0.00, 94
6, 12:50:00-000, 0, 0, 0, 0, 0.00, 16, 1357.00, 104
6, 12:51:00-000, 0, 0, 0, 0, 0.00, 0, 0.00, 132
6, 12:52:00-000, 0, 0, 0, 0, 0.00, 0, 0.00, 118
6, 12:53:00-000, 0, 0, 0, 0, 0.00, 0, 0.00, 119
6, 12:54:00-000, 0, 0, 0, 0, 0.00, 0, 0.00, 121
6, 12:55:00-000, 0, 0, 0, 0, 0.00, 0, 0.00, 111
6, 12:56:00-000, 0, 0, 0, 2, 1344.00, 0, 0.00, 120
6, 12:57:00-000, 0, 0, 0, 0, 0.00, 0, 0.00, 118
6, 12:58:00-000, 0, 0, 0, 0, 0.00, 0, 0.00, 115
6, 12:59:00-000, 0, 0, 0, 0, 0.00, 0, 0.00, 126
6, 15:40:00-000, 6942, 3449, 3493, 1486, 1347.84, 1650, 1348.54, 0
6, 15:41:00-000, 0, 0, 0, 83, 1347.00, 100, 1354.00, 0
6, 15:42:00-000, 0, 0, 0, 93, 1347.00, 164, 1354.00, 0
6, 15:44:00-000, 0, 0, 0, 67, 1346.00, 20, 1355.00, 0
6, 15:45:00-000, 0, 0, 0, 47, 1346.00, 0, 0.00, 0
6, 15:46:00-000, 0, 0, 0, 99, 1346.00, 0, 0.00, 0
6, 15:47:00-000, 0, 0, 0, 3, 1346.00, 59, 1355.00, 0
6, 15:48:00-000, 0, 0, 0, 0, 0.00, 1, 1355.00, 0
6, 15:49:00-000, 0, 0, 0, 0, 0.00, 18, 1355.00, 0
6, 15:50:00-000, 0, 0, 0, 8, 1345.00, 118, 1355.00, 0
6, 15:51:00-000, 0, 0, 0, 0, 0.00, 18, 1355.00, 0
6, 15:52:00-000, 0, 0, 0, 59, 1345.00, 34, 1355.29, 0
6, 15:53:00-000, 0, 0, 0, 23, 1345.00, 0, 0.00, 0
6, 15:54:00-000, 0, 0, 0, 103, 1345.00, 10, 1356.00, 0
6, 15:55:00-000, 0, 0, 0, 23, 1345.00, 0, 0.00, 0
6, 15:56:00-000, 0, 0, 0, 36, 1345.00, 0, 0.00, 0
6, 16:00:00-000, 2, 2, 0, 1, 1348.00, 17, 1356.00, 124
6, 16:01:00-000, 0, 0, 0, 0, 0.00, 0, 0.00, 131
6, 16:02:00-000, 0, 0, 0, 0, 0.00, 0, 0.00, 106
6, 16:03:00-000, 0, 0, 0, 12, 1344.00, 0, 0.00, 125
6, 16:04:00-000, 0, 0, 0, 0, 0.00, 0, 0.00, 126
6, 16:05:00-000, 0, 0, 0, 1, 1344.00, 10, 1356.00, 128
6, 16:06:00-000, 1, 1, 0, 1, 1344.00, 37, 1356.00, 136
6, 16:07:00-000, 0, 0, 0, 3, 1344.00, 17, 1356.00, 127
6, 16:08:00-000, 0, 0, 0, 0, 0.00, 7, 1356.00, 134
6, 16:09:00-000, 0, 0, 0, 8, 1344.00, 0, 0.00, 105
6, 16:10:00-000, 0, 0, 0, 17, 1344.00, 28, 1356.00, 133
6, 16:11:00-000, 0, 0, 0, 0, 0.00, 18, 1356.00, 112
6, 16:12:00-000, 0, 0, 0, 9, 1344.00, 0, 0.00, 114
6, 16:13:00-000, 1, 0, 1, 0, 0.00, 1, 1353.00, 123
6, 16:14:00-000, 0, 0, 0, 2, 1344.00, 9, 1357.00, 97
6, 16:15:00-000, 0, 0, 0, 0, 0.00, 5, 1357.00, 120
6, 16:16:00-000, 0, 0, 0, 0, 0.00, 6, 1357.00, 131
6, 16:17:00-000, 0, 0, 0, 0, 0.00, 17, 1357.00, 110
6, 16:18:00-000, 0, 0, 0, 0, 0.00, 0, 0.00, 111
6, 16:19:00-000, 0, 0, 0, 0, 0.00, 0, 0.00, 103
6, 16:20:00-000, 18, 4, 14, 1, 1345.00, 8, 1351.12, 0
6, 16:21:00-000, 0, 0, 0, 0, 0.00, 1, 1356.00, 0
6, 16:23:00-000, 0, 0, 0, 1, 1345.00, 0, 0.00, 0
6, 16:26:00-000, 0, 0, 0, 0, 0.00, 2, 1358.00, 1
8, 09:06:00-000, 3805, 2645, 1160, 0, 0.00, 0, 0.00, 3805
8, 09:07:00-000, 9251, 5167, 4084, 0, 0.00, 0, 0.00, 9251
8, 09:24:00-000, 2853, 1998, 855, 9, 1351.78, 25, 1351.80, 2819
8, 09:25:00-000, 34, 34, 0, 16, 1356.19, 0, 0.00, 18
8, 09:29:00-000, 847, 726, 121, 2, 1350.00, 2, 1347.00, 843
8, 09:32:00-000, 70, 70, 0, 0, 0.00, 0, 0.00, 70
8, 09:35:00-000, 1103, 13, 1090, 0, 0.00, 0, 0.00, 1103
8, 09:42:00-000, 8310, 6107, 2203, 0, 0.00, 0, 0.00, 8310
8, 09:43:00-000, 1061, 920, 141, 9, 1348.00, 9, 1349.00, 1043
8, 09:47:00-000, 1197, 27, 1170, 0, 0.00, 0, 0.00, 1190
8, 09:48:00-000, 1123, 1065, 58, 9, 1353.11, 9, 1351.00, 1112
8, 09:49:00-000, 2022, 833, 1189, 1, 1349.00, 1, 1351.00, 2020
8, 09:54:00-000, 751, 108, 643, 0, 0.00, 0, 0.00, 751
8, 09:56:00-000, 5914, 2217, 3697, 0, 0.00, 0, 0.00, 5914
8, 09:57:00-000, 3598, 1812, 1786, 0, 0.00, 0, 0.00, 3598
8, 09:58:00-000, 88, 8, 80, 0, 0.00, 0, 0.00, 88
8, 09:59:00-000, 3382, 3152, 230, 1, 1350.00, 1, 1350.00, 3380
8, 10:01:00-000, 1617, 760, 857, 0, 0.00, 0, 0.00, 1617
8, 10:02:00-000, 12717, 4991, 7726, 5, 1346.00, 1, 1350.00, 12659
8, 10:03:00-000, 4340, 2734, 1606, 2, 1349.50, 6, 1347.00, 3404
8, 10:04:00-000, 46, 46, 0, 30, 1355.06, 30, 1350.33, 966
8, 10:08:00-000, 3161, 84, 3077, 15, 1351.00, 24, 1353.67, 3113
8, 10:09:00-000, 4757, 1625, 3132, 20, 1351.15, 11, 1351.45, 4735
8, 10:10:00-000, 2454, 2253, 201, 0, 0.00, 0, 0.00, 994
8, 10:11:00-000, 4118, 1043, 3075, 0, 0.00, 0, 0.00, 5571
8, 10:12:00-000, 1087, 1064, 23, 14, 1351.57, 14, 1351.71, 1066
8, 10:14:00-000, 1141, 16, 1125, 5, 1349.00, 5, 1352.00, 1131
8, 10:16:00-000, 4361, 3035, 1326, 0, 0.00, 0, 0.00, 4361
8, 10:17:00-000, 5252, 2587, 2665, 4, 1351.50, 4, 1351.25, 5244
8, 10:18:00-000, 4013, 249, 3764, 1, 1349.00, 1, 1350.00, 3906
8, 10:19:00-000, 822, 143, 679, 5, 1351.00, 5, 1351.00, 917
8, 10:20:00-000, 5056, 2701, 2355, 12, 1347.67, 12, 1351.33, 5032
8, 10:21:00-000, 5043, 805, 4238, 8, 1350.00, 12, 1350.67, 4928
8, 10:22:00-000, 750, 573, 177, 28, 1349.07, 24, 1345.71, 793
8, 10:23:00-000, 8793, 4655, 4138, 2, 1350.00, 2, 1350.00, 8789
8, 10:24:00-000, 8496, 5909, 2587, 8, 1348.50, 7, 1351.00, 8481
8, 10:25:00-000, 8816, 4986, 3830, 1, 1350.00, 2, 1350.00, 8813
8, 10:26:00-000, 7124, 3080, 4044, 5, 1350.20, 5, 1352.80, 7114
8, 10:27:00-000, 3335, 3144, 191, 10, 1354.20, 10, 1351.00, 3315
8, 10:28:00-000, 5973, 2999, 2974, 0, 0.00, 0, 0.00, 5965
8, 10:29:00-000, 2591, 331, 2260, 3, 1354.00, 3, 1351.00, 2593
8, 10:30:00-000, 4033, 3031, 1002, 3, 1348.00, 3, 1352.00, 4027
8, 10:31:00-000, 3537, 1766, 1771, 0, 0.00, 0, 0.00, 3537
8, 10:32:00-000, 4012, 1921, 2091, 0, 0.00, 0, 0.00, 4012
8, 10:33:00-000, 531, 485, 46, 3, 1353.00, 3, 1352.00, 525
8, 10:34:00-000, 4091, 1832, 2259, 12, 1350.25, 14, 1351.00, 4065
8, 10:35:00-000, 23, 3, 20, 2, 1356.00, 0, 0.00, 20
8, 10:36:00-000, 5654, 2405, 3249, 6, 1352.00, 6, 1353.00, 5643
8, 10:37:00-000, 100, 95, 5, 5, 1354.00, 5, 1351.00, 90
8, 10:40:00-000, 1520, 1520, 0, 0, 0.00, 0, 0.00, 1520
8, 10:41:00-000, 1019, 1005, 14, 0, 0.00, 0, 0.00, 1019
8, 10:42:00-000, 79, 9, 70, 0, 0.00, 0, 0.00, 79
8, 10:44:00-000, 6856, 3923, 2933, 0, 0.00, 0, 0.00, 6856
8, 10:45:00-000, 3367, 1419, 1948, 24, 1353.71, 24, 1351.66, 3319
8, 10:48:00-000, 2541, 616, 1925, 0, 0.00, 0, 0.00, 2541
8, 10:49:00-000, 3513, 919, 2594, 2, 1352.00, 2, 1351.00, 3509
8, 10:50:00-000, 9390, 6760, 2630, 38, 1348.94, 38, 1348.31, 9314
8, 10:51:00-000, 3696, 1430, 2266, 17, 1348.41, 17, 1349.94, 3662
8, 10:52:00-000, 7589, 3801, 3788, 0, 0.00, 0, 0.00, 7586
8, 10:53:00-000, 2949, 1939, 1010, 17, 1353.41, 17, 1351.23, 2918
8, 10:54:00-000, 1939, 686, 1253, 0, 0.00, 0, 0.00, 1851
8, 10:55:00-000, 2156, 1840, 316, 0, 0.00, 0, 0.00, 2223
8, 10:56:00-000, 5, 0, 5, 5, 1348.00, 5, 1350.20, 16
8, 10:57:00-000, 3679, 2184, 1495, 179, 1348.61, 179, 1347.67, 2651
8, 10:58:00-000, 5628, 3507, 2121, 33, 1348.54, 33, 1350.54, 6232
8, 11:00:00-000, 1081, 41, 1040, 0, 0.00, 0, 0.00, 1081
8, 11:01:00-000, 3364, 1666, 1698, 16, 1354.81, 16, 1352.00, 3332
8, 11:02:00-000, 103, 7, 96, 6, 1349.00, 6, 1349.50, 91
8, 11:04:00-000, 8510, 4590, 3920, 0, 0.00, 0, 0.00, 8505
8, 11:05:00-000, 2395, 1978, 417, 3, 1348.00, 3, 1347.67, 2394
8, 11:06:00-000, 3373, 2184, 1189, 2, 1349.00, 2, 1349.00, 3191
8, 11:07:00-000, 6033, 3585, 2448, 0, 0.00, 0, 0.00, 6211
8, 11:08:00-000, 1143, 438, 705, 2, 1349.00, 2, 1352.00, 1139
8, 11:09:00-000, 8137, 5027, 3110, 0, 0.00, 0, 0.00, 8065
8, 11:10:00-000, 1847, 646, 1201, 10, 1349.20, 10, 1349.80, 1899
8, 11:11:00-000, 7281, 4753, 2528, 0, 0.00, 0, 0.00, 6873
8, 11:12:00-000, 1746, 1304, 442, 4, 1345.00, 4, 1346.00, 2146
8, 11:13:00-000, 2070, 1853, 217, 48, 1347.29, 48, 1348.93, 1974
8, 11:14:00-000, 3954, 1797, 2157, 4, 1351.00, 4, 1350.00, 3793
8, 11:15:00-000, 3613, 2018, 1595, 17, 1349.82, 17, 1349.59, 3732
8, 11:16:00-000, 7563, 2664, 4899, 0, 0.00, 0, 0.00, 7563
8, 11:17:00-000, 4344, 1884, 2460, 2, 1351.00, 2, 1351.50, 4340
8, 11:18:00-000, 168, 86, 82, 11, 1352.82, 11, 1351.18, 146
8, 11:20:00-000, 564, 326, 238, 19, 1354.37, 19, 1350.95, 526
8, 11:21:00-000, 2064, 1749, 315, 13, 1351.15, 12, 1351.00, 2039
8, 11:22:00-000, 1054, 843, 211, 34, 1350.73, 35, 1352.94, 985
8, 11:24:00-000, 3325, 966, 2359, 10, 1351.10, 10, 1352.00, 3305
8, 11:25:00-000, 2327, 304, 2023, 20, 1346.20, 20, 1345.30, 2280
8, 11:26:00-000, 5197, 3628, 1569, 23, 1348.48, 23, 1349.78, 5148
8, 11:27:00-000, 9435, 4743, 4692, 0, 0.00, 0, 0.00, 8766
8, 11:28:00-000, 218, 88, 130, 8, 1351.00, 8, 1349.88, 881
8, 11:29:00-000, 2152, 433, 1719, 9, 1354.00, 9, 1351.00, 2134
8, 11:30:00-000, 2888, 1515, 1373, 3, 1349.00, 3, 1350.33, 2882
8, 11:31:00-000, 4887, 2299, 2588, 4, 1349.00, 4, 1347.50, 4879
8, 11:32:00-000, 2589, 2316, 273, 5, 1347.00, 2, 1350.00, 2582
8, 11:33:00-000, 3, 0, 3, 0, 0.00, 3, 1349.00, 0
8, 11:34:00-000, 2657, 12, 2645, 0, 0.00, 0, 0.00, 2657
8, 11:35:00-000, 11131, 4103, 7028, 7, 1348.71, 7, 1347.43, 11117
8, 11:36:00-000, 5201, 3787, 1414, 18, 1351.44, 18, 1352.00, 5156
8, 11:37:00-000, 338, 153, 185, 0, 0.00, 0, 0.00, 347
8, 11:38:00-000, 2125, 94, 2031, 3, 1349.67, 3, 1349.67, 2119
8, 11:39:00-000, 774, 3, 771, 1, 1348.00, 1, 1348.00, 772
8, 11:40:00-000, 3609, 1782, 1827, 21, 1351.00, 21, 1353.00, 3567
8, 11:41:00-000, 1098, 26, 1072, 0, 0.00, 0, 0.00, 1098
8, 11:42:00-000, 14813, 7531, 7282, 1, 1350.00, 1, 1350.00, 13316
8, 11:43:00-000, 2996, 2853, 143, 0, 0.00, 0, 0.00, 4491
8, 11:44:00-000, 1362, 7, 1355, 7, 1346.57, 7, 1351.00, 1348
8, 11:45:00-000, 1813, 194, 1619, 4, 1348.75, 4, 1347.00, 1805
8, 11:46:00-000, 6860, 5130, 1730, 18, 1351.61, 18, 1352.28, 6817
8, 11:47:00-000, 0, 0, 0, 0, 0.00, 0, 0.00, 7
8, 11:48:00-000, 7704, 5942, 1762, 3, 1347.33, 3, 1349.33, 7489
8, 11:49:00-000, 7114, 4550, 2564, 11, 1349.00, 11, 1349.18, 7301
8, 11:50:00-000, 4130, 2794, 1336, 1, 1349.00, 1, 1350.00, 4128
8, 11:51:00-000, 5628, 2017, 3611, 1, 1351.00, 0, 0.00, 5624
8, 11:52:00-000, 2187, 1588, 599, 7, 1349.00, 8, 1347.13, 2175
8, 11:53:00-000, 2104, 183, 1921, 26, 1351.81, 26, 1352.00, 2052
8, 11:54:00-000, 8556, 3763, 4793, 15, 1349.53, 15, 1349.33, 8526
8, 11:55:00-000, 603, 590, 13, 0, 0.00, 0, 0.00, 603
8, 11:56:00-000, 884, 794, 90, 0, 0.00, 0, 0.00, 884
8, 11:57:00-000, 2015, 848, 1167, 6, 1348.00, 6, 1346.33, 2003
8, 12:00:00-000, 2335, 1380, 955, 18, 1349.05, 18, 1349.94, 2299
8, 12:01:00-000, 1398, 1110, 288, 1, 1349.00, 1, 1348.00, 1396
8, 12:02:00-000, 423, 212, 211, 0, 0.00, 0, 0.00, 423
8, 12:04:00-000, 4838, 1634, 3204, 15, 1348.26, 15, 1352.20, 4808
8, 12:05:00-000, 3151, 1741, 1410, 1, 1352.00, 1, 1351.00, 3149
8, 12:06:00-000, 4593, 1736, 2857, 6, 1350.67, 6, 1350.67, 4581
8, 12:07:00-000, 11542, 9044, 2498, 13, 1349.07, 13, 1347.85, 11516
8, 12:08:00-000, 4834, 200, 4634, 12, 1349.83, 12, 1352.75, 4810
8, 12:09:00-000, 95, 90, 5, 0, 0.00, 0, 0.00, 95
8, 12:10:00-000, 3680, 3077, 603, 0, 0.00, 0, 0.00, 3680
8, 12:11:00-000, 1970, 266, 1704, 0, 0.00, 0, 0.00, 1970
8, 12:12:00-000, 744, 740, 4, 0, 0.00, 0, 0.00, 744
8, 12:13:00-000, 307, 185, 122, 0, 0.00, 0, 0.00, 286
8, 12:14:00-000, 1649, 725, 924, 0, 0.00, 0, 0.00, 1670
8, 12:15:00-000, 7276, 5284, 1992, 21, 1350.81, 21, 1349.86, 5767
8, 12:16:00-000, 3884, 2829, 1055, 19, 1348.05, 18, 1351.00, 5314
8, 12:17:00-000, 9701, 5287, 4414, 0, 0.00, 1, 1346.00, 9700
8, 12:18:00-000, 1751, 267, 1484, 11, 1346.91, 11, 1351.55, 1729
8, 12:19:00-000, 6380, 317, 6063, 5, 1354.00, 5, 1350.60, 6370
8, 12:21:00-000, 22, 21, 1, 1, 1353.00, 1, 1349.00, 20
8, 12:22:00-000, 21, 20, 1, 1, 1347.00, 1, 1351.00, 19
8, 12:26:00-000, 945, 30, 915, 0, 0.00, 0, 0.00, 945
8, 12:28:00-000, 2439, 924, 1515, 0, 0.00, 0, 0.00, 2439
8, 12:30:00-000, 2313, 13, 2300, 0, 0.00, 0, 0.00, 2313
8, 12:31:00-000, 4091, 1668, 2423, 43, 1347.34, 43, 1347.74, 4005
8, 12:32:00-000, 112, 106, 6, 6, 1351.00, 6, 1351.00, 100
8, 12:36:00-000, 22, 21, 1, 1, 1351.00, 1, 1351.00, 20
8, 12:38:00-000, 1540, 1530, 10, 10, 1350.30, 10, 1351.00, 1520
8, 12:42:00-000, 97, 90, 7, 0, 0.00, 0, 0.00, 97
8, 12:43:00-000, 4447, 2765, 1682, 0, 0.00, 0, 0.00, 4446
8, 12:44:00-000, 0, 0, 0, 0, 0.00, 0, 0.00, 1
8, 12:48:00-000, 3057, 1089, 1968, 0, 0.00, 0, 0.00, 3057
8, 12:49:00-000, 106, 86, 20, 6, 1354.00, 6, 1350.00, 94
8, 12:50:00-000, 978, 290, 688, 1, 1351.00, 1, 1351.00, 976
8, 12:51:00-000, 1979, 410, 1569, 0, 0.00, 0, 0.00, 1975
8, 12:52:00-000, 578, 560, 18, 0, 0.00, 0, 0.00, 25
8, 12:53:00-000, 6277, 2100, 4177, 2, 1350.00, 2, 1350.00, 6830
8, 12:54:00-000, 258, 8, 250, 0, 0.00, 0, 0.00, 258
8, 12:55:00-000, 3071, 2889, 182, 2, 1350.00, 0, 0.00, 3048
8, 12:56:00-000, 1098, 67, 1031, 0, 0.00, 2, 1348.50, 1117
8, 12:57:00-000, 1043, 953, 90, 0, 0.00, 0, 0.00, 1043
8, 12:58:00-000, 808, 739, 69, 5, 1352.40, 5, 1350.00, 798
8, 13:00:00-000, 3817, 1392, 2425, 4, 1353.50, 4, 1351.75, 3809
8, 13:01:00-000, 2359, 831, 1528, 14, 1349.50, 14, 1351.57, 2331
8, 13:02:00-000, 225, 65, 160, 11, 1347.91, 11, 1351.18, 203
8, 13:04:00-000, 54, 4, 50, 0, 0.00, 0, 0.00, 54
8, 13:05:00-000, 4947, 2335, 2612, 3, 1354.00, 3, 1350.00, 4941
8, 13:06:00-000, 1036, 897, 139, 4, 1348.00, 4, 1350.00, 1020
8, 13:07:00-000, 360, 277, 83, 0, 0.00, 0, 0.00, 361
8, 13:08:00-000, 4243, 2655, 1588, 1, 1351.00, 1, 1351.00, 4247
8, 13:09:00-000, 2999, 236, 2763, 5, 1354.20, 5, 1351.00, 2990
8, 13:10:00-000, 1772, 1218, 554, 1, 1349.00, 1, 1348.00, 1770
8, 13:11:00-000, 1573, 1453, 120, 3, 1350.00, 3, 1351.00, 1567
8, 13:12:00-000, 95, 25, 70, 17, 1352.12, 17, 1353.00, 61
8, 13:13:00-000, 1043, 986, 57, 22, 1351.68, 22, 1351.09, 999
8, 13:14:00-000, 1692, 63, 1629, 0, 0.00, 0, 0.00, 1692
8, 13:15:00-000, 6093, 2590, 3503, 10, 1350.40, 10, 1349.10, 6073
8, 13:16:00-000, 5694, 1305, 4389, 0, 0.00, 0, 0.00, 5694
8, 13:17:00-000, 815, 193, 622, 2, 1349.50, 2, 1348.50, 811
8, 13:18:00-000, 6041, 2319, 3722, 7, 1352.14, 7, 1351.00, 6027
8, 13:19:00-000, 1390, 1050, 340, 0, 0.00, 0, 0.00, 1390
8, 13:20:00-000, 1273, 1094, 179, 25, 1348.00, 25, 1349.88, 1223
8, 13:22:00-000, 6204, 2693, 3511, 1, 1345.00, 1, 1348.00, 6202
8, 13:23:00-000, 3485, 2500, 985, 2, 1351.00, 2, 1351.00, 3414
8, 13:24:00-000, 2767, 479, 2288, 4, 1347.50, 4, 1350.50, 2752
8, 13:25:00-000, 2502, 972, 1530, 1, 1349.00, 1, 1350.00, 2574
8, 13:26:00-000, 1639, 1551, 88, 1, 1349.00, 1, 1352.00, 1637
8, 13:27:00-000, 2344, 767, 1577, 2, 1350.00, 2, 1351.00, 2340
8, 13:28:00-000, 8107, 5498, 2609, 5, 1351.00, 5, 1351.00, 8097
8, 13:29:00-000, 4848, 2341, 2507, 19, 1350.42, 19, 1351.74, 4414
8, 13:30:00-000, 1115, 1010, 105, 9, 1353.33, 9, 1351.11, 1493
8, 13:31:00-000, 5922, 4272, 1650, 1, 1351.00, 1, 1349.00, 5920
8, 13:32:00-000, 4174, 2876, 1298, 3, 1352.00, 3, 1351.00, 4168
8, 13:33:00-000, 584, 391, 193, 1, 1349.00, 0, 0.00, 583
8, 13:34:00-000, 4661, 2631, 2030, 0, 0.00, 1, 1348.00, 4660
8, 13:35:00-000, 6150, 1659, 4491, 1, 1349.00, 1, 1349.00, 4569
8, 13:36:00-000, 2224, 1168, 1056, 1, 1349.00, 1, 1351.00, 3039
8, 13:37:00-000, 4900, 3118, 1782, 36, 1349.53, 36, 1348.47, 5590
8, 13:38:00-000, 970, 953, 17, 3, 1353.00, 3, 1352.00, 964
8, 13:39:00-000, 977, 859, 118, 0, 0.00, 0, 0.00, 977
8, 13:40:00-000, 60, 60, 0, 0, 0.00, 0, 0.00, 60
8, 13:41:00-000, 3338, 1783, 1555, 2, 1347.00, 2, 1352.00, 3334
8, 13:42:00-000, 3481, 3198, 283, 6, 1350.50, 6, 1351.00, 3469
8, 13:43:00-000, 2412, 831, 1581, 4, 1351.00, 4, 1348.00, 2404
8, 13:44:00-000, 5843, 4478, 1365, 0, 0.00, 0, 0.00, 5843
8, 13:45:00-000, 3831, 2072, 1759, 9, 1353.44, 9, 1351.22, 3813
8, 13:46:00-000, 157, 67, 90, 41, 1351.53, 41, 1354.00, 75
8, 13:47:00-000, 1879, 94, 1785, 18, 1348.00, 18, 1348.66, 1143
8, 13:48:00-000, 1316, 1068, 248, 11, 1350.45, 11, 1351.00, 1994
8, 13:49:00-000, 2907, 1459, 1448, 1, 1349.00, 1, 1350.00, 2905
8, 13:50:00-000, 207, 105, 102, 0, 0.00, 0, 0.00, 207
8, 13:51:00-000, 5002, 2499, 2503, 11, 1348.36, 11, 1351.09, 4980
8, 13:52:00-000, 10000, 4620, 5380, 0, 0.00, 0, 0.00, 10000
8, 13:53:00-000, 3846, 2316, 1530, 2, 1350.00, 2, 1349.00, 3842
8, 13:54:00-000, 1961, 700, 1261, 36, 1346.92, 34, 1347.79, 1891
8, 13:55:00-000, 1808, 967, 841, 47, 1351.04, 49, 1350.89, 1712
8, 13:56:00-000, 247, 83, 164, 0, 0.00, 0, 0.00, 247
8, 13:57:00-000, 4509, 3969, 540, 0, 0.00, 0, 0.00, 4509
8, 13:58:00-000, 2547, 312, 2235, 0, 0.00, 0, 0.00, 2547
8, 13:59:00-000, 2794, 678, 2116, 28, 1354.00, 28, 1351.75, 2738
8, 14:00:00-000, 6939, 3783, 3156, 10, 1349.00, 10, 1348.60, 6830
8, 14:01:00-000, 2703, 323, 2380, 3, 1350.00, 2, 1348.50, 2787
8, 14:02:00-000, 2555, 786, 1769, 3, 1352.33, 4, 1349.75, 2548
8, 14:03:00-000, 1310, 521, 789, 1, 1351.00, 1, 1351.00, 1308
8, 14:04:00-000, 3004, 612, 2392, 11, 1349.36, 11, 1348.27, 2982
8, 14:05:00-000, 2168, 2045, 123, 15, 1351.13, 16, 1350.00, 2136
8, 14:06:00-000, 4959, 4723, 236, 5, 1352.00, 4, 1351.00, 4951
8, 14:07:00-000, 97, 80, 17, 0, 0.00, 0, 0.00, 97
8, 14:08:00-000, 518, 314, 204, 24, 1346.42, 24, 1349.33, 470
8, 14:10:00-000, 2396, 209, 2187, 3, 1345.00, 3, 1349.33, 2390
8, 14:11:00-000, 6299, 3262, 3037, 0, 0.00, 0, 0.00, 4774
8, 14:12:00-000, 1556, 1396, 160, 51, 1353.68, 51, 1351.64, 2979
8, 14:13:00-000, 2717, 1038, 1679, 7, 1352.57, 7, 1352.00, 2703
8, 14:14:00-000, 6844, 2803, 4041, 4, 1350.75, 4, 1349.25, 6836
8, 14:15:00-000, 3808, 1114, 2694, 11, 1349.64, 11, 1349.73, 3786
8, 14:16:00-000, 1736, 1167, 569, 19, 1348.58, 19, 1348.26, 1698
8, 14:17:00-000, 3044, 180, 2864, 5, 1350.80, 5, 1351.00, 3034
8, 14:18:00-000, 8235, 2560, 5675, 2, 1349.00, 2, 1348.00, 7440
8, 14:19:00-000, 7572, 3125, 4447, 1, 1349.00, 1, 1349.00, 8361
8, 14:21:00-000, 2873, 608, 2265, 2, 1354.00, 2, 1351.00, 2869
8, 14:22:00-000, 1658, 528, 1130, 0, 0.00, 0, 0.00, 1357
8, 14:23:00-000, 5412, 4777, 635, 2, 1349.00, 2, 1350.00, 5709
8, 14:24:00-000, 2401, 1339, 1062, 12, 1352.08, 12, 1351.33, 2377
8, 14:25:00-000, 3344, 199, 3145, 7, 1349.00, 7, 1353.29, 3330
8, 14:30:00-000, 60, 0, 60, 0, 0.00, 0, 0.00, 0
8, 14:31:00-000, 5776, 5286, 490, 3, 1349.33, 2, 1351.00, 5725
8, 14:32:00-000, 6629, 3425, 3204, 22, 1347.22, 44, 1349.86, 6669
8, 14:33:00-000, 1186, 34, 1152, 33, 1350.87, 12, 1347.50, 1141
8, 14:34:00-000, 2533, 135, 2398, 0, 0.00, 0, 0.00, 2533
8, 14:35:00-000, 9854, 6553, 3301, 4, 1350.00, 4, 1349.00, 9772
8, 14:36:00-000, 5126, 4043, 1083, 19, 1347.10, 19, 1347.63, 5162
8, 14:37:00-000, 5175, 2889, 2286, 10, 1350.50, 10, 1350.70, 5088
8, 14:38:00-000, 6371, 4704, 1667, 6, 1350.00, 6, 1349.67, 6426
8, 14:39:00-000, 1030, 27, 1003, 3, 1348.00, 3, 1351.33, 1024
8, 14:40:00-000, 171, 99, 72, 1, 1352.00, 1, 1351.00, 169
8, 14:42:00-000, 1534, 1530, 4, 0, 0.00, 0, 0.00, 1534
8, 14:43:00-000, 1205, 707, 498, 4, 1353.50, 4, 1353.00, 641
8, 14:44:00-000, 2864, 1084, 1780, 4, 1349.75, 4, 1351.75, 3412
8, 14:45:00-000, 6173, 2617, 3556, 8, 1352.87, 8, 1351.75, 6157
8, 14:46:00-000, 3361, 3120, 241, 4, 1350.50, 4, 1351.00, 3353
8, 14:47:00-000, 6946, 2470, 4476, 0, 0.00, 0, 0.00, 6946
8, 14:49:00-000, 4112, 3183, 929, 0, 0.00, 0, 0.00, 4112
8, 14:50:00-000, 2579, 2570, 9, 30, 1346.00, 6, 1352.00, 2543
8, 14:51:00-000, 278, 148, 130, 0, 0.00, 24, 1347.54, 254
8, 14:52:00-000, 4794, 2504, 2290, 1, 1345.00, 1, 1349.00, 4787
8, 14:53:00-000, 3187, 1314, 1873, 4, 1348.75, 3, 1351.33, 3179
8, 14:54:00-000, 2328, 2030, 298, 15, 1348.93, 13, 1349.00, 2306
8, 14:55:00-000, 8289, 4100, 4189, 3, 1350.33, 6, 1349.50, 7561
8, 14:56:00-000, 1531, 1350, 181, 26, 1350.11, 26, 1350.84, 2198
8, 14:57:00-000, 2524, 1846, 678, 14, 1346.86, 14, 1351.36, 2496
8, 14:58:00-000, 62, 60, 2, 2, 1346.00, 2, 1350.00, 58
8, 14:59:00-000, 1278, 1103, 175, 0, 0.00, 0, 0.00, 1278
8, 15:00:00-000, 2472, 1639, 833, 21, 1352.71, 21, 1352.00, 2430
8, 15:01:00-000, 2780, 894, 1886, 2, 1348.00, 2, 1349.00, 2776
8, 15:02:00-000, 1894, 1036, 858, 2, 1349.50, 2, 1350.50, 1890
8, 15:03:00-000, 2898, 1321, 1577, 1, 1355.00, 1, 1351.00, 2896
8, 15:04:00-000, 6175, 2269, 3906, 7, 1350.57, 7, 1352.14, 6161
8, 15:05:00-000, 571, 308, 263, 1, 1348.00, 1, 1351.00, 463
8, 15:06:00-000, 1691, 1623, 68, 3, 1348.00, 3, 1355.00, 1791
8, 15:07:00-000, 4369, 2845, 1524, 0, 0.00, 0, 0.00, 4369
8, 15:08:00-000, 327, 163, 164, 1, 1350.00, 1, 1350.00, 325
8, 15:09:00-000, 5585, 1822, 3763, 12, 1346.58, 8, 1348.37, 5565
8, 15:10:00-000, 1935, 315, 1620, 2, 1351.00, 6, 1348.67, 1867
8, 15:11:00-000, 4392, 1830, 2562, 1, 1356.00, 1, 1348.00, 4450
8, 15:12:00-000, 2198, 1026, 1172, 106, 1351.53, 63, 1351.07, 2029
8, 15:13:00-000, 4396, 1336, 3060, 2, 1352.00, 45, 1347.46, 4349
8, 15:14:00-000, 3104, 1595, 1509, 5, 1349.00, 9, 1350.78, 3090
8, 15:15:00-000, 10451, 8133, 2318, 4, 1352.25, 0, 0.00, 8826
8, 15:16:00-000, 451, 395, 56, 2, 1353.50, 2, 1351.50, 2068
8, 15:17:00-000, 1612, 84, 1528, 0, 0.00, 0, 0.00, 1612
8, 15:18:00-000, 7375, 4889, 2486, 6, 1352.67, 6, 1351.67, 7363
8, 15:19:00-000, 2125, 245, 1880, 0, 0.00, 2, 1350.00, 2123
8, 15:20:00-000, 9259, 1077, 8182, 14, 1351.78, 12, 1351.83, 9229
8, 15:21:00-000, 3448, 3291, 157, 1, 1345.00, 1, 1349.00, 3244
8, 15:22:00-000, 243, 164, 79, 4, 1354.25, 4, 1351.75, 441
8, 15:23:00-000, 3950, 923, 3027, 0, 0.00, 0, 0.00, 3950
8, 15:24:00-000, 7, 6, 1, 1, 1349.00, 1, 1351.00, 5
8, 15:25:00-000, 3204, 1817, 1387, 0, 0.00, 0, 0.00, 3185
8, 15:26:00-000, 5571, 3897, 1674, 4, 1349.50, 4, 1351.25, 5582
8, 15:28:00-000, 5280, 3215, 2065, 0, 0.00, 0, 0.00, 4942
8, 15:29:00-000, 7467, 1323, 6144, 9, 1349.22, 9, 1349.56, 7787
8, 15:30:00-000, 8052, 4162, 3890, 3, 1348.67, 3, 1348.33, 8046
8, 15:31:00-000, 2476, 1532, 944, 6, 1351.83, 6, 1350.50, 2464
8, 15:32:00-000, 3829, 3714, 115, 14, 1351.86, 14, 1350.64, 3801
8, 15:33:00-000, 6129, 912, 5217, 15, 1351.73, 15, 1351.66, 6099
8, 15:34:00-000, 6554, 3863, 2691, 6, 1350.33, 10, 1350.20, 6538
8, 15:35:00-000, 1580, 82, 1498, 6, 1351.50, 2, 1352.00, 1572
8, 15:36:00-000, 3906, 245, 3661, 0, 0.00, 0, 0.00, 3906
8, 15:37:00-000, 3535, 1355, 2180, 4, 1349.00, 4, 1347.50, 3527
8, 15:38:00-000, 740, 0, 740, 0, 0.00, 0, 0.00, 740
8, 15:39:00-000, 1348, 659, 689, 0, 0.00, 0, 0.00, 1348
8, 15:42:00-000, 375, 372, 3, 2, 1349.00, 2, 1351.00, 371
8, 15:43:00-000, 1879, 326, 1553, 9, 1348.56, 9, 1348.33, 413
8, 15:44:00-000, 101, 8, 93, 3, 1349.00, 3, 1351.00, 1543
8, 15:46:00-000, 116, 103, 13, 1, 1353.00, 13, 1351.00, 102
8, 15:47:00-000, 12, 12, 0, 12, 1355.00, 0, 0.00, 0
8, 15:52:00-000, 864, 14, 850, 0, 0.00, 0, 0.00, 864
8, 15:53:00-000, 1641, 854, 787, 10, 1354.80, 10, 1352.00, 1621
8, 15:56:00-000, 2315, 790, 1525, 0, 0.00, 0, 0.00, 1644
8, 15:57:00-000, 1067, 226, 841, 4, 1349.00, 0, 0.00, 1734
8, 15:58:00-000, 2763, 245, 2518, 1, 1348.00, 5, 1348.40, 2757
8, 15:59:00-000, 2144, 851, 1293, 0, 0.00, 0, 0.00, 2144
8, 16:03:00-000, 889, 880, 9, 0, 0.00, 1, 1351.00, 888
8, 16:04:00-000, 1, 1, 0, 1, 1351.00, 0, 0.00, 0
8, 16:07:00-000, 1168, 68, 1100, 0, 0.00, 0, 0.00, 1168
8, 16:08:00-000, 2681, 784, 1897, 7, 1353.14, 7, 1351.00, 2667
8, 16:09:00-000, 93, 90, 3, 0, 0.00, 0, 0.00, 93
8, 16:10:00-000, 94, 84, 10, 4, 1351.00, 4, 1351.00, 86
8, 16:11:00-000, 88, 80, 8, 0, 0.00, 0, 0.00, 88
8, 16:12:00-000, 1357, 1331, 26, 6, 1351.33, 6, 1351.33, 1345
8, 16:13:00-000, 366, 122, 244, 1, 1352.00, 1, 1351.00, 364
8, 16:16:00-000, 2552, 689, 1863, 0, 0.00, 0, 0.00, 2552
8, 16:17:00-000, 3512, 1624, 1888, 0, 0.00, 0, 0.00, 3512
8, 16:18:00-000, 101, 30, 71, 0, 0.00, 0, 0.00, 101
8, 16:19:00-000, 3749, 2662, 1087, 1, 1349.00, 1, 1346.00, 3747
8, 16:20:00-000, 4584, 3118, 1466, 5, 1349.00, 5, 1348.20, 4574
8, 16:21:00-000, 2579, 148, 2431, 3, 1348.00, 3, 1349.67, 2573
8, 16:23:00-000, 430, 223, 207, 1, 1351.00, 1, 1351.00, 428
8, 16:24:00-000, 1493, 1163, 330, 20, 1349.75, 20, 1348.90, 1453
8, 16:25:00-000, 2088, 1173, 915, 0, 0.00, 0, 0.00, 2088
8, 16:26:00-000, 555, 540, 15, 0, 0.00, 0, 0.00, 555
8, 16:27:00-000, 5759, 3287, 2472, 15, 1349.53, 15, 1348.20, 5729
8, 16:28:00-000, 10845, 6070, 4775, 12, 1352.25, 12, 1352.17, 10821
8, 16:29:00-000, 4074, 2064, 2010, 3, 1346.00, 3, 1347.67, 4047
8, 16:30:00-000, 0, 0, 0, 0, 0.00, 0, 0.00, 20
