TraderType,Time,EnterQty,BuyEnterQty,SellEnterQty,BuyExecutedQty,BuyExecutedPx,SellExecutedQty,SellExecutedPx,CanceledQty
1, 09:06:00-000, 3113, 3113, 0, 838, 1347.89, 0, 0.00, 0
1, 09:07:00-000, 0, 0, 0, 0, 0.00, 0, 0.00, 2255
1, 09:08:00-000, 0, 0, 0, 0, 0.00, 0, 0.00, 20
1, 09:13:00-000, 2986, 2148, 838, 1079, 1347.93, 838, 1347.46, 0
1, 09:14:00-000, 1, 1, 0, 0, 0.00, 0, 0.00, 1069
1, 09:15:00-000, 11, 6, 5, 1, 1351.00, 5, 1352.80, 1
1, 09:16:00-000, 203, 123, 80, 48, 1348.25, 80, 1353.45, 9
1, 09:17:00-000, 188, 91, 97, 54, 1348.44, 97, 1352.46, 60
1, 09:18:00-000, 703, 450, 253, 241, 1347.31, 253, 1349.85, 79
1, 09:19:00-000, 327, 210, 117, 113, 1347.60, 116, 1351.54, 163
1, 09:20:00-000, 755, 513, 242, 211, 1347.92, 243, 1352.01, 91
1, 09:21:00-000, 360, 246, 114, 87, 1351.14, 114, 1358.94, 296
1, 09:22:00-000, 511, 329, 182, 118, 1350.25, 182, 1355.41, 192
1, 09:23:00-000, 227, 158, 69, 108, 1350.39, 69, 1350.23, 166
1, 09:24:00-000, 517, 333, 184, 204, 1348.71, 184, 1349.23, 96
1, 09:25:00-000, 333, 243, 90, 111, 1347.73, 90, 1347.66, 117
1, 09:26:00-000, 771, 516, 255, 266, 1347.94, 255, 1349.34, 121
1, 09:27:00-000, 407, 294, 113, 146, 1349.09, 113, 1349.01, 202
1, 09:28:00-000, 552, 396, 156, 194, 1349.56, 156, 1349.15, 239
1, 09:29:00-000, 284, 201, 83, 113, 1349.13, 83, 1348.45, 149
1, 09:30:00-000, 696, 470, 226, 298, 1347.93, 225, 1348.17, 157
1, 09:31:00-000, 257, 180, 77, 82, 1347.25, 78, 1347.53, 120
1, 09:32:00-000, 666, 409, 257, 245, 1348.11, 257, 1348.27, 123
1, 09:33:00-000, 314, 188, 126, 134, 1347.50, 126, 1347.80, 118
1, 09:34:00-000, 651, 431, 220, 221, 1348.46, 220, 1348.53, 131
1, 09:35:00-000, 353, 210, 143, 153, 1348.67, 143, 1347.94, 125
1, 09:36:00-000, 640, 412, 228, 221, 1348.58, 228, 1348.45, 108
1, 09:37:00-000, 336, 225, 111, 141, 1348.02, 111, 1347.71, 151
1, 09:38:00-000, 488, 289, 199, 194, 1347.80, 199, 1347.06, 106
1, 09:39:00-000, 251, 166, 85, 87, 1347.69, 85, 1348.08, 98
1, 09:40:00-000, 740, 477, 263, 241, 1347.92, 263, 1348.55, 113
1, 09:41:00-000, 311, 200, 111, 147, 1348.59, 111, 1347.69, 160
1, 09:42:00-000, 544, 311, 233, 173, 1347.95, 233, 1347.51, 109
1, 09:43:00-000, 273, 172, 101, 95, 1347.97, 101, 1348.20, 121
1, 09:44:00-000, 685, 427, 258, 271, 1347.69, 258, 1347.73, 109
1, 09:45:00-000, 301, 192, 109, 108, 1347.68, 109, 1347.76, 125
1, 09:46:00-000, 642, 439, 203, 232, 1348.42, 200, 1348.27, 98
1, 09:47:00-000, 340, 204, 136, 141, 1347.81, 139, 1348.38, 166
1, 09:48:00-000, 549, 361, 188, 229, 1348.56, 182, 1348.51, 100
1, 09:49:00-000, 316, 208, 108, 140, 1348.79, 114, 1348.21, 101
1, 09:50:00-000, 635, 390, 245, 281, 1347.94, 245, 1347.21, 116
1, 09:51:00-000, 342, 224, 118, 158, 1347.55, 118, 1346.85, 79
1, 09:52:00-000, 672, 386, 286, 266, 1348.21, 286, 1347.47, 81
1, 09:53:00-000, 322, 189, 133, 142, 1347.76, 133, 1348.17, 81
1, 09:54:00-000, 605, 356, 249, 223, 1348.55, 249, 1347.96, 101
1, 09:55:00-000, 349, 200, 149, 142, 1347.58, 149, 1347.64, 97
1, 09:56:00-000, 732, 425, 307, 298, 1347.04, 306, 1346.78, 86
1, 09:57:00-000, 230, 131, 99, 67, 1348.17, 100, 1347.83, 105
1, 09:58:00-000, 604, 345, 259, 215, 1347.31, 259, 1347.77, 81
1, 09:59:00-000, 340, 179, 161, 151, 1346.46, 161, 1346.55, 105
1, 10:00:00-000, 571, 367, 204, 202, 1348.66, 204, 1348.76, 70
1, 10:01:00-000, 294, 130, 164, 146, 1346.98, 164, 1345.79, 98
1, 10:02:00-000, 683, 486, 197, 263, 1348.33, 197, 1348.38, 45
1, 10:03:00-000, 320, 206, 114, 123, 1349.17, 114, 1349.66, 168
1, 10:04:00-000, 599, 352, 247, 236, 1348.59, 247, 1348.18, 94
1, 10:05:00-000, 282, 152, 130, 146, 1347.91, 130, 1346.82, 102
1, 10:06:00-000, 628, 369, 259, 243, 1348.50, 256, 1347.79, 54
1, 10:07:00-000, 317, 162, 155, 137, 1347.13, 158, 1346.62, 94
1, 10:08:00-000, 558, 325, 233, 184, 1347.62, 233, 1347.48, 63
1, 10:09:00-000, 324, 203, 121, 139, 1348.67, 121, 1347.73, 101
1, 10:10:00-000, 678, 426, 252, 293, 1348.10, 252, 1346.92, 110
1, 10:11:00-000, 354, 217, 137, 142, 1347.55, 137, 1346.73, 94
1, 10:12:00-000, 565, 339, 226, 230, 1347.14, 226, 1347.28, 124
1, 10:13:00-000, 290, 177, 113, 120, 1347.59, 113, 1346.88, 68
1, 10:14:00-000, 512, 320, 192, 166, 1348.42, 192, 1348.89, 90
1, 10:15:00-000, 362, 223, 139, 176, 1348.12, 139, 1347.55, 92
1, 10:16:00-000, 731, 454, 277, 267, 1347.52, 277, 1347.53, 86
1, 10:17:00-000, 301, 183, 118, 106, 1348.81, 118, 1347.65, 172
1, 10:18:00-000, 620, 355, 265, 228, 1348.22, 265, 1347.64, 126
1, 10:19:00-000, 253, 148, 105, 106, 1348.18, 105, 1347.48, 65
1, 10:20:00-000, 601, 365, 236, 232, 1348.57, 236, 1347.71, 81
1, 10:21:00-000, 353, 249, 104, 142, 1347.36, 104, 1348.04, 101
1, 10:22:00-000, 606, 392, 214, 228, 1347.88, 214, 1347.70, 140
1, 10:23:00-000, 337, 187, 150, 149, 1347.82, 150, 1347.91, 117
1, 10:24:00-000, 626, 389, 237, 257, 1348.14, 237, 1347.05, 80
1, 10:25:00-000, 292, 183, 109, 120, 1348.05, 109, 1348.73, 111
1, 10:26:00-000, 633, 371, 262, 274, 1347.86, 262, 1347.28, 77
1, 10:27:00-000, 281, 142, 139, 116, 1348.12, 139, 1346.02, 73
1, 10:28:00-000, 595, 348, 247, 234, 1348.38, 247, 1347.20, 71
1, 10:29:00-000, 243, 154, 89, 69, 1348.64, 89, 1349.36, 75
1, 10:30:00-000, 623, 383, 240, 243, 1348.41, 240, 1347.64, 137
1, 10:31:00-000, 314, 180, 134, 145, 1348.02, 134, 1347.48, 89
1, 10:32:00-000, 571, 321, 250, 238, 1348.33, 250, 1347.57, 61
1, 10:33:00-000, 350, 209, 141, 153, 1347.49, 141, 1347.01, 61
1, 10:34:00-000, 618, 372, 246, 243, 1347.23, 246, 1346.75, 85
1, 10:35:00-000, 334, 198, 136, 154, 1347.49, 136, 1347.00, 73
1, 10:36:00-000, 546, 340, 206, 223, 1347.58, 206, 1346.88, 91
1, 10:37:00-000, 295, 193, 102, 104, 1348.89, 102, 1348.48, 85
1, 10:38:00-000, 642, 349, 293, 297, 1347.75, 293, 1347.52, 91
1, 10:39:00-000, 234, 122, 112, 85, 1347.55, 112, 1346.93, 60
1, 10:40:00-000, 607, 365, 242, 265, 1347.48, 242, 1346.61, 71
1, 10:41:00-000, 342, 199, 143, 143, 1348.96, 143, 1349.01, 70
1, 10:42:00-000, 633, 363, 270, 287, 1347.48, 270, 1347.37, 62
1, 10:43:00-000, 257, 135, 122, 138, 1347.30, 122, 1346.63, 36
1, 10:44:00-000, 685, 444, 241, 258, 1348.55, 241, 1348.17, 78
1, 10:45:00-000, 266, 161, 105, 86, 1349.06, 105, 1347.35, 135
1, 10:46:00-000, 676, 387, 289, 269, 1347.35, 289, 1347.10, 89
1, 10:47:00-000, 289, 152, 137, 101, 1348.76, 137, 1347.52, 117
1, 10:48:00-000, 665, 410, 255, 288, 1347.49, 255, 1347.01, 69
1, 10:49:00-000, 264, 152, 112, 119, 1347.99, 112, 1347.21, 85
1, 10:50:00-000, 601, 368, 233, 285, 1348.37, 233, 1347.62, 67
1, 10:51:00-000, 299, 180, 119, 120, 1347.72, 119, 1347.00, 60
1, 10:52:00-000, 655, 397, 258, 282, 1347.82, 258, 1346.90, 85
1, 10:53:00-000, 299, 133, 166, 123, 1348.00, 166, 1348.08, 69
1, 10:54:00-000, 651, 404, 247, 288, 1348.28, 247, 1347.74, 64
1, 10:55:00-000, 330, 202, 128, 144, 1348.85, 128, 1348.29, 84
1, 10:56:00-000, 579, 308, 271, 252, 1347.06, 271, 1347.13, 58
1, 10:57:00-000, 337, 217, 120, 129, 1349.37, 120, 1348.75, 59
1, 10:58:00-000, 656, 339, 317, 272, 1348.01, 311, 1347.72, 89
1, 10:59:00-000, 314, 189, 125, 111, 1347.96, 131, 1348.50, 68
1, 11:00:00-000, 595, 347, 248, 258, 1348.19, 248, 1347.28, 88
1, 11:01:00-000, 340, 206, 134, 115, 1348.86, 134, 1346.33, 67
1, 11:02:00-000, 636, 388, 248, 282, 1348.14, 248, 1348.23, 102
1, 11:03:00-000, 361, 230, 131, 163, 1347.76, 131, 1347.34, 95
1, 11:04:00-000, 693, 350, 343, 312, 1347.40, 343, 1346.92, 56
1, 11:05:00-000, 355, 199, 156, 139, 1348.19, 156, 1347.70, 51
1, 11:06:00-000, 625, 377, 248, 269, 1348.04, 248, 1347.24, 87
1, 11:07:00-000, 284, 176, 108, 116, 1347.96, 108, 1347.46, 83
1, 11:08:00-000, 602, 358, 244, 281, 1348.44, 244, 1346.75, 60
1, 11:09:00-000, 313, 210, 103, 130, 1349.48, 103, 1348.36, 82
1, 11:10:00-000, 615, 360, 255, 273, 1347.96, 255, 1347.67, 89
1, 11:11:00-000, 377, 191, 186, 159, 1347.18, 186, 1346.51, 61
1, 11:12:00-000, 652, 410, 242, 309, 1347.80, 242, 1347.29, 70
1, 11:13:00-000, 356, 190, 166, 150, 1347.41, 166, 1346.85, 56
1, 11:14:00-000, 656, 400, 256, 261, 1347.96, 256, 1347.15, 74
1, 11:15:00-000, 308, 166, 142, 129, 1347.29, 142, 1348.08, 108
1, 11:16:00-000, 651, 354, 297, 280, 1347.25, 297, 1346.80, 62
1, 11:17:00-000, 285, 134, 151, 105, 1348.11, 151, 1347.39, 56
1, 11:18:00-000, 649, 367, 282, 306, 1347.90, 282, 1347.64, 60
1, 11:19:00-000, 338, 162, 176, 122, 1347.02, 176, 1346.66, 46
1, 11:20:00-000, 560, 338, 222, 226, 1348.48, 222, 1348.22, 64
1, 11:21:00-000, 360, 202, 158, 173, 1347.04, 158, 1346.25, 55
1, 11:22:00-000, 586, 344, 242, 247, 1347.25, 242, 1346.59, 61
1, 11:23:00-000, 298, 143, 155, 111, 1347.32, 155, 1345.57, 86
1, 11:24:00-000, 585, 351, 234, 249, 1348.28, 234, 1347.55, 57
1, 11:25:00-000, 275, 140, 135, 102, 1348.14, 135, 1347.36, 86
1, 11:26:00-000, 548, 307, 241, 205, 1347.67, 241, 1347.23, 76
1, 11:27:00-000, 326, 133, 193, 109, 1345.90, 193, 1345.04, 43
1, 11:28:00-000, 599, 327, 272, 263, 1347.59, 272, 1346.60, 59
1, 11:29:00-000, 301, 184, 117, 123, 1348.40, 117, 1347.53, 48
1, 11:30:00-000, 637, 392, 245, 295, 1347.77, 245, 1346.79, 85
1, 11:31:00-000, 304, 166, 138, 138, 1348.34, 138, 1346.48, 76
1, 11:32:00-000, 612, 379, 233, 225, 1348.19, 233, 1346.79, 47
1, 11:33:00-000, 250, 152, 98, 124, 1347.60, 98, 1347.49, 111
1, 11:34:00-000, 547, 316, 231, 255, 1347.53, 231, 1346.47, 52
1, 11:35:00-000, 331, 192, 139, 146, 1347.58, 139, 1347.27, 65
1, 11:36:00-000, 634, 364, 270, 256, 1347.92, 270, 1346.79, 75
1, 11:37:00-000, 259, 190, 69, 108, 1348.57, 69, 1347.86, 67
1, 11:38:00-000, 569, 308, 261, 236, 1347.81, 261, 1347.22, 96
1, 11:39:00-000, 266, 139, 127, 109, 1347.52, 127, 1345.53, 62
1, 11:40:00-000, 641, 389, 252, 255, 1347.87, 252, 1347.28, 77
1, 11:41:00-000, 316, 191, 125, 130, 1347.88, 125, 1346.47, 79
1, 11:42:00-000, 570, 307, 263, 226, 1347.41, 263, 1346.64, 95
1, 11:43:00-000, 341, 206, 135, 125, 1348.22, 135, 1347.59, 55
1, 11:44:00-000, 539, 301, 238, 241, 1347.64, 238, 1346.79, 94
1, 11:45:00-000, 305, 178, 127, 93, 1348.04, 127, 1348.31, 45
1, 11:46:00-000, 677, 430, 247, 266, 1347.99, 247, 1348.43, 117
1, 11:47:00-000, 275, 171, 104, 114, 1349.54, 104, 1349.17, 112
1, 11:48:00-000, 597, 346, 251, 235, 1348.14, 251, 1347.41, 82
1, 11:49:00-000, 302, 177, 125, 68, 1347.96, 125, 1347.45, 110
1, 11:50:00-000, 664, 434, 230, 247, 1348.13, 230, 1347.70, 123
1, 11:51:00-000, 294, 166, 128, 137, 1347.99, 128, 1347.86, 121
1, 11:52:00-000, 631, 371, 260, 283, 1348.27, 260, 1348.05, 65
1, 11:53:00-000, 289, 195, 94, 68, 1347.62, 94, 1348.25, 109
1, 11:54:00-000, 646, 400, 246, 252, 1348.29, 246, 1347.88, 166
1, 11:55:00-000, 299, 196, 103, 127, 1348.65, 103, 1347.49, 98
1, 11:56:00-000, 705, 443, 262, 263, 1349.37, 262, 1349.00, 108
1, 11:57:00-000, 291, 163, 128, 105, 1347.54, 128, 1347.57, 130
1, 11:58:00-000, 583, 389, 194, 259, 1349.01, 192, 1348.52, 86
1, 11:59:00-000, 289, 168, 121, 134, 1348.39, 123, 1348.27, 79
1, 12:00:00-000, 625, 339, 286, 286, 1347.21, 286, 1347.09, 60
1, 12:01:00-000, 310, 190, 120, 115, 1348.66, 120, 1348.15, 67
1, 12:02:00-000, 656, 421, 235, 222, 1348.57, 235, 1348.68, 93
1, 12:03:00-000, 320, 205, 115, 110, 1349.06, 115, 1348.86, 151
1, 12:04:00-000, 641, 384, 257, 254, 1348.60, 255, 1348.48, 124
1, 12:05:00-000, 285, 159, 126, 141, 1347.64, 128, 1347.32, 99
1, 12:06:00-000, 636, 397, 239, 262, 1348.48, 239, 1347.65, 70
1, 12:07:00-000, 302, 177, 125, 138, 1348.24, 125, 1347.46, 106
1, 12:08:00-000, 613, 369, 244, 227, 1347.78, 244, 1347.72, 77
1, 12:09:00-000, 266, 150, 116, 94, 1347.74, 116, 1347.58, 119
1, 12:10:00-000, 558, 333, 225, 238, 1348.06, 225, 1346.86, 75
1, 12:11:00-000, 376, 228, 148, 153, 1347.41, 148, 1347.13, 60
1, 12:12:00-000, 606, 344, 262, 277, 1347.77, 262, 1347.18, 94
1, 12:13:00-000, 356, 211, 145, 153, 1348.32, 145, 1347.42, 62
1, 12:14:00-000, 602, 356, 246, 239, 1347.68, 240, 1347.45, 82
1, 12:15:00-000, 263, 166, 97, 106, 1348.15, 103, 1348.15, 86
1, 12:16:00-000, 590, 334, 256, 261, 1347.55, 256, 1346.65, 80
1, 12:17:00-000, 306, 183, 123, 121, 1347.78, 123, 1347.31, 59
1, 12:18:00-000, 629, 378, 251, 272, 1348.24, 251, 1347.82, 93
1, 12:19:00-000, 302, 156, 146, 142, 1347.62, 146, 1346.96, 58
1, 12:20:00-000, 569, 355, 214, 179, 1348.43, 214, 1347.61, 70
1, 12:21:00-000, 341, 204, 137, 110, 1348.36, 137, 1347.36, 107
1, 12:22:00-000, 668, 395, 273, 285, 1348.46, 273, 1347.75, 145
1, 12:23:00-000, 286, 174, 112, 97, 1347.72, 112, 1347.07, 89
1, 12:24:00-000, 568, 301, 267, 176, 1348.03, 267, 1346.79, 103
1, 12:25:00-000, 319, 184, 135, 112, 1348.06, 135, 1347.45, 78
1, 12:26:00-000, 647, 434, 213, 230, 1348.52, 213, 1348.02, 132
1, 12:27:00-000, 250, 148, 102, 124, 1348.24, 102, 1348.29, 112
1, 12:28:00-000, 695, 409, 286, 284, 1348.07, 286, 1347.14, 84
1, 12:29:00-000, 365, 231, 134, 178, 1347.42, 134, 1347.00, 98
1, 12:30:00-000, 582, 402, 180, 248, 1348.58, 180, 1347.05, 96
1, 12:31:00-000, 285, 198, 87, 147, 1348.02, 87, 1346.91, 120
1, 12:32:00-000, 745, 420, 325, 291, 1348.27, 325, 1346.58, 67
1, 12:33:00-000, 279, 164, 115, 121, 1348.07, 115, 1347.26, 90
1, 12:34:00-000, 613, 361, 252, 266, 1348.15, 252, 1347.41, 83
1, 12:35:00-000, 342, 208, 134, 137, 1348.57, 134, 1347.85, 83
1, 12:36:00-000, 555, 316, 239, 211, 1348.07, 239, 1347.77, 93
1, 12:37:00-000, 305, 176, 129, 116, 1348.23, 129, 1348.11, 68
1, 12:38:00-000, 624, 367, 257, 227, 1348.53, 257, 1347.62, 97
1, 12:39:00-000, 297, 173, 124, 148, 1348.51, 124, 1348.09, 92
1, 12:40:00-000, 686, 349, 337, 237, 1347.45, 337, 1346.12, 96
1, 12:41:00-000, 285, 173, 112, 93, 1349.18, 112, 1348.32, 74
1, 12:42:00-000, 619, 348, 271, 241, 1347.54, 271, 1347.18, 99
1, 12:43:00-000, 287, 164, 123, 106, 1347.25, 123, 1346.84, 59
1, 12:44:00-000, 560, 357, 203, 231, 1348.23, 203, 1347.74, 91
1, 12:45:00-000, 259, 177, 82, 76, 1349.67, 82, 1349.13, 114
1, 12:46:00-000, 606, 367, 239, 221, 1348.36, 239, 1347.83, 121
1, 12:47:00-000, 376, 219, 157, 161, 1348.10, 157, 1347.35, 103
1, 12:48:00-000, 617, 399, 218, 229, 1349.01, 218, 1347.98, 121
1, 12:49:00-000, 330, 207, 123, 143, 1348.66, 123, 1348.09, 125
1, 12:50:00-000, 514, 318, 196, 197, 1348.93, 193, 1348.31, 99
1, 12:51:00-000, 301, 211, 90, 112, 1348.88, 93, 1347.89, 93
1, 12:52:00-000, 711, 454, 257, 292, 1347.79, 257, 1347.76, 113
1, 12:53:00-000, 275, 163, 112, 102, 1348.56, 112, 1347.99, 132
1, 12:54:00-000, 599, 361, 238, 236, 1347.81, 238, 1347.17, 83
1, 12:55:00-000, 289, 195, 94, 113, 1348.12, 94, 1347.58, 113
1, 12:56:00-000, 568, 364, 204, 226, 1348.45, 204, 1346.64, 96
1, 12:57:00-000, 327, 173, 154, 155, 1347.07, 154, 1346.47, 91
1, 12:58:00-000, 616, 389, 227, 248, 1348.02, 227, 1347.12, 90
1, 12:59:00-000, 258, 134, 124, 124, 1347.09, 124, 1346.94, 83
1, 13:00:00-000, 608, 354, 254, 269, 1347.45, 254, 1346.30, 48
1, 13:01:00-000, 232, 155, 77, 84, 1347.83, 77, 1347.89, 63
1, 13:02:00-000, 697, 386, 311, 331, 1348.04, 311, 1346.92, 65
1, 13:03:00-000, 302, 172, 130, 120, 1348.01, 130, 1347.49, 61
1, 13:04:00-000, 677, 429, 248, 228, 1349.28, 248, 1348.99, 92
1, 13:05:00-000, 255, 127, 128, 112, 1347.52, 128, 1347.41, 138
1, 13:06:00-000, 559, 337, 222, 226, 1348.25, 222, 1347.30, 67
1, 13:07:00-000, 321, 156, 165, 140, 1348.08, 165, 1345.78, 77
1, 13:08:00-000, 583, 296, 287, 240, 1347.58, 287, 1346.56, 49
1, 13:09:00-000, 303, 169, 134, 96, 1348.30, 134, 1347.04, 45
1, 13:10:00-000, 565, 369, 196, 211, 1348.96, 196, 1347.61, 85
1, 13:11:00-000, 313, 193, 120, 111, 1347.98, 120, 1348.28, 103
1, 13:12:00-000, 619, 364, 255, 247, 1348.03, 255, 1347.11, 144
1, 13:13:00-000, 331, 206, 125, 140, 1348.32, 125, 1347.67, 95
1, 13:14:00-000, 603, 353, 250, 276, 1348.04, 250, 1346.83, 81
1, 13:15:00-000, 285, 183, 102, 101, 1349.31, 102, 1349.46, 58
1, 13:16:00-000, 526, 328, 198, 210, 1347.90, 198, 1347.40, 117
1, 13:17:00-000, 280, 176, 104, 123, 1347.99, 104, 1347.89, 72
1, 13:18:00-000, 673, 408, 265, 293, 1347.95, 265, 1347.50, 78
1, 13:19:00-000, 310, 167, 143, 135, 1348.42, 143, 1347.27, 82
1, 13:20:00-000, 519, 312, 207, 224, 1348.65, 207, 1348.53, 57
1, 13:21:00-000, 249, 177, 72, 93, 1349.37, 72, 1347.77, 66
1, 13:22:00-000, 629, 373, 256, 255, 1348.96, 256, 1348.31, 110
1, 13:23:00-000, 359, 200, 159, 155, 1347.29, 159, 1347.40, 68
1, 13:24:00-000, 614, 338, 276, 237, 1347.57, 276, 1347.26, 87
1, 13:25:00-000, 238, 133, 105, 59, 1347.18, 105, 1347.40, 100
1, 13:26:00-000, 635, 357, 278, 211, 1348.22, 278, 1347.37, 97
1, 13:27:00-000, 359, 209, 150, 123, 1347.69, 150, 1346.38, 129
1, 13:28:00-000, 593, 386, 207, 242, 1348.44, 207, 1347.93, 101
1, 13:29:00-000, 318, 211, 107, 131, 1348.93, 107, 1347.67, 93
1, 13:30:00-000, 625, 398, 227, 303, 1348.91, 227, 1348.39, 106
1, 13:31:00-000, 282, 164, 118, 139, 1347.69, 118, 1347.05, 88
1, 13:32:00-000, 618, 390, 228, 249, 1348.20, 228, 1347.28, 67
1, 13:33:00-000, 291, 178, 113, 126, 1348.31, 113, 1347.62, 88
1, 13:34:00-000, 632, 367, 265, 270, 1347.76, 265, 1347.17, 79
1, 13:35:00-000, 317, 188, 129, 131, 1347.13, 129, 1346.67, 89
1, 13:36:00-000, 583, 337, 246, 238, 1347.95, 246, 1346.70, 93
1, 13:37:00-000, 283, 166, 117, 121, 1347.51, 117, 1346.48, 63
1, 13:38:00-000, 702, 452, 250, 273, 1348.04, 250, 1347.70, 70
1, 13:39:00-000, 276, 167, 109, 129, 1348.37, 109, 1347.42, 130
1, 13:40:00-000, 657, 367, 290, 260, 1347.76, 290, 1346.67, 84
1, 13:41:00-000, 268, 135, 133, 102, 1346.55, 133, 1346.94, 68
1, 13:42:00-000, 550, 305, 245, 231, 1347.21, 245, 1347.11, 52
1, 13:43:00-000, 299, 148, 151, 121, 1347.14, 151, 1347.46, 71
1, 13:44:00-000, 549, 354, 195, 212, 1348.12, 195, 1347.46, 55
1, 13:45:00-000, 323, 163, 160, 181, 1346.66, 160, 1346.01, 61
1, 13:46:00-000, 620, 356, 264, 258, 1347.42, 264, 1347.29, 64
1, 13:47:00-000, 313, 191, 122, 165, 1347.82, 122, 1347.38, 69
1, 13:48:00-000, 532, 328, 204, 188, 1347.62, 204, 1347.67, 64
1, 13:49:00-000, 347, 203, 144, 148, 1347.97, 144, 1348.34, 86
1, 13:50:00-000, 583, 318, 265, 217, 1348.12, 265, 1347.36, 90
1, 13:51:00-000, 225, 137, 88, 123, 1347.68, 88, 1346.49, 57
1, 13:52:00-000, 588, 317, 271, 251, 1347.60, 271, 1346.70, 35
1, 13:53:00-000, 298, 177, 121, 149, 1349.07, 121, 1347.43, 41
1, 13:54:00-000, 599, 372, 227, 198, 1348.31, 227, 1348.24, 67
1, 13:55:00-000, 311, 179, 132, 125, 1348.06, 132, 1348.10, 134
1, 13:56:00-000, 641, 373, 268, 245, 1348.66, 268, 1347.60, 112
1, 13:57:00-000, 307, 186, 121, 126, 1349.95, 121, 1348.41, 97
1, 13:58:00-000, 639, 373, 266, 211, 1347.81, 266, 1347.67, 87
1, 13:59:00-000, 349, 231, 118, 150, 1348.78, 118, 1347.79, 108
1, 14:00:00-000, 698, 437, 261, 325, 1348.33, 261, 1347.19, 104
1, 14:01:00-000, 262, 149, 113, 137, 1348.50, 113, 1347.33, 91
1, 14:02:00-000, 579, 328, 251, 204, 1347.03, 251, 1347.06, 66
1, 14:03:00-000, 278, 191, 87, 98, 1349.15, 87, 1347.79, 91
1, 14:04:00-000, 610, 365, 245, 234, 1348.27, 245, 1347.24, 125
1, 14:05:00-000, 291, 163, 128, 158, 1346.70, 128, 1345.90, 87
1, 14:06:00-000, 630, 370, 260, 266, 1347.59, 260, 1345.96, 54
1, 14:07:00-000, 358, 216, 142, 164, 1347.97, 142, 1347.76, 74
1, 14:08:00-000, 717, 470, 247, 322, 1348.26, 247, 1347.02, 78
1, 14:09:00-000, 357, 226, 131, 190, 1347.62, 131, 1347.15, 121
1, 14:10:00-000, 576, 328, 248, 199, 1347.94, 248, 1347.03, 74
1, 14:11:00-000, 251, 119, 132, 121, 1347.67, 132, 1346.43, 57
1, 14:12:00-000, 571, 341, 230, 243, 1347.91, 230, 1347.59, 59
1, 14:13:00-000, 347, 210, 137, 157, 1347.88, 137, 1347.63, 67
1, 14:14:00-000, 617, 320, 297, 218, 1347.85, 297, 1347.07, 69
1, 14:15:00-000, 320, 163, 157, 155, 1347.20, 157, 1347.04, 72
1, 14:16:00-000, 655, 379, 276, 280, 1347.80, 276, 1346.64, 45
1, 14:17:00-000, 298, 180, 118, 125, 1348.85, 118, 1347.51, 78
1, 14:18:00-000, 580, 321, 259, 245, 1347.34, 259, 1346.40, 61
1, 14:19:00-000, 358, 209, 149, 164, 1348.44, 149, 1348.11, 58
1, 14:20:00-000, 674, 378, 296, 313, 1347.53, 296, 1346.53, 69
1, 14:21:00-000, 350, 228, 122, 123, 1348.39, 122, 1347.97, 65
1, 14:22:00-000, 625, 340, 285, 273, 1347.25, 285, 1346.44, 80
1, 14:23:00-000, 277, 179, 98, 131, 1346.90, 98, 1346.75, 76
1, 14:24:00-000, 666, 390, 276, 298, 1346.90, 275, 1346.57, 84
1, 14:25:00-000, 281, 172, 109, 131, 1348.83, 110, 1348.18, 71
1, 14:26:00-000, 605, 343, 262, 273, 1347.28, 262, 1346.80, 44
1, 14:27:00-000, 268, 127, 141, 126, 1346.65, 141, 1345.95, 48
1, 14:28:00-000, 694, 337, 357, 289, 1346.97, 357, 1345.92, 23
1, 14:29:00-000, 358, 226, 132, 136, 1348.27, 132, 1347.77, 48
1, 14:30:00-000, 503, 254, 249, 178, 1347.94, 249, 1347.62, 87
1, 14:31:00-000, 286, 190, 96, 113, 1349.23, 96, 1348.85, 68
1, 14:32:00-000, 606, 322, 284, 252, 1347.69, 284, 1346.61, 71
1, 14:33:00-000, 280, 166, 114, 107, 1347.28, 114, 1347.22, 56
1, 14:34:00-000, 622, 342, 280, 294, 1348.04, 280, 1347.78, 76
1, 14:35:00-000, 309, 184, 125, 132, 1347.49, 125, 1347.24, 58
1, 14:36:00-000, 608, 345, 263, 238, 1348.89, 263, 1347.83, 54
1, 14:37:00-000, 358, 201, 157, 172, 1348.17, 157, 1347.40, 89
1, 14:38:00-000, 625, 336, 289, 245, 1347.64, 289, 1346.61, 50
1, 14:39:00-000, 288, 147, 141, 124, 1347.35, 141, 1347.18, 63
1, 14:40:00-000, 628, 412, 216, 215, 1349.14, 216, 1348.47, 68
1, 14:41:00-000, 339, 221, 118, 146, 1348.31, 118, 1347.67, 142
1, 14:42:00-000, 612, 374, 238, 251, 1348.59, 238, 1347.65, 111
1, 14:43:00-000, 270, 170, 100, 130, 1348.50, 100, 1349.10, 92
1, 14:44:00-000, 631, 344, 287, 231, 1347.58, 286, 1347.49, 78
1, 14:45:00-000, 322, 195, 127, 141, 1347.53, 128, 1347.29, 78
1, 14:46:00-000, 682, 426, 256, 292, 1348.16, 256, 1347.53, 98
1, 14:47:00-000, 324, 224, 100, 109, 1347.91, 100, 1347.60, 102
1, 14:48:00-000, 591, 344, 247, 322, 1347.98, 247, 1346.96, 84
1, 14:49:00-000, 303, 150, 153, 122, 1347.92, 153, 1346.85, 56
1, 14:50:00-000, 605, 369, 236, 256, 1347.65, 236, 1347.46, 54
1, 14:51:00-000, 331, 176, 155, 113, 1347.98, 155, 1347.81, 77
1, 14:52:00-000, 602, 346, 256, 238, 1347.64, 256, 1346.99, 101
1, 14:53:00-000, 305, 193, 112, 132, 1348.53, 112, 1347.38, 71
1, 14:54:00-000, 631, 346, 285, 242, 1348.29, 285, 1347.19, 100
1, 14:55:00-000, 315, 179, 136, 142, 1347.81, 136, 1346.49, 69
1, 14:56:00-000, 646, 368, 278, 289, 1347.51, 278, 1346.03, 70
1, 14:57:00-000, 318, 191, 127, 157, 1347.36, 127, 1346.96, 40
1, 14:58:00-000, 645, 398, 247, 303, 1347.93, 247, 1347.39, 65
1, 14:59:00-000, 246, 157, 89, 124, 1347.91, 89, 1347.21, 75
1, 15:00:00-000, 696, 362, 334, 293, 1346.55, 334, 1345.87, 45
1, 15:01:00-000, 350, 198, 152, 141, 1348.19, 152, 1347.40, 63
1, 15:02:00-000, 466, 280, 186, 205, 1348.14, 186, 1347.03, 79
1, 15:03:00-000, 248, 146, 102, 114, 1348.36, 102, 1347.57, 57
1, 15:04:00-000, 654, 326, 328, 241, 1347.58, 328, 1346.27, 49
1, 15:05:00-000, 289, 159, 130, 136, 1347.68, 130, 1346.36, 59
1, 15:06:00-000, 667, 365, 302, 252, 1347.94, 302, 1347.44, 42
1, 15:07:00-000, 306, 164, 142, 136, 1347.48, 142, 1346.15, 82
1, 15:08:00-000, 569, 359, 210, 210, 1348.18, 210, 1346.86, 80
1, 15:09:00-000, 261, 134, 127, 110, 1347.63, 127, 1346.98, 67
1, 15:10:00-000, 559, 312, 247, 220, 1347.94, 247, 1346.82, 82
1, 15:11:00-000, 317, 180, 137, 136, 1347.40, 137, 1346.67, 63
1, 15:12:00-000, 509, 334, 175, 228, 1348.25, 175, 1347.85, 79
1, 15:13:00-000, 343, 193, 150, 146, 1347.79, 150, 1347.39, 81
1, 15:14:00-000, 605, 346, 259, 271, 1347.74, 259, 1347.03, 65
1, 15:15:00-000, 359, 220, 139, 172, 1347.54, 139, 1347.04, 60
1, 15:16:00-000, 622, 375, 247, 289, 1347.25, 247, 1346.79, 66
1, 15:17:00-000, 309, 173, 136, 132, 1347.99, 136, 1347.65, 71
1, 15:18:00-000, 632, 345, 287, 241, 1347.19, 287, 1346.53, 49
1, 15:19:00-000, 248, 131, 117, 87, 1346.53, 117, 1345.89, 99
1, 15:20:00-000, 644, 389, 255, 283, 1347.66, 255, 1346.64, 62
1, 15:21:00-000, 259, 166, 93, 115, 1347.70, 93, 1347.23, 72
1, 15:22:00-000, 711, 430, 281, 262, 1347.91, 281, 1347.71, 89
1, 15:23:00-000, 312, 176, 136, 140, 1346.85, 136, 1346.58, 113
1, 15:24:00-000, 638, 341, 297, 287, 1347.21, 297, 1345.96, 89
1, 15:25:00-000, 263, 152, 111, 93, 1348.10, 111, 1347.14, 39
1, 15:26:00-000, 616, 364, 252, 251, 1347.82, 252, 1346.86, 48
1, 15:27:00-000, 265, 169, 96, 135, 1347.26, 96, 1347.50, 77
1, 15:28:00-000, 629, 365, 264, 258, 1348.59, 264, 1347.53, 104
1, 15:29:00-000, 242, 154, 88, 101, 1347.69, 88, 1348.01, 66
1, 15:30:00-000, 655, 393, 262, 285, 1348.84, 262, 1347.93, 76
1, 15:31:00-000, 300, 153, 147, 102, 1347.42, 147, 1346.93, 82
1, 15:32:00-000, 677, 393, 284, 276, 1347.58, 284, 1346.82, 76
1, 15:33:00-000, 245, 135, 110, 101, 1348.53, 108, 1347.34, 91
1, 15:34:00-000, 546, 282, 264, 189, 1347.85, 266, 1346.51, 73
1, 15:35:00-000, 354, 209, 145, 158, 1348.19, 145, 1346.99, 52
1, 15:36:00-000, 565, 293, 272, 261, 1346.74, 272, 1345.41, 52
1, 15:37:00-000, 309, 184, 125, 133, 1348.03, 125, 1347.04, 55
1, 15:38:00-000, 635, 387, 248, 260, 1348.27, 248, 1347.37, 61
1, 15:39:00-000, 273, 185, 88, 108, 1348.46, 88, 1346.92, 85
1, 15:40:00-000, 593, 392, 201, 214, 1349.21, 201, 1347.31, 121
1, 15:41:00-000, 234, 135, 99, 98, 1348.85, 99, 1347.64, 123
1, 15:42:00-000, 607, 359, 248, 199, 1347.39, 248, 1346.98, 86
1, 15:43:00-000, 315, 159, 156, 117, 1347.44, 156, 1346.98, 130
1, 15:44:00-000, 640, 350, 290, 222, 1348.22, 290, 1346.65, 72
1, 15:45:00-000, 302, 167, 135, 141, 1347.43, 135, 1347.20, 76
1, 15:46:00-000, 629, 402, 227, 301, 1347.60, 227, 1347.37, 91
1, 15:47:00-000, 295, 170, 125, 151, 1348.15, 125, 1346.65, 61
1, 15:48:00-000, 535, 357, 178, 227, 1348.27, 178, 1347.46, 42
1, 15:49:00-000, 334, 200, 134, 158, 1348.55, 134, 1346.90, 104
1, 15:50:00-000, 684, 431, 253, 282, 1348.29, 253, 1347.72, 69
1, 15:51:00-000, 285, 178, 107, 106, 1348.42, 107, 1347.72, 119
1, 15:52:00-000, 512, 292, 220, 233, 1347.58, 220, 1346.72, 90
1, 15:53:00-000, 393, 242, 151, 158, 1347.74, 151, 1346.55, 61
1, 15:54:00-000, 612, 348, 264, 229, 1348.31, 264, 1346.97, 120
1, 15:55:00-000, 331, 204, 127, 140, 1348.17, 127, 1347.75, 73
1, 15:56:00-000, 659, 374, 285, 275, 1348.48, 285, 1347.78, 90
1, 15:57:00-000, 287, 188, 99, 115, 1348.88, 99, 1348.09, 65
1, 15:58:00-000, 620, 366, 254, 276, 1348.62, 254, 1348.12, 79
1, 15:59:00-000, 357, 213, 144, 157, 1347.81, 144, 1347.28, 73
1, 16:00:00-000, 754, 495, 259, 311, 1348.40, 258, 1347.48, 90
1, 16:01:00-000, 315, 161, 154, 134, 1347.95, 155, 1346.88, 139
1, 16:02:00-000, 707, 416, 291, 315, 1347.42, 291, 1347.08, 76
1, 16:03:00-000, 334, 184, 150, 124, 1346.90, 145, 1347.10, 74
1, 16:04:00-000, 563, 301, 262, 216, 1347.79, 267, 1347.15, 82
1, 16:05:00-000, 266, 133, 133, 80, 1347.90, 133, 1347.74, 78
1, 16:06:00-000, 588, 387, 201, 256, 1348.63, 201, 1348.25, 60
1, 16:07:00-000, 363, 210, 153, 153, 1348.32, 153, 1347.80, 116
1, 16:08:00-000, 619, 338, 281, 244, 1347.79, 281, 1347.47, 80
1, 16:09:00-000, 295, 167, 128, 134, 1347.76, 128, 1346.87, 78
1, 16:10:00-000, 595, 356, 239, 268, 1348.76, 238, 1348.26, 56
1, 16:11:00-000, 254, 145, 109, 107, 1348.04, 110, 1347.55, 50
1, 16:12:00-000, 613, 334, 279, 245, 1347.67, 279, 1347.05, 65
1, 16:13:00-000, 356, 216, 140, 157, 1347.62, 140, 1347.25, 69
1, 16:14:00-000, 607, 355, 252, 261, 1348.18, 252, 1347.83, 50
1, 16:15:00-000, 289, 159, 130, 147, 1347.24, 130, 1346.87, 92
1, 16:16:00-000, 688, 397, 291, 276, 1348.54, 291, 1347.77, 65
1, 16:17:00-000, 306, 173, 133, 126, 1348.42, 133, 1347.58, 92
1, 16:18:00-000, 570, 324, 246, 230, 1348.07, 246, 1347.32, 54
1, 16:19:00-000, 282, 147, 135, 117, 1347.72, 135, 1346.72, 87
1, 16:20:00-000, 625, 408, 217, 261, 1348.43, 217, 1347.94, 53
1, 16:21:00-000, 229, 115, 114, 107, 1347.71, 114, 1347.02, 79
1, 16:22:00-000, 685, 410, 275, 275, 1348.05, 275, 1347.30, 59
1, 16:23:00-000, 314, 180, 134, 113, 1348.61, 134, 1347.71, 114
1, 16:24:00-000, 578, 315, 263, 234, 1347.63, 263, 1347.60, 91
1, 16:25:00-000, 326, 177, 149, 139, 1348.92, 149, 1347.47, 64
1, 16:26:00-000, 625, 349, 276, 281, 1348.24, 274, 1346.92, 52
1, 16:27:00-000, 256, 165, 91, 110, 1347.17, 93, 1347.58, 38
1, 16:28:00-000, 586, 376, 210, 270, 1347.55, 210, 1346.98, 92
1, 16:29:00-000, 344, 174, 170, 150, 1347.15, 170, 1346.20, 69
2, 09:06:00-000, 3081, 0, 3081, 0, 0.00, 1103, 1348.54, 0
2, 09:07:00-000, 0, 0, 0, 0, 0.00, 0, 0.00, 1959
2, 09:08:00-000, 0, 0, 0, 0, 0.00, 0, 0.00, 19
2, 09:13:00-000, 3176, 1103, 2073, 1103, 1351.99, 1592, 1350.87, 0
2, 09:14:00-000, 13, 8, 5, 8, 1357.00, 39, 1356.00, 442
2, 09:15:00-000, 15, 11, 4, 11, 1354.82, 4, 1351.50, 5
2, 09:16:00-000, 197, 103, 94, 103, 1355.25, 90, 1353.00, 0
2, 09:17:00-000, 182, 100, 82, 100, 1355.40, 86, 1354.30, 0
2, 09:18:00-000, 639, 316, 323, 315, 1354.46, 323, 1352.94, 0
2, 09:19:00-000, 374, 174, 200, 175, 1353.93, 169, 1351.30, 0
2, 09:20:00-000, 786, 427, 359, 422, 1355.00, 390, 1352.97, 0
2, 09:21:00-000, 322, 185, 137, 190, 1356.50, 136, 1351.93, 0
2, 09:22:00-000, 632, 358, 274, 358, 1355.50, 275, 1353.62, 0
2, 09:23:00-000, 301, 112, 189, 112, 1353.35, 158, 1352.58, 0
2, 09:24:00-000, 524, 257, 267, 257, 1353.79, 288, 1353.12, 3
2, 09:25:00-000, 305, 122, 183, 122, 1353.08, 152, 1352.45, 3
2, 09:26:00-000, 660, 350, 310, 350, 1354.93, 291, 1352.62, 0
2, 09:27:00-000, 334, 163, 171, 163, 1352.95, 142, 1350.87, 54
2, 09:28:00-000, 670, 334, 336, 334, 1353.37, 315, 1352.11, 19
2, 09:29:00-000, 307, 142, 165, 142, 1353.53, 162, 1352.95, 15
2, 09:30:00-000, 585, 243, 342, 243, 1354.09, 318, 1352.08, 0
2, 09:31:00-000, 313, 163, 150, 163, 1351.77, 152, 1352.53, 21
2, 09:32:00-000, 621, 307, 314, 307, 1353.42, 298, 1352.54, 19
2, 09:33:00-000, 315, 148, 167, 148, 1353.40, 145, 1352.35, 6
2, 09:34:00-000, 641, 336, 305, 336, 1354.10, 302, 1352.60, 8
2, 09:35:00-000, 316, 154, 162, 154, 1353.15, 171, 1352.85, 9
2, 09:36:00-000, 596, 296, 300, 295, 1353.66, 251, 1352.23, 21
2, 09:37:00-000, 309, 112, 197, 113, 1352.28, 152, 1350.56, 38
2, 09:38:00-000, 624, 273, 351, 273, 1353.07, 299, 1351.95, 44
2, 09:39:00-000, 314, 151, 163, 151, 1352.95, 140, 1351.99, 48
2, 09:40:00-000, 651, 340, 311, 340, 1353.77, 294, 1351.83, 14
2, 09:41:00-000, 317, 142, 175, 142, 1352.71, 157, 1351.91, 31
2, 09:42:00-000, 670, 303, 367, 303, 1352.74, 326, 1351.72, 24
2, 09:43:00-000, 275, 129, 146, 129, 1352.93, 117, 1350.95, 33
2, 09:44:00-000, 560, 255, 305, 255, 1352.41, 230, 1350.70, 49
2, 09:45:00-000, 280, 157, 123, 157, 1353.39, 138, 1351.83, 38
2, 09:46:00-000, 724, 319, 405, 319, 1353.10, 353, 1351.42, 2
2, 09:47:00-000, 308, 145, 163, 145, 1354.03, 157, 1351.99, 41
2, 09:48:00-000, 608, 298, 310, 298, 1353.77, 266, 1352.18, 17
2, 09:49:00-000, 307, 136, 171, 136, 1352.67, 135, 1351.82, 35
2, 09:50:00-000, 643, 295, 348, 292, 1352.63, 298, 1351.72, 28
2, 09:51:00-000, 307, 124, 183, 127, 1352.39, 144, 1350.37, 57
2, 09:52:00-000, 668, 308, 360, 308, 1351.91, 314, 1351.28, 42
2, 09:53:00-000, 359, 154, 205, 154, 1353.62, 143, 1351.49, 44
2, 09:54:00-000, 554, 262, 292, 262, 1353.17, 223, 1351.77, 75
2, 09:55:00-000, 290, 154, 136, 154, 1353.36, 132, 1352.13, 39
2, 09:56:00-000, 583, 240, 343, 240, 1352.71, 276, 1350.43, 27
2, 09:57:00-000, 282, 136, 146, 136, 1352.35, 131, 1351.36, 41
2, 09:58:00-000, 727, 330, 397, 330, 1353.38, 363, 1351.31, 29
2, 09:59:00-000, 352, 147, 205, 147, 1351.61, 170, 1350.68, 38
2, 10:00:00-000, 545, 277, 268, 277, 1353.09, 281, 1351.78, 15
2, 10:01:00-000, 385, 166, 219, 166, 1352.35, 167, 1351.31, 15
2, 10:02:00-000, 586, 293, 293, 293, 1353.84, 273, 1352.05, 58
2, 10:03:00-000, 366, 179, 187, 179, 1354.21, 173, 1352.70, 11
2, 10:04:00-000, 571, 266, 305, 266, 1352.88, 258, 1352.24, 39
2, 10:05:00-000, 328, 154, 174, 154, 1351.90, 127, 1350.93, 30
2, 10:06:00-000, 592, 266, 326, 266, 1352.26, 248, 1351.30, 45
2, 10:07:00-000, 315, 169, 146, 169, 1353.06, 142, 1352.33, 52
2, 10:08:00-000, 655, 358, 297, 358, 1352.69, 258, 1351.39, 36
2, 10:09:00-000, 311, 124, 187, 124, 1353.30, 141, 1350.89, 34
2, 10:10:00-000, 628, 253, 375, 253, 1352.97, 304, 1352.03, 44
2, 10:11:00-000, 338, 103, 235, 103, 1350.54, 127, 1350.07, 74
2, 10:12:00-000, 616, 255, 361, 255, 1351.57, 302, 1350.75, 91
2, 10:13:00-000, 329, 131, 198, 131, 1352.41, 164, 1351.79, 47
2, 10:14:00-000, 602, 326, 276, 326, 1353.00, 217, 1352.55, 57
2, 10:15:00-000, 328, 146, 182, 146, 1353.04, 167, 1352.19, 47
2, 10:16:00-000, 568, 259, 309, 259, 1351.93, 261, 1350.59, 50
2, 10:17:00-000, 317, 140, 177, 140, 1353.19, 141, 1352.48, 26
2, 10:18:00-000, 703, 320, 383, 320, 1352.64, 319, 1351.43, 57
2, 10:19:00-000, 343, 160, 183, 160, 1353.29, 173, 1352.17, 33
2, 10:20:00-000, 583, 280, 303, 280, 1353.12, 259, 1351.61, 30
2, 10:21:00-000, 317, 127, 190, 127, 1352.93, 137, 1351.13, 34
2, 10:22:00-000, 564, 260, 304, 260, 1352.47, 257, 1351.87, 39
2, 10:23:00-000, 322, 147, 175, 147, 1352.90, 135, 1351.78, 57
2, 10:24:00-000, 639, 278, 361, 278, 1352.02, 272, 1351.53, 62
2, 10:25:00-000, 283, 138, 145, 138, 1353.24, 121, 1351.37, 58
2, 10:26:00-000, 652, 300, 352, 300, 1352.40, 290, 1351.54, 47
2, 10:27:00-000, 284, 95, 189, 95, 1352.00, 128, 1351.21, 54
2, 10:28:00-000, 571, 260, 311, 260, 1353.04, 282, 1352.32, 43
2, 10:29:00-000, 367, 184, 183, 184, 1353.60, 149, 1351.47, 44
2, 10:30:00-000, 658, 258, 400, 258, 1352.06, 252, 1351.32, 54
2, 10:31:00-000, 307, 138, 169, 138, 1353.38, 171, 1351.21, 88
2, 10:32:00-000, 660, 294, 366, 294, 1352.28, 280, 1351.05, 67
2, 10:33:00-000, 302, 115, 187, 115, 1353.06, 134, 1350.92, 62
2, 10:34:00-000, 661, 297, 364, 297, 1352.06, 260, 1351.20, 68
2, 10:35:00-000, 303, 128, 175, 128, 1351.87, 142, 1351.31, 79
2, 10:36:00-000, 596, 250, 346, 250, 1352.47, 269, 1351.54, 54
2, 10:37:00-000, 326, 180, 146, 180, 1353.50, 135, 1352.18, 50
2, 10:38:00-000, 606, 250, 356, 250, 1352.50, 262, 1351.08, 31
2, 10:39:00-000, 264, 123, 141, 123, 1351.98, 114, 1351.00, 55
2, 10:40:00-000, 688, 310, 378, 310, 1352.00, 282, 1351.05, 67
2, 10:41:00-000, 312, 158, 154, 158, 1353.93, 127, 1352.28, 66
2, 10:42:00-000, 598, 234, 364, 234, 1351.95, 303, 1351.24, 54
2, 10:43:00-000, 290, 128, 162, 128, 1352.59, 156, 1352.04, 43
2, 10:44:00-000, 556, 231, 325, 231, 1353.59, 244, 1351.85, 25
2, 10:45:00-000, 346, 140, 206, 140, 1352.18, 160, 1351.86, 53
2, 10:46:00-000, 677, 324, 353, 324, 1352.60, 316, 1351.19, 52
2, 10:47:00-000, 304, 156, 148, 156, 1353.12, 142, 1352.28, 38
2, 10:48:00-000, 596, 245, 351, 245, 1352.77, 274, 1350.65, 48
2, 10:49:00-000, 343, 155, 188, 155, 1351.89, 137, 1351.13, 42
2, 10:50:00-000, 673, 288, 385, 288, 1352.76, 304, 1351.92, 61
2, 10:51:00-000, 306, 122, 184, 122, 1351.83, 136, 1350.26, 83
2, 10:52:00-000, 553, 251, 302, 251, 1352.12, 250, 1351.09, 54
2, 10:53:00-000, 275, 157, 118, 157, 1353.45, 99, 1352.18, 21
2, 10:54:00-000, 662, 286, 376, 286, 1353.13, 292, 1351.40, 32
2, 10:55:00-000, 292, 134, 158, 134, 1353.22, 150, 1352.76, 76
2, 10:56:00-000, 709, 313, 396, 313, 1352.30, 304, 1350.84, 36
2, 10:57:00-000, 275, 129, 146, 129, 1353.61, 149, 1352.75, 59
2, 10:58:00-000, 592, 269, 323, 269, 1352.92, 267, 1351.23, 29
2, 10:59:00-000, 289, 157, 132, 157, 1354.67, 130, 1351.74, 35
2, 11:00:00-000, 596, 248, 348, 248, 1352.19, 260, 1351.27, 38
2, 11:01:00-000, 275, 140, 135, 140, 1352.30, 89, 1351.30, 66
2, 11:02:00-000, 643, 301, 342, 301, 1353.10, 276, 1351.42, 60
2, 11:03:00-000, 342, 155, 187, 155, 1352.56, 187, 1351.94, 23
2, 11:04:00-000, 573, 267, 306, 267, 1352.40, 246, 1351.06, 31
2, 11:05:00-000, 379, 170, 209, 170, 1352.44, 175, 1351.58, 30
2, 11:06:00-000, 586, 255, 331, 254, 1352.55, 301, 1351.71, 50
2, 11:07:00-000, 248, 134, 114, 135, 1354.02, 110, 1351.70, 36
2, 11:08:00-000, 661, 258, 403, 258, 1351.33, 275, 1351.04, 29
2, 11:09:00-000, 310, 126, 184, 126, 1352.44, 151, 1351.81, 81
2, 11:10:00-000, 647, 297, 350, 297, 1352.66, 278, 1351.21, 45
2, 11:11:00-000, 341, 143, 198, 143, 1352.41, 174, 1351.33, 64
2, 11:12:00-000, 621, 262, 359, 262, 1352.36, 288, 1350.84, 57
2, 11:13:00-000, 322, 109, 213, 109, 1351.20, 131, 1351.18, 46
2, 11:14:00-000, 601, 306, 295, 306, 1352.96, 246, 1352.09, 67
2, 11:15:00-000, 362, 186, 176, 186, 1353.44, 157, 1351.42, 65
2, 11:16:00-000, 599, 260, 339, 260, 1351.95, 297, 1351.09, 43
2, 11:17:00-000, 278, 131, 147, 131, 1352.08, 109, 1351.24, 28
2, 11:18:00-000, 626, 313, 313, 313, 1352.99, 298, 1351.58, 31
2, 11:19:00-000, 307, 144, 163, 144, 1352.17, 122, 1350.61, 25
2, 11:20:00-000, 672, 320, 352, 320, 1352.56, 251, 1350.98, 61
2, 11:21:00-000, 260, 100, 160, 100, 1350.95, 94, 1349.82, 80
2, 11:22:00-000, 594, 241, 353, 241, 1351.33, 243, 1350.47, 67
2, 11:23:00-000, 290, 125, 165, 125, 1351.65, 135, 1351.00, 89
2, 11:24:00-000, 572, 263, 309, 263, 1352.48, 261, 1351.06, 34
2, 11:25:00-000, 317, 144, 173, 144, 1352.23, 162, 1351.47, 39
2, 11:26:00-000, 603, 281, 322, 281, 1352.46, 250, 1351.62, 44
2, 11:27:00-000, 352, 125, 227, 125, 1349.16, 104, 1348.41, 58
2, 11:28:00-000, 632, 272, 360, 270, 1351.58, 329, 1351.04, 74
2, 11:29:00-000, 349, 153, 196, 154, 1352.44, 155, 1350.86, 80
2, 11:30:00-000, 592, 215, 377, 216, 1352.20, 255, 1350.86, 63
2, 11:31:00-000, 313, 172, 141, 172, 1353.11, 136, 1352.12, 82
2, 11:32:00-000, 551, 221, 330, 221, 1352.15, 257, 1350.79, 36
2, 11:33:00-000, 283, 116, 167, 116, 1352.27, 101, 1350.83, 58
2, 11:34:00-000, 694, 332, 362, 332, 1352.35, 304, 1350.74, 62
2, 11:35:00-000, 306, 132, 174, 132, 1352.26, 122, 1350.97, 72
2, 11:36:00-000, 655, 272, 383, 267, 1352.10, 283, 1351.01, 62
2, 11:37:00-000, 268, 93, 175, 98, 1352.43, 133, 1351.61, 82
2, 11:38:00-000, 606, 258, 348, 258, 1352.39, 266, 1351.30, 74
2, 11:39:00-000, 343, 144, 199, 144, 1351.74, 167, 1351.05, 56
2, 11:40:00-000, 629, 264, 365, 264, 1351.94, 283, 1351.38, 40
2, 11:41:00-000, 341, 166, 175, 166, 1351.32, 137, 1351.02, 73
2, 11:42:00-000, 693, 282, 411, 282, 1352.07, 316, 1350.96, 56
2, 11:43:00-000, 288, 136, 152, 136, 1352.74, 121, 1351.19, 62
2, 11:44:00-000, 554, 219, 335, 219, 1351.61, 247, 1351.00, 44
2, 11:45:00-000, 346, 155, 191, 155, 1352.41, 165, 1351.80, 68
2, 11:46:00-000, 625, 317, 308, 317, 1353.30, 280, 1351.43, 47
2, 11:47:00-000, 306, 129, 177, 129, 1353.39, 141, 1353.04, 14
2, 11:48:00-000, 673, 295, 378, 295, 1352.59, 307, 1351.54, 82
2, 11:49:00-000, 296, 124, 172, 124, 1352.44, 102, 1351.61, 37
2, 11:50:00-000, 592, 264, 328, 264, 1352.45, 268, 1351.31, 57
2, 11:51:00-000, 310, 136, 174, 136, 1352.59, 143, 1352.11, 59
2, 11:52:00-000, 590, 271, 319, 271, 1352.99, 277, 1351.51, 54
2, 11:53:00-000, 296, 142, 154, 142, 1353.65, 139, 1351.68, 29
2, 11:54:00-000, 695, 322, 373, 322, 1352.23, 327, 1352.06, 22
2, 11:55:00-000, 334, 142, 192, 142, 1353.27, 156, 1351.88, 42
2, 11:56:00-000, 529, 244, 285, 244, 1352.32, 243, 1351.73, 47
2, 11:57:00-000, 324, 117, 207, 117, 1351.77, 164, 1350.33, 34
2, 11:58:00-000, 613, 300, 313, 300, 1353.73, 293, 1351.82, 42
2, 11:59:00-000, 306, 108, 198, 108, 1352.80, 145, 1351.33, 17
2, 12:00:00-000, 644, 311, 333, 311, 1352.45, 287, 1350.81, 48
2, 12:01:00-000, 324, 144, 180, 144, 1353.16, 123, 1352.04, 45
2, 12:02:00-000, 610, 284, 326, 284, 1353.47, 281, 1351.92, 59
2, 12:03:00-000, 267, 143, 124, 143, 1354.45, 117, 1353.26, 23
2, 12:04:00-000, 546, 257, 289, 257, 1352.79, 221, 1351.77, 65
2, 12:05:00-000, 377, 151, 226, 151, 1352.22, 145, 1351.12, 40
2, 12:06:00-000, 670, 309, 361, 309, 1353.79, 301, 1351.51, 64
2, 12:07:00-000, 261, 109, 152, 109, 1352.60, 119, 1350.95, 66
2, 12:08:00-000, 624, 294, 330, 294, 1352.62, 277, 1351.41, 55
2, 12:09:00-000, 320, 149, 171, 149, 1351.58, 141, 1350.58, 38
2, 12:10:00-000, 551, 234, 317, 234, 1351.96, 233, 1351.01, 44
2, 12:11:00-000, 322, 124, 198, 124, 1351.42, 134, 1351.12, 55
2, 12:12:00-000, 660, 265, 395, 265, 1351.93, 266, 1351.42, 53
2, 12:13:00-000, 331, 161, 170, 161, 1352.43, 165, 1351.39, 122
2, 12:14:00-000, 643, 293, 350, 293, 1353.23, 303, 1351.57, 39
2, 12:15:00-000, 364, 152, 212, 152, 1352.12, 158, 1351.60, 52
2, 12:16:00-000, 641, 255, 386, 255, 1351.59, 250, 1350.42, 77
2, 12:17:00-000, 343, 160, 183, 160, 1351.52, 162, 1351.18, 82
2, 12:18:00-000, 621, 302, 319, 302, 1352.86, 269, 1351.12, 60
2, 12:19:00-000, 293, 108, 185, 108, 1351.41, 128, 1351.03, 37
2, 12:20:00-000, 604, 228, 376, 228, 1351.77, 243, 1349.91, 70
2, 12:21:00-000, 332, 171, 161, 171, 1352.18, 132, 1351.40, 106
2, 12:22:00-000, 648, 301, 347, 301, 1352.33, 196, 1350.83, 91
2, 12:23:00-000, 328, 155, 173, 155, 1352.54, 80, 1350.51, 111
2, 12:24:00-000, 636, 248, 388, 248, 1352.13, 242, 1350.31, 109
2, 12:25:00-000, 337, 144, 193, 144, 1351.48, 170, 1351.33, 94
2, 12:26:00-000, 606, 242, 364, 242, 1352.27, 244, 1351.72, 73
2, 12:27:00-000, 332, 141, 191, 138, 1352.52, 132, 1350.49, 99
2, 12:28:00-000, 606, 210, 396, 213, 1351.45, 267, 1350.65, 103
2, 12:29:00-000, 277, 90, 187, 90, 1350.73, 117, 1350.82, 67
2, 12:30:00-000, 592, 255, 337, 255, 1352.07, 270, 1351.05, 73
2, 12:31:00-000, 350, 111, 239, 111, 1352.06, 161, 1350.31, 80
2, 12:32:00-000, 680, 304, 376, 304, 1352.70, 272, 1351.09, 89
2, 12:33:00-000, 256, 115, 141, 115, 1352.69, 129, 1351.49, 86
2, 12:34:00-000, 655, 271, 384, 271, 1352.16, 295, 1350.96, 35
2, 12:35:00-000, 274, 127, 147, 127, 1352.70, 113, 1352.03, 64
2, 12:36:00-000, 611, 228, 383, 228, 1351.88, 252, 1350.51, 97
2, 12:37:00-000, 348, 173, 175, 173, 1352.36, 148, 1351.73, 63
2, 12:38:00-000, 667, 254, 413, 254, 1351.77, 313, 1351.46, 71
2, 12:39:00-000, 286, 111, 175, 111, 1352.37, 135, 1351.62, 62
2, 12:40:00-000, 563, 231, 332, 231, 1351.88, 237, 1350.64, 86
2, 12:41:00-000, 317, 142, 175, 142, 1352.83, 144, 1351.37, 47
2, 12:42:00-000, 601, 260, 341, 260, 1352.69, 250, 1350.94, 49
2, 12:43:00-000, 350, 143, 207, 142, 1351.36, 164, 1350.70, 62
2, 12:44:00-000, 636, 289, 347, 290, 1352.55, 268, 1351.24, 94
2, 12:45:00-000, 303, 128, 175, 128, 1352.91, 118, 1350.92, 46
2, 12:46:00-000, 724, 325, 399, 325, 1352.62, 292, 1351.38, 79
2, 12:47:00-000, 299, 135, 164, 135, 1352.43, 144, 1351.49, 85
2, 12:48:00-000, 576, 250, 326, 250, 1353.04, 228, 1352.29, 46
2, 12:49:00-000, 289, 134, 155, 134, 1352.17, 141, 1351.19, 75
2, 12:50:00-000, 637, 274, 363, 274, 1352.81, 251, 1351.46, 31
2, 12:51:00-000, 325, 151, 174, 151, 1352.70, 140, 1351.94, 81
2, 12:52:00-000, 566, 245, 321, 242, 1351.79, 198, 1350.25, 88
2, 12:53:00-000, 343, 159, 184, 157, 1352.65, 152, 1352.14, 58
2, 12:54:00-000, 678, 310, 368, 315, 1352.85, 294, 1351.72, 72
2, 12:55:00-000, 280, 140, 140, 140, 1354.13, 115, 1351.48, 57
2, 12:56:00-000, 635, 257, 378, 257, 1351.91, 298, 1351.12, 44
2, 12:57:00-000, 331, 120, 211, 120, 1351.57, 116, 1349.73, 63
2, 12:58:00-000, 603, 244, 359, 244, 1351.95, 278, 1350.71, 108
2, 12:59:00-000, 333, 141, 192, 141, 1352.12, 130, 1351.89, 70
2, 13:00:00-000, 572, 215, 357, 215, 1351.21, 248, 1350.01, 92
2, 13:01:00-000, 310, 127, 183, 127, 1351.66, 157, 1351.19, 68
2, 13:02:00-000, 656, 266, 390, 266, 1352.31, 262, 1351.04, 61
2, 13:03:00-000, 321, 151, 170, 151, 1351.96, 134, 1351.32, 110
2, 13:04:00-000, 683, 317, 366, 317, 1353.38, 303, 1352.81, 21
2, 13:05:00-000, 266, 91, 175, 91, 1351.69, 127, 1351.00, 64
2, 13:06:00-000, 636, 266, 370, 266, 1352.10, 282, 1351.17, 37
2, 13:07:00-000, 362, 132, 230, 132, 1351.07, 158, 1350.72, 78
2, 13:08:00-000, 537, 220, 317, 220, 1350.73, 215, 1350.73, 99
2, 13:09:00-000, 238, 120, 118, 119, 1352.36, 112, 1351.26, 78
2, 13:10:00-000, 574, 270, 304, 271, 1352.96, 256, 1351.32, 39
2, 13:11:00-000, 327, 149, 178, 149, 1351.67, 149, 1351.33, 32
2, 13:12:00-000, 746, 324, 422, 324, 1352.16, 329, 1351.35, 49
2, 13:13:00-000, 317, 129, 188, 129, 1352.98, 140, 1351.78, 55
2, 13:14:00-000, 603, 247, 356, 247, 1352.32, 273, 1351.29, 69
2, 13:15:00-000, 258, 143, 115, 143, 1353.77, 113, 1352.74, 58
2, 13:16:00-000, 618, 229, 389, 229, 1351.75, 257, 1350.72, 88
2, 13:17:00-000, 317, 168, 149, 168, 1352.90, 136, 1351.22, 66
2, 13:18:00-000, 670, 321, 349, 321, 1353.50, 312, 1351.51, 27
2, 13:19:00-000, 301, 107, 194, 107, 1351.73, 144, 1351.08, 41
2, 13:20:00-000, 729, 353, 376, 353, 1352.48, 342, 1351.88, 29
2, 13:21:00-000, 289, 107, 182, 107, 1352.72, 147, 1351.55, 31
2, 13:22:00-000, 535, 240, 295, 240, 1353.04, 265, 1351.35, 28
2, 13:23:00-000, 349, 172, 177, 172, 1352.80, 163, 1351.40, 32
2, 13:24:00-000, 553, 278, 275, 278, 1353.12, 214, 1352.08, 46
2, 13:25:00-000, 335, 157, 178, 157, 1352.79, 128, 1351.34, 41
2, 13:26:00-000, 645, 329, 316, 327, 1352.66, 261, 1351.78, 59
2, 13:27:00-000, 291, 94, 197, 96, 1350.65, 116, 1351.10, 54
2, 13:28:00-000, 695, 320, 375, 320, 1353.00, 327, 1351.56, 58
2, 13:29:00-000, 270, 127, 143, 127, 1352.16, 106, 1351.56, 71
2, 13:30:00-000, 652, 260, 392, 260, 1352.37, 284, 1351.39, 58
2, 13:31:00-000, 268, 114, 154, 114, 1352.19, 99, 1352.12, 78
2, 13:32:00-000, 638, 312, 326, 312, 1352.79, 288, 1351.60, 63
2, 13:33:00-000, 277, 95, 182, 95, 1352.09, 126, 1350.17, 47
2, 13:34:00-000, 655, 295, 360, 295, 1352.07, 269, 1350.82, 71
2, 13:35:00-000, 314, 105, 209, 105, 1351.82, 137, 1350.47, 76
2, 13:36:00-000, 634, 276, 358, 276, 1352.10, 281, 1350.94, 52
2, 13:37:00-000, 246, 96, 150, 96, 1351.45, 104, 1350.49, 94
2, 13:38:00-000, 580, 265, 315, 262, 1352.66, 252, 1351.26, 42
2, 13:39:00-000, 260, 110, 150, 108, 1352.41, 116, 1351.97, 50
2, 13:40:00-000, 606, 227, 379, 229, 1352.03, 294, 1351.19, 55
2, 13:41:00-000, 332, 164, 168, 164, 1352.70, 148, 1351.54, 61
2, 13:42:00-000, 634, 294, 340, 294, 1352.45, 266, 1351.49, 57
2, 13:43:00-000, 318, 152, 166, 152, 1352.47, 152, 1351.03, 44
2, 13:44:00-000, 634, 262, 372, 262, 1352.09, 280, 1351.25, 47
2, 13:45:00-000, 291, 131, 160, 131, 1351.84, 106, 1350.94, 69
2, 13:46:00-000, 655, 303, 352, 303, 1352.08, 307, 1351.13, 55
2, 13:47:00-000, 292, 125, 167, 125, 1352.92, 147, 1351.05, 42
2, 13:48:00-000, 592, 248, 344, 248, 1352.00, 228, 1350.77, 42
2, 13:49:00-000, 258, 115, 143, 115, 1353.22, 125, 1351.09, 77
2, 13:50:00-000, 615, 256, 359, 256, 1352.38, 259, 1351.80, 57
2, 13:51:00-000, 273, 111, 162, 111, 1352.59, 119, 1351.73, 62
2, 13:52:00-000, 636, 307, 329, 307, 1352.14, 277, 1351.50, 64
2, 13:53:00-000, 317, 143, 174, 143, 1352.82, 132, 1351.52, 48
2, 13:54:00-000, 611, 282, 329, 282, 1353.36, 278, 1352.29, 41
2, 13:55:00-000, 303, 129, 174, 124, 1351.96, 134, 1351.53, 44
2, 13:56:00-000, 581, 243, 338, 248, 1351.57, 232, 1351.30, 75
2, 13:57:00-000, 381, 174, 207, 174, 1352.71, 166, 1352.06, 68
2, 13:58:00-000, 566, 287, 279, 287, 1352.66, 225, 1351.76, 61
2, 13:59:00-000, 276, 134, 142, 134, 1353.30, 115, 1352.56, 36
2, 14:00:00-000, 546, 221, 325, 221, 1352.73, 253, 1351.63, 41
2, 14:01:00-000, 280, 112, 168, 112, 1352.63, 131, 1350.61, 72
2, 14:02:00-000, 625, 253, 372, 253, 1352.24, 240, 1350.82, 87
2, 14:03:00-000, 308, 128, 180, 128, 1352.14, 138, 1351.51, 71
2, 14:04:00-000, 652, 300, 352, 300, 1353.34, 261, 1351.57, 62
2, 14:05:00-000, 337, 117, 220, 117, 1351.16, 160, 1350.31, 61
2, 14:06:00-000, 591, 264, 327, 264, 1351.79, 270, 1350.92, 72
2, 14:07:00-000, 310, 130, 180, 130, 1351.99, 132, 1350.77, 55
2, 14:08:00-000, 584, 219, 365, 219, 1351.87, 277, 1351.33, 70
2, 14:09:00-000, 315, 97, 218, 97, 1351.80, 140, 1350.55, 65
2, 14:10:00-000, 595, 296, 299, 296, 1351.46, 267, 1351.09, 66
2, 14:11:00-000, 327, 118, 209, 118, 1350.70, 124, 1350.68, 47
2, 14:12:00-000, 650, 263, 387, 263, 1351.62, 262, 1351.10, 111
2, 14:13:00-000, 299, 122, 177, 122, 1351.46, 134, 1350.63, 85
2, 14:14:00-000, 651, 317, 334, 317, 1351.84, 279, 1351.37, 69
2, 14:15:00-000, 341, 129, 212, 129, 1351.50, 134, 1349.76, 54
2, 14:16:00-000, 609, 260, 349, 260, 1352.04, 280, 1350.81, 51
2, 14:17:00-000, 373, 146, 227, 146, 1352.03, 183, 1350.63, 81
2, 14:18:00-000, 606, 255, 351, 255, 1352.53, 283, 1350.99, 62
2, 14:19:00-000, 297, 149, 148, 149, 1352.99, 123, 1352.48, 51
2, 14:20:00-000, 586, 232, 354, 232, 1351.98, 256, 1350.11, 65
2, 14:21:00-000, 298, 105, 193, 105, 1351.89, 160, 1350.81, 59
2, 14:22:00-000, 668, 268, 400, 268, 1351.65, 274, 1350.75, 62
2, 14:23:00-000, 345, 157, 188, 157, 1351.85, 153, 1350.66, 94
2, 14:24:00-000, 587, 284, 303, 284, 1352.13, 242, 1350.78, 47
2, 14:25:00-000, 338, 196, 142, 196, 1354.10, 143, 1351.60, 45
2, 14:26:00-000, 658, 262, 396, 262, 1351.57, 279, 1350.38, 24
2, 14:27:00-000, 323, 154, 169, 154, 1352.25, 144, 1351.29, 79
2, 14:28:00-000, 574, 260, 314, 260, 1351.08, 247, 1350.30, 54
2, 14:29:00-000, 301, 131, 170, 131, 1352.32, 135, 1350.98, 66
2, 14:30:00-000, 632, 320, 312, 320, 1353.11, 268, 1351.40, 36
2, 14:31:00-000, 314, 156, 158, 156, 1353.41, 136, 1352.30, 48
2, 14:32:00-000, 592, 258, 334, 258, 1352.33, 256, 1351.60, 33
2, 14:33:00-000, 259, 109, 150, 109, 1352.18, 121, 1350.97, 61
2, 14:34:00-000, 624, 293, 331, 293, 1352.88, 254, 1351.61, 30
2, 14:35:00-000, 263, 110, 153, 110, 1352.11, 124, 1350.49, 64
2, 14:36:00-000, 679, 308, 371, 308, 1352.48, 292, 1351.86, 60
2, 14:37:00-000, 268, 111, 157, 111, 1354.22, 140, 1351.14, 54
2, 14:38:00-000, 585, 227, 358, 227, 1351.24, 255, 1350.58, 29
2, 14:39:00-000, 380, 164, 216, 164, 1351.61, 152, 1351.04, 85
2, 14:40:00-000, 576, 275, 301, 275, 1352.77, 255, 1351.86, 71
2, 14:41:00-000, 255, 99, 156, 99, 1352.52, 114, 1351.43, 57
2, 14:42:00-000, 637, 241, 396, 241, 1352.06, 291, 1351.81, 68
2, 14:43:00-000, 330, 145, 185, 145, 1352.75, 156, 1351.34, 57
2, 14:44:00-000, 603, 286, 317, 286, 1352.32, 282, 1351.56, 41
2, 14:45:00-000, 319, 124, 195, 124, 1351.97, 135, 1350.13, 37
2, 14:46:00-000, 701, 304, 397, 304, 1352.50, 316, 1351.31, 68
2, 14:47:00-000, 353, 160, 193, 160, 1352.33, 169, 1350.84, 77
2, 14:48:00-000, 623, 261, 362, 261, 1352.22, 283, 1350.81, 57
2, 14:49:00-000, 307, 146, 161, 146, 1352.09, 116, 1351.57, 51
2, 14:50:00-000, 650, 270, 380, 270, 1352.14, 245, 1350.85, 67
2, 14:51:00-000, 270, 151, 119, 151, 1352.60, 107, 1352.47, 84
2, 14:52:00-000, 706, 337, 369, 337, 1352.43, 303, 1351.33, 46
2, 14:53:00-000, 340, 128, 212, 128, 1352.09, 136, 1351.27, 60
2, 14:54:00-000, 598, 255, 343, 255, 1352.07, 220, 1351.88, 80
2, 14:55:00-000, 287, 111, 176, 111, 1352.00, 128, 1350.30, 101
2, 14:56:00-000, 607, 234, 373, 234, 1352.46, 285, 1351.27, 70
2, 14:57:00-000, 331, 141, 190, 141, 1351.52, 113, 1350.78, 81
2, 14:58:00-000, 647, 288, 359, 288, 1352.65, 261, 1351.31, 104
2, 14:59:00-000, 324, 116, 208, 116, 1352.63, 158, 1351.14, 76
2, 15:00:00-000, 735, 284, 451, 284, 1350.34, 291, 1349.81, 59
2, 15:01:00-000, 255, 127, 128, 127, 1352.00, 137, 1351.58, 97
2, 15:02:00-000, 604, 213, 391, 213, 1351.81, 245, 1350.78, 59
2, 15:03:00-000, 299, 145, 154, 145, 1353.07, 145, 1351.96, 104
2, 15:04:00-000, 600, 284, 316, 284, 1351.84, 219, 1351.46, 49
2, 15:05:00-000, 337, 135, 202, 135, 1352.10, 151, 1351.27, 69
2, 15:06:00-000, 589, 250, 339, 250, 1352.12, 232, 1350.97, 80
2, 15:07:00-000, 331, 156, 175, 156, 1351.42, 153, 1350.86, 74
2, 15:08:00-000, 613, 259, 354, 259, 1352.02, 226, 1351.17, 45
2, 15:09:00-000, 287, 126, 161, 126, 1351.06, 100, 1350.92, 100
2, 15:10:00-000, 633, 297, 336, 297, 1352.59, 271, 1351.15, 71
2, 15:11:00-000, 296, 123, 173, 123, 1351.92, 111, 1351.10, 72
2, 15:12:00-000, 541, 216, 325, 216, 1351.80, 205, 1350.69, 109
2, 15:13:00-000, 274, 138, 136, 138, 1351.76, 114, 1351.21, 58
2, 15:14:00-000, 641, 228, 413, 228, 1352.06, 284, 1350.61, 54
2, 15:15:00-000, 297, 135, 162, 135, 1351.17, 134, 1350.38, 107
2, 15:16:00-000, 596, 234, 362, 234, 1351.40, 234, 1350.27, 64
2, 15:17:00-000, 318, 117, 201, 117, 1351.90, 129, 1350.74, 72
2, 15:18:00-000, 516, 204, 312, 204, 1351.69, 202, 1350.68, 113
2, 15:19:00-000, 259, 89, 170, 85, 1350.10, 87, 1350.14, 73
2, 15:20:00-000, 705, 315, 390, 319, 1352.29, 302, 1350.85, 91
2, 15:21:00-000, 350, 148, 202, 148, 1351.77, 120, 1350.33, 98
2, 15:22:00-000, 627, 282, 345, 282, 1351.48, 281, 1350.72, 111
2, 15:23:00-000, 334, 111, 223, 111, 1351.42, 163, 1350.12, 41
2, 15:24:00-000, 490, 154, 336, 154, 1351.28, 209, 1349.78, 75
2, 15:25:00-000, 316, 101, 215, 101, 1351.23, 146, 1350.96, 81
2, 15:26:00-000, 661, 251, 410, 251, 1351.13, 277, 1350.57, 112
2, 15:27:00-000, 355, 153, 202, 153, 1352.52, 140, 1350.23, 115
2, 15:28:00-000, 636, 266, 370, 266, 1351.99, 266, 1351.21, 107
2, 15:29:00-000, 379, 127, 252, 127, 1351.28, 170, 1349.82, 55
2, 15:30:00-000, 578, 285, 293, 285, 1352.89, 249, 1351.46, 77
2, 15:31:00-000, 339, 134, 205, 134, 1351.74, 122, 1351.47, 54
2, 15:32:00-000, 561, 214, 347, 214, 1351.32, 211, 1350.66, 109
2, 15:33:00-000, 343, 181, 162, 181, 1352.51, 146, 1351.28, 84
2, 15:34:00-000, 737, 332, 405, 332, 1351.81, 310, 1351.22, 71
2, 15:35:00-000, 294, 123, 171, 123, 1351.43, 160, 1351.12, 52
2, 15:36:00-000, 565, 247, 318, 247, 1350.33, 185, 1349.30, 56
2, 15:37:00-000, 326, 158, 168, 158, 1352.72, 156, 1351.95, 49
2, 15:38:00-000, 582, 243, 339, 243, 1352.34, 275, 1351.60, 79
2, 15:39:00-000, 292, 100, 192, 100, 1351.27, 132, 1350.65, 51
2, 15:40:00-000, 635, 247, 388, 247, 1351.87, 190, 1350.51, 94
2, 15:41:00-000, 355, 168, 187, 168, 1352.22, 150, 1351.26, 144
2, 15:42:00-000, 532, 237, 295, 237, 1351.98, 202, 1350.31, 80
2, 15:43:00-000, 322, 139, 183, 139, 1351.69, 125, 1351.22, 77
2, 15:44:00-000, 624, 266, 358, 266, 1352.23, 216, 1350.89, 85
2, 15:45:00-000, 372, 150, 222, 150, 1351.52, 148, 1350.26, 108
2, 15:46:00-000, 618, 202, 416, 202, 1352.05, 257, 1350.47, 102
2, 15:47:00-000, 292, 127, 165, 127, 1352.42, 127, 1351.19, 86
2, 15:48:00-000, 611, 228, 383, 228, 1352.04, 291, 1350.78, 103
2, 15:49:00-000, 322, 113, 209, 113, 1351.26, 151, 1350.39, 74
2, 15:50:00-000, 570, 230, 340, 230, 1352.51, 230, 1350.87, 93
2, 15:51:00-000, 347, 162, 185, 162, 1352.58, 153, 1351.37, 66
2, 15:52:00-000, 663, 243, 420, 243, 1351.22, 265, 1350.06, 79
2, 15:53:00-000, 334, 138, 196, 138, 1352.18, 160, 1350.64, 98
2, 15:54:00-000, 650, 262, 388, 262, 1352.41, 281, 1351.03, 63
2, 15:55:00-000, 327, 147, 180, 147, 1352.52, 144, 1351.11, 95
2, 15:56:00-000, 585, 280, 305, 280, 1352.64, 227, 1351.68, 57
2, 15:57:00-000, 314, 138, 176, 138, 1351.78, 113, 1351.12, 68
2, 15:58:00-000, 695, 280, 415, 280, 1351.92, 306, 1351.01, 70
2, 15:59:00-000, 235, 103, 132, 103, 1352.57, 104, 1351.58, 77
2, 16:00:00-000, 650, 262, 388, 262, 1352.03, 331, 1351.26, 39
2, 16:01:00-000, 389, 127, 262, 127, 1352.07, 185, 1350.44, 55
2, 16:02:00-000, 652, 277, 375, 277, 1352.22, 311, 1350.98, 65
2, 16:03:00-000, 286, 117, 169, 117, 1352.29, 105, 1350.30, 82
2, 16:04:00-000, 586, 304, 282, 304, 1352.68, 207, 1351.39, 64
2, 16:05:00-000, 325, 146, 179, 146, 1352.26, 129, 1351.90, 74
2, 16:06:00-000, 626, 319, 307, 319, 1353.26, 276, 1351.64, 54
2, 16:07:00-000, 359, 164, 195, 164, 1353.67, 161, 1351.77, 36
2, 16:08:00-000, 578, 249, 329, 249, 1352.39, 274, 1351.26, 37
2, 16:09:00-000, 288, 90, 198, 90, 1351.90, 120, 1350.35, 49
2, 16:10:00-000, 658, 283, 375, 283, 1352.53, 308, 1351.81, 71
2, 16:11:00-000, 267, 112, 155, 112, 1351.51, 128, 1351.01, 57
2, 16:12:00-000, 649, 289, 360, 289, 1351.47, 232, 1350.42, 67
2, 16:13:00-000, 305, 116, 189, 116, 1352.11, 131, 1350.31, 97
2, 16:14:00-000, 653, 299, 354, 299, 1352.48, 299, 1351.53, 60
2, 16:15:00-000, 323, 111, 212, 111, 1351.48, 141, 1350.39, 51
2, 16:16:00-000, 606, 265, 341, 265, 1352.44, 295, 1352.14, 36
2, 16:17:00-000, 317, 154, 163, 154, 1352.34, 124, 1350.84, 61
2, 16:18:00-000, 610, 314, 296, 314, 1352.46, 270, 1352.10, 47
2, 16:19:00-000, 280, 105, 175, 105, 1351.26, 118, 1350.73, 48
2, 16:20:00-000, 577, 240, 337, 240, 1351.72, 254, 1350.97, 65
2, 16:21:00-000, 303, 136, 167, 136, 1352.22, 111, 1351.36, 66
2, 16:22:00-000, 580, 257, 323, 257, 1351.96, 273, 1350.38, 67
2, 16:23:00-000, 307, 165, 142, 165, 1352.36, 131, 1351.33, 40
2, 16:24:00-000, 649, 249, 400, 249, 1352.33, 277, 1351.49, 19
2, 16:25:00-000, 326, 150, 176, 150, 1351.79, 162, 1351.71, 91
2, 16:26:00-000, 592, 242, 350, 242, 1353.10, 263, 1351.42, 65
2, 16:27:00-000, 315, 110, 205, 110, 1350.86, 128, 1349.96, 45
2, 16:28:00-000, 594, 243, 351, 243, 1352.01, 270, 1350.82, 90
2, 16:29:00-000, 336, 160, 176, 160, 1351.64, 140, 1351.14, 81
3, 09:00:00-000, 207, 189, 18, 5, 1351.00, 5, 1351.00, 185
3, 09:01:00-000, 209, 203, 6, 0, 0.00, 0, 0.00, 217
3, 09:02:00-000, 175, 167, 8, 0, 0.00, 0, 0.00, 175
3, 09:03:00-000, 201, 193, 8, 0, 0.00, 3, 1522.83, 194
3, 09:04:00-000, 190, 190, 0, 0, 0.00, 0, 0.00, 187
3, 09:05:00-000, 194, 194, 0, 0, 0.00, 0, 0.00, 200
3, 09:06:00-000, 228, 228, 0, 2, 1346.50, 0, 0.00, 231
3, 09:07:00-000, 225, 225, 0, 0, 0.00, 0, 0.00, 220
3, 09:08:00-000, 187, 187, 0, 0, 0.00, 0, 0.00, 181
3, 09:09:00-000, 227, 227, 0, 0, 0.00, 0, 0.00, 227
3, 09:10:00-000, 180, 180, 0, 2, 1352.00, 0, 0.00, 188
3, 09:11:00-000, 232, 232, 0, 0, 0.00, 0, 0.00, 233
3, 09:12:00-000, 200, 200, 0, 0, 0.00, 0, 0.00, 197
3, 09:13:00-000, 188, 187, 1, 5, 1546.40, 1, 1352.00, 184
3, 09:14:00-000, 167, 167, 0, 0, 0.00, 0, 0.00, 154
3, 09:15:00-000, 197, 197, 0, 0, 0.00, 0, 0.00, 210
3, 09:16:00-000, 239, 237, 2, 12, 1354.58, 0, 0.00, 220
3, 09:17:00-000, 211, 198, 13, 7, 1356.57, 11, 1359.00, 200
3, 09:18:00-000, 209, 204, 5, 4, 1351.75, 1, 1352.00, 202
3, 09:19:00-000, 230, 215, 15, 6, 1351.00, 6, 1351.67, 211
3, 09:20:00-000, 198, 191, 7, 12, 1352.17, 6, 1359.00, 182
3, 09:21:00-000, 175, 152, 23, 11, 1352.27, 2, 1352.00, 166
3, 09:22:00-000, 213, 192, 21, 4, 1352.25, 13, 1352.85, 190
3, 09:23:00-000, 199, 190, 9, 5, 1351.80, 6, 1353.67, 197
3, 09:24:00-000, 191, 182, 9, 7, 1350.28, 2, 1353.50, 174
3, 09:25:00-000, 203, 190, 13, 6, 1353.67, 2, 1355.00, 198
3, 09:26:00-000, 197, 182, 15, 14, 1351.50, 11, 1355.64, 174
3, 09:27:00-000, 199, 156, 43, 2, 1349.50, 0, 0.00, 198
3, 09:28:00-000, 217, 192, 25, 6, 1352.33, 8, 1352.62, 206
3, 09:29:00-000, 205, 196, 9, 3, 1354.33, 3, 1355.00, 194
3, 09:30:00-000, 211, 190, 21, 16, 1352.69, 10, 1355.20, 189
3, 09:31:00-000, 223, 174, 49, 2, 1348.00, 5, 1352.20, 210
3, 09:32:00-000, 171, 154, 17, 8, 1351.25, 6, 1352.17, 160
3, 09:33:00-000, 185, 162, 23, 4, 1349.75, 4, 1350.75, 179
3, 09:34:00-000, 192, 172, 20, 17, 1348.00, 4, 1351.75, 168
3, 09:35:00-000, 228, 170, 58, 5, 1351.00, 8, 1351.00, 218
3, 09:36:00-000, 237, 188, 49, 4, 1349.50, 15, 1354.47, 218
3, 09:37:00-000, 191, 176, 15, 7, 1356.14, 3, 1352.33, 179
3, 09:38:00-000, 178, 155, 23, 8, 1348.25, 8, 1351.12, 163
3, 09:39:00-000, 201, 181, 20, 4, 1350.00, 11, 1350.82, 180
3, 09:40:00-000, 179, 158, 21, 5, 1349.80, 7, 1354.29, 172
3, 09:41:00-000, 200, 176, 24, 6, 1350.83, 13, 1351.46, 185
3, 09:42:00-000, 225, 210, 15, 14, 1348.71, 4, 1351.00, 202
3, 09:43:00-000, 203, 183, 20, 4, 1349.75, 10, 1353.40, 191
3, 09:44:00-000, 205, 183, 22, 16, 1348.87, 2, 1349.50, 181
3, 09:45:00-000, 243, 201, 42, 6, 1348.33, 13, 1352.84, 228
3, 09:46:00-000, 193, 175, 18, 13, 1348.92, 5, 1351.80, 173
3, 09:47:00-000, 189, 158, 31, 9, 1348.33, 1, 1351.00, 181
3, 09:48:00-000, 205, 131, 74, 10, 1348.50, 8, 1354.50, 187
3, 09:49:00-000, 182, 110, 72, 5, 1348.40, 5, 1350.00, 168
3, 09:50:00-000, 201, 127, 74, 1, 1350.00, 11, 1350.91, 192
3, 09:51:00-000, 153, 111, 42, 7, 1347.43, 3, 1351.67, 144
3, 09:52:00-000, 213, 149, 64, 5, 1349.60, 27, 1351.33, 176
3, 09:53:00-000, 204, 171, 33, 2, 1353.00, 1, 1349.00, 208
3, 09:54:00-000, 186, 153, 33, 12, 1349.17, 3, 1355.33, 169
3, 09:55:00-000, 202, 158, 44, 4, 1348.50, 1, 1348.00, 191
3, 09:56:00-000, 189, 117, 72, 11, 1347.27, 19, 1350.89, 170
3, 09:57:00-000, 217, 134, 83, 14, 1349.14, 9, 1350.78, 189
3, 09:58:00-000, 186, 124, 62, 11, 1348.09, 10, 1350.60, 168
3, 09:59:00-000, 157, 116, 41, 6, 1349.33, 4, 1350.00, 148
3, 10:00:00-000, 209, 151, 58, 7, 1351.86, 8, 1350.25, 195
3, 10:01:00-000, 205, 166, 39, 4, 1348.00, 6, 1350.83, 193
3, 10:02:00-000, 175, 160, 15, 10, 1349.80, 9, 1352.78, 148
3, 10:03:00-000, 164, 139, 25, 8, 1350.62, 1, 1353.00, 164
3, 10:04:00-000, 217, 184, 33, 16, 1349.31, 16, 1353.06, 182
3, 10:05:00-000, 208, 175, 33, 1, 1349.00, 9, 1352.22, 193
3, 10:06:00-000, 200, 155, 45, 18, 1349.55, 9, 1350.44, 181
3, 10:07:00-000, 248, 134, 114, 12, 1349.75, 1, 1350.00, 219
3, 10:08:00-000, 186, 80, 106, 10, 1347.60, 17, 1351.29, 172
3, 10:09:00-000, 187, 111, 76, 3, 1349.00, 12, 1350.91, 173
3, 10:10:00-000, 228, 168, 60, 16, 1351.69, 22, 1352.95, 186
3, 10:11:00-000, 220, 160, 60, 10, 1346.80, 7, 1349.28, 209
3, 10:12:00-000, 198, 163, 35, 11, 1346.36, 8, 1350.62, 175
3, 10:13:00-000, 212, 172, 40, 1, 1347.00, 4, 1350.50, 203
3, 10:14:00-000, 182, 168, 14, 10, 1348.60, 5, 1353.00, 174
3, 10:15:00-000, 185, 146, 39, 7, 1348.86, 2, 1350.50, 168
3, 10:16:00-000, 199, 133, 66, 16, 1347.94, 30, 1351.30, 159
3, 10:17:00-000, 212, 195, 17, 4, 1351.25, 8, 1352.25, 195
3, 10:18:00-000, 221, 173, 48, 12, 1348.66, 3, 1350.33, 214
3, 10:19:00-000, 195, 154, 41, 4, 1354.00, 10, 1353.40, 171
3, 10:20:00-000, 213, 164, 49, 12, 1350.33, 10, 1351.50, 197
3, 10:21:00-000, 228, 198, 30, 2, 1346.50, 2, 1350.50, 220
3, 10:22:00-000, 202, 184, 18, 9, 1348.89, 7, 1351.71, 194
3, 10:23:00-000, 205, 171, 34, 15, 1348.60, 21, 1351.43, 169
3, 10:24:00-000, 194, 152, 42, 9, 1349.33, 3, 1350.33, 179
3, 10:25:00-000, 176, 132, 44, 2, 1349.00, 5, 1350.00, 172
3, 10:26:00-000, 186, 157, 29, 12, 1348.00, 2, 1351.00, 171
3, 10:27:00-000, 217, 156, 61, 3, 1350.00, 4, 1351.50, 203
3, 10:28:00-000, 210, 143, 67, 10, 1347.00, 5, 1352.20, 197
3, 10:29:00-000, 176, 121, 55, 12, 1349.50, 13, 1352.77, 153
3, 10:30:00-000, 199, 145, 54, 3, 1347.67, 9, 1351.11, 187
3, 10:31:00-000, 239, 189, 50, 20, 1348.85, 4, 1352.50, 219
3, 10:32:00-000, 215, 156, 59, 11, 1348.27, 20, 1352.40, 173
3, 10:33:00-000, 207, 153, 54, 4, 1350.00, 4, 1352.00, 208
3, 10:34:00-000, 224, 153, 71, 14, 1348.71, 15, 1352.27, 187
3, 10:35:00-000, 214, 168, 46, 8, 1351.00, 25, 1351.32, 190
3, 10:36:00-000, 176, 144, 32, 8, 1347.50, 10, 1351.60, 159
3, 10:37:00-000, 194, 152, 42, 8, 1350.62, 3, 1352.67, 182
3, 10:38:00-000, 196, 158, 38, 4, 1348.50, 9, 1350.78, 175
3, 10:39:00-000, 233, 223, 10, 1, 1345.00, 5, 1351.00, 234
3, 10:40:00-000, 215, 171, 44, 16, 1346.37, 0, 0.00, 202
3, 10:41:00-000, 193, 140, 53, 8, 1349.12, 7, 1348.29, 170
3, 10:42:00-000, 178, 140, 38, 15, 1351.53, 14, 1351.93, 153
3, 10:43:00-000, 233, 209, 24, 1, 1354.00, 4, 1354.00, 227
3, 10:44:00-000, 229, 207, 22, 22, 1349.68, 10, 1352.20, 200
3, 10:45:00-000, 176, 121, 55, 17, 1350.88, 11, 1351.27, 141
3, 10:46:00-000, 172, 104, 68, 8, 1347.75, 15, 1351.06, 157
3, 10:47:00-000, 213, 178, 35, 4, 1351.00, 18, 1352.00, 184
3, 10:48:00-000, 225, 157, 68, 21, 1349.86, 9, 1351.44, 199
3, 10:49:00-000, 188, 107, 81, 4, 1346.50, 8, 1351.12, 177
3, 10:50:00-000, 202, 155, 47, 10, 1348.70, 11, 1350.63, 183
3, 10:51:00-000, 200, 154, 46, 6, 1346.83, 6, 1350.00, 186
3, 10:52:00-000, 210, 152, 58, 8, 1347.62, 9, 1353.33, 185
3, 10:53:00-000, 217, 141, 76, 0, 0.00, 6, 1352.67, 219
3, 10:54:00-000, 184, 158, 26, 7, 1348.00, 4, 1350.25, 175
3, 10:55:00-000, 231, 193, 38, 7, 1347.29, 6, 1350.83, 218
3, 10:56:00-000, 186, 147, 39, 7, 1349.00, 15, 1350.86, 165
3, 10:57:00-000, 166, 143, 23, 18, 1346.44, 8, 1352.62, 134
3, 10:58:00-000, 146, 121, 25, 20, 1348.00, 9, 1351.44, 117
3, 10:59:00-000, 183, 142, 41, 7, 1350.86, 4, 1350.50, 172
3, 11:00:00-000, 184, 126, 58, 14, 1347.93, 4, 1350.25, 171
3, 11:01:00-000, 220, 94, 126, 8, 1350.75, 21, 1352.57, 192
3, 11:02:00-000, 187, 135, 52, 16, 1349.68, 8, 1354.25, 161
3, 11:03:00-000, 230, 109, 121, 8, 1347.50, 1, 1350.00, 214
3, 11:04:00-000, 199, 87, 112, 9, 1345.22, 22, 1350.77, 165
3, 11:05:00-000, 197, 92, 105, 2, 1347.50, 7, 1350.28, 197
3, 11:06:00-000, 179, 142, 37, 4, 1346.75, 13, 1351.77, 153
3, 11:07:00-000, 172, 131, 41, 11, 1353.64, 10, 1355.30, 161
3, 11:08:00-000, 215, 117, 98, 10, 1348.10, 6, 1349.50, 200
3, 11:09:00-000, 209, 123, 86, 8, 1345.62, 4, 1350.25, 190
3, 11:10:00-000, 196, 134, 62, 15, 1348.60, 13, 1350.38, 168
3, 11:11:00-000, 215, 171, 44, 4, 1349.25, 14, 1352.57, 204
3, 11:12:00-000, 204, 195, 9, 5, 1346.80, 7, 1351.57, 187
3, 11:13:00-000, 184, 140, 44, 7, 1349.28, 0, 0.00, 183
3, 11:14:00-000, 206, 161, 45, 13, 1348.08, 13, 1351.31, 179
3, 11:15:00-000, 180, 165, 15, 2, 1350.50, 9, 1352.44, 170
3, 11:16:00-000, 198, 139, 59, 21, 1350.04, 15, 1352.46, 152
3, 11:17:00-000, 211, 146, 65, 13, 1349.08, 7, 1350.86, 198
3, 11:18:00-000, 179, 94, 85, 4, 1347.50, 12, 1351.92, 166
3, 11:19:00-000, 195, 151, 44, 1, 1351.00, 4, 1351.00, 182
3, 11:20:00-000, 174, 95, 79, 11, 1348.00, 5, 1350.80, 164
3, 11:21:00-000, 212, 117, 95, 14, 1347.43, 15, 1350.60, 168
3, 11:22:00-000, 183, 124, 59, 3, 1347.67, 12, 1349.83, 184
3, 11:23:00-000, 187, 145, 42, 1, 1345.00, 6, 1351.67, 173
3, 11:24:00-000, 183, 160, 23, 14, 1349.07, 4, 1350.50, 173
3, 11:25:00-000, 246, 148, 98, 21, 1348.62, 14, 1351.93, 206
3, 11:26:00-000, 205, 115, 90, 11, 1349.64, 3, 1351.33, 186
3, 11:27:00-000, 172, 75, 97, 2, 1348.00, 15, 1350.73, 165
3, 11:28:00-000, 200, 109, 91, 18, 1347.44, 19, 1351.26, 157
3, 11:29:00-000, 199, 162, 37, 3, 1354.00, 15, 1352.67, 172
3, 11:30:00-000, 198, 160, 38, 11, 1348.27, 10, 1351.00, 191
3, 11:31:00-000, 194, 174, 20, 3, 1352.00, 2, 1352.00, 178
3, 11:32:00-000, 205, 178, 27, 9, 1347.78, 15, 1351.00, 180
3, 11:33:00-000, 190, 171, 19, 6, 1348.00, 0, 0.00, 197
3, 11:34:00-000, 198, 143, 55, 24, 1347.29, 9, 1350.00, 159
3, 11:35:00-000, 184, 145, 39, 5, 1347.60, 13, 1351.46, 170
3, 11:36:00-000, 214, 190, 24, 6, 1349.00, 6, 1353.33, 195
3, 11:37:00-000, 207, 187, 20, 8, 1348.12, 4, 1351.50, 202
3, 11:38:00-000, 197, 157, 40, 11, 1346.54, 9, 1351.67, 178
3, 11:39:00-000, 218, 180, 38, 1, 1345.00, 3, 1350.67, 210
3, 11:40:00-000, 203, 143, 60, 25, 1350.56, 25, 1352.12, 156
3, 11:41:00-000, 221, 159, 62, 13, 1348.00, 12, 1350.08, 195
3, 11:42:00-000, 227, 165, 62, 11, 1349.27, 19, 1350.10, 195
3, 11:43:00-000, 219, 146, 73, 14, 1347.29, 0, 0.00, 206
3, 11:44:00-000, 182, 129, 53, 6, 1348.83, 8, 1351.37, 169
3, 11:45:00-000, 218, 137, 81, 10, 1348.30, 11, 1352.82, 198
3, 11:46:00-000, 197, 132, 65, 10, 1350.90, 21, 1351.24, 160
3, 11:47:00-000, 181, 139, 42, 11, 1351.64, 8, 1354.37, 165
3, 11:48:00-000, 195, 154, 41, 9, 1348.44, 11, 1351.36, 164
3, 11:49:00-000, 195, 133, 62, 18, 1349.72, 6, 1351.67, 184
3, 11:50:00-000, 225, 177, 48, 16, 1348.56, 16, 1351.81, 189
3, 11:51:00-000, 227, 160, 67, 3, 1349.00, 6, 1350.17, 217
3, 11:52:00-000, 233, 146, 87, 12, 1348.91, 6, 1353.17, 216
3, 11:53:00-000, 235, 173, 62, 2, 1350.50, 7, 1349.86, 222
3, 11:54:00-000, 225, 158, 67, 18, 1349.05, 20, 1351.05, 196
3, 11:55:00-000, 186, 134, 52, 9, 1351.22, 16, 1353.75, 157
3, 11:56:00-000, 182, 144, 38, 9, 1350.89, 11, 1351.54, 152
3, 11:57:00-000, 168, 128, 40, 8, 1351.12, 14, 1351.64, 159
3, 11:58:00-000, 177, 157, 20, 9, 1346.89, 5, 1350.40, 165
3, 11:59:00-000, 227, 187, 40, 2, 1349.50, 0, 0.00, 218
3, 12:00:00-000, 188, 141, 47, 13, 1347.92, 11, 1350.73, 172
3, 12:01:00-000, 198, 184, 14, 4, 1347.75, 4, 1353.50, 186
3, 12:02:00-000, 207, 199, 8, 8, 1350.00, 0, 0.00, 199
3, 12:03:00-000, 176, 149, 27, 2, 1350.00, 6, 1350.83, 170
3, 12:04:00-000, 214, 193, 21, 8, 1349.62, 6, 1351.17, 190
3, 12:05:00-000, 194, 179, 15, 8, 1348.00, 6, 1351.50, 185
3, 12:06:00-000, 184, 129, 55, 16, 1350.31, 3, 1350.33, 171
3, 12:07:00-000, 189, 102, 87, 5, 1348.40, 12, 1350.50, 165
3, 12:08:00-000, 200, 145, 55, 14, 1348.64, 25, 1353.40, 169
3, 12:09:00-000, 226, 162, 64, 10, 1350.20, 16, 1351.50, 199
3, 12:10:00-000, 187, 119, 68, 20, 1347.20, 10, 1351.00, 153
3, 12:11:00-000, 246, 181, 65, 0, 0.00, 4, 1350.25, 247
3, 12:12:00-000, 235, 189, 46, 12, 1346.83, 6, 1350.50, 201
3, 12:13:00-000, 171, 104, 67, 10, 1347.70, 7, 1351.28, 170
3, 12:14:00-000, 200, 121, 79, 13, 1349.69, 8, 1350.50, 170
3, 12:15:00-000, 229, 141, 88, 5, 1346.80, 2, 1349.50, 225
3, 12:16:00-000, 190, 111, 79, 6, 1345.50, 10, 1350.70, 176
3, 12:17:00-000, 196, 134, 62, 9, 1351.44, 17, 1352.53, 160
3, 12:18:00-000, 223, 161, 62, 20, 1347.30, 10, 1351.10, 200
3, 12:19:00-000, 172, 116, 56, 4, 1350.50, 3, 1352.33, 166
3, 12:20:00-000, 191, 106, 85, 16, 1348.62, 9, 1351.00, 164
3, 12:21:00-000, 196, 89, 107, 0, 0.00, 6, 1351.17, 195
3, 12:22:00-000, 223, 141, 82, 5, 1348.20, 21, 1351.09, 197
3, 12:23:00-000, 210, 144, 66, 12, 1349.08, 5, 1351.40, 186
3, 12:24:00-000, 175, 108, 67, 25, 1347.76, 10, 1351.80, 149
3, 12:25:00-000, 216, 86, 130, 2, 1347.00, 9, 1351.22, 196
3, 12:26:00-000, 228, 126, 102, 11, 1349.18, 22, 1351.59, 204
3, 12:27:00-000, 210, 174, 36, 3, 1349.67, 5, 1351.00, 200
3, 12:28:00-000, 204, 147, 57, 14, 1348.36, 13, 1351.77, 178
3, 12:29:00-000, 212, 158, 54, 9, 1348.44, 1, 1350.00, 201
3, 12:30:00-000, 222, 149, 73, 12, 1346.67, 15, 1350.93, 192
3, 12:31:00-000, 188, 118, 70, 3, 1350.00, 1, 1353.00, 180
3, 12:32:00-000, 211, 168, 43, 3, 1349.33, 15, 1350.46, 196
3, 12:33:00-000, 196, 153, 43, 10, 1349.00, 7, 1353.14, 175
3, 12:34:00-000, 192, 139, 53, 17, 1348.70, 8, 1351.12, 163
3, 12:35:00-000, 182, 121, 61, 3, 1347.00, 11, 1352.09, 178
3, 12:36:00-000, 218, 153, 65, 15, 1348.06, 14, 1350.71, 194
3, 12:37:00-000, 186, 163, 23, 3, 1346.00, 8, 1351.25, 171
3, 12:38:00-000, 211, 163, 48, 15, 1349.60, 9, 1350.89, 187
3, 12:39:00-000, 202, 158, 44, 13, 1349.23, 9, 1350.44, 177
3, 12:40:00-000, 217, 98, 119, 24, 1347.24, 12, 1350.91, 181
3, 12:41:00-000, 200, 117, 83, 1, 1348.00, 11, 1351.36, 189
3, 12:42:00-000, 193, 125, 68, 11, 1345.54, 10, 1351.20, 170
3, 12:43:00-000, 207, 152, 55, 10, 1346.00, 8, 1352.12, 194
3, 12:44:00-000, 217, 125, 92, 11, 1348.27, 11, 1350.73, 195
3, 12:45:00-000, 215, 175, 40, 0, 0.00, 12, 1351.00, 195
3, 12:46:00-000, 209, 189, 20, 12, 1348.58, 0, 0.00, 200
3, 12:47:00-000, 203, 131, 72, 9, 1347.89, 18, 1350.66, 181
3, 12:48:00-000, 194, 143, 51, 19, 1349.47, 6, 1351.17, 163
3, 12:49:00-000, 204, 141, 63, 4, 1351.00, 22, 1351.36, 185
3, 12:50:00-000, 244, 224, 20, 6, 1348.83, 8, 1351.00, 228
3, 12:51:00-000, 178, 139, 39, 6, 1348.00, 3, 1350.67, 167
3, 12:52:00-000, 189, 160, 29, 8, 1348.50, 8, 1350.87, 171
3, 12:53:00-000, 170, 132, 38, 13, 1349.92, 8, 1351.37, 156
3, 12:54:00-000, 212, 170, 42, 13, 1347.61, 3, 1351.33, 190
3, 12:55:00-000, 190, 127, 63, 4, 1350.25, 10, 1351.10, 170
3, 12:56:00-000, 203, 117, 86, 19, 1348.10, 14, 1350.93, 169
3, 12:57:00-000, 226, 129, 97, 5, 1348.20, 9, 1351.11, 217
3, 12:58:00-000, 228, 162, 66, 13, 1349.46, 18, 1351.44, 201
3, 12:59:00-000, 218, 154, 64, 2, 1348.50, 3, 1352.00, 203
3, 13:00:00-000, 193, 117, 76, 13, 1347.31, 10, 1350.70, 175
3, 13:01:00-000, 192, 144, 48, 14, 1350.64, 17, 1352.12, 157
3, 13:02:00-000, 180, 118, 62, 17, 1346.94, 14, 1351.21, 160
3, 13:03:00-000, 155, 118, 37, 4, 1348.00, 10, 1350.40, 141
3, 13:04:00-000, 178, 138, 40, 10, 1353.10, 10, 1351.90, 156
3, 13:05:00-000, 213, 175, 38, 9, 1350.00, 10, 1352.10, 196
3, 13:06:00-000, 194, 130, 64, 20, 1347.95, 3, 1350.00, 164
3, 13:07:00-000, 206, 135, 71, 5, 1346.80, 17, 1351.18, 186
3, 13:08:00-000, 213, 66, 147, 22, 1347.36, 12, 1350.67, 185
3, 13:09:00-000, 212, 113, 99, 4, 1346.75, 18, 1351.11, 187
3, 13:10:00-000, 238, 181, 57, 12, 1348.83, 15, 1350.66, 199
3, 13:11:00-000, 215, 165, 50, 5, 1353.00, 19, 1352.10, 204
3, 13:12:00-000, 204, 166, 38, 10, 1349.00, 2, 1352.00, 193
3, 13:13:00-000, 209, 147, 62, 9, 1346.11, 9, 1350.33, 190
3, 13:14:00-000, 195, 147, 48, 11, 1348.00, 6, 1351.33, 180
3, 13:15:00-000, 196, 107, 89, 11, 1349.73, 12, 1352.08, 174
3, 13:16:00-000, 210, 163, 47, 5, 1348.40, 8, 1350.25, 197
3, 13:17:00-000, 187, 141, 46, 3, 1347.67, 8, 1350.87, 167
3, 13:18:00-000, 197, 140, 57, 27, 1348.26, 18, 1351.61, 154
3, 13:19:00-000, 211, 160, 51, 10, 1349.20, 13, 1351.15, 192
3, 13:20:00-000, 239, 208, 31, 13, 1348.92, 12, 1352.83, 209
3, 13:21:00-000, 175, 170, 5, 3, 1349.33, 3, 1352.00, 178
3, 13:22:00-000, 200, 174, 26, 12, 1348.92, 2, 1351.00, 184
3, 13:23:00-000, 202, 148, 54, 4, 1350.00, 10, 1355.30, 188
3, 13:24:00-000, 205, 152, 53, 8, 1349.00, 12, 1350.17, 181
3, 13:25:00-000, 218, 175, 43, 20, 1347.85, 1, 1354.00, 200
3, 13:26:00-000, 201, 143, 58, 6, 1347.83, 21, 1351.04, 172
3, 13:27:00-000, 173, 134, 39, 6, 1348.00, 6, 1351.17, 165
3, 13:28:00-000, 201, 131, 70, 26, 1348.92, 17, 1351.94, 158
3, 13:29:00-000, 214, 123, 91, 13, 1348.15, 11, 1350.36, 191
3, 13:30:00-000, 189, 109, 80, 14, 1348.57, 16, 1351.19, 152
3, 13:31:00-000, 193, 138, 55, 1, 1347.00, 4, 1351.00, 189
3, 13:32:00-000, 228, 156, 72, 28, 1347.43, 21, 1350.90, 182
3, 13:33:00-000, 174, 139, 35, 3, 1349.67, 10, 1351.40, 164
3, 13:34:00-000, 178, 112, 66, 18, 1347.89, 14, 1351.14, 140
3, 13:35:00-000, 205, 149, 56, 8, 1348.50, 16, 1350.81, 183
3, 13:36:00-000, 209, 138, 71, 17, 1347.53, 30, 1350.96, 165
3, 13:37:00-000, 224, 177, 47, 6, 1348.50, 9, 1351.11, 210
3, 13:38:00-000, 188, 151, 37, 21, 1348.09, 10, 1351.10, 150
3, 13:39:00-000, 231, 158, 73, 11, 1349.00, 11, 1350.73, 213
3, 13:40:00-000, 219, 150, 69, 15, 1346.20, 5, 1351.20, 201
3, 13:41:00-000, 233, 179, 54, 12, 1347.42, 17, 1350.29, 197
3, 13:42:00-000, 177, 152, 25, 15, 1347.40, 13, 1351.54, 156
3, 13:43:00-000, 170, 156, 14, 1, 1349.00, 4, 1351.50, 166
3, 13:44:00-000, 198, 142, 56, 22, 1348.45, 11, 1350.73, 153
3, 13:45:00-000, 201, 129, 72, 10, 1348.40, 8, 1351.00, 188
3, 13:46:00-000, 194, 87, 107, 14, 1347.28, 12, 1351.33, 163
3, 13:47:00-000, 201, 90, 111, 3, 1349.33, 13, 1350.00, 195
3, 13:48:00-000, 214, 130, 84, 11, 1348.91, 8, 1350.37, 188
3, 13:49:00-000, 199, 106, 93, 12, 1348.92, 8, 1351.37, 177
3, 13:50:00-000, 194, 85, 109, 8, 1348.62, 16, 1351.94, 180
3, 13:51:00-000, 172, 99, 73, 5, 1347.80, 7, 1350.00, 154
3, 13:52:00-000, 180, 128, 52, 8, 1347.12, 10, 1349.70, 159
3, 13:53:00-000, 181, 159, 22, 6, 1347.00, 11, 1351.45, 164
3, 13:54:00-000, 190, 176, 14, 5, 1351.00, 1, 1354.00, 187
3, 13:55:00-000, 195, 177, 18, 3, 1349.33, 5, 1350.80, 191
3, 13:56:00-000, 203, 177, 26, 25, 1348.16, 5, 1351.20, 175
3, 13:57:00-000, 207, 153, 54, 19, 1350.58, 26, 1351.88, 162
3, 13:58:00-000, 188, 139, 49, 15, 1346.86, 11, 1350.82, 160
3, 13:59:00-000, 219, 172, 47, 0, 0.00, 8, 1351.00, 204
3, 14:00:00-000, 209, 157, 52, 3, 1347.33, 9, 1351.67, 204
3, 14:01:00-000, 189, 152, 37, 15, 1348.80, 9, 1351.11, 163
3, 14:02:00-000, 204, 156, 48, 18, 1349.72, 20, 1351.70, 166
3, 14:03:00-000, 180, 132, 48, 11, 1348.27, 9, 1351.44, 160
3, 14:04:00-000, 198, 95, 103, 12, 1347.58, 19, 1351.21, 170
3, 14:05:00-000, 212, 170, 42, 3, 1349.67, 20, 1351.70, 190
3, 14:06:00-000, 214, 178, 36, 7, 1347.00, 1, 1352.00, 205
3, 14:07:00-000, 195, 168, 27, 5, 1347.60, 8, 1351.00, 173
3, 14:08:00-000, 172, 127, 45, 17, 1350.00, 11, 1351.18, 155
3, 14:09:00-000, 216, 157, 59, 12, 1346.25, 7, 1350.43, 196
3, 14:10:00-000, 236, 183, 53, 5, 1347.20, 13, 1351.31, 215
3, 14:11:00-000, 182, 150, 32, 8, 1350.00, 6, 1352.17, 171
3, 14:12:00-000, 237, 207, 30, 12, 1347.58, 6, 1351.00, 206
3, 14:13:00-000, 189, 146, 43, 11, 1346.45, 8, 1351.75, 180
3, 14:14:00-000, 173, 138, 35, 19, 1348.58, 9, 1351.55, 147
3, 14:15:00-000, 226, 142, 84, 1, 1347.00, 3, 1351.00, 218
3, 14:16:00-000, 268, 170, 98, 21, 1347.90, 7, 1351.14, 239
3, 14:17:00-000, 212, 144, 68, 4, 1347.50, 13, 1351.30, 185
3, 14:18:00-000, 201, 147, 54, 16, 1346.94, 13, 1352.92, 188
3, 14:19:00-000, 189, 123, 66, 9, 1349.67, 21, 1352.47, 157
3, 14:20:00-000, 203, 134, 69, 23, 1348.43, 14, 1350.14, 162
3, 14:21:00-000, 167, 117, 50, 11, 1348.64, 11, 1351.00, 145
3, 14:22:00-000, 211, 142, 69, 15, 1346.87, 23, 1351.34, 178
3, 14:23:00-000, 215, 133, 82, 6, 1345.67, 4, 1349.25, 204
3, 14:24:00-000, 219, 133, 86, 7, 1345.00, 7, 1350.29, 208
3, 14:25:00-000, 154, 70, 84, 9, 1348.78, 7, 1351.14, 135
3, 14:26:00-000, 196, 113, 83, 7, 1346.14, 13, 1350.77, 176
3, 14:27:00-000, 202, 157, 45, 1, 1350.00, 11, 1350.54, 185
3, 14:28:00-000, 214, 189, 25, 17, 1348.76, 11, 1352.09, 188
3, 14:29:00-000, 213, 172, 41, 13, 1351.92, 24, 1350.58, 177
3, 14:30:00-000, 190, 136, 54, 39, 1349.25, 2, 1351.00, 151
3, 14:31:00-000, 223, 114, 109, 3, 1347.33, 13, 1350.77, 210
3, 14:32:00-000, 205, 111, 94, 13, 1348.54, 22, 1351.04, 163
3, 14:33:00-000, 239, 153, 86, 12, 1348.41, 5, 1350.80, 228
3, 14:34:00-000, 237, 183, 54, 6, 1347.83, 18, 1351.28, 200
3, 14:35:00-000, 199, 157, 42, 17, 1349.59, 17, 1351.18, 176
3, 14:36:00-000, 178, 132, 46, 15, 1347.93, 8, 1350.50, 154
3, 14:37:00-000, 231, 176, 55, 16, 1348.31, 6, 1352.33, 207
3, 14:38:00-000, 221, 156, 65, 13, 1349.23, 25, 1351.76, 180
3, 14:39:00-000, 205, 153, 52, 24, 1347.21, 16, 1351.44, 171
3, 14:40:00-000, 212, 168, 44, 5, 1348.80, 18, 1352.50, 187
3, 14:41:00-000, 203, 162, 41, 18, 1349.72, 17, 1351.35, 164
3, 14:42:00-000, 217, 184, 33, 17, 1349.76, 11, 1350.91, 190
3, 14:43:00-000, 192, 155, 37, 4, 1351.00, 5, 1352.80, 190
3, 14:44:00-000, 185, 109, 76, 14, 1349.50, 4, 1350.25, 158
3, 14:45:00-000, 222, 121, 101, 8, 1348.37, 13, 1351.84, 190
3, 14:46:00-000, 183, 110, 73, 20, 1348.75, 14, 1351.50, 169
3, 14:47:00-000, 208, 127, 81, 7, 1350.00, 15, 1351.60, 187
3, 14:48:00-000, 179, 98, 81, 12, 1346.83, 15, 1351.86, 148
3, 14:49:00-000, 182, 119, 63, 5, 1348.80, 8, 1350.87, 160
3, 14:50:00-000, 178, 109, 69, 14, 1347.14, 8, 1350.87, 165
3, 14:51:00-000, 191, 126, 65, 8, 1347.75, 7, 1351.71, 165
3, 14:52:00-000, 224, 149, 75, 10, 1347.70, 32, 1352.03, 186
3, 14:53:00-000, 188, 159, 29, 10, 1348.10, 3, 1352.00, 185
3, 14:54:00-000, 247, 171, 76, 13, 1349.00, 22, 1351.22, 207
3, 14:55:00-000, 172, 152, 20, 2, 1349.00, 4, 1351.25, 168
3, 14:56:00-000, 182, 131, 51, 5, 1346.00, 3, 1349.33, 173
3, 14:57:00-000, 184, 132, 52, 18, 1349.50, 7, 1350.43, 160
3, 14:58:00-000, 192, 118, 74, 12, 1346.33, 4, 1351.25, 177
3, 14:59:00-000, 187, 113, 74, 11, 1352.64, 19, 1353.52, 159
3, 15:00:00-000, 181, 109, 72, 21, 1347.33, 13, 1349.69, 146
3, 15:01:00-000, 184, 95, 89, 6, 1349.00, 15, 1350.67, 164
3, 15:02:00-000, 210, 150, 60, 18, 1347.89, 15, 1351.27, 178
3, 15:03:00-000, 204, 144, 60, 11, 1348.00, 9, 1350.33, 182
3, 15:04:00-000, 199, 130, 69, 14, 1347.36, 17, 1351.82, 154
3, 15:05:00-000, 215, 148, 67, 17, 1347.23, 6, 1352.50, 201
3, 15:06:00-000, 224, 146, 78, 22, 1347.45, 4, 1350.00, 198
3, 15:07:00-000, 198, 82, 116, 4, 1345.00, 7, 1350.14, 190
3, 15:08:00-000, 186, 74, 112, 5, 1350.00, 10, 1351.30, 173
3, 15:09:00-000, 200, 87, 113, 10, 1349.70, 23, 1350.91, 165
3, 15:10:00-000, 161, 126, 35, 20, 1347.45, 16, 1351.75, 129
3, 15:11:00-000, 215, 156, 59, 2, 1348.00, 9, 1351.00, 195
3, 15:12:00-000, 211, 163, 48, 15, 1347.07, 16, 1351.81, 183
3, 15:13:00-000, 213, 171, 42, 9, 1349.56, 3, 1352.00, 205
3, 15:14:00-000, 222, 146, 76, 10, 1346.40, 13, 1351.23, 191
3, 15:15:00-000, 208, 131, 77, 12, 1347.83, 2, 1351.00, 195
3, 15:16:00-000, 195, 116, 79, 15, 1348.20, 13, 1351.08, 174
3, 15:17:00-000, 205, 137, 68, 17, 1348.29, 19, 1351.00, 170
3, 15:18:00-000, 217, 143, 74, 9, 1346.67, 10, 1351.70, 198
3, 15:19:00-000, 198, 139, 59, 8, 1347.37, 9, 1349.89, 176
3, 15:20:00-000, 198, 108, 90, 14, 1347.78, 10, 1350.40, 176
3, 15:21:00-000, 209, 73, 136, 7, 1348.57, 13, 1351.54, 188
3, 15:22:00-000, 208, 145, 63, 10, 1348.50, 20, 1351.90, 181
3, 15:23:00-000, 199, 188, 11, 3, 1350.67, 2, 1352.50, 195
3, 15:24:00-000, 208, 121, 87, 19, 1346.95, 12, 1350.41, 167
3, 15:25:00-000, 193, 136, 57, 11, 1348.91, 13, 1350.69, 178
3, 15:26:00-000, 208, 130, 78, 15, 1348.06, 16, 1350.94, 172
3, 15:27:00-000, 210, 164, 46, 7, 1350.57, 10, 1351.50, 186
3, 15:28:00-000, 161, 115, 46, 19, 1348.94, 5, 1351.60, 144
3, 15:29:00-000, 198, 93, 105, 2, 1348.00, 18, 1351.33, 178
3, 15:30:00-000, 233, 148, 85, 17, 1348.47, 15, 1350.87, 201
3, 15:31:00-000, 185, 156, 29, 3, 1349.67, 6, 1352.83, 181
3, 15:32:00-000, 192, 138, 54, 12, 1347.08, 9, 1351.00, 163
3, 15:33:00-000, 228, 157, 71, 11, 1347.73, 8, 1350.13, 213
3, 15:34:00-000, 205, 146, 59, 12, 1348.25, 24, 1351.33, 156
3, 15:35:00-000, 207, 176, 31, 4, 1346.75, 3, 1350.33, 219
3, 15:36:00-000, 201, 139, 62, 13, 1345.69, 4, 1349.50, 182
3, 15:37:00-000, 223, 169, 54, 4, 1346.50, 15, 1351.07, 204
3, 15:38:00-000, 193, 158, 35, 28, 1348.07, 7, 1351.00, 160
3, 15:39:00-000, 227, 124, 103, 5, 1349.20, 7, 1351.43, 213
3, 15:40:00-000, 164, 62, 102, 4, 1349.00, 8, 1351.87, 150
3, 15:41:00-000, 175, 112, 63, 5, 1349.00, 9, 1350.44, 164
3, 15:42:00-000, 174, 139, 35, 8, 1349.75, 11, 1351.63, 150
3, 15:43:00-000, 217, 180, 37, 1, 1346.00, 2, 1350.00, 219
3, 15:44:00-000, 248, 187, 61, 11, 1347.09, 4, 1350.75, 220
3, 15:45:00-000, 189, 144, 45, 9, 1349.44, 17, 1351.00, 172
3, 15:46:00-000, 213, 178, 35, 18, 1347.33, 3, 1350.33, 192
3, 15:47:00-000, 175, 114, 61, 0, 0.00, 6, 1352.00, 172
3, 15:48:00-000, 161, 132, 29, 13, 1350.08, 11, 1350.91, 129
3, 15:49:00-000, 215, 177, 38, 9, 1348.55, 18, 1350.66, 198
3, 15:50:00-000, 187, 129, 58, 19, 1352.00, 12, 1352.00, 155
3, 15:51:00-000, 176, 127, 49, 1, 1347.00, 6, 1350.17, 166
3, 15:52:00-000, 180, 140, 40, 11, 1348.45, 6, 1351.33, 164
3, 15:53:00-000, 226, 166, 60, 22, 1349.68, 17, 1351.17, 188
3, 15:54:00-000, 213, 156, 57, 11, 1348.36, 8, 1350.88, 185
3, 15:55:00-000, 234, 119, 115, 7, 1348.57, 4, 1349.50, 225
3, 15:56:00-000, 174, 91, 83, 8, 1348.87, 21, 1351.14, 148
3, 15:57:00-000, 225, 176, 49, 15, 1351.20, 16, 1351.94, 192
3, 15:58:00-000, 165, 140, 25, 10, 1349.30, 4, 1350.50, 157
3, 15:59:00-000, 201, 135, 66, 9, 1347.78, 2, 1349.00, 192
3, 16:00:00-000, 208, 127, 81, 19, 1347.16, 17, 1351.70, 158
3, 16:01:00-000, 166, 85, 81, 10, 1347.80, 4, 1350.00, 161
3, 16:02:00-000, 219, 101, 118, 10, 1347.80, 27, 1351.63, 185
3, 16:03:00-000, 215, 151, 64, 5, 1347.40, 6, 1351.00, 191
3, 16:04:00-000, 195, 104, 91, 17, 1346.70, 14, 1353.00, 176
3, 16:05:00-000, 220, 144, 76, 7, 1347.71, 10, 1350.60, 204
3, 16:06:00-000, 176, 129, 47, 22, 1350.95, 18, 1352.11, 128
3, 16:07:00-000, 211, 151, 60, 9, 1350.00, 19, 1352.26, 191
3, 16:08:00-000, 202, 162, 40, 9, 1348.67, 10, 1351.60, 183
3, 16:09:00-000, 208, 125, 83, 12, 1347.58, 3, 1350.67, 190
3, 16:10:00-000, 205, 152, 53, 8, 1347.62, 11, 1349.73, 188
3, 16:11:00-000, 196, 122, 74, 1, 1347.00, 2, 1351.50, 189
3, 16:12:00-000, 171, 119, 52, 6, 1347.33, 5, 1351.00, 163
3, 16:13:00-000, 206, 160, 46, 8, 1348.37, 21, 1351.19, 172
3, 16:14:00-000, 201, 186, 15, 26, 1349.07, 3, 1350.00, 172
3, 16:15:00-000, 243, 184, 59, 1, 1350.00, 9, 1350.11, 237
3, 16:16:00-000, 215, 158, 57, 9, 1348.44, 10, 1351.10, 193
3, 16:17:00-000, 198, 140, 58, 5, 1347.20, 8, 1350.75, 193
3, 16:18:00-000, 242, 144, 98, 19, 1347.68, 26, 1351.07, 197
3, 16:19:00-000, 212, 153, 59, 1, 1350.00, 4, 1350.25, 204
3, 16:20:00-000, 180, 139, 41, 10, 1350.20, 9, 1351.00, 164
3, 16:21:00-000, 191, 155, 36, 17, 1347.17, 4, 1351.50, 165
3, 16:22:00-000, 202, 139, 63, 9, 1346.89, 12, 1350.00, 183
3, 16:23:00-000, 193, 171, 22, 1, 1348.00, 5, 1351.80, 190
3, 16:24:00-000, 224, 152, 72, 21, 1349.62, 4, 1352.25, 189
3, 16:25:00-000, 178, 87, 91, 14, 1348.07, 16, 1351.06, 157
3, 16:26:00-000, 223, 141, 82, 9, 1346.78, 25, 1350.80, 189
3, 16:27:00-000, 205, 138, 67, 4, 1348.00, 0, 0.00, 202
3, 16:28:00-000, 209, 143, 66, 7, 1347.57, 22, 1351.36, 171
3, 16:29:00-000, 192, 158, 34, 12, 1347.33, 4, 1352.00, 184
3, 16:30:00-000, 2, 0, 2, 0, 0.00, 0, 0.00, 0
4, 09:03:00-000, 301, 301, 0, 3, 1522.83, 0, 0.00, 296
4, 09:04:00-000, 0, 0, 0, 0, 0.00, 0, 0.00, 2
4, 09:06:00-000, 267, 267, 0, 263, 1351.00, 0, 0.00, 0
4, 09:07:00-000, 2, 1, 1, 0, 0.00, 0, 0.00, 5
4, 09:08:00-000, 26, 24, 2, 2, 1352.00, 2, 1352.50, 6
4, 09:09:00-000, 86, 77, 9, 9, 1364.11, 9, 1364.11, 61
4, 09:10:00-000, 111, 96, 15, 13, 1410.69, 15, 1402.86, 90
4, 09:11:00-000, 77, 68, 9, 9, 1458.78, 9, 1458.78, 55
4, 09:12:00-000, 70, 60, 10, 10, 1503.80, 10, 1503.80, 53
4, 09:13:00-000, 101, 86, 15, 75, 1417.69, 13, 1352.92, 26
4, 09:14:00-000, 82, 73, 9, 71, 1356.30, 5, 1355.00, 6
4, 09:15:00-000, 81, 64, 17, 47, 1355.97, 13, 1354.31, 20
4, 09:16:00-000, 69, 44, 25, 33, 1355.15, 26, 1355.23, 11
4, 09:17:00-000, 93, 75, 18, 51, 1356.19, 18, 1356.11, 16
4, 09:18:00-000, 69, 37, 32, 47, 1355.03, 30, 1352.83, 5
4, 09:19:00-000, 114, 53, 61, 50, 1352.19, 53, 1352.35, 4
4, 09:20:00-000, 96, 47, 49, 42, 1360.66, 48, 1359.43, 6
4, 09:21:00-000, 88, 23, 65, 23, 1351.13, 59, 1351.72, 10
4, 09:22:00-000, 85, 31, 54, 31, 1352.61, 41, 1351.94, 1
4, 09:23:00-000, 70, 34, 36, 33, 1351.54, 25, 1351.20, 24
4, 09:24:00-000, 97, 57, 40, 47, 1352.35, 41, 1351.41, 3
4, 09:25:00-000, 91, 43, 48, 40, 1351.37, 35, 1350.82, 18
4, 09:26:00-000, 90, 39, 51, 38, 1355.41, 34, 1356.14, 14
4, 09:27:00-000, 78, 34, 44, 30, 1351.29, 31, 1351.45, 12
4, 09:28:00-000, 91, 45, 46, 48, 1351.93, 52, 1351.35, 1
4, 09:29:00-000, 44, 18, 26, 17, 1351.53, 19, 1352.36, 9
4, 09:30:00-000, 94, 47, 47, 48, 1354.24, 41, 1354.75, 1
4, 09:31:00-000, 106, 51, 55, 47, 1351.42, 59, 1351.43, 6
4, 09:32:00-000, 67, 32, 35, 26, 1352.19, 24, 1352.54, 6
4, 09:33:00-000, 74, 37, 37, 36, 1351.60, 36, 1352.16, 8
4, 09:34:00-000, 76, 29, 47, 29, 1351.48, 42, 1351.42, 4
4, 09:35:00-000, 96, 43, 53, 43, 1351.76, 52, 1351.84, 4
4, 09:36:00-000, 79, 43, 36, 38, 1352.81, 36, 1350.80, 3
4, 09:37:00-000, 84, 34, 50, 32, 1352.93, 33, 1348.69, 24
4, 09:38:00-000, 102, 62, 40, 47, 1350.86, 36, 1350.72, 6
4, 09:39:00-000, 88, 45, 43, 51, 1350.89, 34, 1350.14, 15
4, 09:40:00-000, 80, 39, 41, 34, 1353.73, 35, 1352.99, 4
4, 09:41:00-000, 86, 42, 44, 43, 1351.64, 40, 1351.62, 12
4, 09:42:00-000, 78, 39, 39, 35, 1350.91, 33, 1351.08, 6
4, 09:43:00-000, 80, 52, 28, 42, 1354.35, 24, 1354.29, 16
4, 09:44:00-000, 72, 25, 47, 25, 1349.80, 39, 1349.58, 12
4, 09:45:00-000, 90, 42, 48, 42, 1353.78, 31, 1352.73, 15
4, 09:46:00-000, 72, 49, 23, 40, 1352.32, 22, 1352.40, 3
4, 09:47:00-000, 66, 29, 37, 31, 1350.41, 24, 1350.29, 13
4, 09:48:00-000, 86, 30, 56, 29, 1351.44, 46, 1351.34, 10
4, 09:49:00-000, 69, 31, 38, 31, 1349.74, 33, 1349.36, 10
4, 09:50:00-000, 93, 59, 34, 54, 1351.14, 33, 1351.21, 4
4, 09:51:00-000, 82, 36, 46, 37, 1351.07, 39, 1350.38, 7
4, 09:52:00-000, 82, 46, 36, 46, 1351.21, 38, 1350.97, 1
4, 09:53:00-000, 78, 25, 53, 24, 1349.12, 48, 1348.30, 5
4, 09:54:00-000, 72, 24, 48, 23, 1353.13, 39, 1352.63, 1
4, 09:55:00-000, 82, 32, 50, 28, 1348.75, 40, 1349.67, 14
4, 09:56:00-000, 70, 46, 24, 45, 1350.66, 29, 1350.96, 6
4, 09:57:00-000, 72, 38, 34, 36, 1349.77, 30, 1349.76, 2
4, 09:58:00-000, 78, 44, 34, 43, 1350.20, 34, 1349.93, 0
4, 09:59:00-000, 73, 31, 42, 32, 1349.49, 30, 1349.16, 10
4, 10:00:00-000, 80, 32, 48, 29, 1349.89, 41, 1350.09, 3
4, 10:01:00-000, 108, 55, 53, 51, 1351.13, 51, 1350.76, 11
4, 10:02:00-000, 71, 36, 35, 28, 1351.60, 33, 1351.33, 12
4, 10:03:00-000, 80, 33, 47, 33, 1351.99, 34, 1350.90, 10
4, 10:04:00-000, 113, 57, 56, 53, 1353.50, 61, 1353.09, 6
4, 10:05:00-000, 64, 36, 28, 34, 1351.26, 28, 1350.42, 3
4, 10:06:00-000, 83, 39, 44, 39, 1350.48, 37, 1350.78, 6
4, 10:07:00-000, 103, 41, 62, 36, 1349.47, 53, 1349.77, 6
4, 10:08:00-000, 76, 27, 49, 34, 1350.26, 37, 1351.07, 9
4, 10:09:00-000, 87, 40, 47, 37, 1351.48, 38, 1351.23, 10
4, 10:10:00-000, 66, 33, 33, 33, 1351.81, 42, 1351.73, 0
4, 10:11:00-000, 106, 45, 61, 36, 1348.69, 42, 1349.11, 3
4, 10:12:00-000, 74, 41, 33, 49, 1349.46, 47, 1349.74, 0
4, 10:13:00-000, 89, 40, 49, 33, 1348.36, 37, 1348.13, 16
4, 10:14:00-000, 97, 49, 48, 44, 1353.54, 36, 1352.08, 12
4, 10:15:00-000, 107, 52, 55, 46, 1351.01, 61, 1350.89, 3
4, 10:16:00-000, 81, 44, 37, 48, 1351.10, 34, 1351.67, 4
4, 10:17:00-000, 68, 35, 33, 34, 1352.26, 24, 1352.16, 8
4, 10:18:00-000, 87, 40, 47, 40, 1350.27, 39, 1350.74, 1
4, 10:19:00-000, 86, 52, 34, 47, 1353.27, 43, 1352.67, 3
4, 10:20:00-000, 84, 39, 45, 43, 1351.08, 40, 1350.47, 0
4, 10:21:00-000, 82, 42, 40, 42, 1350.07, 38, 1350.10, 3
4, 10:22:00-000, 83, 41, 42, 34, 1352.96, 32, 1352.71, 19
4, 10:23:00-000, 94, 59, 35, 54, 1351.60, 31, 1351.57, 1
4, 10:24:00-000, 63, 25, 38, 26, 1350.80, 35, 1351.68, 10
4, 10:25:00-000, 94, 35, 59, 35, 1349.19, 57, 1349.13, 4
4, 10:26:00-000, 97, 35, 62, 35, 1350.94, 53, 1350.74, 4
4, 10:27:00-000, 62, 35, 27, 35, 1350.94, 26, 1350.80, 7
4, 10:28:00-000, 65, 33, 32, 29, 1351.51, 26, 1350.76, 3
4, 10:29:00-000, 102, 47, 55, 47, 1351.78, 40, 1351.42, 19
4, 10:30:00-000, 85, 38, 47, 38, 1350.44, 41, 1350.53, 4
4, 10:31:00-000, 80, 41, 39, 41, 1350.77, 37, 1350.37, 5
4, 10:32:00-000, 90, 46, 44, 43, 1352.39, 32, 1351.53, 6
4, 10:33:00-000, 101, 39, 62, 37, 1351.32, 34, 1350.82, 22
4, 10:34:00-000, 56, 28, 28, 27, 1349.59, 39, 1350.66, 0
4, 10:35:00-000, 104, 47, 57, 45, 1351.01, 42, 1351.09, 11
4, 10:36:00-000, 74, 36, 38, 32, 1351.30, 45, 1352.24, 4
4, 10:37:00-000, 68, 25, 43, 25, 1351.87, 28, 1351.46, 18
4, 10:38:00-000, 85, 44, 41, 39, 1350.92, 41, 1351.19, 10
4, 10:39:00-000, 113, 57, 56, 50, 1350.15, 53, 1350.33, 6
4, 10:40:00-000, 95, 33, 62, 36, 1348.13, 48, 1348.05, 5
4, 10:41:00-000, 64, 30, 34, 28, 1349.92, 27, 1349.29, 16
4, 10:42:00-000, 91, 44, 47, 37, 1353.05, 48, 1352.26, 1
4, 10:43:00-000, 97, 56, 41, 50, 1351.11, 40, 1349.34, 9
4, 10:44:00-000, 94, 51, 43, 54, 1350.27, 33, 1350.21, 7
4, 10:45:00-000, 101, 42, 59, 42, 1351.40, 39, 1351.69, 12
4, 10:46:00-000, 72, 42, 30, 33, 1350.57, 31, 1351.09, 5
4, 10:47:00-000, 92, 57, 35, 44, 1352.01, 33, 1352.17, 17
4, 10:48:00-000, 68, 42, 26, 38, 1350.81, 31, 1351.38, 13
4, 10:49:00-000, 96, 45, 51, 39, 1350.71, 43, 1350.48, 5
4, 10:50:00-000, 67, 40, 27, 41, 1351.14, 31, 1351.80, 3
4, 10:51:00-000, 64, 39, 25, 35, 1349.79, 23, 1349.91, 3
4, 10:52:00-000, 86, 43, 43, 41, 1351.99, 33, 1352.27, 10
4, 10:53:00-000, 77, 27, 50, 21, 1348.00, 37, 1348.88, 18
4, 10:54:00-000, 100, 41, 59, 37, 1350.88, 57, 1350.24, 5
4, 10:55:00-000, 76, 28, 48, 29, 1350.27, 35, 1350.36, 10
4, 10:56:00-000, 106, 57, 49, 51, 1350.52, 44, 1350.56, 4
4, 10:57:00-000, 66, 38, 28, 36, 1350.96, 28, 1350.35, 9
4, 10:58:00-000, 71, 45, 26, 50, 1350.81, 30, 1350.99, 0
4, 10:59:00-000, 70, 32, 38, 32, 1351.12, 26, 1351.03, 8
4, 11:00:00-000, 100, 35, 65, 35, 1349.31, 62, 1349.50, 9
4, 11:01:00-000, 72, 34, 38, 34, 1352.29, 37, 1352.56, 0
4, 11:02:00-000, 81, 36, 45, 36, 1352.08, 45, 1350.93, 1
4, 11:03:00-000, 77, 27, 50, 27, 1349.29, 35, 1349.36, 4
4, 11:04:00-000, 96, 42, 54, 41, 1348.19, 42, 1348.63, 7
4, 11:05:00-000, 76, 33, 43, 30, 1349.96, 44, 1350.29, 14
4, 11:06:00-000, 97, 70, 27, 66, 1353.00, 29, 1352.13, 4
4, 11:07:00-000, 109, 43, 66, 44, 1352.76, 43, 1352.27, 10
4, 11:08:00-000, 96, 33, 63, 28, 1349.78, 65, 1350.43, 7
4, 11:09:00-000, 68, 21, 47, 22, 1349.81, 23, 1349.21, 18
4, 11:10:00-000, 84, 43, 41, 39, 1350.48, 56, 1350.92, 1
4, 11:11:00-000, 88, 45, 43, 43, 1353.25, 38, 1353.20, 7
4, 11:12:00-000, 62, 39, 23, 37, 1351.34, 26, 1352.38, 0
4, 11:13:00-000, 68, 28, 40, 26, 1350.88, 34, 1350.82, 2
4, 11:14:00-000, 99, 59, 40, 61, 1351.99, 37, 1352.16, 7
4, 11:15:00-000, 92, 48, 44, 47, 1351.88, 44, 1352.01, 3
4, 11:16:00-000, 79, 46, 33, 46, 1353.97, 29, 1352.37, 2
4, 11:17:00-000, 97, 47, 50, 42, 1349.61, 43, 1350.27, 6
4, 11:18:00-000, 107, 50, 57, 56, 1351.10, 42, 1349.04, 6
4, 11:19:00-000, 84, 38, 46, 33, 1349.48, 38, 1349.84, 17
4, 11:20:00-000, 67, 29, 38, 28, 1349.32, 37, 1349.54, 3
4, 11:21:00-000, 97, 31, 66, 24, 1349.62, 46, 1349.47, 14
4, 11:22:00-000, 56, 33, 23, 32, 1348.81, 30, 1350.13, 7
4, 11:23:00-000, 91, 59, 32, 55, 1351.64, 33, 1351.48, 8
4, 11:24:00-000, 70, 24, 46, 25, 1350.03, 45, 1349.79, 2
4, 11:25:00-000, 83, 54, 29, 42, 1350.23, 26, 1350.65, 9
4, 11:26:00-000, 86, 43, 43, 46, 1350.92, 42, 1351.11, 0
4, 11:27:00-000, 78, 23, 55, 21, 1349.19, 30, 1350.66, 8
4, 11:28:00-000, 85, 41, 44, 41, 1349.72, 57, 1350.29, 6
4, 11:29:00-000, 69, 43, 26, 43, 1352.53, 25, 1352.28, 2
4, 11:30:00-000, 92, 50, 42, 48, 1349.97, 42, 1349.64, 5
4, 11:31:00-000, 92, 45, 47, 37, 1350.70, 38, 1351.55, 9
4, 11:32:00-000, 64, 40, 24, 39, 1350.79, 25, 1351.20, 1
4, 11:33:00-000, 76, 39, 37, 37, 1350.24, 31, 1350.35, 2
4, 11:34:00-000, 61, 23, 38, 25, 1349.84, 40, 1350.52, 5
4, 11:35:00-000, 87, 44, 43, 40, 1351.22, 31, 1351.80, 5
4, 11:36:00-000, 88, 45, 43, 39, 1351.46, 51, 1351.34, 4
4, 11:37:00-000, 64, 23, 41, 25, 1350.87, 30, 1350.63, 9
4, 11:38:00-000, 81, 36, 45, 34, 1348.23, 49, 1349.13, 0
4, 11:39:00-000, 97, 51, 46, 45, 1348.99, 45, 1348.84, 6
4, 11:40:00-000, 85, 63, 22, 67, 1352.33, 25, 1352.04, 0
4, 11:41:00-000, 78, 32, 46, 29, 1350.10, 32, 1349.50, 6
4, 11:42:00-000, 106, 48, 58, 49, 1349.89, 57, 1350.61, 10
4, 11:43:00-000, 81, 28, 53, 29, 1349.20, 39, 1349.12, 3
4, 11:44:00-000, 91, 39, 52, 28, 1350.00, 55, 1349.88, 7
4, 11:45:00-000, 60, 34, 26, 33, 1350.78, 26, 1350.69, 12
4, 11:46:00-000, 90, 41, 49, 42, 1349.52, 40, 1349.04, 3
4, 11:47:00-000, 85, 46, 39, 46, 1352.14, 38, 1351.34, 4
4, 11:48:00-000, 84, 46, 38, 37, 1351.64, 40, 1351.62, 3
4, 11:49:00-000, 79, 43, 36, 45, 1350.79, 33, 1351.33, 7
4, 11:50:00-000, 55, 29, 26, 27, 1351.81, 25, 1352.11, 1
4, 11:51:00-000, 94, 27, 67, 28, 1349.60, 44, 1349.61, 14
4, 11:52:00-000, 79, 31, 48, 27, 1352.48, 45, 1350.37, 3
4, 11:53:00-000, 87, 35, 52, 36, 1349.96, 38, 1350.39, 19
4, 11:54:00-000, 96, 44, 52, 44, 1352.15, 53, 1350.80, 7
4, 11:55:00-000, 86, 40, 46, 38, 1352.70, 26, 1352.50, 8
4, 11:56:00-000, 78, 28, 50, 30, 1351.39, 53, 1352.42, 8
4, 11:57:00-000, 75, 36, 39, 29, 1351.00, 28, 1350.32, 12
4, 11:58:00-000, 91, 35, 56, 35, 1350.28, 47, 1350.31, 12
4, 11:59:00-000, 81, 32, 49, 32, 1348.93, 41, 1349.24, 9
4, 12:00:00-000, 65, 41, 24, 40, 1351.24, 24, 1351.12, 0
4, 12:01:00-000, 96, 50, 46, 43, 1352.67, 42, 1351.78, 13
4, 12:02:00-000, 77, 50, 27, 48, 1351.14, 28, 1351.10, 3
4, 12:03:00-000, 61, 27, 34, 27, 1350.36, 30, 1350.09, 2
4, 12:04:00-000, 78, 40, 38, 37, 1351.37, 41, 1351.09, 0
4, 12:05:00-000, 90, 47, 43, 47, 1351.91, 41, 1352.09, 4
4, 12:06:00-000, 71, 27, 44, 25, 1349.35, 32, 1349.43, 8
4, 12:07:00-000, 90, 50, 40, 46, 1350.17, 32, 1349.81, 13
4, 12:08:00-000, 73, 48, 25, 45, 1353.01, 24, 1352.83, 2
4, 12:09:00-000, 112, 68, 44, 64, 1350.86, 41, 1350.87, 7
4, 12:10:00-000, 97, 36, 61, 42, 1349.95, 42, 1350.61, 12
4, 12:11:00-000, 63, 26, 37, 26, 1349.19, 25, 1349.11, 12
4, 12:12:00-000, 77, 32, 45, 31, 1351.51, 37, 1350.64, 5
4, 12:13:00-000, 82, 45, 37, 37, 1351.21, 33, 1351.20, 19
4, 12:14:00-000, 66, 35, 31, 37, 1350.18, 33, 1350.05, 0
4, 12:15:00-000, 90, 28, 62, 27, 1348.66, 38, 1349.10, 10
4, 12:16:00-000, 70, 30, 40, 26, 1348.19, 46, 1348.79, 9
4, 12:17:00-000, 89, 52, 37, 50, 1352.01, 30, 1351.79, 5
4, 12:18:00-000, 94, 46, 48, 48, 1351.05, 50, 1351.81, 6
4, 12:19:00-000, 66, 22, 44, 21, 1349.85, 23, 1348.78, 4
4, 12:20:00-000, 71, 37, 34, 37, 1350.34, 38, 1350.60, 3
4, 12:21:00-000, 90, 35, 55, 30, 1350.16, 49, 1349.71, 10
4, 12:22:00-000, 78, 41, 37, 39, 1350.09, 41, 1350.36, 6
4, 12:23:00-000, 79, 41, 38, 39, 1351.04, 38, 1351.02, 3
4, 12:24:00-000, 75, 32, 43, 30, 1348.49, 36, 1348.38, 3
4, 12:25:00-000, 105, 47, 58, 50, 1350.55, 52, 1349.49, 7
4, 12:26:00-000, 79, 41, 38, 39, 1352.48, 40, 1351.72, 1
4, 12:27:00-000, 72, 29, 43, 31, 1350.38, 36, 1350.30, 3
4, 12:28:00-000, 111, 50, 61, 51, 1350.40, 50, 1350.83, 14
4, 12:29:00-000, 55, 22, 33, 21, 1350.09, 28, 1349.64, 1
4, 12:30:00-000, 90, 39, 51, 36, 1351.63, 38, 1351.33, 13
4, 12:31:00-000, 92, 38, 54, 33, 1349.60, 44, 1349.60, 15
4, 12:32:00-000, 106, 52, 54, 43, 1350.55, 54, 1351.29, 12
4, 12:33:00-000, 87, 41, 46, 39, 1352.22, 44, 1351.36, 5
4, 12:34:00-000, 80, 38, 42, 38, 1349.05, 32, 1349.15, 6
4, 12:35:00-000, 95, 49, 46, 49, 1351.25, 49, 1349.93, 6
4, 12:36:00-000, 72, 44, 28, 44, 1352.13, 26, 1351.50, 0
4, 12:37:00-000, 87, 59, 28, 40, 1351.27, 28, 1351.14, 9
4, 12:38:00-000, 77, 41, 36, 45, 1350.61, 28, 1350.21, 13
4, 12:39:00-000, 69, 36, 33, 34, 1350.23, 30, 1350.16, 5
4, 12:40:00-000, 99, 57, 42, 52, 1350.34, 35, 1350.36, 7
4, 12:41:00-000, 75, 39, 36, 33, 1350.57, 28, 1350.35, 13
4, 12:42:00-000, 101, 44, 57, 40, 1350.74, 54, 1350.66, 4
4, 12:43:00-000, 76, 37, 39, 37, 1351.59, 33, 1350.23, 9
4, 12:44:00-000, 83, 36, 47, 34, 1350.20, 49, 1351.44, 7
4, 12:45:00-000, 55, 35, 20, 32, 1350.87, 20, 1351.15, 0
4, 12:46:00-000, 101, 41, 60, 44, 1350.52, 58, 1350.90, 3
4, 12:47:00-000, 86, 38, 48, 36, 1350.49, 36, 1349.77, 8
4, 12:48:00-000, 75, 29, 46, 31, 1349.70, 46, 1350.56, 1
4, 12:49:00-000, 84, 46, 38, 37, 1350.72, 35, 1350.56, 2
4, 12:50:00-000, 113, 50, 63, 55, 1350.14, 58, 1350.00, 6
4, 12:51:00-000, 74, 28, 46, 26, 1349.69, 45, 1350.06, 2
4, 12:52:00-000, 83, 34, 49, 38, 1350.23, 46, 1350.58, 4
4, 12:53:00-000, 86, 52, 34, 45, 1351.79, 37, 1351.78, 2
4, 12:54:00-000, 71, 34, 37, 37, 1348.97, 29, 1348.51, 1
4, 12:55:00-000, 67, 36, 31, 37, 1351.18, 32, 1351.34, 6
4, 12:56:00-000, 80, 44, 36, 41, 1351.65, 33, 1351.60, 1
4, 12:57:00-000, 101, 46, 55, 41, 1351.48, 43, 1351.88, 12
4, 12:58:00-000, 79, 39, 40, 38, 1351.44, 48, 1351.12, 0
4, 12:59:00-000, 76, 31, 45, 29, 1350.89, 28, 1349.92, 12
4, 13:00:00-000, 85, 41, 44, 40, 1349.69, 50, 1350.33, 6
4, 13:01:00-000, 80, 49, 31, 46, 1352.34, 34, 1352.26, 0
4, 13:02:00-000, 88, 55, 33, 51, 1351.60, 29, 1350.79, 10
4, 13:03:00-000, 98, 56, 42, 49, 1350.05, 34, 1350.88, 5
4, 13:04:00-000, 79, 42, 37, 38, 1350.15, 37, 1350.48, 3
4, 13:05:00-000, 72, 33, 39, 37, 1353.62, 21, 1352.85, 12
4, 13:06:00-000, 70, 29, 41, 31, 1348.16, 44, 1349.93, 1
4, 13:07:00-000, 86, 46, 40, 41, 1349.65, 28, 1349.74, 9
4, 13:08:00-000, 89, 30, 59, 33, 1348.18, 55, 1349.17, 5
4, 13:09:00-000, 88, 56, 32, 56, 1350.20, 38, 1350.23, 2
4, 13:10:00-000, 82, 27, 55, 27, 1349.66, 45, 1350.28, 8
4, 13:11:00-000, 83, 47, 36, 44, 1352.65, 34, 1351.93, 7
4, 13:12:00-000, 100, 30, 70, 31, 1348.96, 54, 1349.49, 6
4, 13:13:00-000, 56, 30, 26, 28, 1348.21, 26, 1348.03, 12
4, 13:14:00-000, 93, 47, 46, 46, 1353.45, 43, 1351.16, 5
4, 13:15:00-000, 65, 32, 33, 28, 1350.00, 28, 1349.64, 4
4, 13:16:00-000, 84, 24, 60, 27, 1350.36, 42, 1350.11, 0
4, 13:17:00-000, 89, 41, 48, 42, 1350.23, 38, 1350.49, 20
4, 13:18:00-000, 80, 47, 33, 41, 1352.29, 41, 1352.53, 0
4, 13:19:00-000, 69, 37, 32, 36, 1350.94, 22, 1351.77, 7
4, 13:20:00-000, 74, 39, 35, 39, 1353.17, 38, 1352.39, 2
4, 13:21:00-000, 79, 41, 38, 36, 1351.38, 35, 1351.45, 12
4, 13:22:00-000, 67, 33, 34, 33, 1350.11, 24, 1350.08, 7
4, 13:23:00-000, 74, 34, 40, 31, 1351.35, 36, 1350.58, 7
4, 13:24:00-000, 79, 36, 43, 33, 1348.45, 43, 1348.53, 3
4, 13:25:00-000, 82, 40, 42, 38, 1350.41, 24, 1351.50, 6
4, 13:26:00-000, 102, 51, 51, 57, 1349.36, 55, 1349.81, 1
4, 13:27:00-000, 73, 46, 27, 41, 1351.46, 33, 1351.24, 5
4, 13:28:00-000, 82, 42, 40, 43, 1352.04, 33, 1351.48, 5
4, 13:29:00-000, 82, 37, 45, 40, 1350.57, 40, 1350.54, 1
4, 13:30:00-000, 65, 22, 43, 22, 1350.31, 42, 1350.45, 3
4, 13:31:00-000, 72, 27, 45, 26, 1350.23, 39, 1349.28, 5
4, 13:32:00-000, 106, 48, 58, 46, 1351.25, 57, 1351.76, 6
4, 13:33:00-000, 74, 29, 45, 31, 1351.12, 30, 1351.36, 4
4, 13:34:00-000, 62, 30, 32, 30, 1351.06, 41, 1351.23, 0
4, 13:35:00-000, 88, 49, 39, 43, 1350.34, 31, 1350.93, 3
4, 13:36:00-000, 87, 46, 41, 49, 1350.97, 46, 1351.88, 1
4, 13:37:00-000, 85, 45, 40, 39, 1351.10, 26, 1350.96, 6
4, 13:38:00-000, 77, 35, 42, 40, 1350.22, 41, 1350.14, 7
4, 13:39:00-000, 86, 37, 49, 38, 1350.47, 45, 1350.19, 7
4, 13:40:00-000, 87, 40, 47, 32, 1348.90, 40, 1349.09, 0
4, 13:41:00-000, 71, 40, 31, 48, 1350.97, 38, 1351.54, 1
4, 13:42:00-000, 91, 58, 33, 51, 1352.09, 31, 1351.41, 6
4, 13:43:00-000, 70, 37, 33, 31, 1351.19, 30, 1351.19, 8
4, 13:44:00-000, 69, 37, 32, 38, 1350.44, 28, 1350.53, 7
4, 13:45:00-000, 101, 39, 62, 40, 1348.89, 49, 1348.40, 3
4, 13:46:00-000, 96, 50, 46, 51, 1350.40, 45, 1350.35, 2
4, 13:47:00-000, 78, 40, 38, 36, 1349.80, 33, 1349.57, 5
4, 13:48:00-000, 100, 48, 52, 48, 1350.05, 39, 1350.51, 13
4, 13:49:00-000, 73, 27, 46, 23, 1350.52, 36, 1350.91, 16
4, 13:50:00-000, 84, 38, 46, 41, 1350.39, 44, 1350.95, 6
4, 13:51:00-000, 74, 28, 46, 27, 1348.55, 26, 1349.27, 16
4, 13:52:00-000, 71, 35, 36, 33, 1349.11, 39, 1349.94, 2
4, 13:53:00-000, 63, 32, 31, 17, 1352.53, 32, 1352.93, 7
4, 13:54:00-000, 75, 50, 25, 48, 1353.07, 28, 1353.49, 9
4, 13:55:00-000, 105, 50, 55, 53, 1350.73, 44, 1350.67, 2
4, 13:56:00-000, 74, 36, 38, 36, 1350.72, 44, 1351.04, 3
4, 13:57:00-000, 91, 44, 47, 44, 1351.47, 30, 1351.90, 0
4, 13:58:00-000, 68, 40, 28, 36, 1351.27, 40, 1352.04, 5
4, 13:59:00-000, 95, 33, 62, 34, 1349.52, 46, 1350.56, 9
4, 14:00:00-000, 67, 34, 33, 25, 1351.35, 35, 1351.28, 10
4, 14:01:00-000, 61, 28, 33, 26, 1351.46, 19, 1351.78, 14
4, 14:02:00-000, 96, 54, 42, 53, 1351.65, 48, 1351.45, 1
4, 14:03:00-000, 111, 38, 73, 36, 1350.66, 51, 1350.58, 8
4, 14:04:00-000, 84, 48, 36, 46, 1351.08, 50, 1350.49, 1
4, 14:05:00-000, 73, 40, 33, 41, 1351.31, 31, 1351.28, 1
4, 14:06:00-000, 87, 35, 52, 38, 1350.91, 50, 1350.77, 2
4, 14:07:00-000, 77, 50, 27, 38, 1351.60, 24, 1350.95, 6
4, 14:08:00-000, 72, 26, 46, 31, 1350.99, 36, 1350.99, 9
4, 14:09:00-000, 56, 21, 35, 20, 1348.65, 31, 1349.83, 7
4, 14:10:00-000, 98, 48, 50, 42, 1349.80, 55, 1349.55, 1
4, 14:11:00-000, 58, 27, 31, 27, 1351.47, 28, 1351.78, 5
4, 14:12:00-000, 83, 39, 44, 39, 1349.74, 43, 1350.11, 1
4, 14:13:00-000, 100, 63, 37, 58, 1350.85, 37, 1350.13, 2
4, 14:14:00-000, 78, 49, 29, 48, 1351.51, 21, 1351.00, 8
4, 14:15:00-000, 79, 31, 48, 31, 1349.57, 37, 1349.88, 4
4, 14:16:00-000, 99, 43, 56, 43, 1350.57, 51, 1350.81, 6
4, 14:17:00-000, 62, 44, 18, 36, 1349.63, 27, 1350.03, 5
4, 14:18:00-000, 105, 41, 64, 47, 1349.80, 58, 1350.64, 3
4, 14:19:00-000, 99, 46, 53, 37, 1353.53, 35, 1351.51, 6
4, 14:20:00-000, 82, 32, 50, 42, 1349.13, 52, 1350.45, 5
4, 14:21:00-000, 66, 35, 31, 28, 1350.49, 35, 1349.74, 8
4, 14:22:00-000, 79, 34, 45, 35, 1350.11, 31, 1350.22, 3
4, 14:23:00-000, 71, 29, 42, 28, 1348.71, 44, 1348.61, 5
4, 14:24:00-000, 106, 39, 67, 40, 1349.47, 63, 1348.78, 1
4, 14:25:00-000, 89, 49, 40, 42, 1348.80, 37, 1348.59, 7
4, 14:26:00-000, 84, 43, 41, 39, 1350.48, 46, 1350.45, 8
4, 14:27:00-000, 82, 53, 29, 45, 1350.86, 23, 1350.91, 14
4, 14:28:00-000, 58, 39, 19, 35, 1351.88, 21, 1351.04, 2
4, 14:29:00-000, 113, 66, 47, 57, 1350.68, 47, 1350.65, 4
4, 14:30:00-000, 71, 31, 40, 36, 1349.82, 38, 1350.20, 2
4, 14:31:00-000, 67, 37, 30, 33, 1350.02, 32, 1351.09, 1
4, 14:32:00-000, 92, 50, 42, 43, 1350.46, 24, 1350.37, 6
4, 14:33:00-000, 94, 44, 50, 48, 1351.05, 50, 1351.19, 12
4, 14:34:00-000, 89, 44, 45, 40, 1349.94, 47, 1350.46, 3
4, 14:35:00-000, 84, 46, 38, 46, 1351.56, 33, 1351.75, 11
4, 14:36:00-000, 71, 27, 44, 26, 1349.96, 35, 1350.22, 0
4, 14:37:00-000, 85, 32, 53, 29, 1349.65, 49, 1350.40, 7
4, 14:38:00-000, 102, 53, 49, 55, 1350.04, 53, 1350.58, 1
4, 14:39:00-000, 59, 33, 26, 26, 1350.11, 24, 1351.04, 4
4, 14:40:00-000, 80, 42, 38, 46, 1352.56, 32, 1352.21, 5
4, 14:41:00-000, 104, 47, 57, 49, 1351.38, 41, 1350.97, 6
4, 14:42:00-000, 89, 33, 56, 34, 1350.53, 45, 1350.48, 11
4, 14:43:00-000, 81, 47, 34, 40, 1351.79, 42, 1351.30, 7
4, 14:44:00-000, 90, 34, 56, 35, 1349.59, 53, 1350.69, 2
4, 14:45:00-000, 74, 44, 30, 36, 1350.60, 36, 1350.49, 1
4, 14:46:00-000, 82, 36, 46, 36, 1350.77, 40, 1350.94, 5
4, 14:47:00-000, 98, 50, 48, 53, 1350.93, 48, 1350.95, 3
4, 14:48:00-000, 76, 40, 36, 34, 1349.96, 31, 1349.22, 3
4, 14:49:00-000, 75, 33, 42, 29, 1350.69, 19, 1350.21, 10
4, 14:50:00-000, 67, 33, 34, 37, 1350.34, 48, 1350.68, 4
4, 14:51:00-000, 88, 31, 57, 31, 1349.70, 30, 1349.49, 6
4, 14:52:00-000, 81, 48, 33, 49, 1351.11, 46, 1350.40, 9
4, 14:53:00-000, 70, 32, 38, 31, 1350.93, 32, 1351.68, 4
4, 14:54:00-000, 108, 50, 58, 48, 1351.66, 49, 1350.93, 3
4, 14:55:00-000, 90, 41, 49, 39, 1351.17, 44, 1351.92, 9
4, 14:56:00-000, 58, 26, 32, 27, 1349.18, 32, 1349.46, 8
4, 14:57:00-000, 92, 40, 52, 41, 1351.80, 46, 1351.86, 0
4, 14:58:00-000, 83, 42, 41, 29, 1351.00, 44, 1350.15, 1
4, 14:59:00-000, 67, 38, 29, 40, 1352.24, 27, 1352.07, 13
4, 15:00:00-000, 98, 40, 58, 37, 1348.45, 43, 1348.62, 6
4, 15:01:00-000, 89, 52, 37, 53, 1351.20, 42, 1350.47, 7
4, 15:02:00-000, 73, 49, 24, 40, 1350.27, 26, 1350.30, 0
4, 15:03:00-000, 110, 46, 64, 46, 1351.08, 44, 1351.15, 16
4, 15:04:00-000, 96, 52, 44, 51, 1350.13, 54, 1349.77, 3
4, 15:05:00-000, 66, 26, 40, 25, 1351.32, 15, 1350.20, 4
4, 15:06:00-000, 85, 39, 46, 34, 1348.91, 49, 1349.44, 14
4, 15:07:00-000, 101, 46, 55, 42, 1348.35, 48, 1348.45, 10
4, 15:08:00-000, 69, 31, 38, 35, 1350.34, 40, 1350.52, 6
4, 15:09:00-000, 75, 42, 33, 42, 1351.04, 29, 1350.92, 1
4, 15:10:00-000, 75, 43, 32, 41, 1352.24, 35, 1352.65, 1
4, 15:11:00-000, 107, 42, 65, 41, 1351.26, 60, 1350.79, 1
4, 15:12:00-000, 85, 30, 55, 31, 1350.22, 48, 1350.20, 11
4, 15:13:00-000, 105, 55, 50, 51, 1350.21, 47, 1350.16, 0
4, 15:14:00-000, 86, 49, 37, 53, 1349.22, 33, 1349.81, 5
4, 15:15:00-000, 84, 24, 60, 23, 1348.60, 41, 1348.99, 10
4, 15:16:00-000, 107, 64, 43, 62, 1350.49, 49, 1350.93, 5
4, 15:17:00-000, 60, 38, 22, 37, 1350.88, 19, 1351.15, 3
4, 15:18:00-000, 90, 44, 46, 36, 1349.08, 47, 1349.08, 6
4, 15:19:00-000, 73, 38, 35, 37, 1349.13, 30, 1348.83, 5
4, 15:20:00-000, 72, 36, 36, 32, 1350.09, 33, 1350.48, 7
4, 15:21:00-000, 78, 34, 44, 31, 1350.67, 35, 1350.65, 9
4, 15:22:00-000, 51, 25, 26, 24, 1350.62, 33, 1351.99, 2
4, 15:23:00-000, 93, 40, 53, 38, 1351.60, 27, 1351.81, 6
4, 15:24:00-000, 80, 45, 35, 35, 1349.45, 46, 1350.82, 2
4, 15:25:00-000, 80, 34, 46, 43, 1350.36, 28, 1350.92, 13
4, 15:26:00-000, 80, 43, 37, 32, 1350.12, 47, 1350.74, 8
4, 15:27:00-000, 89, 44, 45, 46, 1350.93, 36, 1349.58, 4
4, 15:28:00-000, 69, 40, 29, 46, 1350.36, 35, 1350.74, 0
4, 15:29:00-000, 101, 40, 61, 38, 1348.97, 46, 1348.58, 1
4, 15:30:00-000, 73, 48, 25, 40, 1351.87, 35, 1351.19, 2
4, 15:31:00-000, 81, 26, 55, 30, 1350.46, 37, 1351.16, 6
4, 15:32:00-000, 90, 51, 39, 55, 1349.74, 53, 1350.46, 2
4, 15:33:00-000, 81, 32, 49, 30, 1349.76, 36, 1349.72, 1
4, 15:34:00-000, 100, 48, 52, 47, 1351.63, 53, 1351.54, 3
4, 15:35:00-000, 76, 37, 39, 36, 1350.69, 43, 1350.78, 6
4, 15:36:00-000, 88, 40, 48, 35, 1349.77, 40, 1350.14, 3
4, 15:37:00-000, 90, 48, 42, 44, 1347.29, 42, 1347.75, 14
4, 15:38:00-000, 77, 40, 37, 37, 1350.18, 31, 1350.90, 4
4, 15:39:00-000, 98, 47, 51, 44, 1351.45, 55, 1351.54, 0
4, 15:40:00-000, 85, 32, 53, 34, 1349.79, 50, 1348.91, 7
4, 15:41:00-000, 89, 46, 43, 45, 1350.37, 40, 1350.74, 2
4, 15:42:00-000, 68, 44, 24, 43, 1350.83, 19, 1351.15, 7
4, 15:43:00-000, 94, 49, 45, 50, 1350.99, 40, 1350.94, 1
4, 15:44:00-000, 62, 29, 33, 24, 1349.33, 36, 1349.97, 6
4, 15:45:00-000, 95, 38, 57, 35, 1350.11, 43, 1349.95, 2
4, 15:46:00-000, 55, 25, 30, 24, 1350.20, 38, 1351.13, 3
4, 15:47:00-000, 94, 46, 48, 39, 1351.66, 44, 1350.43, 6
4, 15:48:00-000, 85, 51, 34, 56, 1351.31, 27, 1350.66, 8
4, 15:49:00-000, 94, 55, 39, 53, 1352.35, 35, 1352.45, 2
4, 15:50:00-000, 84, 51, 33, 50, 1351.09, 31, 1350.29, 7
4, 15:51:00-000, 94, 34, 60, 38, 1350.63, 39, 1350.71, 5
4, 15:52:00-000, 76, 34, 42, 28, 1348.35, 54, 1349.91, 0
4, 15:53:00-000, 91, 58, 33, 50, 1351.83, 37, 1351.45, 5
4, 15:54:00-000, 79, 33, 46, 34, 1348.49, 36, 1348.85, 9
4, 15:55:00-000, 77, 40, 37, 38, 1350.20, 37, 1349.72, 8
4, 15:56:00-000, 75, 37, 38, 32, 1351.77, 33, 1351.18, 5
4, 15:57:00-000, 103, 49, 54, 44, 1352.56, 39, 1352.17, 12
4, 15:58:00-000, 80, 41, 39, 45, 1349.93, 48, 1350.26, 3
4, 15:59:00-000, 100, 34, 66, 34, 1348.73, 55, 1348.84, 3
4, 16:00:00-000, 74, 36, 38, 37, 1350.18, 32, 1350.40, 7
4, 16:01:00-000, 75, 42, 33, 37, 1349.59, 31, 1349.77, 1
4, 16:02:00-000, 95, 44, 51, 45, 1350.61, 54, 1351.16, 0
4, 16:03:00-000, 62, 23, 39, 26, 1349.42, 30, 1350.09, 4
4, 16:04:00-000, 70, 41, 29, 39, 1350.63, 33, 1350.75, 2
4, 16:05:00-000, 64, 33, 31, 32, 1350.27, 26, 1350.34, 4
4, 16:06:00-000, 103, 56, 47, 48, 1350.49, 46, 1351.01, 5
4, 16:07:00-000, 73, 37, 36, 39, 1350.63, 24, 1350.54, 5
4, 16:08:00-000, 110, 58, 52, 56, 1350.26, 52, 1350.83, 0
4, 16:09:00-000, 79, 35, 44, 31, 1347.41, 36, 1348.71, 16
4, 16:10:00-000, 87, 30, 57, 29, 1348.79, 50, 1349.55, 7
4, 16:11:00-000, 79, 37, 42, 43, 1349.88, 43, 1349.85, 2
4, 16:12:00-000, 95, 43, 52, 36, 1348.63, 46, 1349.23, 10
4, 16:13:00-000, 87, 52, 35, 50, 1351.55, 38, 1350.28, 1
4, 16:14:00-000, 80, 43, 37, 41, 1351.26, 39, 1351.84, 5
4, 16:15:00-000, 74, 39, 35, 38, 1349.73, 28, 1349.75, 6
4, 16:16:00-000, 82, 43, 39, 42, 1350.85, 32, 1350.93, 1
4, 16:17:00-000, 105, 45, 60, 40, 1349.32, 57, 1349.69, 8
4, 16:18:00-000, 96, 44, 52, 39, 1349.69, 48, 1349.97, 1
4, 16:19:00-000, 64, 29, 35, 33, 1349.63, 31, 1350.44, 8
4, 16:20:00-000, 87, 50, 37, 52, 1351.89, 44, 1351.79, 2
4, 16:21:00-000, 49, 20, 29, 21, 1351.04, 24, 1351.62, 1
4, 16:22:00-000, 86, 43, 43, 40, 1349.52, 40, 1349.39, 8
4, 16:23:00-000, 87, 34, 53, 33, 1349.75, 37, 1349.86, 5
4, 16:24:00-000, 80, 36, 44, 34, 1348.67, 47, 1349.76, 5
4, 16:25:00-000, 67, 38, 29, 31, 1350.96, 25, 1351.19, 8
4, 16:26:00-000, 87, 44, 43, 49, 1348.99, 41, 1349.21, 6
4, 16:27:00-000, 75, 24, 51, 21, 1347.90, 27, 1348.40, 4
4, 16:28:00-000, 83, 41, 42, 43, 1350.13, 55, 1350.23, 6
4, 16:29:00-000, 87, 50, 37, 48, 1349.47, 41, 1348.99, 0
5, 09:13:00-000, 10388, 5829, 4559, 3878, 1348.19, 3696, 1350.09, 0
5, 09:14:00-000, 0, 0, 0, 0, 0.00, 35, 1357.00, 682
5, 09:15:00-000, 0, 0, 0, 0, 0.00, 37, 1357.00, 2060
5, 09:26:00-000, 10145, 5441, 4704, 3668, 1348.20, 3745, 1348.37, 0
5, 09:27:00-000, 0, 0, 0, 0, 0.00, 55, 1356.00, 0
5, 09:28:00-000, 7, 7, 0, 24, 1348.91, 75, 1356.70, 1891
5, 09:29:00-000, 36, 15, 21, 14, 1347.50, 22, 1349.91, 693
5, 09:30:00-000, 80, 34, 46, 28, 1348.42, 39, 1352.12, 0
5, 09:32:00-000, 196, 117, 79, 75, 1348.83, 76, 1352.35, 8
5, 09:33:00-000, 334, 182, 152, 122, 1349.06, 133, 1349.74, 23
5, 09:34:00-000, 594, 344, 250, 225, 1349.49, 260, 1351.55, 52
5, 09:35:00-000, 0, 0, 0, 21, 1347.76, 2, 1359.00, 33
5, 09:36:00-000, 926, 485, 441, 350, 1348.92, 378, 1350.50, 71
5, 09:37:00-000, 1138, 647, 491, 428, 1348.81, 422, 1349.55, 137
5, 09:38:00-000, 1406, 746, 660, 601, 1348.98, 581, 1349.66, 139
5, 09:39:00-000, 0, 0, 0, 0, 0.00, 23, 1357.00, 170
5, 09:40:00-000, 1309, 726, 583, 532, 1349.20, 553, 1350.35, 192
5, 09:41:00-000, 1210, 621, 589, 469, 1349.13, 486, 1349.42, 174
5, 09:42:00-000, 1088, 603, 485, 483, 1348.94, 412, 1349.92, 185
5, 09:43:00-000, 0, 0, 0, 16, 1346.00, 34, 1357.00, 153
5, 09:44:00-000, 1012, 474, 538, 383, 1348.56, 421, 1349.57, 151
5, 09:45:00-000, 898, 486, 412, 351, 1349.27, 373, 1350.11, 142
5, 09:46:00-000, 897, 500, 397, 361, 1349.73, 385, 1350.99, 129
5, 09:47:00-000, 0, 0, 0, 12, 1346.50, 17, 1358.00, 101
5, 09:48:00-000, 920, 499, 421, 332, 1349.10, 396, 1350.29, 115
5, 09:49:00-000, 983, 507, 476, 345, 1348.85, 370, 1349.35, 131
5, 09:50:00-000, 1002, 455, 547, 384, 1347.98, 425, 1349.06, 165
5, 09:51:00-000, 0, 0, 0, 12, 1345.67, 37, 1355.00, 155
5, 09:52:00-000, 1115, 598, 517, 454, 1348.81, 429, 1349.58, 147
5, 09:53:00-000, 1087, 615, 472, 456, 1348.85, 438, 1349.73, 188
5, 09:54:00-000, 1126, 584, 542, 454, 1348.52, 460, 1349.75, 113
5, 09:55:00-000, 0, 0, 0, 16, 1346.00, 22, 1357.00, 138
5, 09:56:00-000, 1164, 624, 540, 509, 1348.19, 473, 1349.60, 153
5, 09:57:00-000, 1097, 609, 488, 427, 1349.12, 410, 1349.61, 167
5, 09:58:00-000, 936, 534, 402, 458, 1348.91, 391, 1350.32, 126
5, 09:59:00-000, 0, 0, 0, 29, 1345.00, 0, 0.00, 129
5, 10:00:00-000, 973, 528, 445, 392, 1348.95, 373, 1349.81, 115
5, 10:01:00-000, 1000, 499, 501, 426, 1347.70, 405, 1348.61, 115
5, 10:02:00-000, 1020, 539, 481, 370, 1349.50, 452, 1350.52, 129
5, 10:03:00-000, 0, 0, 0, 9, 1348.00, 30, 1358.07, 135
5, 10:04:00-000, 976, 515, 461, 415, 1349.04, 404, 1349.61, 102
5, 10:05:00-000, 1024, 480, 544, 371, 1348.28, 412, 1349.15, 142
5, 10:06:00-000, 1045, 567, 478, 407, 1348.30, 423, 1349.47, 121
5, 10:07:00-000, 0, 0, 0, 28, 1345.39, 28, 1356.46, 153
5, 10:08:00-000, 985, 494, 491, 383, 1347.97, 424, 1349.77, 175
5, 10:09:00-000, 1034, 573, 461, 403, 1348.81, 394, 1349.71, 151
5, 10:10:00-000, 977, 494, 483, 395, 1348.44, 370, 1349.17, 130
5, 10:11:00-000, 0, 0, 0, 22, 1345.00, 0, 0.00, 141
5, 10:12:00-000, 1014, 515, 499, 405, 1348.12, 376, 1348.06, 185
5, 10:13:00-000, 1046, 546, 500, 426, 1348.82, 384, 1349.06, 182
5, 10:14:00-000, 997, 521, 476, 333, 1348.81, 429, 1350.13, 127
5, 10:15:00-000, 0, 0, 0, 4, 1347.00, 10, 1356.10, 175
5, 10:16:00-000, 972, 518, 454, 393, 1348.71, 378, 1349.47, 175
5, 10:17:00-000, 1040, 562, 478, 402, 1349.42, 398, 1350.11, 157
5, 10:18:00-000, 1079, 598, 481, 467, 1348.87, 441, 1350.12, 146
5, 10:19:00-000, 0, 0, 0, 31, 1346.00, 17, 1357.00, 149
5, 10:20:00-000, 1126, 578, 548, 430, 1348.55, 452, 1350.06, 143
5, 10:21:00-000, 1009, 538, 471, 365, 1348.81, 397, 1348.99, 166
5, 10:22:00-000, 1087, 522, 565, 410, 1348.82, 431, 1349.25, 184
5, 10:23:00-000, 2, 2, 0, 2, 1352.00, 30, 1355.56, 167
5, 10:24:00-000, 935, 474, 461, 340, 1348.08, 363, 1349.07, 187
5, 10:25:00-000, 1017, 576, 441, 397, 1350.05, 400, 1350.57, 170
5, 10:26:00-000, 983, 471, 512, 390, 1348.14, 404, 1349.10, 141
5, 10:27:00-000, 0, 0, 0, 57, 1344.43, 9, 1356.00, 120
5, 10:28:00-000, 1031, 546, 485, 420, 1348.24, 393, 1349.20, 142
5, 10:29:00-000, 1058, 567, 491, 403, 1349.32, 424, 1350.28, 139
5, 10:30:00-000, 1000, 508, 492, 383, 1348.02, 362, 1348.76, 155
5, 10:31:00-000, 0, 0, 0, 28, 1345.25, 47, 1354.82, 140
5, 10:32:00-000, 1109, 578, 531, 442, 1348.90, 446, 1350.24, 178
5, 10:33:00-000, 954, 496, 458, 355, 1349.20, 351, 1349.99, 181
5, 10:34:00-000, 950, 456, 494, 377, 1348.49, 398, 1349.30, 166
5, 10:35:00-000, 0, 0, 0, 10, 1345.00, 0, 0.00, 171
5, 10:36:00-000, 986, 511, 475, 394, 1348.67, 377, 1349.17, 145
5, 10:37:00-000, 1130, 570, 560, 416, 1349.15, 465, 1350.01, 138
5, 10:38:00-000, 1009, 527, 482, 417, 1349.12, 402, 1350.03, 125
5, 10:39:00-000, 4, 2, 2, 39, 1345.40, 14, 1355.00, 207
5, 10:40:00-000, 974, 485, 489, 365, 1348.46, 420, 1349.72, 145
5, 10:41:00-000, 950, 506, 444, 384, 1348.92, 417, 1349.81, 126
5, 10:42:00-000, 1005, 518, 487, 449, 1349.16, 387, 1349.09, 110
5, 10:43:00-000, 0, 0, 0, 14, 1345.36, 9, 1356.00, 102
5, 10:44:00-000, 966, 529, 437, 380, 1349.38, 417, 1350.43, 128
5, 10:45:00-000, 993, 524, 469, 381, 1348.96, 351, 1349.44, 114
5, 10:46:00-000, 1062, 556, 506, 437, 1348.40, 420, 1349.61, 133
5, 10:47:00-000, 3, 0, 3, 46, 1345.00, 21, 1356.19, 152
5, 10:48:00-000, 1131, 547, 584, 449, 1348.72, 472, 1349.85, 162
5, 10:49:00-000, 1022, 494, 528, 392, 1348.72, 409, 1349.19, 152
5, 10:50:00-000, 1012, 491, 521, 381, 1348.89, 436, 1349.48, 177
5, 10:51:00-000, 0, 0, 0, 30, 1344.63, 19, 1356.00, 127
5, 10:52:00-000, 963, 444, 519, 388, 1348.13, 420, 1349.22, 128
5, 10:53:00-000, 1079, 593, 486, 410, 1349.46, 403, 1350.40, 114
5, 10:54:00-000, 1045, 544, 501, 423, 1348.65, 441, 1349.97, 139
5, 10:55:00-000, 0, 0, 0, 7, 1346.00, 2, 1357.00, 188
5, 10:56:00-000, 973, 490, 483, 404, 1348.60, 393, 1349.80, 166
5, 10:57:00-000, 1064, 565, 499, 416, 1349.34, 423, 1349.54, 99
5, 10:58:00-000, 991, 503, 488, 428, 1348.70, 422, 1350.05, 146
5, 10:59:00-000, 0, 0, 0, 32, 1345.00, 48, 1356.89, 111
5, 11:00:00-000, 1130, 579, 551, 443, 1348.91, 421, 1349.64, 100
5, 11:01:00-000, 1100, 554, 546, 449, 1348.88, 460, 1349.99, 177
5, 11:02:00-000, 977, 521, 456, 362, 1348.96, 428, 1350.21, 140
5, 11:03:00-000, 2, 2, 0, 1, 1348.00, 0, 0.00, 149
5, 11:04:00-000, 909, 480, 429, 398, 1348.00, 374, 1349.34, 123
5, 11:05:00-000, 1131, 621, 510, 468, 1349.32, 427, 1349.78, 155
5, 11:06:00-000, 1066, 556, 510, 429, 1348.64, 431, 1349.54, 122
5, 11:07:00-000, 1, 0, 1, 13, 1346.00, 48, 1357.39, 152
5, 11:08:00-000, 970, 455, 515, 383, 1348.25, 370, 1349.17, 129
5, 11:09:00-000, 1022, 571, 451, 374, 1349.01, 379, 1349.32, 171
5, 11:10:00-000, 1035, 543, 492, 410, 1348.78, 432, 1349.85, 164
5, 11:11:00-000, 0, 0, 0, 63, 1345.32, 0, 0.00, 146
5, 11:12:00-000, 1088, 523, 565, 409, 1348.77, 459, 1349.58, 134
5, 11:13:00-000, 1006, 513, 493, 391, 1348.67, 352, 1348.80, 169
5, 11:14:00-000, 1078, 532, 546, 413, 1348.36, 502, 1349.79, 160
5, 11:15:00-000, 0, 0, 0, 21, 1345.00, 31, 1356.74, 135
5, 11:16:00-000, 1011, 531, 480, 453, 1348.75, 424, 1349.87, 117
5, 11:17:00-000, 1041, 572, 469, 422, 1348.38, 403, 1349.04, 116
5, 11:18:00-000, 956, 491, 465, 378, 1348.50, 418, 1349.97, 131
5, 11:19:00-000, 0, 0, 0, 55, 1344.38, 20, 1357.00, 128
5, 11:20:00-000, 1047, 504, 543, 385, 1348.76, 455, 1350.25, 107
5, 11:21:00-000, 1058, 504, 554, 397, 1348.57, 395, 1348.86, 130
5, 11:22:00-000, 1038, 504, 534, 409, 1348.57, 405, 1349.18, 141
5, 11:23:00-000, 0, 0, 0, 68, 1344.57, 31, 1353.67, 174
5, 11:24:00-000, 1078, 563, 515, 431, 1349.45, 427, 1350.49, 98
5, 11:25:00-000, 1084, 560, 524, 450, 1348.69, 433, 1349.17, 163
5, 11:26:00-000, 1048, 514, 534, 404, 1348.56, 411, 1349.73, 173
5, 11:27:00-000, 0, 0, 0, 85, 1343.64, 0, 0.00, 102
5, 11:28:00-000, 1036, 522, 514, 444, 1348.54, 359, 1348.98, 181
5, 11:29:00-000, 987, 504, 483, 384, 1348.93, 395, 1349.85, 125
5, 11:30:00-000, 1030, 474, 556, 397, 1348.15, 415, 1349.11, 165
5, 11:31:00-000, 0, 0, 0, 29, 1344.00, 65, 1354.61, 132
5, 11:32:00-000, 1043, 569, 474, 430, 1348.40, 394, 1349.76, 105
5, 11:33:00-000, 1078, 528, 550, 375, 1348.45, 428, 1348.90, 185
5, 11:34:00-000, 1030, 493, 537, 412, 1348.15, 458, 1349.68, 153
5, 11:35:00-000, 0, 0, 0, 6, 1344.00, 30, 1355.00, 160
5, 11:36:00-000, 950, 485, 465, 422, 1348.78, 380, 1350.15, 146
5, 11:37:00-000, 1092, 584, 508, 392, 1349.48, 395, 1349.48, 113
5, 11:38:00-000, 1014, 505, 509, 463, 1348.76, 417, 1349.61, 118
5, 11:39:00-000, 0, 0, 0, 55, 1344.56, 12, 1356.00, 148
5, 11:40:00-000, 1057, 525, 532, 382, 1348.54, 408, 1349.39, 138
5, 11:41:00-000, 1085, 507, 578, 409, 1348.74, 441, 1349.35, 201
5, 11:42:00-000, 1092, 597, 495, 510, 1348.83, 423, 1349.88, 143
5, 11:43:00-000, 0, 0, 0, 21, 1344.00, 30, 1355.96, 135
5, 11:44:00-000, 1010, 510, 500, 424, 1348.84, 370, 1349.50, 124
5, 11:45:00-000, 1094, 612, 482, 417, 1349.13, 379, 1349.34, 156
5, 11:46:00-000, 945, 507, 438, 389, 1349.51, 436, 1350.71, 158
5, 11:47:00-000, 7, 7, 0, 0, 0.00, 9, 1358.00, 170
5, 11:48:00-000, 981, 498, 483, 405, 1348.85, 375, 1349.93, 144
5, 11:49:00-000, 1072, 548, 524, 396, 1349.05, 382, 1349.80, 167
5, 11:50:00-000, 1025, 553, 472, 399, 1349.79, 414, 1350.63, 177
5, 11:51:00-000, 0, 0, 0, 17, 1347.00, 0, 0.00, 174
5, 11:52:00-000, 1036, 555, 481, 434, 1349.07, 439, 1350.07, 144
5, 11:53:00-000, 1124, 653, 471, 446, 1349.93, 416, 1350.59, 155
5, 11:54:00-000, 1071, 561, 510, 432, 1348.94, 422, 1349.26, 128
5, 11:55:00-000, 0, 0, 0, 13, 1346.00, 28, 1357.00, 182
5, 11:56:00-000, 1007, 550, 457, 391, 1349.55, 368, 1349.93, 167
5, 11:57:00-000, 1080, 598, 482, 462, 1349.17, 387, 1349.58, 184
5, 11:58:00-000, 1032, 536, 496, 407, 1349.55, 473, 1350.83, 132
5, 11:59:00-000, 2, 0, 2, 33, 1346.93, 0, 0.00, 160
5, 12:00:00-000, 1015, 483, 532, 408, 1348.02, 450, 1349.33, 116
5, 12:01:00-000, 1050, 538, 512, 412, 1348.74, 429, 1349.46, 117
5, 12:02:00-000, 1020, 597, 423, 390, 1349.62, 408, 1350.74, 139
5, 12:03:00-000, 0, 0, 0, 17, 1347.82, 31, 1358.00, 135
5, 12:04:00-000, 986, 497, 489, 360, 1349.64, 393, 1350.56, 148
5, 12:05:00-000, 1063, 531, 532, 397, 1348.88, 424, 1349.35, 152
5, 12:06:00-000, 1024, 545, 479, 396, 1348.17, 433, 1350.37, 148
5, 12:07:00-000, 0, 0, 0, 15, 1345.40, 25, 1357.00, 162
5, 12:08:00-000, 1054, 559, 495, 426, 1348.94, 436, 1349.86, 179
5, 12:09:00-000, 1068, 510, 558, 397, 1348.76, 400, 1349.33, 165
5, 12:10:00-000, 1056, 537, 519, 430, 1348.41, 454, 1349.31, 127
5, 12:11:00-000, 1, 0, 1, 14, 1345.00, 6, 1354.50, 177
5, 12:12:00-000, 939, 441, 498, 396, 1348.23, 410, 1348.91, 140
5, 12:13:00-000, 1017, 513, 504, 389, 1347.90, 400, 1348.59, 113
5, 12:14:00-000, 985, 538, 447, 427, 1348.91, 425, 1350.16, 127
5, 12:15:00-000, 1, 1, 0, 12, 1346.00, 1, 1351.00, 115
5, 12:16:00-000, 1132, 545, 587, 456, 1348.40, 442, 1349.50, 129
5, 12:17:00-000, 1137, 590, 547, 426, 1349.52, 434, 1349.88, 164
5, 12:18:00-000, 1119, 567, 552, 421, 1348.90, 483, 1350.08, 148
5, 12:19:00-000, 1, 0, 1, 28, 1345.00, 3, 1352.33, 189
5, 12:20:00-000, 987, 536, 451, 332, 1349.40, 285, 1348.58, 197
5, 12:21:00-000, 990, 532, 458, 378, 1348.97, 345, 1348.51, 243
5, 12:22:00-000, 1046, 489, 557, 418, 1348.86, 387, 1348.97, 228
5, 12:23:00-000, 0, 0, 0, 0, 0.00, 0, 0.00, 181
5, 12:24:00-000, 1029, 496, 533, 344, 1349.09, 414, 1349.14, 203
5, 12:25:00-000, 1074, 575, 499, 404, 1349.15, 368, 1349.03, 195
5, 12:26:00-000, 993, 535, 458, 366, 1349.89, 317, 1349.69, 238
5, 12:27:00-000, 1, 0, 1, 19, 1348.00, 0, 0.00, 226
5, 12:28:00-000, 1007, 550, 457, 417, 1348.93, 332, 1349.23, 178
5, 12:29:00-000, 981, 493, 488, 342, 1349.18, 341, 1348.65, 227
5, 12:30:00-000, 998, 515, 483, 368, 1349.31, 373, 1349.69, 243
5, 12:31:00-000, 1, 0, 1, 17, 1346.00, 0, 0.00, 178
5, 12:32:00-000, 1043, 485, 558, 392, 1349.01, 449, 1349.84, 186
5, 12:33:00-000, 1027, 541, 486, 394, 1348.87, 390, 1348.81, 174
5, 12:34:00-000, 1032, 512, 520, 380, 1349.32, 417, 1349.95, 169
5, 12:35:00-000, 0, 0, 0, 13, 1346.00, 0, 0.00, 178
5, 12:36:00-000, 993, 512, 481, 407, 1349.26, 374, 1350.36, 163
5, 12:37:00-000, 1039, 521, 518, 391, 1349.05, 409, 1349.53, 155
5, 12:38:00-000, 1064, 582, 482, 406, 1349.31, 351, 1349.35, 157
5, 12:39:00-000, 1, 0, 1, 1, 1346.00, 9, 1355.00, 189
5, 12:40:00-000, 1015, 487, 528, 412, 1348.08, 416, 1349.20, 209
5, 12:41:00-000, 1032, 554, 478, 386, 1349.80, 344, 1350.41, 160
5, 12:42:00-000, 1033, 587, 446, 436, 1348.89, 337, 1349.11, 183
5, 12:43:00-000, 2, 0, 2, 35, 1345.22, 1, 1347.00, 206
5, 12:44:00-000, 938, 484, 454, 340, 1349.23, 352, 1349.91, 186
5, 12:45:00-000, 1126, 638, 488, 424, 1350.08, 373, 1350.04, 204
5, 12:46:00-000, 1061, 523, 538, 422, 1347.85, 426, 1349.05, 164
5, 12:47:00-000, 1, 1, 0, 32, 1346.00, 18, 1355.00, 161
5, 12:48:00-000, 1051, 537, 514, 370, 1349.07, 401, 1350.13, 169
5, 12:49:00-000, 970, 515, 455, 361, 1348.96, 358, 1349.36, 242
5, 12:50:00-000, 1011, 524, 487, 380, 1348.77, 386, 1349.82, 190
5, 12:51:00-000, 0, 0, 0, 13, 1347.00, 27, 1354.77, 167
5, 12:52:00-000, 1042, 485, 557, 317, 1348.55, 388, 1349.56, 181
5, 12:53:00-000, 1056, 567, 489, 398, 1349.92, 406, 1350.35, 222
5, 12:54:00-000, 971, 488, 483, 372, 1348.73, 409, 1350.11, 191
5, 12:55:00-000, 0, 0, 0, 12, 1346.00, 17, 1356.00, 192
5, 12:56:00-000, 1044, 521, 523, 392, 1348.66, 386, 1349.83, 137
5, 12:57:00-000, 1097, 530, 567, 409, 1348.75, 408, 1349.41, 204
5, 12:58:00-000, 1098, 571, 527, 441, 1348.63, 413, 1349.53, 188
5, 12:59:00-000, 2, 0, 2, 4, 1346.00, 15, 1354.86, 193
5, 13:00:00-000, 984, 489, 495, 414, 1348.35, 389, 1349.41, 178
5, 13:01:00-000, 1025, 531, 494, 403, 1349.32, 389, 1349.33, 143
5, 13:02:00-000, 1042, 493, 549, 444, 1348.46, 493, 1349.87, 124
5, 13:03:00-000, 0, 0, 0, 6, 1344.00, 22, 1356.00, 133
5, 13:04:00-000, 1012, 569, 443, 412, 1349.80, 407, 1350.54, 136
5, 13:05:00-000, 1024, 551, 473, 407, 1348.90, 370, 1349.15, 140
5, 13:06:00-000, 989, 483, 506, 409, 1348.72, 401, 1349.55, 107
5, 13:07:00-000, 0, 0, 0, 68, 1344.45, 18, 1354.17, 166
5, 13:08:00-000, 1095, 574, 521, 465, 1348.63, 411, 1349.27, 119
5, 13:09:00-000, 1004, 552, 452, 412, 1348.50, 385, 1349.33, 118
5, 13:10:00-000, 1026, 532, 494, 391, 1348.88, 400, 1350.58, 162
5, 13:11:00-000, 1, 0, 1, 16, 1346.62, 3, 1352.00, 145
5, 13:12:00-000, 1001, 517, 484, 408, 1348.88, 380, 1350.09, 193
5, 13:13:00-000, 1122, 566, 556, 446, 1348.57, 452, 1348.93, 150
5, 13:14:00-000, 943, 461, 482, 399, 1348.73, 407, 1350.17, 170
5, 13:15:00-000, 0, 0, 0, 0, 0.00, 28, 1356.60, 125
5, 13:16:00-000, 1082, 593, 489, 432, 1349.46, 398, 1350.15, 110
5, 13:17:00-000, 1083, 524, 559, 417, 1348.55, 467, 1349.32, 145
5, 13:18:00-000, 948, 503, 445, 372, 1349.43, 418, 1350.99, 169
5, 13:19:00-000, 1, 0, 1, 35, 1345.00, 1, 1351.00, 140
5, 13:20:00-000, 1026, 519, 507, 357, 1348.84, 387, 1349.57, 151
5, 13:21:00-000, 981, 528, 453, 389, 1348.89, 371, 1349.27, 152
5, 13:22:00-000, 1047, 554, 493, 441, 1349.57, 434, 1350.76, 186
5, 13:23:00-000, 0, 0, 0, 24, 1346.29, 18, 1357.00, 135
5, 13:24:00-000, 1044, 533, 511, 429, 1349.39, 440, 1350.66, 152
5, 13:25:00-000, 1078, 559, 519, 425, 1348.78, 441, 1349.34, 124
5, 13:26:00-000, 1046, 560, 486, 422, 1348.95, 408, 1350.64, 114
5, 13:27:00-000, 0, 0, 0, 39, 1345.10, 0, 0.00, 152
5, 13:28:00-000, 1012, 503, 509, 397, 1348.83, 444, 1350.03, 150
5, 13:29:00-000, 1024, 476, 548, 354, 1348.66, 400, 1349.31, 141
5, 13:30:00-000, 999, 498, 501, 365, 1348.95, 396, 1349.50, 128
5, 13:31:00-000, 1, 0, 1, 0, 0.00, 20, 1354.80, 197
5, 13:32:00-000, 1113, 559, 554, 435, 1348.58, 476, 1349.76, 178
5, 13:33:00-000, 1097, 564, 533, 413, 1349.03, 389, 1349.53, 170
5, 13:34:00-000, 947, 456, 491, 369, 1348.54, 393, 1349.82, 178
5, 13:35:00-000, 0, 0, 0, 27, 1345.00, 1, 1355.00, 188
5, 13:36:00-000, 968, 486, 482, 396, 1348.61, 373, 1350.02, 156
5, 13:37:00-000, 1105, 521, 584, 396, 1348.36, 403, 1348.83, 123
5, 13:38:00-000, 1090, 548, 542, 393, 1348.84, 435, 1349.79, 164
5, 13:39:00-000, 1, 1, 0, 8, 1346.00, 13, 1354.84, 216
5, 13:40:00-000, 1017, 553, 464, 484, 1348.59, 391, 1349.39, 201
5, 13:41:00-000, 968, 483, 485, 400, 1348.85, 388, 1349.38, 118
5, 13:42:00-000, 975, 489, 486, 372, 1349.04, 410, 1350.08, 139
5, 13:43:00-000, 7, 7, 0, 43, 1345.72, 11, 1356.00, 106
5, 13:44:00-000, 994, 504, 490, 380, 1348.81, 400, 1349.50, 135
5, 13:45:00-000, 1064, 481, 583, 390, 1348.19, 429, 1348.77, 144
5, 13:46:00-000, 1083, 569, 514, 447, 1348.57, 436, 1349.13, 164
5, 13:47:00-000, 0, 0, 0, 2, 1345.00, 25, 1356.00, 171
5, 13:48:00-000, 1068, 531, 537, 396, 1348.65, 412, 1349.39, 147
5, 13:49:00-000, 1035, 543, 492, 413, 1349.64, 398, 1349.96, 178
5, 13:50:00-000, 1000, 533, 467, 408, 1349.67, 394, 1349.99, 178
5, 13:51:00-000, 1, 0, 1, 38, 1346.10, 16, 1355.56, 134
5, 13:52:00-000, 1032, 497, 535, 460, 1348.40, 462, 1349.39, 135
5, 13:53:00-000, 934, 478, 456, 370, 1348.34, 389, 1349.22, 108
5, 13:54:00-000, 946, 532, 414, 337, 1349.51, 336, 1350.75, 88
5, 13:55:00-000, 2, 2, 0, 12, 1347.08, 2, 1357.00, 126
5, 13:56:00-000, 957, 462, 495, 369, 1348.41, 374, 1349.34, 202
5, 13:57:00-000, 1130, 628, 502, 413, 1349.50, 433, 1350.18, 165
5, 13:58:00-000, 1023, 492, 531, 416, 1348.17, 423, 1349.23, 175
5, 13:59:00-000, 0, 0, 0, 1, 1347.00, 32, 1355.50, 146
5, 14:00:00-000, 1099, 550, 549, 421, 1348.29, 437, 1349.15, 154
5, 14:01:00-000, 1012, 524, 488, 369, 1349.05, 387, 1349.83, 195
5, 14:02:00-000, 963, 492, 471, 386, 1348.76, 355, 1350.04, 167
5, 14:03:00-000, 1, 0, 1, 20, 1345.55, 8, 1356.00, 157
5, 14:04:00-000, 1028, 531, 497, 431, 1348.28, 448, 1350.22, 180
5, 14:05:00-000, 1034, 465, 569, 395, 1348.12, 375, 1348.21, 123
5, 14:06:00-000, 1019, 499, 520, 432, 1348.05, 426, 1349.44, 143
5, 14:07:00-000, 1, 1, 0, 1, 1347.00, 32, 1355.00, 164
5, 14:08:00-000, 926, 453, 473, 347, 1349.11, 365, 1349.72, 158
5, 14:09:00-000, 1016, 488, 528, 349, 1348.68, 359, 1348.57, 161
5, 14:10:00-000, 1033, 501, 532, 434, 1348.08, 393, 1349.07, 138
5, 14:11:00-000, 0, 0, 0, 23, 1344.43, 7, 1355.00, 198
5, 14:12:00-000, 1057, 516, 541, 360, 1348.66, 380, 1349.08, 184
5, 14:13:00-000, 944, 471, 473, 324, 1348.50, 359, 1348.88, 218
5, 14:14:00-000, 1205, 622, 583, 503, 1348.37, 492, 1349.59, 180
5, 14:15:00-000, 2, 2, 0, 31, 1344.93, 16, 1355.37, 162
5, 14:16:00-000, 1059, 516, 543, 437, 1348.10, 427, 1349.21, 181
5, 14:17:00-000, 1016, 536, 480, 409, 1349.05, 379, 1349.82, 143
5, 14:18:00-000, 1067, 552, 515, 478, 1348.30, 428, 1349.31, 155
5, 14:19:00-000, 4, 4, 0, 1, 1352.00, 32, 1356.00, 144
5, 14:20:00-000, 962, 462, 500, 408, 1348.24, 400, 1349.78, 106
5, 14:21:00-000, 982, 551, 431, 395, 1349.18, 334, 1349.39, 141
5, 14:22:00-000, 1081, 517, 564, 432, 1347.66, 410, 1348.52, 118
5, 14:23:00-000, 1, 1, 0, 1, 1347.00, 24, 1354.00, 182
5, 14:24:00-000, 965, 459, 506, 384, 1348.25, 426, 1349.49, 156
5, 14:25:00-000, 969, 532, 437, 337, 1348.58, 418, 1350.27, 119
5, 14:26:00-000, 964, 424, 540, 398, 1347.37, 379, 1348.20, 129
5, 14:27:00-000, 0, 0, 0, 26, 1343.96, 33, 1355.00, 142
5, 14:28:00-000, 1107, 534, 573, 497, 1347.78, 462, 1349.32, 130
5, 14:29:00-000, 987, 517, 470, 375, 1349.66, 374, 1350.25, 128
5, 14:30:00-000, 1046, 532, 514, 442, 1348.41, 457, 1350.21, 101
5, 14:31:00-000, 2, 0, 2, 0, 0.00, 29, 1356.69, 134
5, 14:32:00-000, 979, 509, 470, 404, 1348.85, 384, 1350.18, 158
5, 14:33:00-000, 1041, 533, 508, 413, 1348.79, 399, 1349.02, 155
5, 14:34:00-000, 1089, 492, 597, 423, 1348.03, 454, 1349.13, 150
5, 14:35:00-000, 1, 0, 1, 12, 1344.00, 21, 1355.00, 133
5, 14:36:00-000, 996, 525, 471, 415, 1348.98, 404, 1350.16, 149
5, 14:37:00-000, 971, 506, 465, 414, 1348.69, 390, 1349.47, 149
5, 14:38:00-000, 1094, 555, 539, 469, 1348.09, 387, 1348.87, 106
5, 14:39:00-000, 1, 1, 0, 6, 1346.33, 11, 1354.00, 110
5, 14:40:00-000, 1053, 548, 505, 409, 1349.25, 429, 1350.29, 156
5, 14:41:00-000, 948, 515, 433, 338, 1349.92, 360, 1350.23, 184
5, 14:42:00-000, 1028, 557, 471, 432, 1348.87, 390, 1349.16, 161
5, 14:43:00-000, 1, 0, 1, 0, 0.00, 16, 1355.75, 176
5, 14:44:00-000, 1086, 580, 506, 498, 1348.67, 439, 1349.24, 172
5, 14:45:00-000, 1164, 586, 578, 463, 1348.02, 459, 1348.44, 131
5, 14:46:00-000, 1105, 565, 540, 417, 1348.88, 444, 1349.81, 160
5, 14:47:00-000, 0, 0, 0, 24, 1346.00, 21, 1356.00, 142
5, 14:48:00-000, 938, 444, 494, 360, 1348.04, 413, 1349.31, 184
5, 14:49:00-000, 982, 473, 509, 376, 1348.36, 382, 1349.32, 117
5, 14:50:00-000, 985, 484, 501, 366, 1348.71, 406, 1349.48, 116
5, 14:51:00-000, 0, 0, 0, 17, 1344.35, 21, 1355.76, 159
5, 14:52:00-000, 1051, 555, 496, 420, 1347.99, 417, 1349.36, 185
5, 14:53:00-000, 1093, 528, 565, 379, 1349.21, 397, 1349.49, 140
5, 14:54:00-000, 1120, 578, 542, 445, 1348.47, 427, 1349.54, 163
5, 14:55:00-000, 0, 0, 0, 38, 1344.79, 20, 1355.30, 163
5, 14:56:00-000, 1058, 543, 515, 482, 1348.05, 439, 1349.17, 208
5, 14:57:00-000, 954, 412, 542, 317, 1347.87, 381, 1348.38, 133
5, 14:58:00-000, 1078, 500, 578, 396, 1348.30, 472, 1349.44, 115
5, 14:59:00-000, 0, 0, 0, 11, 1345.00, 9, 1356.00, 157
5, 15:00:00-000, 922, 454, 468, 395, 1347.70, 349, 1348.77, 179
5, 15:01:00-000, 1020, 515, 505, 410, 1348.47, 389, 1348.95, 161
5, 15:02:00-000, 953, 479, 474, 371, 1348.37, 377, 1349.19, 126
5, 15:03:00-000, 2, 2, 0, 10, 1345.80, 26, 1355.77, 137
5, 15:04:00-000, 1035, 494, 541, 464, 1347.31, 436, 1348.97, 167
5, 15:05:00-000, 1029, 480, 549, 408, 1349.00, 419, 1349.54, 109
5, 15:06:00-000, 1069, 532, 537, 413, 1348.32, 385, 1349.34, 130
5, 15:07:00-000, 0, 0, 0, 32, 1344.49, 19, 1354.05, 129
5, 15:08:00-000, 1026, 486, 540, 418, 1348.19, 441, 1349.46, 156
5, 15:09:00-000, 1001, 485, 516, 343, 1349.06, 352, 1349.53, 156
5, 15:10:00-000, 990, 506, 484, 410, 1348.99, 421, 1350.69, 147
5, 15:11:00-000, 1, 1, 0, 29, 1344.68, 12, 1356.00, 172
5, 15:12:00-000, 1002, 476, 526, 346, 1348.76, 392, 1349.25, 168
5, 15:13:00-000, 1115, 574, 541, 383, 1348.94, 413, 1349.42, 182
5, 15:14:00-000, 1076, 500, 576, 448, 1348.11, 421, 1348.97, 164
5, 15:15:00-000, 3, 3, 0, 0, 0.00, 26, 1353.08, 186
5, 15:16:00-000, 1078, 466, 612, 382, 1347.31, 439, 1348.11, 190
5, 15:17:00-000, 992, 493, 499, 359, 1348.56, 359, 1348.97, 204
5, 15:18:00-000, 1043, 480, 563, 445, 1347.93, 389, 1348.89, 178
5, 15:19:00-000, 9, 2, 7, 26, 1344.00, 0, 0.00, 159
5, 15:20:00-000, 1002, 497, 505, 366, 1347.94, 414, 1349.67, 179
5, 15:21:00-000, 1016, 454, 562, 351, 1348.58, 391, 1348.98, 198
5, 15:22:00-000, 1069, 595, 474, 425, 1349.81, 386, 1350.39, 163
5, 15:23:00-000, 1, 0, 1, 45, 1346.44, 11, 1355.36, 164
5, 15:24:00-000, 1127, 538, 589, 497, 1348.12, 428, 1349.03, 169
5, 15:25:00-000, 1002, 472, 530, 402, 1348.59, 352, 1348.67, 169
5, 15:26:00-000, 982, 519, 463, 389, 1348.71, 346, 1349.40, 193
5, 15:27:00-000, 0, 0, 0, 0, 0.00, 59, 1354.62, 131
5, 15:28:00-000, 1047, 517, 530, 370, 1348.82, 394, 1349.97, 195
5, 15:29:00-000, 968, 486, 482, 356, 1348.79, 297, 1348.90, 169
5, 15:30:00-000, 991, 529, 462, 400, 1349.44, 466, 1350.93, 185
5, 15:31:00-000, 4, 1, 3, 46, 1345.71, 3, 1350.00, 175
5, 15:32:00-000, 1080, 537, 543, 411, 1348.38, 412, 1349.03, 128
5, 15:33:00-000, 995, 516, 479, 402, 1348.68, 423, 1349.64, 176
5, 15:34:00-000, 1057, 547, 510, 469, 1347.85, 398, 1349.19, 138
5, 15:35:00-000, 0, 0, 0, 29, 1345.34, 0, 0.00, 110
5, 15:36:00-000, 980, 425, 555, 366, 1347.28, 421, 1348.93, 140
5, 15:37:00-000, 1023, 519, 504, 429, 1348.40, 430, 1348.81, 161
5, 15:38:00-000, 953, 500, 453, 360, 1349.29, 367, 1349.97, 140
5, 15:39:00-000, 1, 1, 0, 25, 1345.32, 0, 0.00, 127
5, 15:40:00-000, 1038, 512, 526, 325, 1348.80, 358, 1348.00, 166
5, 15:41:00-000, 1034, 533, 501, 351, 1348.51, 362, 1349.05, 218
5, 15:42:00-000, 1045, 495, 550, 369, 1349.18, 359, 1348.54, 192
5, 15:43:00-000, 2, 1, 1, 1, 1351.00, 0, 0.00, 294
5, 15:44:00-000, 1077, 518, 559, 391, 1348.37, 377, 1348.61, 246
5, 15:45:00-000, 1005, 522, 483, 384, 1348.96, 380, 1349.40, 202
5, 15:46:00-000, 1081, 545, 536, 405, 1349.06, 413, 1349.14, 215
5, 15:47:00-000, 0, 0, 0, 0, 0.00, 0, 0.00, 201
5, 15:48:00-000, 995, 534, 461, 397, 1349.59, 333, 1349.35, 225
5, 15:49:00-000, 1007, 495, 512, 372, 1349.06, 356, 1349.05, 210
5, 15:50:00-000, 969, 521, 448, 372, 1350.15, 348, 1350.20, 196
5, 15:51:00-000, 4, 3, 1, 34, 1347.08, 31, 1354.87, 191
5, 15:52:00-000, 969, 457, 512, 336, 1348.12, 359, 1348.49, 129
5, 15:53:00-000, 1028, 520, 508, 375, 1348.93, 422, 1349.39, 154
5, 15:54:00-000, 1150, 595, 555, 430, 1348.83, 407, 1348.77, 225
5, 15:55:00-000, 0, 0, 0, 13, 1346.00, 0, 0.00, 187
5, 15:56:00-000, 1053, 508, 545, 411, 1348.65, 401, 1349.43, 249
5, 15:57:00-000, 1161, 572, 589, 356, 1349.87, 392, 1350.24, 161
5, 15:58:00-000, 945, 504, 441, 373, 1349.05, 372, 1349.86, 235
5, 15:59:00-000, 2, 1, 1, 20, 1347.00, 18, 1355.00, 251
5, 16:00:00-000, 920, 483, 437, 374, 1348.70, 359, 1349.03, 131
5, 16:01:00-000, 1149, 611, 538, 476, 1349.50, 396, 1350.14, 188
5, 16:02:00-000, 1054, 556, 498, 457, 1348.75, 420, 1349.22, 166
5, 16:03:00-000, 1, 0, 1, 29, 1345.00, 0, 0.00, 174
5, 16:04:00-000, 1007, 475, 532, 376, 1347.98, 419, 1349.30, 139
5, 16:05:00-000, 970, 515, 455, 384, 1349.64, 328, 1349.77, 147
5, 16:06:00-000, 1051, 497, 554, 363, 1348.64, 461, 1350.02, 169
5, 16:07:00-000, 2, 2, 0, 28, 1345.60, 8, 1356.00, 168
5, 16:08:00-000, 988, 531, 457, 452, 1349.18, 393, 1350.00, 153
5, 16:09:00-000, 1062, 542, 520, 413, 1348.26, 393, 1348.61, 133
5, 16:10:00-000, 1049, 577, 472, 427, 1349.29, 416, 1349.66, 150
5, 16:11:00-000, 0, 0, 0, 20, 1345.30, 0, 0.00, 150
5, 16:12:00-000, 975, 485, 490, 379, 1348.24, 393, 1349.67, 156
5, 16:13:00-000, 1054, 541, 513, 391, 1348.53, 392, 1349.20, 163
5, 16:14:00-000, 915, 470, 445, 330, 1349.71, 364, 1350.62, 188
5, 16:15:00-000, 3, 0, 3, 17, 1345.88, 6, 1356.00, 151
5, 16:16:00-000, 1022, 561, 461, 446, 1348.50, 410, 1348.95, 150
5, 16:17:00-000, 993, 507, 486, 370, 1348.34, 373, 1349.28, 165
5, 16:18:00-000, 1158, 604, 554, 428, 1348.59, 440, 1349.39, 147
5, 16:19:00-000, 1, 1, 0, 29, 1344.93, 3, 1356.00, 167
5, 16:20:00-000, 962, 479, 483, 325, 1348.72, 360, 1349.39, 227
5, 16:21:00-000, 1043, 504, 539, 390, 1349.10, 420, 1349.56, 199
5, 16:22:00-000, 946, 520, 426, 392, 1348.79, 370, 1350.25, 141
5, 16:23:00-000, 0, 0, 0, 30, 1346.00, 38, 1355.92, 147
5, 16:24:00-000, 1046, 558, 488, 434, 1349.06, 381, 1349.44, 147
5, 16:25:00-000, 1056, 549, 507, 417, 1349.22, 396, 1349.79, 164
5, 16:26:00-000, 976, 496, 480, 413, 1347.77, 397, 1349.37, 161
5, 16:27:00-000, 7, 4, 3, 7, 1346.29, 1, 1348.00, 130
5, 16:28:00-000, 1106, 533, 573, 423, 1348.74, 427, 1349.11, 183
5, 16:29:00-000, 1135, 530, 605, 422, 1348.36, 440, 1349.09, 161
6, 12:20:00-000, 6952, 3467, 3485, 1594, 1347.78, 1597, 1348.31, 0
6, 12:21:00-000, 0, 0, 0, 76, 1347.00, 96, 1353.02, 0
6, 12:22:00-000, 0, 0, 0, 4, 1346.00, 134, 1354.00, 0
6, 12:23:00-000, 0, 0, 0, 22, 1346.00, 90, 1354.00, 0
6, 12:24:00-000, 0, 0, 0, 189, 1346.00, 43, 1354.00, 0
6, 12:25:00-000, 0, 0, 0, 31, 1346.00, 9, 1355.00, 0
6, 12:26:00-000, 0, 0, 0, 0, 0.00, 52, 1355.00, 0
6, 12:27:00-000, 0, 0, 0, 0, 0.00, 40, 1355.00, 0
6, 12:28:00-000, 0, 0, 0, 0, 0.00, 31, 1355.00, 0
6, 12:29:00-000, 0, 0, 0, 0, 0.00, 19, 1355.00, 0
6, 12:30:00-000, 0, 0, 0, 0, 0.00, 43, 1355.00, 0
6, 12:31:00-000, 0, 0, 0, 0, 0.00, 18, 1355.00, 0
6, 12:32:00-000, 0, 0, 0, 116, 1345.00, 34, 1355.00, 0
6, 12:33:00-000, 0, 0, 0, 23, 1345.00, 17, 1356.00, 0
6, 12:34:00-000, 0, 0, 0, 34, 1345.00, 2, 1356.00, 0
6, 12:35:00-000, 0, 0, 0, 5, 1345.00, 27, 1356.00, 0
6, 12:37:00-000, 0, 0, 0, 0, 0.00, 1, 1356.00, 0
6, 12:38:00-000, 0, 0, 0, 26, 1345.00, 15, 1356.00, 0
6, 12:40:00-000, 0, 0, 0, 81, 1344.53, 0, 0.00, 114
6, 12:41:00-000, 0, 0, 0, 0, 0.00, 16, 1356.00, 136
6, 12:42:00-000, 0, 0, 0, 0, 0.00, 66, 1356.00, 119
6, 12:43:00-000, 0, 0, 0, 0, 0.00, 1, 1356.00, 108
6, 12:44:00-000, 0, 0, 0, 0, 0.00, 23, 1356.00, 118
6, 12:45:00-000, 0, 0, 0, 0, 0.00, 55, 1356.00, 102
6, 12:46:00-000, 0, 0, 0, 0, 0.00, 9, 1356.00, 117
6, 12:47:00-000, 0, 0, 0, 0, 0.00, 0, 0.00, 109
6, 12:48:00-000, 0, 0, 0, 0, 0.00, 0, 0.00, 105
6, 12:49:00-000, 0, 0, 0, 0, 0.00, 0, 0.00, 117
6, 12:50:00-000, 0, 0, 0, 0, 0.00, 16, 1357.00, 114
6, 12:51:00-000, 0, 0, 0, 0, 0.00, 0, 0.00, 124
6, 12:52:00-000, 0, 0, 0, 0, 0.00, 0, 0.00, 101
6, 12:53:00-000, 0, 0, 0, 0, 0.00, 0, 0.00, 127
6, 12:54:00-000, 0, 0, 0, 0, 0.00, 0, 0.00, 121
6, 12:55:00-000, 0, 0, 0, 0, 0.00, 38, 1357.00, 120
6, 12:56:00-000, 0, 0, 0, 0, 0.00, 0, 0.00, 114
6, 12:57:00-000, 0, 0, 0, 0, 0.00, 0, 0.00, 94
6, 12:58:00-000, 0, 0, 0, 0, 0.00, 0, 0.00, 94
6, 12:59:00-000, 0, 0, 0, 0, 0.00, 0, 0.00, 105
6, 15:40:00-000, 6943, 3441, 3502, 1659, 1347.76, 1676, 1348.41, 0
6, 15:41:00-000, 0, 0, 0, 11, 1347.00, 18, 1353.89, 0
6, 15:42:00-000, 0, 0, 0, 95, 1346.00, 112, 1354.00, 0
6, 15:43:00-000, 0, 0, 0, 42, 1346.00, 22, 1354.00, 0
6, 15:44:00-000, 0, 0, 0, 106, 1346.00, 102, 1354.00, 0
6, 15:45:00-000, 0, 0, 0, 4, 1345.00, 0, 0.00, 0
6, 15:46:00-000, 0, 0, 0, 0, 0.00, 12, 1355.00, 0
6, 15:47:00-000, 0, 0, 0, 26, 1345.00, 41, 1355.00, 0
6, 15:48:00-000, 0, 0, 0, 0, 0.00, 81, 1355.00, 0
6, 15:49:00-000, 0, 0, 0, 22, 1345.00, 33, 1355.00, 0
6, 15:50:00-000, 0, 0, 0, 11, 1345.00, 90, 1355.00, 0
6, 15:51:00-000, 0, 0, 0, 0, 0.00, 5, 1355.00, 0
6, 15:52:00-000, 0, 0, 0, 53, 1345.00, 0, 0.00, 0
6, 15:53:00-000, 0, 0, 0, 44, 1345.00, 0, 0.00, 0
6, 15:54:00-000, 0, 0, 0, 81, 1345.00, 51, 1356.00, 0
6, 15:55:00-000, 0, 0, 0, 0, 0.00, 33, 1356.00, 0
6, 15:56:00-000, 0, 0, 0, 0, 0.00, 39, 1356.00, 0
6, 15:57:00-000, 0, 0, 0, 0, 0.00, 9, 1356.00, 0
6, 16:00:00-000, 2, 1, 1, 1, 1350.00, 7, 1356.00, 139
6, 16:01:00-000, 0, 0, 0, 0, 0.00, 13, 1356.00, 127
6, 16:02:00-000, 0, 0, 0, 0, 0.00, 1, 1356.00, 125
6, 16:03:00-000, 0, 0, 0, 0, 0.00, 15, 1356.00, 123
6, 16:04:00-000, 0, 0, 0, 14, 1344.00, 26, 1356.00, 137
6, 16:05:00-000, 0, 0, 0, 0, 0.00, 23, 1356.00, 120
6, 16:06:00-000, 0, 0, 0, 0, 0.00, 6, 1356.83, 115
6, 16:07:00-000, 0, 0, 0, 0, 0.00, 28, 1357.00, 108
6, 16:08:00-000, 0, 0, 0, 0, 0.00, 0, 0.00, 120
6, 16:09:00-000, 0, 0, 0, 0, 0.00, 0, 0.00, 103
6, 16:10:00-000, 0, 0, 0, 8, 1344.00, 0, 0.00, 103
6, 16:11:00-000, 0, 0, 0, 0, 0.00, 0, 0.00, 123
6, 16:12:00-000, 0, 0, 0, 0, 0.00, 0, 0.00, 116
6, 16:13:00-000, 0, 0, 0, 0, 0.00, 0, 0.00, 106
6, 16:14:00-000, 0, 0, 0, 0, 0.00, 0, 0.00, 98
6, 16:15:00-000, 0, 0, 0, 0, 0.00, 0, 0.00, 121
6, 16:16:00-000, 0, 0, 0, 0, 0.00, 0, 0.00, 95
6, 16:17:00-000, 0, 0, 0, 0, 0.00, 0, 0.00, 116
6, 16:18:00-000, 0, 0, 0, 0, 0.00, 0, 0.00, 115
6, 16:19:00-000, 0, 0, 0, 5, 1344.00, 0, 0.00, 108
6, 16:20:00-000, 26, 11, 15, 6, 1349.00, 7, 1351.00, 1
6, 16:22:00-000, 0, 0, 0, 2, 1344.50, 0, 0.00, 0
6, 16:23:00-000, 0, 0, 0, 0, 0.00, 2, 1356.00, 1
8, 09:06:00-000, 1202, 97, 1105, 0, 0.00, 0, 0.00, 1202
8, 09:07:00-000, 6560, 2959, 3601, 0, 0.00, 0, 0.00, 6554
8, 09:08:00-000, 2, 2, 0, 1, 1352.00, 1, 1351.00, 6
8, 09:19:00-000, 2748, 808, 1940, 0, 0.00, 0, 0.00, 2747
8, 09:20:00-000, 1, 1, 0, 1, 1363.00, 1, 1353.00, 0
8, 09:30:00-000, 617, 325, 292, 0, 0.00, 0, 0.00, 527
8, 09:31:00-000, 6633, 2255, 4378, 55, 1354.92, 55, 1352.00, 6613
8, 09:38:00-000, 707, 700, 7, 0, 0.00, 0, 0.00, 707
8, 09:42:00-000, 974, 764, 210, 3, 1353.33, 3, 1352.00, 968
8, 09:44:00-000, 7986, 2846, 5140, 13, 1348.92, 13, 1352.00, 7960
8, 09:50:00-000, 5527, 3855, 1672, 0, 0.00, 0, 0.00, 4022
8, 09:51:00-000, 2914, 2537, 377, 3, 1349.00, 3, 1349.33, 4413
8, 09:52:00-000, 1775, 198, 1577, 38, 1349.89, 23, 1351.96, 1714
8, 09:53:00-000, 15, 0, 15, 0, 0.00, 15, 1346.00, 0
8, 09:55:00-000, 1116, 940, 176, 0, 0.00, 0, 0.00, 1116
8, 09:56:00-000, 4255, 1978, 2277, 65, 1354.24, 65, 1352.00, 4125
8, 09:57:00-000, 3215, 461, 2754, 3, 1348.67, 3, 1348.67, 3209
8, 09:58:00-000, 870, 860, 10, 0, 0.00, 0, 0.00, 870
8, 10:01:00-000, 765, 2, 763, 2, 1345.00, 2, 1351.00, 761
8, 10:05:00-000, 854, 75, 779, 2, 1345.00, 2, 1349.50, 850
8, 10:06:00-000, 1716, 98, 1618, 4, 1350.00, 4, 1347.75, 1708
8, 10:07:00-000, 6432, 2671, 3761, 6, 1350.00, 6, 1351.00, 6420
8, 10:08:00-000, 3278, 1138, 2140, 8, 1349.00, 8, 1349.00, 3262
8, 10:09:00-000, 85, 5, 80, 0, 0.00, 0, 0.00, 85
8, 10:10:00-000, 674, 670, 4, 0, 0.00, 0, 0.00, 674
8, 10:11:00-000, 2881, 1070, 1811, 0, 0.00, 0, 0.00, 2881
8, 10:12:00-000, 7178, 4934, 2244, 42, 1346.90, 33, 1347.36, 7103
8, 10:13:00-000, 3375, 2954, 421, 1, 1351.00, 10, 1345.70, 3296
8, 10:14:00-000, 732, 52, 680, 23, 1352.30, 23, 1350.87, 754
8, 10:15:00-000, 3555, 3006, 549, 0, 0.00, 0, 0.00, 3555
8, 10:16:00-000, 3075, 2384, 691, 8, 1353.00, 11, 1350.82, 3056
8, 10:17:00-000, 3, 3, 0, 3, 1356.00, 0, 0.00, 0
8, 10:18:00-000, 2494, 942, 1552, 0, 0.00, 0, 0.00, 2494
8, 10:19:00-000, 54, 9, 45, 0, 0.00, 0, 0.00, 54
8, 10:20:00-000, 61, 11, 50, 7, 1348.86, 7, 1353.00, 47
8, 10:22:00-000, 1549, 1316, 233, 0, 0.00, 0, 0.00, 1021
8, 10:23:00-000, 988, 980, 8, 0, 0.00, 0, 0.00, 1516
8, 10:24:00-000, 5860, 1360, 4500, 0, 0.00, 0, 0.00, 5860
8, 10:25:00-000, 1992, 1970, 22, 0, 0.00, 0, 0.00, 1992
8, 10:26:00-000, 3612, 2831, 781, 5, 1351.60, 5, 1351.40, 3602
8, 10:27:00-000, 3603, 1708, 1895, 3, 1351.00, 3, 1352.00, 3597
8, 10:28:00-000, 23, 20, 3, 3, 1348.00, 3, 1350.33, 17
8, 10:30:00-000, 2487, 2324, 163, 1, 1350.00, 22, 1352.00, 2464
8, 10:31:00-000, 4866, 3105, 1761, 23, 1352.82, 2, 1349.00, 4841
8, 10:32:00-000, 4991, 1271, 3720, 14, 1351.71, 14, 1350.86, 4963
8, 10:33:00-000, 9789, 3916, 5873, 0, 0.00, 0, 0.00, 9618
8, 10:34:00-000, 1684, 628, 1056, 38, 1347.00, 38, 1348.18, 1779
8, 10:35:00-000, 2790, 1214, 1576, 0, 0.00, 0, 0.00, 2790
8, 10:36:00-000, 235, 159, 76, 0, 0.00, 0, 0.00, 235
8, 10:37:00-000, 5749, 1538, 4211, 10, 1349.00, 10, 1350.80, 5729
8, 10:38:00-000, 2091, 858, 1233, 2, 1350.00, 2, 1348.00, 2087
8, 10:39:00-000, 1978, 550, 1428, 1, 1355.00, 1, 1351.00, 1976
8, 10:40:00-000, 5485, 3614, 1871, 2, 1349.00, 2, 1350.00, 5481
8, 10:41:00-000, 1037, 865, 172, 0, 0.00, 0, 0.00, 1037
8, 10:42:00-000, 2051, 1833, 218, 10, 1348.00, 10, 1353.10, 2031
8, 10:45:00-000, 3725, 1736, 1989, 2, 1351.00, 2, 1351.00, 3721
8, 10:46:00-000, 7647, 5600, 2047, 10, 1349.10, 10, 1349.90, 7363
8, 10:47:00-000, 2446, 1694, 752, 0, 0.00, 0, 0.00, 2710
8, 10:48:00-000, 2697, 1199, 1498, 1, 1350.00, 1, 1351.00, 2695
8, 10:49:00-000, 5400, 1454, 3946, 18, 1353.89, 18, 1355.00, 4580
8, 10:50:00-000, 1605, 718, 887, 55, 1347.42, 45, 1348.37, 2289
8, 10:51:00-000, 7580, 4113, 3467, 8, 1345.00, 18, 1346.17, 7554
8, 10:53:00-000, 1059, 1040, 19, 0, 0.00, 0, 0.00, 1050
8, 10:54:00-000, 0, 0, 0, 0, 0.00, 0, 0.00, 9
8, 10:55:00-000, 396, 128, 268, 1, 1352.00, 1, 1351.00, 394
8, 10:56:00-000, 5122, 3916, 1206, 2, 1350.00, 2, 1349.50, 4301
8, 10:57:00-000, 3350, 1447, 1903, 12, 1353.83, 12, 1352.25, 4143
8, 10:58:00-000, 2428, 2425, 3, 0, 0.00, 0, 0.00, 2427
8, 10:59:00-000, 1730, 152, 1578, 0, 0.00, 0, 0.00, 1731
8, 11:00:00-000, 7238, 5977, 1261, 20, 1346.60, 23, 1350.13, 7195
8, 11:01:00-000, 6137, 1900, 4237, 43, 1353.09, 48, 1352.83, 6046
8, 11:02:00-000, 1500, 1490, 10, 18, 1352.22, 10, 1352.00, 1472
8, 11:04:00-000, 91, 80, 11, 0, 0.00, 0, 0.00, 91
8, 11:05:00-000, 2184, 1005, 1179, 5, 1350.00, 5, 1352.00, 2095
8, 11:06:00-000, 2505, 1957, 548, 1, 1350.00, 1, 1351.00, 2582
8, 11:08:00-000, 4048, 1197, 2851, 0, 0.00, 0, 0.00, 4048
8, 11:09:00-000, 9752, 5690, 4062, 0, 0.00, 0, 0.00, 8318
8, 11:10:00-000, 2336, 1447, 889, 2, 1352.50, 2, 1350.00, 3766
8, 11:11:00-000, 508, 506, 2, 1, 1356.00, 1, 1351.00, 506
8, 11:13:00-000, 5957, 5258, 699, 2, 1349.00, 2, 1350.00, 5932
8, 11:14:00-000, 3298, 142, 3156, 1, 1349.00, 1, 1351.00, 3317
8, 11:15:00-000, 4773, 1069, 3704, 0, 0.00, 2, 1353.00, 4771
8, 11:16:00-000, 5650, 2513, 3137, 22, 1356.13, 20, 1353.00, 5608
8, 11:17:00-000, 9144, 2872, 6272, 15, 1349.00, 15, 1348.40, 9114
8, 11:18:00-000, 1797, 1644, 153, 9, 1349.56, 14, 1350.14, 1774
8, 11:19:00-000, 88, 8, 80, 5, 1350.00, 0, 0.00, 83
8, 11:20:00-000, 7734, 2102, 5632, 0, 0.00, 0, 0.00, 7531
8, 11:21:00-000, 5243, 3854, 1389, 10, 1345.60, 10, 1350.20, 5426
8, 11:22:00-000, 5368, 1603, 3765, 19, 1348.00, 19, 1350.84, 5330
8, 11:23:00-000, 907, 727, 180, 0, 0.00, 0, 0.00, 907
8, 11:24:00-000, 3499, 1560, 1939, 35, 1348.51, 46, 1350.43, 3418
8, 11:25:00-000, 11, 11, 0, 11, 1354.27, 0, 0.00, 0
8, 11:26:00-000, 3608, 1159, 2449, 4, 1352.00, 4, 1351.00, 3600
8, 11:27:00-000, 2470, 849, 1621, 8, 1350.00, 8, 1346.88, 2454
8, 11:30:00-000, 3278, 1340, 1938, 4, 1350.00, 4, 1351.00, 3270
8, 11:31:00-000, 4764, 1509, 3255, 0, 0.00, 0, 0.00, 4764
8, 11:32:00-000, 7880, 3470, 4410, 11, 1350.91, 11, 1350.00, 7858
8, 11:33:00-000, 2548, 523, 2025, 4, 1349.50, 4, 1349.25, 2540
8, 11:34:00-000, 6204, 2216, 3988, 19, 1346.58, 25, 1349.00, 6160
8, 11:35:00-000, 6, 6, 0, 6, 1353.00, 0, 0.00, 0
8, 11:37:00-000, 4721, 3632, 1089, 0, 0.00, 0, 0.00, 4721
8, 11:38:00-000, 1093, 13, 1080, 0, 0.00, 0, 0.00, 1093
8, 11:39:00-000, 4749, 234, 4515, 0, 0.00, 0, 0.00, 4749
8, 11:40:00-000, 403, 76, 327, 11, 1347.55, 11, 1349.54, 381
8, 11:41:00-000, 4434, 2094, 2340, 14, 1346.00, 14, 1346.93, 4406
8, 11:42:00-000, 7235, 4517, 2718, 37, 1352.86, 37, 1352.56, 7161
8, 11:43:00-000, 1635, 1574, 61, 0, 0.00, 0, 0.00, 1635
8, 11:44:00-000, 3893, 3356, 537, 15, 1349.93, 15, 1349.47, 3863
8, 11:45:00-000, 5245, 1245, 4000, 30, 1353.80, 30, 1352.63, 4801
8, 11:46:00-000, 2160, 0, 2160, 0, 0.00, 0, 0.00, 2544
8, 11:48:00-000, 2398, 1478, 920, 9, 1347.00, 6, 1351.83, 2383
8, 11:49:00-000, 3782, 3450, 332, 0, 0.00, 3, 1350.00, 3713
8, 11:50:00-000, 225, 45, 180, 23, 1351.95, 23, 1350.00, 245
8, 12:00:00-000, 2107, 1336, 771, 12, 1346.50, 12, 1349.25, 2082
8, 12:01:00-000, 2280, 122, 2158, 1, 1349.00, 1, 1354.00, 2279
8, 12:02:00-000, 3807, 1145, 2662, 0, 0.00, 0, 0.00, 3807
8, 12:05:00-000, 1378, 371, 1007, 2, 1354.00, 2, 1353.00, 1374
8, 12:06:00-000, 175, 105, 70, 0, 0.00, 0, 0.00, 175
8, 12:07:00-000, 3410, 1555, 1855, 2, 1348.00, 2, 1349.00, 3406
8, 12:09:00-000, 2175, 722, 1453, 2, 1353.00, 2, 1351.00, 2171
8, 12:10:00-000, 1116, 26, 1090, 0, 0.00, 0, 0.00, 1116
8, 12:11:00-000, 57, 20, 37, 20, 1348.00, 20, 1345.80, 17
8, 12:12:00-000, 3475, 1744, 1731, 16, 1354.50, 16, 1353.81, 3441
8, 12:13:00-000, 985, 41, 944, 0, 0.00, 0, 0.00, 987
8, 12:14:00-000, 6595, 1519, 5076, 5, 1352.00, 5, 1351.20, 6585
8, 12:15:00-000, 3280, 2473, 807, 1, 1347.00, 1, 1346.00, 3278
8, 12:16:00-000, 697, 128, 569, 5, 1349.00, 5, 1346.00, 687
8, 12:17:00-000, 3695, 1753, 1942, 7, 1354.14, 7, 1352.00, 3681
8, 12:18:00-000, 840, 746, 94, 11, 1347.91, 11, 1349.45, 818
8, 12:20:00-000, 741, 10, 731, 1, 1345.00, 1, 1350.00, 739
8, 12:21:00-000, 193, 190, 3, 0, 0.00, 0, 0.00, 193
8, 12:22:00-000, 4352, 874, 3478, 12, 1345.00, 12, 1350.00, 4328
8, 12:23:00-000, 865, 59, 806, 0, 0.00, 0, 0.00, 865
8, 12:24:00-000, 21, 1, 20, 0, 0.00, 0, 0.00, 21
8, 12:25:00-000, 2375, 976, 1399, 3, 1352.00, 3, 1352.00, 2369
8, 12:26:00-000, 175, 72, 103, 0, 0.00, 0, 0.00, 175
8, 12:30:00-000, 106, 100, 6, 5, 1346.40, 5, 1351.40, 96
8, 12:40:00-000, 1234, 1200, 34, 0, 0.00, 0, 0.00, 1234
8, 12:42:00-000, 2458, 831, 1627, 0, 0.00, 0, 0.00, 2458
8, 12:46:00-000, 324, 301, 23, 0, 0.00, 0, 0.00, 324
8, 12:47:00-000, 2765, 939, 1826, 0, 0.00, 0, 0.00, 1859
8, 12:48:00-000, 1402, 30, 1372, 15, 1351.07, 15, 1351.40, 2278
8, 12:49:00-000, 21, 20, 1, 0, 0.00, 0, 0.00, 21
8, 12:50:00-000, 85, 80, 5, 0, 0.00, 0, 0.00, 85
8, 12:51:00-000, 1789, 893, 896, 8, 1350.87, 8, 1353.00, 1717
8, 12:52:00-000, 2346, 1873, 473, 6, 1350.50, 6, 1348.17, 2390
8, 12:53:00-000, 595, 15, 580, 0, 0.00, 0, 0.00, 595
8, 12:54:00-000, 2956, 974, 1982, 0, 0.00, 0, 0.00, 2956
8, 12:55:00-000, 250, 150, 100, 0, 0.00, 0, 0.00, 247
8, 12:56:00-000, 4867, 2530, 2337, 2, 1351.00, 2, 1351.00, 4866
8, 12:57:00-000, 6265, 2463, 3802, 5, 1351.40, 5, 1351.00, 6255
8, 12:58:00-000, 4820, 2988, 1832, 0, 0.00, 0, 0.00, 4820
8, 12:59:00-000, 857, 781, 76, 4, 1350.50, 4, 1351.00, 849
8, 13:00:00-000, 1408, 1031, 377, 5, 1349.00, 5, 1347.00, 1398
8, 13:01:00-000, 79, 51, 28, 0, 0.00, 0, 0.00, 79
8, 13:02:00-000, 4827, 3354, 1473, 7, 1347.86, 7, 1350.57, 4813
8, 13:03:00-000, 100, 0, 100, 0, 0.00, 0, 0.00, 100
8, 13:06:00-000, 1067, 102, 965, 1, 1349.00, 1, 1350.00, 1065
8, 13:07:00-000, 3775, 3591, 184, 30, 1346.53, 30, 1345.16, 3715
8, 13:08:00-000, 128, 103, 25, 3, 1349.00, 3, 1349.67, 122
8, 13:09:00-000, 4739, 2028, 2711, 10, 1353.10, 10, 1351.70, 4719
8, 13:10:00-000, 1505, 1294, 211, 0, 0.00, 0, 0.00, 1505
8, 13:11:00-000, 1845, 1011, 834, 0, 0.00, 0, 0.00, 1845
8, 13:12:00-000, 3419, 129, 3290, 0, 0.00, 0, 0.00, 3419
8, 13:13:00-000, 113, 53, 60, 0, 0.00, 0, 0.00, 113
8, 13:14:00-000, 3762, 1986, 1776, 9, 1352.11, 9, 1349.89, 3637
8, 13:15:00-000, 3617, 1926, 1691, 7, 1347.86, 7, 1349.71, 3710
8, 13:16:00-000, 3904, 881, 3023, 3, 1350.33, 3, 1350.00, 3870
8, 13:17:00-000, 4205, 1465, 2740, 12, 1352.17, 12, 1350.58, 4209
8, 13:18:00-000, 72, 60, 12, 0, 0.00, 0, 0.00, 72
8, 13:19:00-000, 5904, 3173, 2731, 0, 0.00, 0, 0.00, 5901
8, 13:20:00-000, 3771, 701, 3070, 38, 1353.36, 38, 1352.58, 3698
8, 13:21:00-000, 2999, 1366, 1633, 0, 0.00, 0, 0.00, 2999
8, 13:22:00-000, 1618, 1067, 551, 1, 1350.00, 1, 1351.00, 1616
8, 13:24:00-000, 4981, 253, 4728, 21, 1349.19, 21, 1351.47, 4939
8, 13:25:00-000, 134, 100, 34, 23, 1345.43, 23, 1348.69, 88
8, 13:27:00-000, 2221, 1852, 369, 0, 0.00, 0, 0.00, 2221
8, 13:28:00-000, 78, 60, 18, 0, 0.00, 0, 0.00, 0
8, 13:29:00-000, 9340, 6008, 3332, 3, 1355.00, 4, 1350.75, 9411
8, 13:30:00-000, 6173, 2090, 4083, 20, 1347.00, 19, 1348.10, 6134
8, 13:31:00-000, 101, 100, 1, 0, 0.00, 0, 0.00, 101
8, 13:32:00-000, 7684, 3788, 3896, 17, 1353.82, 17, 1350.53, 7650
8, 13:33:00-000, 3187, 1749, 1438, 8, 1351.00, 8, 1351.00, 3171
8, 13:34:00-000, 5085, 2596, 2489, 3, 1352.00, 3, 1352.00, 5005
8, 13:35:00-000, 4342, 3105, 1237, 0, 0.00, 0, 0.00, 2848
8, 13:36:00-000, 2074, 2032, 42, 9, 1353.00, 9, 1350.78, 3624
8, 13:37:00-000, 5151, 1550, 3601, 4, 1346.00, 3, 1350.00, 4934
8, 13:38:00-000, 957, 199, 758, 0, 0.00, 1, 1350.00, 1166
8, 13:39:00-000, 4992, 3201, 1791, 2, 1349.50, 2, 1348.50, 4978
8, 13:40:00-000, 200, 108, 92, 0, 0.00, 0, 0.00, 210
8, 13:41:00-000, 8503, 4327, 4176, 7, 1351.00, 9, 1351.00, 8487
8, 13:42:00-000, 197, 183, 14, 3, 1349.00, 1, 1349.00, 80
8, 13:43:00-000, 2360, 715, 1645, 0, 0.00, 0, 0.00, 2473
8, 13:44:00-000, 1495, 324, 1171, 0, 0.00, 0, 0.00, 1495
8, 13:45:00-000, 221, 85, 136, 0, 0.00, 0, 0.00, 221
8, 13:46:00-000, 4187, 3530, 657, 3, 1349.00, 12, 1351.58, 4172
8, 13:47:00-000, 4397, 219, 4178, 29, 1347.62, 20, 1347.35, 4339
8, 13:48:00-000, 7615, 2865, 4750, 16, 1348.75, 16, 1350.94, 7592
8, 13:49:00-000, 6628, 4329, 2299, 0, 0.00, 0, 0.00, 6628
8, 13:50:00-000, 7727, 5049, 2678, 76, 1346.78, 28, 1349.53, 7623
8, 13:51:00-000, 112, 3, 109, 1, 1349.00, 49, 1346.67, 62
8, 13:52:00-000, 2452, 1639, 813, 19, 1350.37, 19, 1352.00, 2414
8, 13:53:00-000, 2119, 1991, 128, 21, 1351.95, 21, 1351.00, 2077
8, 13:54:00-000, 22, 21, 1, 1, 1353.00, 1, 1354.00, 20
8, 13:56:00-000, 3921, 194, 3727, 11, 1349.27, 11, 1348.45, 3899
8, 13:57:00-000, 224, 136, 88, 0, 0.00, 0, 0.00, 216
8, 13:58:00-000, 970, 121, 849, 14, 1350.93, 14, 1350.64, 950
8, 14:00:00-000, 4749, 2259, 2490, 0, 0.00, 0, 0.00, 4749
8, 14:01:00-000, 531, 300, 231, 0, 0.00, 0, 0.00, 531
8, 14:02:00-000, 55, 52, 3, 2, 1355.00, 2, 1351.00, 51
8, 14:04:00-000, 9874, 6251, 3623, 0, 0.00, 0, 0.00, 9874
8, 14:05:00-000, 1421, 1296, 125, 1, 1350.00, 1, 1349.00, 1419
8, 14:06:00-000, 151, 96, 55, 0, 0.00, 0, 0.00, 151
8, 14:08:00-000, 3363, 1655, 1708, 4, 1353.50, 4, 1351.00, 3355
8, 14:10:00-000, 1779, 591, 1188, 4, 1352.25, 4, 1349.75, 1771
8, 14:11:00-000, 4731, 1529, 3202, 0, 0.00, 0, 0.00, 3996
8, 14:12:00-000, 2761, 231, 2530, 5, 1350.20, 1, 1351.00, 3490
8, 14:13:00-000, 2333, 109, 2224, 17, 1350.29, 14, 1349.78, 2302
8, 14:14:00-000, 820, 32, 788, 1, 1347.00, 8, 1350.50, 811
8, 14:15:00-000, 6473, 2531, 3942, 0, 0.00, 0, 0.00, 6473
8, 14:16:00-000, 3846, 1867, 1979, 12, 1346.50, 12, 1350.33, 3822
8, 14:17:00-000, 188, 76, 112, 15, 1352.40, 15, 1350.60, 158
8, 14:18:00-000, 2926, 2443, 483, 3, 1349.00, 3, 1347.67, 2920
8, 14:19:00-000, 267, 185, 82, 0, 0.00, 0, 0.00, 267
8, 14:20:00-000, 1737, 1098, 639, 30, 1352.37, 30, 1351.20, 1677
8, 14:21:00-000, 6415, 3004, 3411, 11, 1350.18, 11, 1349.91, 4815
8, 14:22:00-000, 3881, 1025, 2856, 22, 1347.59, 22, 1348.36, 3915
8, 14:23:00-000, 1702, 318, 1384, 2, 1347.00, 2, 1349.50, 3198
8, 14:24:00-000, 6689, 4900, 1789, 4, 1351.00, 4, 1351.00, 6681
8, 14:26:00-000, 3685, 2194, 1491, 3, 1351.00, 3, 1351.00, 3679
8, 14:28:00-000, 2774, 928, 1846, 0, 0.00, 0, 0.00, 2674
8, 14:29:00-000, 4550, 2572, 1978, 12, 1349.92, 12, 1351.92, 4626
8, 14:30:00-000, 1260, 59, 1201, 0, 0.00, 1, 1349.00, 1259
8, 14:31:00-000, 4059, 1253, 2806, 5, 1349.20, 4, 1348.75, 4050
8, 14:32:00-000, 1861, 1011, 850, 0, 0.00, 0, 0.00, 1861
8, 14:33:00-000, 9218, 5512, 3706, 0, 0.00, 0, 0.00, 9115
8, 14:34:00-000, 8248, 2117, 6131, 5, 1350.60, 8, 1349.00, 8254
8, 14:35:00-000, 5, 5, 0, 3, 1351.67, 0, 0.00, 86
8, 14:36:00-000, 6058, 4338, 1720, 0, 0.00, 0, 0.00, 6058
8, 14:37:00-000, 9690, 3344, 6346, 1, 1350.00, 1, 1351.00, 9688
8, 14:38:00-000, 3947, 2756, 1191, 1, 1350.00, 1, 1350.00, 3945
8, 14:39:00-000, 3244, 1503, 1741, 1, 1352.00, 1, 1350.00, 3242
8, 14:42:00-000, 5407, 3665, 1742, 1, 1350.00, 1, 1349.00, 5405
8, 14:44:00-000, 74, 70, 4, 0, 0.00, 0, 0.00, 74
8, 14:45:00-000, 4174, 1358, 2816, 5, 1349.80, 6, 1348.83, 4163
8, 14:46:00-000, 2096, 2086, 10, 1, 1351.00, 0, 0.00, 2095
8, 14:47:00-000, 1860, 1830, 30, 0, 0.00, 0, 0.00, 1860
8, 14:48:00-000, 1283, 38, 1245, 5, 1350.00, 5, 1346.00, 1273
8, 14:49:00-000, 1957, 1208, 749, 1, 1351.00, 1, 1348.00, 1812
8, 14:50:00-000, 7636, 5382, 2254, 15, 1347.93, 15, 1350.66, 7749
8, 14:51:00-000, 1658, 427, 1231, 1, 1348.00, 1, 1347.00, 1656
8, 14:52:00-000, 2601, 805, 1796, 0, 0.00, 0, 0.00, 2601
8, 14:53:00-000, 246, 168, 78, 17, 1349.06, 17, 1351.88, 212
8, 14:54:00-000, 6055, 2173, 3882, 5, 1349.20, 5, 1351.60, 6045
8, 14:55:00-000, 686, 339, 347, 0, 0.00, 0, 0.00, 598
8, 14:56:00-000, 418, 57, 361, 0, 0.00, 0, 0.00, 506
8, 14:57:00-000, 3678, 1914, 1764, 8, 1350.00, 8, 1351.00, 3662
8, 14:58:00-000, 1786, 80, 1706, 0, 0.00, 0, 0.00, 1786
8, 14:59:00-000, 1762, 227, 1535, 0, 0.00, 0, 0.00, 1653
8, 15:00:00-000, 5545, 3739, 1806, 12, 1347.92, 12, 1347.17, 5630
8, 15:01:00-000, 1880, 1681, 199, 6, 1351.83, 8, 1351.00, 266
8, 15:02:00-000, 3549, 1256, 2293, 8, 1349.25, 6, 1351.17, 5135
8, 15:03:00-000, 1656, 201, 1455, 2, 1351.00, 2, 1353.00, 1652
8, 15:04:00-000, 906, 568, 338, 7, 1348.57, 7, 1348.43, 892
8, 15:05:00-000, 3436, 2366, 1070, 0, 0.00, 0, 0.00, 3436
8, 15:06:00-000, 6357, 671, 5686, 23, 1348.26, 22, 1350.63, 6312
8, 15:07:00-000, 114, 105, 9, 8, 1347.50, 9, 1350.33, 97
8, 15:08:00-000, 6809, 3798, 3011, 1, 1352.00, 1, 1351.00, 6807
8, 15:09:00-000, 352, 253, 99, 0, 0.00, 0, 0.00, 352
8, 15:10:00-000, 3518, 1568, 1950, 3, 1349.00, 1, 1351.00, 3514
8, 15:11:00-000, 2949, 2065, 884, 7, 1352.57, 9, 1350.00, 2933
8, 15:12:00-000, 6570, 4086, 2484, 5, 1348.00, 5, 1351.00, 6560
8, 15:13:00-000, 2067, 330, 1737, 0, 0.00, 0, 0.00, 2067
8, 15:14:00-000, 1551, 455, 1096, 27, 1348.48, 27, 1346.70, 1497
8, 15:15:00-000, 1198, 1127, 71, 1, 1348.00, 1, 1347.00, 1173
8, 15:16:00-000, 1410, 0, 1410, 0, 0.00, 0, 0.00, 1433
8, 15:17:00-000, 3517, 1471, 2046, 0, 0.00, 0, 0.00, 3517
8, 15:18:00-000, 6816, 6361, 455, 1, 1347.00, 1, 1350.00, 6814
8, 15:19:00-000, 1726, 1598, 128, 0, 0.00, 0, 0.00, 1726
8, 15:20:00-000, 2047, 371, 1676, 0, 0.00, 0, 0.00, 2047
8, 15:21:00-000, 5878, 2524, 3354, 17, 1346.06, 17, 1350.53, 5164
8, 15:22:00-000, 1274, 511, 763, 46, 1350.47, 48, 1350.08, 1860
8, 15:23:00-000, 3004, 2040, 964, 9, 1356.00, 7, 1350.57, 2988
8, 15:24:00-000, 5724, 4599, 1125, 7, 1349.71, 7, 1351.29, 5710
8, 15:25:00-000, 66, 6, 60, 0, 0.00, 0, 0.00, 66
8, 15:27:00-000, 2222, 2006, 216, 0, 0.00, 0, 0.00, 2222
8, 15:28:00-000, 10219, 3086, 7133, 42, 1348.85, 37, 1349.54, 9626
8, 15:29:00-000, 3631, 226, 3405, 30, 1348.36, 35, 1349.54, 4080
8, 15:30:00-000, 7418, 3311, 4107, 7, 1350.43, 7, 1351.00, 7404
8, 15:31:00-000, 1773, 902, 871, 2, 1350.00, 2, 1348.00, 1769
8, 15:32:00-000, 2822, 1002, 1820, 15, 1345.93, 14, 1348.00, 2793
8, 15:33:00-000, 7079, 2722, 4357, 7, 1348.57, 11, 1349.18, 7061
8, 15:34:00-000, 3752, 1298, 2454, 7, 1350.29, 5, 1352.40, 3740
8, 15:35:00-000, 5414, 4334, 1080, 5, 1349.00, 4, 1346.00, 5401
8, 15:36:00-000, 4547, 4084, 463, 7, 1351.00, 7, 1350.00, 4537
8, 15:37:00-000, 171, 109, 62, 0, 0.00, 0, 0.00, 171
8, 15:38:00-000, 129, 43, 86, 6, 1351.00, 6, 1351.00, 117
8, 15:39:00-000, 4939, 1141, 3798, 7, 1352.43, 7, 1351.43, 4925
8, 15:40:00-000, 978, 890, 88, 23, 1347.74, 23, 1347.43, 932
8, 15:41:00-000, 7716, 3532, 4184, 0, 0.00, 0, 0.00, 7716
8, 15:42:00-000, 754, 28, 726, 6, 1345.50, 6, 1349.33, 742
8, 15:43:00-000, 2034, 1112, 922, 1, 1350.00, 6, 1350.83, 2027
8, 15:44:00-000, 3482, 1214, 2268, 9, 1350.11, 4, 1346.00, 3469
8, 15:45:00-000, 716, 710, 6, 0, 0.00, 0, 0.00, 716
8, 15:46:00-000, 1922, 789, 1133, 0, 0.00, 0, 0.00, 1922
8, 15:47:00-000, 4574, 259, 4315, 3, 1350.00, 3, 1349.00, 4568
8, 15:48:00-000, 109, 100, 9, 0, 0.00, 0, 0.00, 109
8, 15:50:00-000, 791, 21, 770, 10, 1350.70, 10, 1352.00, 771
8, 15:52:00-000, 62, 54, 8, 4, 1350.25, 4, 1352.00, 54
8, 15:55:00-000, 446, 420, 26, 0, 0.00, 0, 0.00, 195
8, 15:56:00-000, 0, 0, 0, 0, 0.00, 0, 0.00, 251
8, 15:58:00-000, 1594, 798, 796, 0, 0.00, 0, 0.00, 1483
8, 15:59:00-000, 5476, 399, 5077, 0, 0.00, 0, 0.00, 5587
8, 16:00:00-000, 800, 88, 712, 0, 0.00, 0, 0.00, 800
8, 16:05:00-000, 2117, 221, 1896, 9, 1350.67, 9, 1351.00, 553
8, 16:06:00-000, 1842, 1031, 811, 3, 1352.00, 3, 1351.00, 3382
8, 16:08:00-000, 3436, 1585, 1851, 0, 0.00, 0, 0.00, 3415
8, 16:09:00-000, 2259, 755, 1504, 5, 1349.00, 5, 1347.80, 2270
8, 16:10:00-000, 6895, 5005, 1890, 0, 0.00, 0, 0.00, 6895
8, 16:11:00-000, 1364, 1193, 171, 0, 0.00, 0, 0.00, 1364
8, 16:12:00-000, 1475, 5, 1470, 0, 0.00, 0, 0.00, 1475
8, 16:13:00-000, 70, 60, 10, 10, 1352.50, 10, 1351.00, 50
8, 16:14:00-000, 5446, 2623, 2823, 5, 1353.00, 5, 1351.00, 5351
8, 16:15:00-000, 4266, 1789, 2477, 2, 1349.00, 2, 1348.50, 4347
8, 16:16:00-000, 3643, 969, 2674, 0, 0.00, 0, 0.00, 3643
8, 16:17:00-000, 1026, 1021, 5, 4, 1347.50, 4, 1348.00, 1018
8, 16:18:00-000, 90, 85, 5, 5, 1351.00, 5, 1351.00, 80
8, 16:19:00-000, 5055, 968, 4087, 1, 1350.00, 0, 0.00, 5054
8, 16:20:00-000, 2419, 1178, 1241, 10, 1350.70, 13, 1350.84, 2396
8, 16:21:00-000, 1166, 946, 220, 15, 1351.40, 13, 1351.84, 1138
8, 16:22:00-000, 6009, 1285, 4724, 7, 1350.57, 12, 1350.83, 5899
8, 16:23:00-000, 7645, 2424, 5221, 6, 1351.33, 1, 1351.00, 7729
8, 16:24:00-000, 3445, 1867, 1578, 2, 1352.00, 2, 1350.00, 3441
8, 16:25:00-000, 1263, 940, 323, 21, 1353.24, 24, 1350.00, 1218
8, 16:26:00-000, 4129, 1894, 2235, 16, 1349.69, 10, 1348.50, 4103
8, 16:27:00-000, 1865, 32, 1833, 10, 1348.00, 13, 1347.00, 1842
8, 16:28:00-000, 368, 121, 247, 11, 1349.00, 13, 1351.69, 344
8, 16:29:00-000, 4662, 263, 4399, 6, 1350.33, 3, 1350.67, 4653
