TraderType,Time,EnterQty,BuyEnterQty,SellEnterQty,BuyExecutedQty,BuyExecutedPx,SellExecutedQty,SellExecutedPx,CanceledQty
1, 09:06:00-000, 3031, 3031, 0, 820, 1347.46, 0, 0.00, 0
1, 09:07:00-000, 0, 0, 0, 0, 0.00, 0, 0.00, 2209
1, 09:08:00-000, 0, 0, 0, 0, 0.00, 0, 0.00, 2
1, 09:13:00-000, 3092, 2272, 820, 1217, 1347.81, 820, 1347.47, 0
1, 09:14:00-000, 10, 6, 4, 0, 0.00, 4, 1354.50, 1055
1, 09:15:00-000, 18, 14, 4, 3, 1349.67, 4, 1350.00, 4
1, 09:16:00-000, 147, 110, 37, 20, 1351.95, 37, 1358.78, 20
1, 09:17:00-000, 158, 106, 52, 34, 1350.96, 52, 1355.59, 65
1, 09:18:00-000, 661, 396, 265, 164, 1349.00, 265, 1354.26, 110
1, 09:19:00-000, 427, 269, 158, 101, 1349.72, 158, 1361.38, 177
1, 09:20:00-000, 838, 515, 323, 224, 1349.63, 323, 1363.78, 247
1, 09:21:00-000, 374, 248, 126, 110, 1348.61, 126, 1350.64, 235
1, 09:22:00-000, 615, 398, 217, 265, 1348.39, 217, 1348.44, 145
1, 09:23:00-000, 279, 192, 87, 109, 1348.75, 87, 1349.02, 114
1, 09:24:00-000, 503, 367, 136, 129, 1349.70, 133, 1354.70, 139
1, 09:25:00-000, 288, 185, 103, 124, 1350.13, 106, 1350.73, 122
1, 09:26:00-000, 605, 373, 232, 241, 1348.27, 228, 1348.62, 138
1, 09:27:00-000, 368, 282, 86, 122, 1348.96, 90, 1347.66, 134
1, 09:28:00-000, 663, 443, 220, 265, 1348.01, 220, 1348.27, 180
1, 09:29:00-000, 333, 245, 88, 125, 1348.34, 88, 1347.53, 134
1, 09:30:00-000, 560, 326, 234, 239, 1347.58, 234, 1347.82, 135
1, 09:31:00-000, 318, 207, 111, 87, 1348.90, 111, 1352.66, 86
1, 09:32:00-000, 670, 440, 230, 296, 1348.44, 230, 1349.41, 137
1, 09:33:00-000, 337, 212, 125, 92, 1348.57, 125, 1349.82, 135
1, 09:34:00-000, 573, 360, 213, 236, 1348.34, 213, 1348.84, 146
1, 09:35:00-000, 349, 251, 98, 109, 1348.43, 98, 1348.36, 106
1, 09:36:00-000, 612, 346, 266, 245, 1348.31, 266, 1348.05, 131
1, 09:37:00-000, 302, 180, 122, 130, 1347.43, 122, 1347.06, 92
1, 09:38:00-000, 606, 401, 205, 221, 1348.37, 205, 1348.31, 96
1, 09:39:00-000, 354, 227, 127, 133, 1348.10, 127, 1348.21, 133
1, 09:40:00-000, 626, 374, 252, 264, 1348.35, 252, 1348.26, 120
1, 09:41:00-000, 297, 165, 132, 55, 1348.66, 130, 1348.99, 99
1, 09:42:00-000, 507, 311, 196, 181, 1348.68, 198, 1348.65, 124
1, 09:43:00-000, 320, 232, 88, 77, 1349.29, 88, 1349.28, 120
1, 09:44:00-000, 657, 394, 263, 247, 1348.46, 263, 1348.56, 155
1, 09:45:00-000, 349, 218, 131, 118, 1348.16, 131, 1348.67, 136
1, 09:46:00-000, 590, 358, 232, 238, 1347.76, 232, 1348.18, 118
1, 09:47:00-000, 351, 235, 116, 141, 1347.80, 116, 1347.83, 105
1, 09:48:00-000, 547, 344, 203, 177, 1347.73, 203, 1347.91, 131
1, 09:49:00-000, 345, 226, 119, 164, 1348.34, 119, 1347.24, 93
1, 09:50:00-000, 616, 404, 212, 250, 1348.66, 212, 1348.37, 121
1, 09:51:00-000, 292, 196, 96, 92, 1347.60, 96, 1347.30, 134
1, 09:52:00-000, 599, 367, 232, 267, 1348.06, 232, 1347.51, 108
1, 09:53:00-000, 343, 206, 137, 180, 1347.96, 137, 1346.18, 81
1, 09:54:00-000, 611, 378, 233, 209, 1347.69, 233, 1347.39, 78
1, 09:55:00-000, 270, 173, 97, 131, 1348.12, 97, 1348.47, 105
1, 09:56:00-000, 649, 409, 240, 257, 1348.63, 239, 1347.95, 87
1, 09:57:00-000, 294, 200, 94, 162, 1347.52, 95, 1349.14, 78
1, 09:58:00-000, 665, 434, 231, 268, 1348.16, 228, 1348.30, 116
1, 09:59:00-000, 333, 181, 152, 129, 1348.07, 155, 1347.89, 123
1, 10:00:00-000, 647, 340, 307, 256, 1346.98, 307, 1346.32, 74
1, 10:01:00-000, 338, 178, 160, 124, 1348.26, 160, 1347.88, 72
1, 10:02:00-000, 658, 385, 273, 253, 1348.21, 271, 1347.83, 82
1, 10:03:00-000, 306, 191, 115, 126, 1348.38, 117, 1347.94, 102
1, 10:04:00-000, 639, 393, 246, 232, 1348.09, 246, 1347.53, 127
1, 10:05:00-000, 306, 195, 111, 123, 1347.57, 111, 1348.00, 102
1, 10:06:00-000, 680, 424, 256, 251, 1347.55, 256, 1346.94, 97
1, 10:07:00-000, 350, 204, 146, 157, 1348.21, 146, 1347.16, 146
1, 10:08:00-000, 564, 355, 209, 188, 1348.02, 209, 1347.73, 103
1, 10:09:00-000, 321, 192, 129, 159, 1347.37, 129, 1348.08, 72
1, 10:10:00-000, 621, 401, 220, 241, 1348.24, 220, 1347.63, 87
1, 10:11:00-000, 263, 150, 113, 139, 1347.95, 113, 1347.15, 116
1, 10:12:00-000, 620, 355, 265, 263, 1347.63, 259, 1347.72, 55
1, 10:13:00-000, 306, 182, 124, 142, 1347.35, 124, 1347.05, 74
1, 10:14:00-000, 644, 370, 274, 225, 1347.30, 274, 1346.60, 83
1, 10:15:00-000, 410, 247, 163, 174, 1347.95, 163, 1347.71, 90
1, 10:16:00-000, 598, 333, 265, 290, 1347.53, 265, 1346.69, 101
1, 10:17:00-000, 300, 192, 108, 105, 1347.67, 108, 1347.31, 47
1, 10:18:00-000, 572, 324, 248, 271, 1348.09, 248, 1346.62, 81
1, 10:19:00-000, 296, 161, 135, 129, 1347.74, 135, 1346.63, 62
1, 10:20:00-000, 643, 402, 241, 237, 1347.39, 241, 1346.74, 56
1, 10:21:00-000, 314, 175, 139, 123, 1347.25, 139, 1347.21, 127
1, 10:22:00-000, 658, 371, 287, 266, 1346.96, 287, 1346.98, 81
1, 10:23:00-000, 353, 233, 120, 157, 1348.34, 120, 1347.66, 79
1, 10:24:00-000, 689, 376, 313, 289, 1347.07, 312, 1346.48, 107
1, 10:25:00-000, 259, 139, 120, 91, 1348.97, 121, 1347.13, 71
1, 10:26:00-000, 653, 428, 225, 264, 1347.76, 225, 1347.20, 82
1, 10:27:00-000, 360, 231, 129, 148, 1347.78, 129, 1347.06, 119
1, 10:28:00-000, 626, 354, 272, 287, 1347.27, 272, 1346.61, 94
1, 10:29:00-000, 380, 224, 156, 141, 1348.19, 156, 1346.96, 61
1, 10:30:00-000, 624, 390, 234, 250, 1348.34, 234, 1348.06, 77
1, 10:31:00-000, 292, 157, 135, 137, 1348.21, 135, 1348.49, 112
1, 10:32:00-000, 525, 266, 259, 259, 1346.98, 259, 1346.36, 36
1, 10:33:00-000, 326, 200, 126, 127, 1348.32, 123, 1347.57, 32
1, 10:34:00-000, 724, 412, 312, 301, 1347.56, 315, 1347.32, 72
1, 10:35:00-000, 340, 237, 103, 136, 1347.76, 103, 1347.06, 79
1, 10:36:00-000, 676, 409, 267, 297, 1347.89, 267, 1347.25, 118
1, 10:37:00-000, 266, 137, 129, 116, 1347.66, 129, 1347.23, 102
1, 10:38:00-000, 609, 337, 272, 234, 1348.23, 272, 1347.30, 62
1, 10:39:00-000, 333, 196, 137, 135, 1348.65, 137, 1347.63, 71
1, 10:40:00-000, 657, 398, 259, 263, 1347.89, 259, 1347.09, 93
1, 10:41:00-000, 297, 193, 104, 142, 1348.36, 104, 1347.24, 109
1, 10:42:00-000, 629, 317, 312, 267, 1346.88, 312, 1346.58, 48
1, 10:43:00-000, 352, 203, 149, 140, 1347.22, 149, 1346.43, 63
1, 10:44:00-000, 643, 338, 305, 291, 1348.13, 303, 1346.88, 80
1, 10:45:00-000, 380, 223, 157, 182, 1347.90, 159, 1347.51, 28
1, 10:46:00-000, 634, 377, 257, 235, 1348.02, 257, 1347.30, 69
1, 10:47:00-000, 302, 179, 123, 137, 1347.13, 123, 1346.77, 86
1, 10:48:00-000, 658, 359, 299, 215, 1348.12, 299, 1348.09, 94
1, 10:49:00-000, 218, 128, 90, 61, 1348.14, 90, 1348.05, 122
1, 10:50:00-000, 534, 332, 202, 211, 1348.69, 202, 1347.92, 78
1, 10:51:00-000, 313, 150, 163, 110, 1347.92, 163, 1347.33, 100
1, 10:52:00-000, 659, 397, 262, 277, 1347.55, 262, 1347.23, 55
1, 10:53:00-000, 309, 194, 115, 131, 1348.53, 115, 1347.94, 92
1, 10:54:00-000, 646, 362, 284, 248, 1347.68, 284, 1347.18, 84
1, 10:55:00-000, 282, 188, 94, 139, 1349.09, 94, 1348.95, 100
1, 10:56:00-000, 522, 330, 192, 202, 1348.11, 192, 1347.92, 90
1, 10:57:00-000, 312, 188, 124, 129, 1347.66, 124, 1347.01, 73
1, 10:58:00-000, 631, 364, 267, 271, 1348.62, 267, 1347.58, 113
1, 10:59:00-000, 290, 189, 101, 123, 1348.74, 101, 1348.31, 65
1, 11:00:00-000, 648, 420, 228, 276, 1348.11, 228, 1347.44, 99
1, 11:01:00-000, 316, 192, 124, 126, 1347.62, 124, 1346.36, 93
1, 11:02:00-000, 630, 346, 284, 255, 1347.41, 284, 1346.27, 69
1, 11:03:00-000, 316, 180, 136, 134, 1347.83, 136, 1347.66, 87
1, 11:04:00-000, 523, 275, 248, 240, 1346.84, 248, 1346.88, 55
1, 11:05:00-000, 339, 226, 113, 124, 1348.35, 113, 1347.93, 32
1, 11:06:00-000, 571, 318, 253, 228, 1347.41, 253, 1347.37, 118
1, 11:07:00-000, 296, 168, 128, 99, 1347.08, 128, 1346.56, 74
1, 11:08:00-000, 666, 364, 302, 291, 1347.31, 302, 1346.63, 87
1, 11:09:00-000, 317, 182, 135, 114, 1347.93, 135, 1347.83, 64
1, 11:10:00-000, 658, 416, 242, 273, 1347.68, 242, 1347.28, 115
1, 11:11:00-000, 284, 173, 111, 107, 1347.55, 111, 1347.28, 100
1, 11:12:00-000, 600, 366, 234, 256, 1348.40, 234, 1348.41, 104
1, 11:13:00-000, 283, 153, 130, 129, 1347.59, 130, 1346.99, 74
1, 11:14:00-000, 577, 355, 222, 191, 1347.33, 222, 1346.65, 51
1, 11:15:00-000, 351, 189, 162, 177, 1347.90, 162, 1346.39, 117
1, 11:16:00-000, 634, 399, 235, 262, 1348.24, 230, 1347.64, 48
1, 11:17:00-000, 279, 165, 114, 90, 1347.32, 119, 1348.16, 103
1, 11:18:00-000, 621, 363, 258, 243, 1347.75, 258, 1347.50, 119
1, 11:19:00-000, 354, 229, 125, 156, 1347.62, 125, 1346.89, 70
1, 11:20:00-000, 577, 340, 237, 245, 1348.05, 237, 1347.11, 106
1, 11:21:00-000, 270, 182, 88, 129, 1348.30, 88, 1347.00, 77
1, 11:22:00-000, 655, 406, 249, 321, 1348.16, 249, 1347.87, 49
1, 11:23:00-000, 374, 257, 117, 157, 1348.66, 117, 1348.42, 77
1, 11:24:00-000, 640, 359, 281, 260, 1348.13, 281, 1348.00, 124
1, 11:25:00-000, 330, 193, 137, 130, 1347.77, 137, 1346.69, 97
1, 11:26:00-000, 695, 376, 319, 267, 1347.11, 319, 1346.42, 59
1, 11:27:00-000, 344, 199, 145, 177, 1347.45, 145, 1346.76, 88
1, 11:28:00-000, 569, 327, 242, 215, 1348.21, 242, 1347.43, 61
1, 11:29:00-000, 297, 149, 148, 129, 1347.66, 148, 1346.37, 63
1, 11:30:00-000, 598, 305, 293, 215, 1347.50, 293, 1346.92, 77
1, 11:31:00-000, 298, 169, 129, 129, 1346.51, 129, 1346.47, 62
1, 11:32:00-000, 607, 337, 270, 251, 1347.64, 270, 1346.94, 61
1, 11:33:00-000, 412, 266, 146, 171, 1347.95, 146, 1347.26, 66
1, 11:34:00-000, 630, 376, 254, 263, 1348.72, 254, 1348.75, 96
1, 11:35:00-000, 280, 175, 105, 89, 1347.41, 105, 1347.42, 118
1, 11:36:00-000, 601, 398, 203, 230, 1348.71, 203, 1347.78, 122
1, 11:37:00-000, 292, 169, 123, 121, 1348.30, 123, 1346.82, 112
1, 11:38:00-000, 651, 390, 261, 281, 1348.01, 261, 1347.86, 91
1, 11:39:00-000, 320, 167, 153, 134, 1347.08, 153, 1346.73, 66
1, 11:40:00-000, 586, 361, 225, 241, 1348.07, 225, 1347.60, 67
1, 11:41:00-000, 275, 156, 119, 136, 1347.19, 119, 1345.77, 69
1, 11:42:00-000, 631, 405, 226, 255, 1347.72, 226, 1346.78, 86
1, 11:43:00-000, 277, 161, 116, 100, 1347.96, 116, 1347.00, 108
1, 11:44:00-000, 632, 332, 300, 240, 1347.93, 300, 1347.00, 80
1, 11:45:00-000, 298, 171, 127, 132, 1348.86, 127, 1348.71, 68
1, 11:46:00-000, 617, 331, 286, 226, 1347.67, 286, 1347.73, 70
1, 11:47:00-000, 306, 162, 144, 111, 1347.34, 144, 1346.90, 64
1, 11:48:00-000, 557, 360, 197, 225, 1348.56, 197, 1348.00, 114
1, 11:49:00-000, 316, 185, 131, 137, 1348.18, 131, 1348.43, 71
1, 11:50:00-000, 544, 293, 251, 196, 1347.70, 251, 1347.65, 68
1, 11:51:00-000, 292, 183, 109, 144, 1348.74, 109, 1347.34, 79
1, 11:52:00-000, 644, 424, 220, 294, 1348.41, 220, 1348.07, 85
1, 11:53:00-000, 256, 132, 124, 90, 1347.57, 124, 1347.75, 85
1, 11:54:00-000, 676, 426, 250, 269, 1347.94, 250, 1347.34, 82
1, 11:55:00-000, 312, 174, 138, 121, 1347.34, 138, 1347.02, 104
1, 11:56:00-000, 622, 374, 248, 247, 1347.81, 248, 1347.57, 94
1, 11:57:00-000, 270, 185, 85, 124, 1347.90, 85, 1347.83, 110
1, 11:58:00-000, 596, 371, 225, 235, 1348.20, 225, 1347.41, 93
1, 11:59:00-000, 246, 142, 104, 103, 1347.42, 104, 1346.97, 88
1, 12:00:00-000, 691, 429, 262, 321, 1347.57, 262, 1347.21, 80
1, 12:01:00-000, 248, 123, 125, 106, 1347.16, 125, 1346.27, 88
1, 12:02:00-000, 620, 366, 254, 293, 1348.02, 254, 1347.28, 33
1, 12:03:00-000, 308, 157, 151, 133, 1347.53, 151, 1346.60, 64
1, 12:04:00-000, 669, 412, 257, 272, 1348.52, 257, 1348.17, 68
1, 12:05:00-000, 264, 131, 133, 125, 1347.04, 133, 1346.15, 65
1, 12:06:00-000, 634, 347, 287, 253, 1347.63, 287, 1347.31, 52
1, 12:07:00-000, 330, 211, 119, 143, 1347.81, 119, 1347.02, 60
1, 12:08:00-000, 592, 331, 261, 266, 1348.03, 261, 1347.63, 70
1, 12:09:00-000, 339, 202, 137, 123, 1347.93, 137, 1347.96, 64
1, 12:10:00-000, 605, 343, 262, 229, 1348.09, 262, 1347.46, 95
1, 12:11:00-000, 329, 206, 123, 131, 1348.30, 123, 1348.74, 92
1, 12:12:00-000, 648, 376, 272, 274, 1348.39, 272, 1348.32, 95
1, 12:13:00-000, 307, 166, 141, 97, 1347.59, 141, 1347.06, 100
1, 12:14:00-000, 604, 356, 248, 241, 1347.49, 248, 1347.10, 75
1, 12:15:00-000, 270, 163, 107, 109, 1347.86, 107, 1347.78, 91
1, 12:16:00-000, 640, 375, 265, 259, 1347.53, 265, 1347.13, 77
1, 12:17:00-000, 321, 210, 111, 136, 1347.76, 111, 1347.66, 95
1, 12:18:00-000, 622, 352, 270, 263, 1348.64, 270, 1348.06, 82
1, 12:19:00-000, 328, 218, 110, 146, 1348.90, 110, 1348.23, 87
1, 12:20:00-000, 578, 306, 272, 196, 1348.53, 272, 1347.36, 109
1, 12:21:00-000, 294, 184, 110, 101, 1349.65, 110, 1346.90, 87
1, 12:22:00-000, 606, 348, 258, 226, 1348.34, 258, 1347.09, 123
1, 12:23:00-000, 217, 134, 83, 89, 1348.93, 83, 1347.92, 85
1, 12:24:00-000, 656, 384, 272, 257, 1348.57, 272, 1347.63, 62
1, 12:25:00-000, 303, 170, 133, 136, 1347.53, 133, 1346.59, 89
1, 12:26:00-000, 607, 363, 244, 272, 1348.58, 244, 1347.62, 60
1, 12:27:00-000, 341, 225, 116, 139, 1347.62, 116, 1346.51, 70
1, 12:28:00-000, 599, 369, 230, 245, 1348.36, 230, 1347.08, 122
1, 12:29:00-000, 336, 212, 124, 134, 1349.00, 124, 1347.96, 80
1, 12:30:00-000, 557, 351, 206, 250, 1348.98, 206, 1346.95, 93
1, 12:31:00-000, 333, 200, 133, 152, 1348.74, 133, 1348.57, 79
1, 12:32:00-000, 679, 385, 294, 276, 1347.72, 294, 1346.77, 107
1, 12:33:00-000, 229, 143, 86, 54, 1348.03, 86, 1348.17, 76
1, 12:34:00-000, 595, 329, 266, 260, 1348.24, 266, 1347.83, 79
1, 12:35:00-000, 314, 170, 144, 130, 1348.67, 144, 1347.71, 75
1, 12:36:00-000, 661, 378, 283, 245, 1347.74, 283, 1347.21, 101
1, 12:37:00-000, 274, 120, 154, 96, 1347.73, 154, 1346.21, 64
1, 12:38:00-000, 622, 419, 203, 252, 1348.94, 203, 1348.28, 78
1, 12:39:00-000, 320, 195, 125, 162, 1348.85, 125, 1348.61, 103
1, 12:40:00-000, 587, 350, 237, 240, 1348.18, 237, 1347.24, 70
1, 12:41:00-000, 283, 150, 133, 120, 1347.61, 133, 1346.44, 77
1, 12:42:00-000, 655, 431, 224, 242, 1348.86, 224, 1348.38, 103
1, 12:43:00-000, 390, 213, 177, 182, 1348.32, 177, 1347.70, 77
1, 12:44:00-000, 640, 418, 222, 259, 1347.46, 222, 1346.69, 124
1, 12:45:00-000, 268, 168, 100, 155, 1348.07, 100, 1347.39, 94
1, 12:46:00-000, 562, 374, 188, 248, 1348.39, 188, 1347.83, 78
1, 12:47:00-000, 327, 195, 132, 141, 1347.99, 132, 1347.68, 81
1, 12:48:00-000, 558, 328, 230, 264, 1348.07, 230, 1347.67, 58
1, 12:49:00-000, 328, 166, 162, 135, 1347.86, 159, 1346.99, 52
1, 12:50:00-000, 735, 420, 315, 326, 1348.00, 318, 1347.85, 60
1, 12:51:00-000, 349, 221, 128, 167, 1347.55, 128, 1346.20, 59
1, 12:52:00-000, 712, 361, 351, 266, 1347.08, 351, 1346.39, 107
1, 12:53:00-000, 222, 107, 115, 65, 1346.28, 115, 1346.85, 68
1, 12:54:00-000, 565, 319, 246, 210, 1348.59, 246, 1347.03, 61
1, 12:55:00-000, 329, 189, 140, 150, 1349.42, 140, 1348.38, 79
1, 12:56:00-000, 694, 398, 296, 232, 1347.56, 295, 1347.51, 79
1, 12:57:00-000, 315, 178, 137, 136, 1348.42, 138, 1347.31, 113
1, 12:58:00-000, 633, 380, 253, 274, 1348.12, 253, 1347.23, 75
1, 12:59:00-000, 295, 189, 106, 139, 1347.89, 106, 1347.91, 77
1, 13:00:00-000, 587, 314, 273, 246, 1348.35, 273, 1347.24, 82
1, 13:01:00-000, 287, 184, 103, 128, 1348.65, 103, 1347.83, 45
1, 13:02:00-000, 582, 354, 228, 239, 1347.60, 227, 1347.74, 96
1, 13:03:00-000, 351, 228, 123, 152, 1348.59, 124, 1347.39, 77
1, 13:04:00-000, 597, 341, 256, 263, 1347.44, 256, 1347.08, 74
1, 13:05:00-000, 350, 208, 142, 115, 1349.38, 142, 1348.34, 82
1, 13:06:00-000, 501, 247, 254, 219, 1347.52, 253, 1346.84, 73
1, 13:07:00-000, 289, 142, 147, 126, 1347.15, 148, 1345.14, 39
1, 13:08:00-000, 689, 371, 318, 252, 1347.94, 318, 1347.96, 47
1, 13:09:00-000, 269, 165, 104, 125, 1347.76, 104, 1346.94, 81
1, 13:10:00-000, 671, 422, 249, 253, 1347.78, 249, 1347.33, 89
1, 13:11:00-000, 260, 165, 95, 125, 1349.24, 95, 1349.57, 145
1, 13:12:00-000, 658, 391, 267, 227, 1348.59, 267, 1347.65, 75
1, 13:13:00-000, 316, 193, 123, 142, 1347.67, 123, 1347.22, 119
1, 13:14:00-000, 568, 336, 232, 217, 1347.86, 232, 1348.02, 78
1, 13:15:00-000, 308, 196, 112, 118, 1348.39, 112, 1347.37, 95
1, 13:16:00-000, 577, 321, 256, 254, 1348.20, 256, 1347.16, 68
1, 13:17:00-000, 318, 195, 123, 146, 1347.17, 123, 1346.81, 53
1, 13:18:00-000, 601, 354, 247, 239, 1347.79, 247, 1347.31, 87
1, 13:19:00-000, 318, 182, 136, 126, 1348.41, 136, 1347.07, 90
1, 13:20:00-000, 701, 415, 286, 318, 1347.53, 286, 1347.10, 57
1, 13:21:00-000, 245, 172, 73, 86, 1348.66, 73, 1348.11, 91
1, 13:22:00-000, 618, 396, 222, 252, 1348.69, 220, 1348.06, 130
1, 13:23:00-000, 278, 168, 110, 134, 1348.18, 112, 1348.16, 87
1, 13:24:00-000, 652, 368, 284, 239, 1347.66, 284, 1347.06, 71
1, 13:25:00-000, 330, 196, 134, 138, 1347.48, 134, 1346.81, 105
1, 13:26:00-000, 620, 338, 282, 284, 1347.82, 282, 1346.74, 69
1, 13:27:00-000, 269, 161, 108, 118, 1347.88, 108, 1346.14, 61
1, 13:28:00-000, 557, 331, 226, 248, 1348.33, 226, 1347.43, 75
1, 13:29:00-000, 324, 186, 138, 125, 1347.62, 138, 1347.41, 50
1, 13:30:00-000, 596, 364, 232, 235, 1347.79, 232, 1347.07, 92
1, 13:31:00-000, 380, 230, 150, 158, 1348.15, 150, 1347.69, 74
1, 13:32:00-000, 644, 394, 250, 317, 1348.13, 250, 1346.95, 112
1, 13:33:00-000, 318, 176, 142, 138, 1347.67, 142, 1347.26, 56
1, 13:34:00-000, 631, 367, 264, 278, 1347.88, 264, 1347.70, 46
1, 13:35:00-000, 289, 151, 138, 125, 1347.30, 138, 1346.82, 63
1, 13:36:00-000, 590, 366, 224, 245, 1348.31, 224, 1347.93, 82
1, 13:37:00-000, 317, 168, 149, 92, 1348.20, 149, 1347.80, 78
1, 13:38:00-000, 584, 325, 259, 264, 1347.98, 259, 1347.07, 76
1, 13:39:00-000, 379, 242, 137, 176, 1348.04, 137, 1347.19, 60
1, 13:40:00-000, 639, 329, 310, 253, 1347.86, 310, 1347.05, 89
1, 13:41:00-000, 338, 196, 142, 132, 1348.66, 138, 1347.94, 57
1, 13:42:00-000, 602, 360, 242, 235, 1348.00, 246, 1347.43, 84
1, 13:43:00-000, 276, 161, 115, 114, 1348.55, 115, 1348.62, 112
1, 13:44:00-000, 656, 372, 284, 292, 1347.89, 284, 1346.94, 53
1, 13:45:00-000, 318, 161, 157, 121, 1347.44, 157, 1346.81, 51
1, 13:46:00-000, 584, 335, 249, 275, 1347.55, 249, 1346.64, 75
1, 13:47:00-000, 321, 198, 123, 128, 1349.39, 119, 1349.40, 35
1, 13:48:00-000, 670, 410, 260, 332, 1347.98, 264, 1347.66, 65
1, 13:49:00-000, 296, 172, 124, 138, 1347.82, 124, 1346.95, 71
1, 13:50:00-000, 501, 277, 224, 191, 1347.50, 224, 1347.72, 84
1, 13:51:00-000, 354, 173, 181, 143, 1347.37, 181, 1347.16, 49
1, 13:52:00-000, 630, 295, 335, 266, 1346.83, 335, 1345.64, 39
1, 13:53:00-000, 339, 201, 138, 108, 1347.77, 138, 1347.17, 29
1, 13:54:00-000, 615, 368, 247, 257, 1347.82, 247, 1347.25, 128
1, 13:55:00-000, 304, 181, 123, 135, 1347.61, 123, 1346.89, 77
1, 13:56:00-000, 581, 365, 216, 248, 1348.66, 216, 1347.48, 81
1, 13:57:00-000, 267, 142, 125, 99, 1348.77, 125, 1347.62, 82
1, 13:58:00-000, 578, 340, 238, 202, 1348.86, 238, 1347.46, 61
1, 13:59:00-000, 355, 172, 183, 133, 1348.21, 183, 1347.61, 114
1, 14:00:00-000, 569, 343, 226, 250, 1347.65, 226, 1347.22, 61
1, 14:01:00-000, 294, 195, 99, 103, 1348.22, 99, 1347.75, 83
1, 14:02:00-000, 652, 425, 227, 272, 1348.34, 227, 1347.77, 101
1, 14:03:00-000, 396, 255, 141, 174, 1348.39, 141, 1347.02, 124
1, 14:04:00-000, 613, 354, 259, 218, 1348.84, 259, 1348.09, 128
1, 14:05:00-000, 275, 150, 125, 135, 1347.66, 125, 1346.70, 80
1, 14:06:00-000, 520, 282, 238, 206, 1346.86, 238, 1346.39, 39
1, 14:07:00-000, 301, 176, 125, 138, 1347.73, 125, 1347.13, 50
1, 14:08:00-000, 598, 393, 205, 240, 1348.64, 205, 1348.04, 93
1, 14:09:00-000, 336, 172, 164, 127, 1347.81, 164, 1346.92, 118
1, 14:10:00-000, 637, 391, 246, 233, 1348.42, 246, 1348.16, 92
1, 14:11:00-000, 283, 171, 112, 136, 1348.40, 112, 1347.77, 94
1, 14:12:00-000, 616, 346, 270, 224, 1347.47, 270, 1346.65, 83
1, 14:13:00-000, 254, 167, 87, 96, 1348.84, 87, 1347.95, 89
1, 14:14:00-000, 597, 389, 208, 244, 1348.20, 208, 1347.66, 119
1, 14:15:00-000, 291, 153, 138, 117, 1347.35, 138, 1346.85, 98
1, 14:16:00-000, 547, 320, 227, 218, 1347.21, 227, 1346.85, 65
1, 14:17:00-000, 365, 192, 173, 158, 1348.49, 173, 1347.28, 63
1, 14:18:00-000, 624, 376, 248, 235, 1348.42, 248, 1348.43, 88
1, 14:19:00-000, 321, 195, 126, 149, 1346.90, 126, 1346.90, 76
1, 14:20:00-000, 606, 379, 227, 177, 1349.42, 227, 1349.03, 108
1, 14:21:00-000, 286, 153, 133, 133, 1348.51, 133, 1347.33, 134
1, 14:22:00-000, 567, 350, 217, 210, 1348.76, 217, 1347.75, 69
1, 14:23:00-000, 261, 155, 106, 136, 1347.96, 106, 1347.98, 92
1, 14:24:00-000, 627, 404, 223, 233, 1348.86, 223, 1348.04, 79
1, 14:25:00-000, 291, 187, 104, 122, 1348.11, 104, 1347.85, 148
1, 14:26:00-000, 568, 357, 211, 187, 1347.86, 211, 1347.66, 92
1, 14:27:00-000, 297, 199, 98, 101, 1348.46, 98, 1348.35, 129
1, 14:28:00-000, 577, 329, 248, 261, 1348.34, 248, 1347.14, 101
1, 14:29:00-000, 367, 196, 171, 115, 1347.89, 169, 1347.54, 68
1, 14:30:00-000, 598, 364, 234, 230, 1348.02, 236, 1347.59, 125
1, 14:31:00-000, 283, 173, 110, 121, 1347.58, 108, 1347.80, 72
1, 14:32:00-000, 599, 362, 237, 243, 1348.90, 239, 1347.64, 100
1, 14:33:00-000, 267, 192, 75, 77, 1349.43, 75, 1350.11, 97
1, 14:34:00-000, 632, 411, 221, 258, 1349.06, 221, 1348.02, 127
1, 14:35:00-000, 268, 166, 102, 101, 1349.18, 102, 1348.39, 138
1, 14:36:00-000, 668, 424, 244, 319, 1348.67, 244, 1347.29, 93
1, 14:37:00-000, 318, 188, 130, 123, 1348.57, 130, 1348.08, 64
1, 14:38:00-000, 566, 358, 208, 230, 1348.30, 208, 1348.24, 83
1, 14:39:00-000, 316, 184, 132, 140, 1348.60, 132, 1347.82, 103
1, 14:40:00-000, 605, 367, 238, 266, 1348.79, 238, 1348.28, 73
1, 14:41:00-000, 273, 167, 106, 89, 1347.74, 106, 1347.68, 70
1, 14:42:00-000, 627, 373, 254, 273, 1347.99, 254, 1346.58, 104
1, 14:43:00-000, 326, 202, 124, 166, 1347.89, 124, 1347.26, 87
1, 14:44:00-000, 648, 341, 307, 277, 1347.02, 307, 1346.33, 59
1, 14:45:00-000, 341, 237, 104, 132, 1348.48, 104, 1347.44, 52
1, 14:46:00-000, 610, 335, 275, 260, 1347.85, 275, 1347.37, 109
1, 14:47:00-000, 319, 164, 155, 140, 1347.92, 155, 1346.88, 57
1, 14:48:00-000, 594, 372, 222, 254, 1347.63, 222, 1347.49, 51
1, 14:49:00-000, 328, 181, 147, 129, 1347.50, 147, 1347.81, 89
1, 14:50:00-000, 625, 354, 271, 267, 1348.12, 271, 1347.56, 90
1, 14:51:00-000, 301, 170, 131, 139, 1347.84, 131, 1346.77, 56
1, 14:52:00-000, 679, 389, 290, 290, 1347.79, 290, 1347.64, 66
1, 14:53:00-000, 271, 176, 95, 139, 1349.23, 95, 1348.55, 73
1, 14:54:00-000, 643, 385, 258, 202, 1348.16, 258, 1347.83, 64
1, 14:55:00-000, 360, 219, 141, 170, 1348.37, 138, 1348.30, 126
1, 14:56:00-000, 634, 393, 241, 271, 1348.27, 244, 1348.70, 85
1, 14:57:00-000, 366, 188, 178, 126, 1348.67, 178, 1347.20, 106
1, 14:58:00-000, 633, 364, 269, 246, 1347.99, 269, 1347.63, 81
1, 14:59:00-000, 319, 216, 103, 129, 1348.03, 103, 1348.06, 103
1, 15:00:00-000, 704, 379, 325, 287, 1347.74, 325, 1346.87, 103
1, 15:01:00-000, 318, 201, 117, 140, 1348.02, 117, 1347.88, 79
1, 15:02:00-000, 652, 383, 269, 268, 1347.74, 269, 1346.81, 94
1, 15:03:00-000, 293, 192, 101, 124, 1347.78, 101, 1347.17, 62
1, 15:04:00-000, 660, 384, 276, 270, 1348.34, 276, 1347.90, 119
1, 15:05:00-000, 307, 185, 122, 108, 1348.23, 122, 1347.08, 82
1, 15:06:00-000, 631, 361, 270, 270, 1348.15, 270, 1347.71, 70
1, 15:07:00-000, 255, 105, 150, 128, 1347.77, 150, 1347.01, 61
1, 15:08:00-000, 577, 307, 270, 241, 1347.85, 266, 1347.17, 43
1, 15:09:00-000, 310, 169, 141, 107, 1347.38, 145, 1347.41, 40
1, 15:10:00-000, 613, 359, 254, 272, 1347.63, 254, 1347.42, 67
1, 15:11:00-000, 299, 163, 136, 123, 1347.52, 136, 1346.80, 77
1, 15:12:00-000, 543, 309, 234, 214, 1348.03, 234, 1347.95, 54
1, 15:13:00-000, 310, 230, 80, 139, 1348.78, 80, 1349.31, 53
1, 15:14:00-000, 598, 323, 275, 235, 1347.72, 275, 1347.62, 82
1, 15:15:00-000, 327, 196, 131, 163, 1348.09, 131, 1347.46, 101
1, 15:16:00-000, 696, 446, 250, 236, 1349.05, 250, 1349.20, 91
1, 15:17:00-000, 306, 164, 142, 136, 1347.34, 142, 1347.11, 125
1, 15:18:00-000, 643, 400, 243, 260, 1348.22, 243, 1348.34, 101
1, 15:19:00-000, 345, 185, 160, 153, 1347.32, 160, 1346.56, 103
1, 15:20:00-000, 528, 299, 229, 232, 1347.75, 229, 1346.99, 78
1, 15:21:00-000, 314, 173, 141, 131, 1347.36, 141, 1347.70, 24
1, 15:22:00-000, 614, 331, 283, 223, 1347.85, 282, 1347.49, 60
1, 15:23:00-000, 271, 188, 83, 102, 1349.68, 79, 1349.28, 94
1, 15:24:00-000, 605, 339, 266, 224, 1348.13, 271, 1346.89, 106
1, 15:25:00-000, 298, 182, 116, 120, 1348.07, 116, 1347.33, 93
1, 15:26:00-000, 562, 374, 188, 237, 1348.31, 188, 1347.19, 110
1, 15:27:00-000, 275, 166, 109, 123, 1347.72, 109, 1347.39, 97
1, 15:28:00-000, 657, 387, 270, 241, 1348.44, 270, 1347.60, 68
1, 15:29:00-000, 301, 180, 121, 125, 1347.74, 121, 1347.43, 116
1, 15:30:00-000, 635, 402, 233, 296, 1347.92, 233, 1347.29, 86
1, 15:31:00-000, 311, 199, 112, 103, 1348.57, 112, 1348.93, 85
1, 15:32:00-000, 623, 359, 264, 258, 1348.30, 264, 1347.71, 112
1, 15:33:00-000, 302, 179, 123, 141, 1347.40, 123, 1346.69, 56
1, 15:34:00-000, 594, 346, 248, 230, 1347.98, 248, 1347.28, 87
1, 15:35:00-000, 340, 230, 110, 93, 1349.90, 108, 1350.19, 83
1, 15:36:00-000, 617, 377, 240, 260, 1348.72, 242, 1348.42, 173
1, 15:37:00-000, 314, 174, 140, 123, 1347.87, 140, 1346.85, 88
1, 15:38:00-000, 667, 398, 269, 250, 1348.07, 269, 1347.50, 55
1, 15:39:00-000, 240, 140, 100, 134, 1348.31, 100, 1347.78, 111
1, 15:40:00-000, 548, 290, 258, 120, 1348.54, 258, 1347.02, 84
1, 15:41:00-000, 333, 194, 139, 139, 1348.73, 139, 1347.68, 112
1, 15:42:00-000, 602, 392, 210, 229, 1348.36, 210, 1347.32, 85
1, 15:43:00-000, 348, 206, 142, 109, 1347.15, 142, 1346.39, 141
1, 15:44:00-000, 654, 407, 247, 330, 1349.07, 247, 1346.94, 102
1, 15:45:00-000, 271, 171, 100, 80, 1348.36, 100, 1348.16, 84
1, 15:46:00-000, 536, 341, 195, 221, 1347.85, 195, 1347.24, 94
1, 15:47:00-000, 296, 188, 108, 132, 1347.02, 108, 1346.69, 105
1, 15:48:00-000, 612, 377, 235, 247, 1347.19, 235, 1346.57, 95
1, 15:49:00-000, 286, 179, 107, 117, 1348.02, 107, 1347.76, 107
1, 15:50:00-000, 646, 382, 264, 269, 1348.45, 264, 1347.15, 82
1, 15:51:00-000, 337, 221, 116, 154, 1348.19, 116, 1347.43, 82
1, 15:52:00-000, 571, 328, 243, 225, 1347.97, 243, 1346.61, 86
1, 15:53:00-000, 275, 167, 108, 111, 1347.84, 108, 1347.01, 94
1, 15:54:00-000, 524, 279, 245, 183, 1347.66, 245, 1347.25, 62
1, 15:55:00-000, 342, 174, 168, 136, 1346.83, 168, 1346.56, 69
1, 15:56:00-000, 673, 436, 237, 246, 1348.44, 237, 1347.82, 99
1, 15:57:00-000, 274, 176, 98, 176, 1347.98, 98, 1347.22, 97
1, 15:58:00-000, 631, 359, 272, 286, 1347.77, 272, 1347.08, 44
1, 15:59:00-000, 286, 187, 99, 115, 1347.59, 99, 1347.61, 65
1, 16:00:00-000, 597, 365, 232, 258, 1349.03, 232, 1347.45, 117
1, 16:01:00-000, 283, 166, 117, 122, 1348.63, 117, 1348.24, 70
1, 16:02:00-000, 612, 403, 209, 263, 1348.26, 209, 1347.59, 74
1, 16:03:00-000, 308, 147, 161, 113, 1347.74, 161, 1347.05, 105
1, 16:04:00-000, 587, 325, 262, 222, 1347.59, 262, 1347.00, 61
1, 16:05:00-000, 334, 203, 131, 93, 1348.46, 131, 1348.06, 83
1, 16:06:00-000, 648, 324, 324, 275, 1347.12, 324, 1346.66, 108
1, 16:07:00-000, 288, 172, 116, 136, 1347.96, 116, 1347.47, 38
1, 16:08:00-000, 673, 410, 263, 302, 1347.97, 263, 1347.12, 71
1, 16:09:00-000, 247, 127, 120, 117, 1346.86, 120, 1346.70, 75
1, 16:10:00-000, 629, 414, 215, 308, 1348.11, 215, 1347.84, 45
1, 16:11:00-000, 293, 172, 121, 117, 1347.53, 121, 1346.66, 86
1, 16:12:00-000, 514, 302, 212, 240, 1348.24, 212, 1347.45, 74
1, 16:13:00-000, 324, 159, 165, 96, 1347.48, 165, 1347.06, 32
1, 16:14:00-000, 660, 353, 307, 292, 1347.74, 307, 1347.00, 78
1, 16:15:00-000, 321, 182, 139, 126, 1346.95, 139, 1346.07, 54
1, 16:16:00-000, 614, 360, 254, 245, 1348.53, 254, 1347.56, 91
1, 16:17:00-000, 296, 155, 141, 79, 1348.82, 141, 1347.87, 82
1, 16:18:00-000, 622, 346, 276, 244, 1347.81, 276, 1347.49, 95
1, 16:19:00-000, 264, 164, 100, 112, 1347.64, 100, 1347.21, 76
1, 16:20:00-000, 609, 344, 265, 265, 1348.37, 265, 1347.72, 78
1, 16:21:00-000, 361, 187, 174, 160, 1348.56, 173, 1348.23, 64
1, 16:22:00-000, 527, 359, 168, 227, 1348.76, 169, 1348.04, 41
1, 16:23:00-000, 304, 205, 99, 112, 1347.93, 99, 1347.29, 111
1, 16:24:00-000, 633, 375, 258, 273, 1348.52, 258, 1347.65, 118
1, 16:25:00-000, 318, 205, 113, 135, 1349.98, 113, 1349.12, 77
1, 16:26:00-000, 578, 357, 221, 247, 1347.73, 221, 1347.42, 100
1, 16:27:00-000, 307, 138, 169, 112, 1347.68, 169, 1346.92, 80
1, 16:28:00-000, 571, 348, 223, 256, 1348.21, 223, 1346.64, 45
1, 16:29:00-000, 285, 142, 143, 109, 1347.74, 143, 1347.76, 44
2, 09:06:00-000, 3070, 0, 3070, 0, 0.00, 1098, 1348.25, 0
2, 09:07:00-000, 0, 0, 0, 0, 0.00, 0, 0.00, 1951
2, 09:08:00-000, 0, 0, 0, 0, 0.00, 0, 0.00, 21
2, 09:13:00-000, 3121, 1098, 2023, 1098, 1352.24, 1616, 1350.94, 0
2, 09:14:00-000, 3, 3, 0, 3, 1356.00, 38, 1356.00, 369
2, 09:15:00-000, 35, 21, 14, 21, 1355.14, 14, 1353.57, 0
2, 09:16:00-000, 171, 89, 82, 82, 1355.96, 82, 1354.84, 0
2, 09:17:00-000, 225, 116, 109, 120, 1355.60, 109, 1354.30, 3
2, 09:18:00-000, 586, 338, 248, 336, 1356.57, 248, 1353.77, 0
2, 09:19:00-000, 410, 233, 177, 222, 1359.37, 177, 1352.91, 0
2, 09:20:00-000, 841, 454, 387, 467, 1361.63, 368, 1353.81, 0
2, 09:21:00-000, 372, 197, 175, 197, 1353.90, 170, 1353.08, 0
2, 09:22:00-000, 518, 244, 274, 244, 1353.54, 278, 1352.65, 11
2, 09:23:00-000, 225, 106, 119, 106, 1353.77, 128, 1352.37, 0
2, 09:24:00-000, 545, 261, 284, 261, 1355.88, 269, 1353.05, 0
2, 09:25:00-000, 334, 151, 183, 151, 1353.89, 162, 1353.25, 0
2, 09:26:00-000, 671, 303, 368, 303, 1352.89, 335, 1351.89, 17
2, 09:27:00-000, 311, 125, 186, 125, 1353.59, 151, 1351.03, 52
2, 09:28:00-000, 716, 365, 351, 365, 1353.32, 305, 1351.49, 53
2, 09:29:00-000, 244, 89, 155, 89, 1352.26, 136, 1351.64, 25
2, 09:30:00-000, 614, 319, 295, 319, 1353.04, 293, 1352.73, 3
2, 09:31:00-000, 330, 182, 148, 182, 1355.67, 168, 1353.80, 1
2, 09:32:00-000, 555, 258, 297, 258, 1355.35, 297, 1352.96, 0
2, 09:33:00-000, 264, 145, 119, 145, 1354.24, 111, 1352.13, 0
2, 09:34:00-000, 691, 317, 374, 317, 1353.06, 332, 1351.78, 7
2, 09:35:00-000, 262, 116, 146, 116, 1354.06, 128, 1352.97, 31
2, 09:36:00-000, 628, 304, 324, 304, 1353.67, 279, 1352.24, 24
2, 09:37:00-000, 295, 128, 167, 128, 1353.31, 155, 1351.86, 36
2, 09:38:00-000, 702, 331, 371, 331, 1353.53, 314, 1351.74, 27
2, 09:39:00-000, 301, 154, 147, 154, 1353.91, 140, 1351.84, 45
2, 09:40:00-000, 558, 267, 291, 267, 1353.27, 261, 1351.84, 24
2, 09:41:00-000, 257, 113, 144, 113, 1353.01, 106, 1351.71, 17
2, 09:42:00-000, 713, 360, 353, 360, 1353.31, 320, 1352.27, 39
2, 09:43:00-000, 282, 162, 120, 162, 1354.12, 123, 1352.98, 25
2, 09:44:00-000, 611, 311, 300, 311, 1353.68, 282, 1351.95, 9
2, 09:45:00-000, 335, 126, 209, 126, 1352.77, 172, 1351.20, 11
2, 09:46:00-000, 517, 231, 286, 231, 1353.03, 265, 1351.13, 35
2, 09:47:00-000, 344, 123, 221, 123, 1353.27, 166, 1351.25, 22
2, 09:48:00-000, 667, 323, 344, 323, 1352.81, 319, 1352.26, 42
2, 09:49:00-000, 280, 116, 164, 116, 1352.67, 130, 1351.32, 49
2, 09:50:00-000, 641, 339, 302, 339, 1353.66, 274, 1352.11, 23
2, 09:51:00-000, 277, 140, 137, 140, 1353.41, 130, 1351.50, 29
2, 09:52:00-000, 636, 291, 345, 291, 1353.76, 292, 1351.75, 30
2, 09:53:00-000, 291, 111, 180, 111, 1352.62, 150, 1351.27, 23
2, 09:54:00-000, 666, 340, 326, 340, 1353.65, 288, 1351.34, 44
2, 09:55:00-000, 299, 113, 186, 113, 1353.24, 139, 1351.28, 35
2, 09:56:00-000, 590, 272, 318, 272, 1353.22, 291, 1352.15, 37
2, 09:57:00-000, 311, 174, 137, 174, 1354.24, 110, 1351.41, 33
2, 09:58:00-000, 541, 251, 290, 251, 1353.01, 232, 1351.97, 45
2, 09:59:00-000, 270, 139, 131, 139, 1353.45, 123, 1352.01, 34
2, 10:00:00-000, 650, 265, 385, 265, 1351.12, 302, 1350.48, 52
2, 10:01:00-000, 371, 161, 210, 161, 1352.50, 179, 1351.51, 41
2, 10:02:00-000, 529, 243, 286, 243, 1352.60, 229, 1351.86, 63
2, 10:03:00-000, 335, 150, 185, 150, 1352.57, 158, 1352.06, 29
2, 10:04:00-000, 650, 272, 378, 272, 1352.02, 251, 1351.01, 64
2, 10:05:00-000, 303, 147, 156, 147, 1352.55, 148, 1351.53, 61
2, 10:06:00-000, 646, 245, 401, 244, 1351.74, 299, 1350.85, 64
2, 10:07:00-000, 232, 98, 134, 99, 1352.50, 122, 1351.47, 60
2, 10:08:00-000, 563, 288, 275, 288, 1353.38, 237, 1351.67, 25
2, 10:09:00-000, 264, 117, 147, 117, 1353.06, 97, 1352.02, 40
2, 10:10:00-000, 581, 273, 308, 273, 1353.21, 254, 1351.25, 64
2, 10:11:00-000, 328, 161, 167, 161, 1353.00, 157, 1351.72, 38
2, 10:12:00-000, 683, 335, 348, 335, 1353.71, 300, 1351.60, 16
2, 10:13:00-000, 285, 107, 178, 107, 1352.74, 128, 1349.43, 53
2, 10:14:00-000, 538, 228, 310, 227, 1352.22, 211, 1350.85, 56
2, 10:15:00-000, 275, 161, 114, 161, 1353.54, 127, 1351.77, 62
2, 10:16:00-000, 598, 240, 358, 240, 1351.61, 264, 1349.85, 54
2, 10:17:00-000, 277, 106, 171, 106, 1351.68, 125, 1351.27, 51
2, 10:18:00-000, 667, 266, 401, 266, 1351.99, 285, 1351.20, 59
2, 10:19:00-000, 327, 148, 179, 148, 1351.58, 155, 1350.52, 93
2, 10:20:00-000, 555, 244, 311, 244, 1352.66, 249, 1351.44, 52
2, 10:21:00-000, 284, 149, 135, 149, 1352.72, 138, 1351.79, 27
2, 10:22:00-000, 608, 279, 329, 279, 1352.82, 260, 1350.82, 31
2, 10:23:00-000, 309, 137, 172, 137, 1353.16, 151, 1351.81, 52
2, 10:24:00-000, 644, 284, 360, 283, 1351.95, 273, 1350.77, 44
2, 10:25:00-000, 306, 122, 184, 123, 1352.35, 147, 1350.63, 46
2, 10:26:00-000, 624, 236, 388, 236, 1352.24, 288, 1351.22, 58
2, 10:27:00-000, 308, 136, 172, 136, 1352.02, 137, 1351.18, 83
2, 10:28:00-000, 613, 251, 362, 251, 1352.26, 278, 1350.93, 55
2, 10:29:00-000, 295, 133, 162, 133, 1352.70, 134, 1352.12, 67
2, 10:30:00-000, 543, 294, 249, 294, 1353.74, 231, 1351.73, 40
2, 10:31:00-000, 277, 146, 131, 146, 1354.73, 142, 1352.52, 6
2, 10:32:00-000, 652, 271, 381, 271, 1351.80, 261, 1350.99, 49
2, 10:33:00-000, 398, 185, 213, 185, 1352.88, 150, 1351.34, 70
2, 10:34:00-000, 563, 227, 336, 227, 1352.31, 258, 1350.84, 81
2, 10:35:00-000, 250, 142, 108, 142, 1354.05, 108, 1352.61, 44
2, 10:36:00-000, 601, 314, 287, 314, 1352.76, 248, 1351.68, 32
2, 10:37:00-000, 281, 124, 157, 124, 1353.14, 132, 1351.76, 22
2, 10:38:00-000, 624, 286, 338, 286, 1352.39, 271, 1351.32, 47
2, 10:39:00-000, 295, 124, 171, 124, 1353.03, 134, 1351.99, 53
2, 10:40:00-000, 646, 245, 401, 245, 1351.48, 295, 1351.02, 65
2, 10:41:00-000, 330, 117, 213, 117, 1351.84, 139, 1351.25, 77
2, 10:42:00-000, 657, 257, 400, 257, 1351.44, 271, 1350.10, 94
2, 10:43:00-000, 321, 152, 169, 152, 1352.23, 129, 1351.87, 81
2, 10:44:00-000, 583, 239, 344, 239, 1352.78, 256, 1351.03, 63
2, 10:45:00-000, 267, 103, 164, 103, 1351.83, 115, 1350.43, 78
2, 10:46:00-000, 649, 284, 365, 281, 1351.73, 287, 1350.81, 88
2, 10:47:00-000, 310, 135, 175, 138, 1352.86, 155, 1351.08, 43
2, 10:48:00-000, 658, 320, 338, 320, 1352.84, 334, 1351.94, 23
2, 10:49:00-000, 263, 115, 148, 115, 1352.64, 104, 1351.61, 9
2, 10:50:00-000, 598, 274, 324, 274, 1352.40, 248, 1351.56, 48
2, 10:51:00-000, 367, 157, 210, 157, 1351.67, 146, 1350.77, 70
2, 10:52:00-000, 631, 271, 360, 271, 1351.67, 293, 1351.18, 50
2, 10:53:00-000, 303, 127, 176, 127, 1351.88, 150, 1351.27, 65
2, 10:54:00-000, 540, 261, 279, 261, 1352.56, 251, 1351.43, 57
2, 10:55:00-000, 314, 141, 173, 141, 1354.72, 143, 1352.36, 20
2, 10:56:00-000, 664, 287, 377, 287, 1352.70, 271, 1351.50, 49
2, 10:57:00-000, 309, 102, 207, 102, 1351.16, 150, 1350.74, 76
2, 10:58:00-000, 641, 337, 304, 337, 1352.75, 242, 1351.68, 51
2, 10:59:00-000, 256, 123, 133, 123, 1353.42, 124, 1351.92, 66
2, 11:00:00-000, 612, 241, 371, 241, 1351.93, 279, 1350.81, 34
2, 11:01:00-000, 370, 152, 218, 152, 1351.59, 170, 1350.52, 70
2, 11:02:00-000, 605, 265, 340, 265, 1352.18, 267, 1350.58, 67
2, 11:03:00-000, 296, 140, 156, 140, 1352.66, 130, 1351.30, 49
2, 11:04:00-000, 579, 238, 341, 238, 1351.78, 234, 1350.93, 68
2, 11:05:00-000, 319, 165, 154, 165, 1352.51, 148, 1351.94, 59
2, 11:06:00-000, 628, 270, 358, 270, 1352.08, 235, 1350.70, 45
2, 11:07:00-000, 321, 149, 172, 149, 1352.19, 133, 1351.44, 94
2, 11:08:00-000, 701, 252, 449, 252, 1351.61, 290, 1350.59, 79
2, 11:09:00-000, 270, 110, 160, 110, 1351.87, 137, 1351.58, 101
2, 11:10:00-000, 674, 299, 375, 299, 1352.24, 306, 1351.13, 56
2, 11:11:00-000, 336, 146, 190, 146, 1352.32, 167, 1350.03, 44
2, 11:12:00-000, 631, 281, 350, 281, 1353.24, 310, 1351.53, 30
2, 11:13:00-000, 284, 126, 158, 126, 1351.93, 107, 1351.09, 53
2, 11:14:00-000, 689, 274, 415, 274, 1351.61, 300, 1350.64, 61
2, 11:15:00-000, 294, 132, 162, 132, 1351.83, 143, 1351.31, 81
2, 11:16:00-000, 570, 210, 360, 210, 1352.48, 284, 1351.23, 59
2, 11:17:00-000, 386, 204, 182, 204, 1352.95, 144, 1351.35, 62
2, 11:18:00-000, 665, 319, 346, 319, 1352.35, 281, 1351.76, 43
2, 11:19:00-000, 315, 129, 186, 129, 1352.96, 158, 1351.68, 46
2, 11:20:00-000, 628, 278, 350, 278, 1351.86, 269, 1351.16, 57
2, 11:21:00-000, 270, 102, 168, 102, 1352.12, 113, 1350.41, 58
2, 11:22:00-000, 707, 304, 403, 304, 1352.63, 331, 1350.75, 59
2, 11:23:00-000, 247, 133, 114, 133, 1353.73, 116, 1352.04, 56
2, 11:24:00-000, 621, 310, 311, 310, 1352.76, 247, 1351.77, 34
2, 11:25:00-000, 336, 122, 214, 122, 1351.87, 144, 1350.98, 49
2, 11:26:00-000, 667, 303, 364, 303, 1352.28, 304, 1351.27, 47
2, 11:27:00-000, 311, 134, 177, 134, 1351.86, 140, 1351.68, 63
2, 11:28:00-000, 677, 289, 388, 289, 1352.00, 287, 1351.60, 55
2, 11:29:00-000, 289, 162, 127, 162, 1352.16, 115, 1351.76, 69
2, 11:30:00-000, 653, 288, 365, 288, 1351.84, 282, 1351.72, 51
2, 11:31:00-000, 289, 124, 165, 124, 1352.05, 138, 1351.07, 59
2, 11:32:00-000, 563, 249, 314, 249, 1352.64, 262, 1351.59, 52
2, 11:33:00-000, 288, 132, 156, 129, 1352.60, 116, 1350.29, 28
2, 11:34:00-000, 660, 305, 355, 308, 1353.16, 289, 1351.50, 63
2, 11:35:00-000, 344, 147, 197, 147, 1352.06, 159, 1351.40, 51
2, 11:36:00-000, 597, 223, 374, 223, 1352.79, 259, 1351.73, 36
2, 11:37:00-000, 319, 164, 155, 164, 1352.41, 163, 1352.04, 63
2, 11:38:00-000, 605, 253, 352, 253, 1352.23, 277, 1350.87, 58
2, 11:39:00-000, 332, 149, 183, 149, 1352.46, 151, 1351.40, 30
2, 11:40:00-000, 673, 335, 338, 331, 1352.48, 286, 1351.30, 81
2, 11:41:00-000, 324, 145, 179, 149, 1351.68, 134, 1350.60, 46
2, 11:42:00-000, 558, 235, 323, 235, 1351.77, 232, 1351.30, 34
2, 11:43:00-000, 336, 158, 178, 158, 1351.58, 153, 1351.81, 55
2, 11:44:00-000, 624, 249, 375, 249, 1351.95, 315, 1350.79, 65
2, 11:45:00-000, 275, 139, 136, 139, 1353.40, 103, 1351.78, 57
2, 11:46:00-000, 657, 321, 336, 321, 1353.25, 277, 1351.10, 45
2, 11:47:00-000, 311, 129, 182, 129, 1351.02, 128, 1349.98, 46
2, 11:48:00-000, 629, 273, 356, 273, 1352.36, 324, 1351.41, 58
2, 11:49:00-000, 300, 158, 142, 158, 1352.66, 110, 1352.10, 33
2, 11:50:00-000, 554, 244, 310, 244, 1352.46, 246, 1351.51, 39
2, 11:51:00-000, 310, 127, 183, 127, 1352.58, 173, 1351.73, 43
2, 11:52:00-000, 670, 290, 380, 290, 1352.55, 268, 1351.35, 54
2, 11:53:00-000, 287, 172, 115, 172, 1352.73, 90, 1351.73, 80
2, 11:54:00-000, 633, 295, 338, 295, 1352.56, 282, 1351.05, 34
2, 11:55:00-000, 266, 102, 164, 102, 1351.69, 103, 1351.47, 49
2, 11:56:00-000, 599, 269, 330, 269, 1351.86, 265, 1350.77, 65
2, 11:57:00-000, 310, 127, 183, 127, 1352.53, 127, 1350.53, 61
2, 11:58:00-000, 591, 217, 374, 217, 1352.04, 271, 1351.39, 67
2, 11:59:00-000, 314, 124, 190, 124, 1351.71, 143, 1350.73, 83
2, 12:00:00-000, 608, 262, 346, 262, 1352.78, 302, 1350.34, 57
2, 12:01:00-000, 352, 113, 239, 113, 1352.05, 139, 1350.69, 37
2, 12:02:00-000, 538, 285, 253, 285, 1352.41, 209, 1352.11, 91
2, 12:03:00-000, 297, 124, 173, 124, 1351.57, 137, 1351.31, 58
2, 12:04:00-000, 673, 306, 367, 306, 1353.35, 298, 1351.89, 33
2, 12:05:00-000, 355, 131, 224, 131, 1351.32, 141, 1349.48, 63
2, 12:06:00-000, 636, 273, 363, 273, 1351.91, 245, 1350.40, 116
2, 12:07:00-000, 221, 104, 117, 104, 1352.59, 106, 1352.10, 81
2, 12:08:00-000, 646, 271, 375, 271, 1352.17, 248, 1351.32, 72
2, 12:09:00-000, 331, 151, 180, 151, 1352.53, 175, 1351.50, 53
2, 12:10:00-000, 624, 270, 354, 270, 1352.72, 285, 1351.79, 42
2, 12:11:00-000, 367, 175, 192, 175, 1352.55, 162, 1351.37, 51
2, 12:12:00-000, 612, 252, 360, 252, 1353.16, 292, 1351.01, 47
2, 12:13:00-000, 228, 91, 137, 91, 1351.34, 111, 1351.20, 46
2, 12:14:00-000, 603, 256, 347, 256, 1352.38, 272, 1350.84, 43
2, 12:15:00-000, 310, 139, 171, 139, 1351.73, 131, 1351.56, 60
2, 12:16:00-000, 686, 260, 426, 260, 1351.45, 297, 1351.13, 66
2, 12:17:00-000, 307, 154, 153, 154, 1352.57, 140, 1351.06, 96
2, 12:18:00-000, 593, 298, 295, 298, 1352.82, 229, 1351.27, 37
2, 12:19:00-000, 356, 135, 221, 135, 1352.60, 178, 1352.22, 60
2, 12:20:00-000, 530, 279, 251, 279, 1352.39, 138, 1350.74, 70
2, 12:21:00-000, 242, 102, 140, 102, 1352.74, 72, 1350.85, 92
2, 12:22:00-000, 731, 325, 406, 325, 1352.35, 294, 1350.78, 87
2, 12:23:00-000, 321, 153, 168, 153, 1352.46, 141, 1350.36, 75
2, 12:24:00-000, 554, 245, 309, 245, 1352.38, 220, 1350.98, 79
2, 12:25:00-000, 310, 109, 201, 109, 1351.67, 135, 1350.33, 54
2, 12:26:00-000, 581, 264, 317, 264, 1352.67, 230, 1351.61, 52
2, 12:27:00-000, 308, 104, 204, 104, 1351.88, 133, 1351.45, 83
2, 12:28:00-000, 540, 196, 344, 196, 1351.72, 284, 1350.80, 67
2, 12:29:00-000, 278, 95, 183, 95, 1352.21, 118, 1352.02, 58
2, 12:30:00-000, 577, 232, 345, 232, 1352.31, 283, 1350.81, 101
2, 12:31:00-000, 220, 104, 116, 104, 1353.64, 89, 1350.52, 45
2, 12:32:00-000, 632, 228, 404, 228, 1351.47, 275, 1350.66, 60
2, 12:33:00-000, 348, 131, 217, 131, 1351.96, 164, 1351.46, 89
2, 12:34:00-000, 577, 261, 316, 261, 1351.72, 258, 1350.53, 63
2, 12:35:00-000, 345, 156, 189, 156, 1353.11, 152, 1350.59, 60
2, 12:36:00-000, 595, 282, 313, 282, 1352.57, 222, 1351.24, 47
2, 12:37:00-000, 296, 141, 155, 141, 1352.91, 113, 1351.50, 82
2, 12:38:00-000, 620, 291, 329, 291, 1352.56, 239, 1351.40, 33
2, 12:39:00-000, 295, 144, 151, 144, 1354.02, 134, 1352.07, 77
2, 12:40:00-000, 576, 259, 317, 259, 1352.72, 253, 1351.31, 42
2, 12:41:00-000, 326, 150, 176, 150, 1352.18, 138, 1351.04, 46
2, 12:42:00-000, 577, 222, 355, 222, 1352.44, 278, 1351.47, 59
2, 12:43:00-000, 346, 156, 190, 156, 1352.28, 161, 1350.98, 61
2, 12:44:00-000, 555, 240, 315, 240, 1352.66, 278, 1351.07, 40
2, 12:45:00-000, 271, 108, 163, 108, 1351.72, 125, 1351.07, 36
2, 12:46:00-000, 623, 262, 361, 262, 1352.16, 273, 1351.40, 52
2, 12:47:00-000, 329, 119, 210, 119, 1351.84, 160, 1350.91, 60
2, 12:48:00-000, 668, 305, 363, 305, 1352.36, 294, 1351.19, 83
2, 12:49:00-000, 329, 156, 173, 156, 1351.86, 139, 1351.27, 45
2, 12:50:00-000, 591, 255, 336, 255, 1352.11, 236, 1350.54, 56
2, 12:51:00-000, 277, 102, 175, 102, 1351.62, 147, 1350.94, 60
2, 12:52:00-000, 608, 258, 350, 258, 1351.30, 256, 1350.89, 31
2, 12:53:00-000, 286, 140, 146, 140, 1351.93, 144, 1350.53, 72
2, 12:54:00-000, 581, 273, 308, 273, 1352.70, 265, 1351.69, 40
2, 12:55:00-000, 258, 127, 131, 127, 1353.10, 115, 1351.97, 31
2, 12:56:00-000, 684, 311, 373, 311, 1352.21, 274, 1351.76, 54
2, 12:57:00-000, 323, 131, 192, 131, 1352.77, 143, 1350.97, 55
2, 12:58:00-000, 657, 266, 391, 266, 1352.09, 275, 1351.45, 95
2, 12:59:00-000, 315, 149, 166, 149, 1353.69, 154, 1351.59, 59
2, 13:00:00-000, 572, 259, 313, 259, 1351.96, 244, 1351.57, 49
2, 13:01:00-000, 317, 122, 195, 122, 1353.79, 164, 1351.45, 39
2, 13:02:00-000, 716, 291, 425, 291, 1351.41, 313, 1350.10, 81
2, 13:03:00-000, 376, 191, 185, 191, 1353.05, 188, 1351.77, 47
2, 13:04:00-000, 537, 261, 276, 261, 1352.69, 264, 1351.10, 28
2, 13:05:00-000, 356, 132, 224, 132, 1352.00, 155, 1351.08, 20
2, 13:06:00-000, 647, 261, 386, 261, 1352.23, 309, 1350.78, 68
2, 13:07:00-000, 328, 156, 172, 156, 1350.38, 147, 1350.50, 59
2, 13:08:00-000, 670, 332, 338, 332, 1353.09, 267, 1351.41, 49
2, 13:09:00-000, 299, 114, 185, 114, 1351.53, 152, 1350.50, 65
2, 13:10:00-000, 575, 306, 269, 306, 1352.96, 241, 1350.78, 29
2, 13:11:00-000, 301, 138, 163, 138, 1354.41, 142, 1351.98, 23
2, 13:12:00-000, 618, 266, 352, 266, 1352.76, 288, 1351.71, 30
2, 13:13:00-000, 356, 148, 208, 148, 1353.61, 179, 1351.33, 59
2, 13:14:00-000, 722, 329, 393, 329, 1352.14, 323, 1351.64, 37
2, 13:15:00-000, 285, 109, 176, 109, 1351.97, 133, 1351.36, 57
2, 13:16:00-000, 594, 263, 331, 263, 1352.08, 262, 1351.15, 47
2, 13:17:00-000, 345, 177, 168, 177, 1351.65, 123, 1350.16, 67
2, 13:18:00-000, 667, 295, 372, 295, 1352.38, 273, 1351.49, 58
2, 13:19:00-000, 293, 132, 161, 131, 1352.16, 144, 1352.31, 54
2, 13:20:00-000, 598, 272, 326, 271, 1351.59, 249, 1350.75, 58
2, 13:21:00-000, 354, 156, 198, 158, 1351.83, 172, 1351.56, 74
2, 13:22:00-000, 580, 229, 351, 229, 1353.06, 263, 1351.69, 40
2, 13:23:00-000, 290, 137, 153, 137, 1352.76, 125, 1351.52, 53
2, 13:24:00-000, 661, 321, 340, 321, 1352.32, 249, 1350.93, 68
2, 13:25:00-000, 333, 129, 204, 129, 1352.24, 151, 1350.72, 67
2, 13:26:00-000, 669, 287, 382, 287, 1351.77, 270, 1350.45, 74
2, 13:27:00-000, 321, 142, 179, 142, 1352.06, 164, 1351.24, 80
2, 13:28:00-000, 619, 270, 349, 270, 1352.53, 249, 1351.11, 56
2, 13:29:00-000, 321, 148, 173, 148, 1351.81, 139, 1351.16, 67
2, 13:30:00-000, 714, 244, 470, 244, 1351.21, 336, 1350.75, 60
2, 13:31:00-000, 345, 160, 185, 160, 1352.30, 158, 1352.20, 80
2, 13:32:00-000, 667, 251, 416, 251, 1352.25, 331, 1350.87, 68
2, 13:33:00-000, 345, 160, 185, 160, 1351.31, 120, 1350.16, 73
2, 13:34:00-000, 656, 303, 353, 303, 1352.68, 266, 1350.71, 77
2, 13:35:00-000, 273, 126, 147, 126, 1352.53, 107, 1351.63, 80
2, 13:36:00-000, 694, 345, 349, 345, 1352.96, 276, 1351.43, 44
2, 13:37:00-000, 327, 142, 185, 142, 1352.14, 135, 1351.22, 66
2, 13:38:00-000, 655, 277, 378, 277, 1352.12, 275, 1351.60, 71
2, 13:39:00-000, 254, 87, 167, 87, 1351.80, 101, 1350.76, 70
2, 13:40:00-000, 641, 294, 347, 294, 1352.03, 280, 1351.03, 83
2, 13:41:00-000, 337, 145, 192, 145, 1352.86, 167, 1351.84, 42
2, 13:42:00-000, 659, 281, 378, 281, 1351.86, 297, 1350.60, 66
2, 13:43:00-000, 371, 161, 210, 161, 1353.00, 158, 1352.22, 53
2, 13:44:00-000, 619, 238, 381, 238, 1351.51, 265, 1350.72, 94
2, 13:45:00-000, 300, 132, 168, 128, 1351.90, 129, 1350.93, 62
2, 13:46:00-000, 770, 307, 463, 308, 1352.11, 343, 1350.74, 81
2, 13:47:00-000, 290, 151, 139, 151, 1352.53, 134, 1351.60, 62
2, 13:48:00-000, 630, 296, 334, 296, 1352.99, 279, 1351.32, 68
2, 13:49:00-000, 290, 126, 164, 126, 1352.65, 116, 1351.55, 39
2, 13:50:00-000, 626, 293, 333, 293, 1352.71, 243, 1351.44, 74
2, 13:51:00-000, 297, 144, 153, 144, 1351.16, 113, 1351.36, 59
2, 13:52:00-000, 564, 253, 311, 253, 1352.55, 228, 1350.98, 60
2, 13:53:00-000, 335, 133, 202, 133, 1351.83, 138, 1350.92, 63
2, 13:54:00-000, 611, 252, 359, 252, 1352.43, 257, 1351.42, 65
2, 13:55:00-000, 295, 118, 177, 118, 1351.49, 109, 1350.91, 98
2, 13:56:00-000, 671, 288, 383, 288, 1352.34, 313, 1351.56, 71
2, 13:57:00-000, 287, 113, 174, 113, 1353.04, 97, 1351.24, 71
2, 13:58:00-000, 583, 280, 303, 280, 1352.38, 275, 1351.84, 65
2, 13:59:00-000, 281, 139, 142, 139, 1351.88, 107, 1351.28, 35
2, 14:00:00-000, 619, 271, 348, 271, 1351.88, 280, 1351.42, 43
2, 14:01:00-000, 336, 145, 191, 145, 1352.23, 134, 1351.38, 57
2, 14:02:00-000, 581, 218, 363, 218, 1352.29, 260, 1351.00, 67
2, 14:03:00-000, 342, 145, 197, 145, 1351.82, 182, 1352.09, 72
2, 14:04:00-000, 624, 242, 382, 242, 1352.57, 267, 1351.09, 68
2, 14:05:00-000, 326, 121, 205, 121, 1352.50, 164, 1351.32, 88
2, 14:06:00-000, 642, 257, 385, 257, 1351.54, 278, 1350.48, 66
2, 14:07:00-000, 318, 157, 161, 157, 1352.18, 128, 1351.09, 71
2, 14:08:00-000, 694, 276, 418, 276, 1352.52, 341, 1351.51, 52
2, 14:09:00-000, 314, 118, 196, 118, 1352.68, 141, 1351.36, 71
2, 14:10:00-000, 654, 288, 366, 288, 1352.25, 264, 1350.91, 78
2, 14:11:00-000, 325, 165, 160, 165, 1352.97, 143, 1351.30, 62
2, 14:12:00-000, 614, 272, 342, 272, 1351.58, 249, 1350.87, 53
2, 14:13:00-000, 341, 146, 195, 146, 1352.92, 134, 1350.94, 53
2, 14:14:00-000, 716, 338, 378, 338, 1352.36, 330, 1351.15, 73
2, 14:15:00-000, 369, 159, 210, 159, 1351.94, 162, 1352.05, 56
2, 14:16:00-000, 631, 247, 384, 244, 1351.66, 318, 1350.69, 35
2, 14:17:00-000, 305, 119, 186, 122, 1352.17, 154, 1351.34, 61
2, 14:18:00-000, 583, 307, 276, 307, 1353.02, 238, 1351.26, 46
2, 14:19:00-000, 332, 133, 199, 133, 1351.89, 134, 1350.43, 49
2, 14:20:00-000, 579, 283, 296, 282, 1352.60, 275, 1351.93, 41
2, 14:21:00-000, 380, 204, 176, 205, 1353.43, 147, 1351.66, 45
2, 14:22:00-000, 671, 288, 383, 288, 1352.67, 309, 1351.84, 37
2, 14:23:00-000, 315, 106, 209, 106, 1351.82, 146, 1350.57, 56
2, 14:24:00-000, 568, 290, 278, 290, 1352.78, 268, 1351.84, 43
2, 14:25:00-000, 307, 132, 175, 132, 1352.56, 126, 1351.94, 26
2, 14:26:00-000, 598, 253, 345, 253, 1352.44, 236, 1351.29, 57
2, 14:27:00-000, 274, 130, 144, 130, 1353.09, 125, 1351.79, 86
2, 14:28:00-000, 649, 295, 354, 295, 1353.50, 313, 1352.28, 40
2, 14:29:00-000, 255, 105, 150, 105, 1352.37, 73, 1350.81, 37
2, 14:30:00-000, 627, 306, 321, 306, 1352.39, 276, 1350.51, 83
2, 14:31:00-000, 340, 140, 200, 140, 1352.72, 143, 1351.15, 34
2, 14:32:00-000, 626, 278, 348, 278, 1352.48, 284, 1351.73, 59
2, 14:33:00-000, 286, 163, 123, 163, 1354.94, 147, 1353.47, 43
2, 14:34:00-000, 631, 252, 379, 252, 1351.72, 269, 1351.27, 29
2, 14:35:00-000, 295, 118, 177, 118, 1352.67, 135, 1351.62, 72
2, 14:36:00-000, 627, 226, 401, 226, 1352.17, 287, 1351.18, 89
2, 14:37:00-000, 307, 160, 147, 160, 1353.34, 132, 1351.90, 63
2, 14:38:00-000, 595, 281, 314, 281, 1352.91, 236, 1351.15, 49
2, 14:39:00-000, 311, 142, 169, 142, 1352.58, 147, 1351.82, 50
2, 14:40:00-000, 629, 292, 337, 292, 1352.55, 298, 1351.70, 34
2, 14:41:00-000, 312, 145, 167, 145, 1352.05, 110, 1351.48, 29
2, 14:42:00-000, 637, 282, 355, 282, 1351.83, 302, 1350.83, 54
2, 14:43:00-000, 305, 136, 169, 136, 1351.91, 124, 1350.46, 60
2, 14:44:00-000, 559, 236, 323, 236, 1350.93, 234, 1349.76, 75
2, 14:45:00-000, 293, 110, 183, 110, 1351.61, 127, 1351.08, 64
2, 14:46:00-000, 658, 293, 365, 293, 1352.47, 258, 1351.62, 63
2, 14:47:00-000, 359, 146, 213, 146, 1351.98, 157, 1350.75, 93
2, 14:48:00-000, 628, 274, 354, 274, 1352.59, 295, 1351.44, 63
2, 14:49:00-000, 312, 129, 183, 129, 1351.69, 148, 1350.82, 40
2, 14:50:00-000, 559, 219, 340, 219, 1352.00, 290, 1351.34, 42
2, 14:51:00-000, 278, 115, 163, 113, 1351.90, 125, 1351.29, 56
2, 14:52:00-000, 682, 308, 374, 310, 1352.09, 315, 1350.57, 46
2, 14:53:00-000, 320, 165, 155, 165, 1353.35, 155, 1351.70, 40
2, 14:54:00-000, 619, 301, 318, 301, 1352.42, 245, 1351.74, 28
2, 14:55:00-000, 297, 137, 160, 137, 1353.16, 153, 1351.68, 35
2, 14:56:00-000, 615, 289, 326, 289, 1353.62, 270, 1351.37, 65
2, 14:57:00-000, 316, 119, 197, 119, 1352.39, 139, 1350.70, 32
2, 14:58:00-000, 638, 289, 349, 289, 1352.60, 229, 1352.03, 49
2, 14:59:00-000, 389, 173, 216, 173, 1353.39, 183, 1351.90, 64
2, 15:00:00-000, 622, 293, 329, 293, 1351.99, 292, 1351.16, 78
2, 15:01:00-000, 313, 133, 180, 133, 1353.11, 156, 1351.91, 42
2, 15:02:00-000, 662, 262, 400, 262, 1352.26, 275, 1350.72, 55
2, 15:03:00-000, 290, 134, 156, 133, 1353.02, 150, 1350.46, 69
2, 15:04:00-000, 595, 255, 340, 256, 1351.86, 224, 1351.26, 77
2, 15:05:00-000, 308, 135, 173, 135, 1352.73, 148, 1351.99, 55
2, 15:06:00-000, 662, 272, 390, 272, 1352.03, 275, 1350.87, 64
2, 15:07:00-000, 297, 142, 155, 142, 1351.51, 134, 1350.85, 80
2, 15:08:00-000, 604, 261, 343, 261, 1351.89, 219, 1350.84, 75
2, 15:09:00-000, 306, 112, 194, 112, 1352.36, 149, 1350.51, 73
2, 15:10:00-000, 584, 259, 325, 259, 1351.75, 250, 1351.02, 67
2, 15:11:00-000, 304, 139, 165, 139, 1352.24, 146, 1351.22, 69
2, 15:12:00-000, 623, 268, 355, 268, 1352.24, 265, 1350.97, 42
2, 15:13:00-000, 380, 179, 201, 179, 1352.98, 171, 1351.96, 34
2, 15:14:00-000, 666, 281, 385, 281, 1351.98, 267, 1350.76, 83
2, 15:15:00-000, 312, 125, 187, 125, 1351.84, 156, 1350.83, 77
2, 15:16:00-000, 567, 270, 297, 270, 1353.24, 235, 1351.81, 75
2, 15:17:00-000, 305, 120, 185, 120, 1352.23, 154, 1351.27, 24
2, 15:18:00-000, 646, 332, 314, 332, 1353.05, 247, 1351.83, 36
2, 15:19:00-000, 283, 80, 203, 80, 1350.45, 119, 1349.80, 67
2, 15:20:00-000, 570, 258, 312, 258, 1352.09, 254, 1351.39, 72
2, 15:21:00-000, 330, 151, 179, 151, 1352.20, 143, 1352.10, 62
2, 15:22:00-000, 659, 284, 375, 284, 1352.32, 269, 1350.90, 72
2, 15:23:00-000, 321, 127, 194, 127, 1351.97, 146, 1351.47, 61
2, 15:24:00-000, 652, 267, 385, 267, 1352.37, 300, 1351.40, 78
2, 15:25:00-000, 326, 143, 183, 143, 1352.26, 155, 1351.37, 72
2, 15:26:00-000, 627, 241, 386, 241, 1352.03, 275, 1350.85, 74
2, 15:27:00-000, 385, 171, 214, 171, 1353.08, 165, 1350.77, 59
2, 15:28:00-000, 620, 268, 352, 268, 1352.60, 307, 1351.54, 68
2, 15:29:00-000, 291, 129, 162, 129, 1352.51, 132, 1350.94, 42
2, 15:30:00-000, 652, 277, 375, 277, 1353.02, 311, 1350.97, 44
2, 15:31:00-000, 306, 161, 145, 161, 1352.62, 135, 1352.21, 51
2, 15:32:00-000, 675, 259, 416, 259, 1351.90, 270, 1351.20, 44
2, 15:33:00-000, 320, 132, 188, 132, 1352.47, 168, 1352.12, 77
2, 15:34:00-000, 601, 283, 318, 283, 1352.56, 235, 1351.05, 59
2, 15:35:00-000, 258, 158, 100, 158, 1354.43, 91, 1352.40, 67
2, 15:36:00-000, 598, 271, 327, 271, 1353.30, 249, 1351.44, 39
2, 15:37:00-000, 301, 111, 190, 111, 1351.78, 149, 1350.61, 46
2, 15:38:00-000, 677, 352, 325, 352, 1352.43, 277, 1351.38, 48
2, 15:39:00-000, 348, 159, 189, 159, 1352.82, 161, 1351.31, 39
2, 15:40:00-000, 630, 270, 360, 270, 1351.96, 210, 1350.45, 90
2, 15:41:00-000, 300, 105, 195, 105, 1351.76, 105, 1351.02, 92
2, 15:42:00-000, 600, 251, 349, 251, 1351.71, 193, 1350.70, 119
2, 15:43:00-000, 336, 105, 231, 105, 1351.21, 113, 1350.10, 135
2, 15:44:00-000, 618, 257, 361, 257, 1352.44, 252, 1351.29, 133
2, 15:45:00-000, 301, 149, 152, 149, 1351.94, 114, 1351.35, 85
2, 15:46:00-000, 624, 264, 360, 264, 1352.47, 241, 1351.01, 68
2, 15:47:00-000, 299, 95, 204, 95, 1351.24, 144, 1350.12, 97
2, 15:48:00-000, 608, 227, 381, 227, 1352.21, 258, 1350.62, 93
2, 15:49:00-000, 322, 132, 190, 132, 1352.00, 136, 1350.33, 85
2, 15:50:00-000, 590, 229, 361, 229, 1351.70, 244, 1350.06, 88
2, 15:51:00-000, 309, 112, 197, 112, 1351.58, 160, 1350.42, 75
2, 15:52:00-000, 598, 263, 335, 263, 1352.60, 266, 1351.17, 63
2, 15:53:00-000, 331, 106, 225, 106, 1351.52, 114, 1350.72, 52
2, 15:54:00-000, 623, 280, 343, 280, 1351.90, 258, 1350.72, 134
2, 15:55:00-000, 246, 104, 142, 104, 1351.21, 106, 1350.53, 57
2, 15:56:00-000, 532, 249, 283, 249, 1352.75, 245, 1351.21, 53
2, 15:57:00-000, 313, 121, 192, 121, 1351.71, 139, 1350.18, 39
2, 15:58:00-000, 652, 263, 389, 263, 1351.45, 275, 1350.73, 64
2, 15:59:00-000, 273, 123, 150, 123, 1352.52, 116, 1350.92, 81
2, 16:00:00-000, 632, 268, 364, 268, 1352.34, 277, 1351.51, 56
2, 16:01:00-000, 310, 150, 160, 150, 1353.11, 141, 1352.04, 63
2, 16:02:00-000, 633, 270, 363, 270, 1353.07, 250, 1351.12, 51
2, 16:03:00-000, 330, 163, 167, 163, 1352.65, 124, 1351.55, 80
2, 16:04:00-000, 593, 220, 373, 220, 1351.47, 277, 1351.08, 69
2, 16:05:00-000, 272, 117, 155, 117, 1351.91, 126, 1351.29, 76
2, 16:06:00-000, 633, 246, 387, 246, 1351.49, 296, 1351.01, 49
2, 16:07:00-000, 332, 158, 174, 158, 1352.76, 154, 1351.43, 66
2, 16:08:00-000, 651, 280, 371, 280, 1352.34, 269, 1351.56, 63
2, 16:09:00-000, 307, 156, 151, 156, 1352.80, 121, 1352.16, 62
2, 16:10:00-000, 567, 238, 329, 238, 1353.10, 252, 1351.23, 52
2, 16:11:00-000, 432, 170, 262, 170, 1351.68, 185, 1351.49, 53
2, 16:12:00-000, 624, 277, 347, 277, 1352.79, 277, 1351.21, 85
2, 16:13:00-000, 274, 104, 170, 104, 1351.18, 114, 1350.32, 72
2, 16:14:00-000, 692, 279, 413, 279, 1352.12, 279, 1351.17, 80
2, 16:15:00-000, 243, 94, 149, 94, 1351.38, 115, 1350.12, 101
2, 16:16:00-000, 594, 261, 333, 261, 1351.99, 266, 1351.34, 55
2, 16:17:00-000, 326, 168, 158, 168, 1352.19, 113, 1351.68, 56
2, 16:18:00-000, 612, 276, 336, 276, 1352.36, 214, 1351.15, 59
2, 16:19:00-000, 355, 152, 203, 152, 1351.95, 134, 1350.99, 86
2, 16:20:00-000, 650, 252, 398, 252, 1352.47, 315, 1351.78, 87
2, 16:21:00-000, 321, 175, 146, 175, 1352.71, 136, 1352.07, 71
2, 16:22:00-000, 543, 242, 301, 242, 1352.39, 251, 1351.09, 42
2, 16:23:00-000, 350, 104, 246, 104, 1351.53, 124, 1350.98, 37
2, 16:24:00-000, 615, 273, 342, 273, 1352.51, 293, 1351.69, 92
2, 16:25:00-000, 317, 146, 171, 146, 1353.72, 157, 1352.28, 67
2, 16:26:00-000, 623, 269, 354, 269, 1352.11, 285, 1350.91, 33
2, 16:27:00-000, 330, 134, 196, 134, 1351.84, 135, 1351.78, 71
2, 16:28:00-000, 519, 207, 312, 207, 1352.02, 205, 1349.88, 101
2, 16:29:00-000, 364, 163, 201, 163, 1351.48, 156, 1350.85, 48
3, 09:00:00-000, 219, 201, 18, 1, 1349.00, 1, 1349.00, 214
3, 09:01:00-000, 207, 207, 0, 0, 0.00, 0, 0.00, 200
3, 09:02:00-000, 217, 217, 0, 0, 0.00, 0, 0.00, 209
3, 09:03:00-000, 192, 192, 0, 0, 0.00, 0, 0.00, 206
3, 09:04:00-000, 219, 219, 0, 0, 0.00, 0, 0.00, 223
3, 09:05:00-000, 199, 199, 0, 0, 0.00, 0, 0.00, 188
3, 09:06:00-000, 218, 218, 0, 0, 0.00, 0, 0.00, 221
3, 09:07:00-000, 203, 203, 0, 0, 0.00, 0, 0.00, 206
3, 09:08:00-000, 185, 185, 0, 2, 1353.00, 0, 0.00, 183
3, 09:09:00-000, 192, 192, 0, 0, 0.00, 0, 0.00, 195
3, 09:10:00-000, 182, 182, 0, 0, 0.00, 0, 0.00, 182
3, 09:11:00-000, 212, 212, 0, 0, 0.00, 0, 0.00, 214
3, 09:12:00-000, 207, 207, 0, 0, 0.00, 0, 0.00, 205
3, 09:13:00-000, 207, 206, 1, 2, 1349.00, 1, 1355.00, 202
3, 09:14:00-000, 210, 202, 8, 3, 1354.67, 0, 0.00, 205
3, 09:15:00-000, 206, 204, 2, 0, 0.00, 1, 1356.00, 199
3, 09:16:00-000, 190, 186, 4, 14, 1359.14, 2, 1365.00, 180
3, 09:17:00-000, 190, 172, 18, 14, 1361.28, 7, 1354.00, 175
3, 09:18:00-000, 170, 164, 6, 3, 1351.00, 4, 1362.25, 160
3, 09:19:00-000, 179, 174, 5, 7, 1373.57, 2, 1382.00, 164
3, 09:20:00-000, 228, 199, 29, 11, 1377.18, 4, 1351.75, 213
3, 09:21:00-000, 217, 202, 15, 4, 1350.00, 7, 1350.86, 204
3, 09:22:00-000, 205, 185, 20, 11, 1349.00, 2, 1351.00, 201
3, 09:23:00-000, 167, 150, 17, 3, 1355.33, 9, 1362.11, 146
3, 09:24:00-000, 174, 146, 28, 15, 1354.07, 14, 1352.64, 149
3, 09:25:00-000, 198, 192, 6, 2, 1350.00, 2, 1350.50, 193
3, 09:26:00-000, 187, 165, 22, 7, 1348.14, 3, 1352.00, 179
3, 09:27:00-000, 206, 185, 21, 2, 1350.00, 3, 1350.00, 206
3, 09:28:00-000, 211, 171, 40, 15, 1349.20, 3, 1350.67, 189
3, 09:29:00-000, 185, 154, 31, 2, 1351.00, 6, 1351.50, 173
3, 09:30:00-000, 202, 168, 34, 12, 1350.67, 11, 1352.09, 187
3, 09:31:00-000, 216, 173, 43, 16, 1352.25, 20, 1354.45, 171
3, 09:32:00-000, 203, 111, 92, 14, 1351.00, 4, 1350.25, 187
3, 09:33:00-000, 234, 130, 104, 4, 1349.75, 17, 1353.70, 218
3, 09:34:00-000, 202, 138, 64, 10, 1349.60, 8, 1352.50, 182
3, 09:35:00-000, 210, 155, 55, 10, 1350.50, 21, 1352.71, 183
3, 09:36:00-000, 231, 190, 41, 8, 1349.25, 5, 1351.00, 214
3, 09:37:00-000, 218, 183, 35, 3, 1352.00, 10, 1354.90, 208
3, 09:38:00-000, 204, 169, 35, 11, 1348.54, 7, 1351.57, 175
3, 09:39:00-000, 194, 152, 42, 5, 1351.20, 10, 1352.00, 190
3, 09:40:00-000, 229, 207, 22, 10, 1348.90, 5, 1352.80, 202
3, 09:41:00-000, 221, 211, 10, 12, 1348.50, 1, 1351.00, 215
3, 09:42:00-000, 185, 166, 19, 14, 1350.28, 8, 1351.75, 167
3, 09:43:00-000, 202, 185, 17, 0, 0.00, 6, 1351.17, 195
3, 09:44:00-000, 217, 181, 36, 6, 1348.83, 1, 1351.00, 210
3, 09:45:00-000, 194, 163, 31, 7, 1351.57, 17, 1353.82, 165
3, 09:46:00-000, 225, 202, 23, 21, 1349.81, 5, 1354.00, 206
3, 09:47:00-000, 195, 160, 35, 8, 1352.25, 5, 1351.80, 176
3, 09:48:00-000, 196, 161, 35, 5, 1349.00, 6, 1350.83, 187
3, 09:49:00-000, 183, 136, 47, 12, 1348.17, 8, 1351.25, 163
3, 09:50:00-000, 220, 150, 70, 7, 1346.86, 13, 1351.46, 204
3, 09:51:00-000, 183, 134, 49, 7, 1348.29, 14, 1351.00, 160
3, 09:52:00-000, 234, 177, 57, 4, 1348.75, 11, 1351.09, 222
3, 09:53:00-000, 202, 185, 17, 3, 1346.33, 3, 1350.67, 194
3, 09:54:00-000, 213, 169, 44, 20, 1349.35, 10, 1353.00, 185
3, 09:55:00-000, 190, 129, 61, 3, 1349.00, 6, 1350.50, 173
3, 09:56:00-000, 162, 114, 48, 7, 1348.71, 10, 1351.60, 150
3, 09:57:00-000, 203, 130, 73, 6, 1347.33, 2, 1356.00, 196
3, 09:58:00-000, 198, 157, 41, 14, 1348.29, 11, 1352.91, 167
3, 09:59:00-000, 216, 149, 67, 2, 1352.50, 14, 1352.43, 199
3, 10:00:00-000, 197, 156, 41, 14, 1347.71, 10, 1351.80, 175
3, 10:01:00-000, 205, 145, 60, 11, 1347.91, 12, 1351.75, 186
3, 10:02:00-000, 171, 137, 34, 13, 1348.92, 9, 1350.67, 141
3, 10:03:00-000, 229, 164, 65, 9, 1350.55, 13, 1353.54, 211
3, 10:04:00-000, 190, 119, 71, 12, 1349.50, 9, 1350.11, 166
3, 10:05:00-000, 186, 146, 40, 4, 1347.25, 4, 1349.25, 189
3, 10:06:00-000, 197, 152, 45, 5, 1346.40, 14, 1351.50, 171
3, 10:07:00-000, 191, 179, 12, 4, 1349.25, 0, 0.00, 190
3, 10:08:00-000, 213, 177, 36, 4, 1349.50, 5, 1350.00, 206
3, 10:09:00-000, 198, 185, 13, 3, 1350.00, 2, 1351.00, 191
3, 10:10:00-000, 188, 164, 24, 9, 1348.78, 2, 1351.00, 175
3, 10:11:00-000, 200, 161, 39, 1, 1349.00, 1, 1350.00, 194
3, 10:12:00-000, 196, 137, 59, 8, 1348.00, 7, 1350.86, 178
3, 10:13:00-000, 176, 152, 24, 4, 1349.25, 9, 1351.00, 172
3, 10:14:00-000, 214, 190, 24, 8, 1349.87, 6, 1352.00, 199
3, 10:15:00-000, 222, 190, 32, 8, 1348.75, 1, 1352.00, 216
3, 10:16:00-000, 216, 151, 65, 5, 1346.20, 13, 1351.23, 193
3, 10:17:00-000, 192, 153, 39, 7, 1349.29, 13, 1352.77, 179
3, 10:18:00-000, 208, 171, 37, 19, 1349.10, 15, 1351.20, 174
3, 10:19:00-000, 218, 189, 29, 3, 1349.67, 8, 1352.62, 194
3, 10:20:00-000, 199, 131, 68, 26, 1347.15, 21, 1351.33, 162
3, 10:21:00-000, 187, 159, 28, 5, 1349.40, 10, 1352.30, 172
3, 10:22:00-000, 215, 185, 30, 10, 1348.90, 6, 1352.00, 193
3, 10:23:00-000, 202, 166, 36, 3, 1350.00, 4, 1355.25, 203
3, 10:24:00-000, 181, 145, 36, 9, 1351.78, 2, 1351.00, 168
3, 10:25:00-000, 180, 114, 66, 7, 1348.86, 2, 1351.00, 173
3, 10:26:00-000, 162, 109, 53, 15, 1347.47, 13, 1351.15, 133
3, 10:27:00-000, 254, 206, 48, 2, 1347.00, 14, 1351.00, 230
3, 10:28:00-000, 193, 147, 46, 7, 1348.86, 8, 1352.00, 180
3, 10:29:00-000, 199, 162, 37, 12, 1348.17, 10, 1351.70, 177
3, 10:30:00-000, 211, 171, 40, 21, 1350.52, 14, 1353.35, 169
3, 10:31:00-000, 219, 150, 69, 8, 1351.37, 10, 1352.10, 215
3, 10:32:00-000, 190, 133, 57, 18, 1346.11, 9, 1350.44, 155
3, 10:33:00-000, 224, 137, 87, 9, 1348.11, 9, 1349.78, 208
3, 10:34:00-000, 184, 107, 77, 13, 1349.31, 11, 1353.18, 165
3, 10:35:00-000, 208, 106, 102, 2, 1351.00, 14, 1350.21, 188
3, 10:36:00-000, 203, 156, 47, 2, 1346.50, 14, 1350.64, 189
3, 10:37:00-000, 186, 161, 25, 12, 1347.00, 2, 1351.00, 167
3, 10:38:00-000, 220, 185, 35, 13, 1351.15, 14, 1351.00, 201
3, 10:39:00-000, 179, 120, 59, 8, 1347.37, 4, 1352.75, 166
3, 10:40:00-000, 200, 128, 72, 10, 1349.00, 10, 1352.20, 175
3, 10:41:00-000, 217, 139, 78, 3, 1348.00, 8, 1351.50, 203
3, 10:42:00-000, 194, 122, 72, 19, 1347.95, 3, 1350.00, 179
3, 10:43:00-000, 197, 104, 93, 5, 1345.20, 5, 1349.00, 185
3, 10:44:00-000, 178, 75, 103, 7, 1347.71, 2, 1350.00, 173
3, 10:45:00-000, 198, 86, 112, 0, 0.00, 6, 1348.00, 186
3, 10:46:00-000, 190, 116, 74, 2, 1348.50, 14, 1351.00, 178
3, 10:47:00-000, 221, 164, 57, 12, 1350.58, 18, 1351.33, 187
3, 10:48:00-000, 187, 166, 21, 6, 1351.00, 11, 1351.09, 168
3, 10:49:00-000, 225, 208, 17, 8, 1349.37, 9, 1350.55, 217
3, 10:50:00-000, 196, 184, 12, 8, 1347.63, 1, 1350.00, 183
3, 10:51:00-000, 211, 187, 24, 5, 1347.00, 6, 1352.50, 202
3, 10:52:00-000, 185, 149, 36, 6, 1348.67, 6, 1351.00, 172
3, 10:53:00-000, 215, 145, 70, 11, 1348.36, 0, 0.00, 199
3, 10:54:00-000, 198, 144, 54, 3, 1349.33, 10, 1350.90, 186
3, 10:55:00-000, 188, 135, 53, 4, 1348.75, 7, 1351.57, 178
3, 10:56:00-000, 239, 161, 78, 22, 1348.68, 11, 1350.82, 211
3, 10:57:00-000, 202, 144, 58, 4, 1346.25, 11, 1350.82, 174
3, 10:58:00-000, 193, 144, 49, 8, 1347.37, 3, 1348.67, 190
3, 10:59:00-000, 226, 151, 75, 6, 1350.17, 10, 1354.30, 212
3, 11:00:00-000, 171, 100, 71, 10, 1347.30, 9, 1351.11, 146
3, 11:01:00-000, 191, 117, 74, 1, 1348.00, 4, 1351.25, 195
3, 11:02:00-000, 183, 142, 41, 16, 1347.37, 6, 1350.33, 148
3, 11:03:00-000, 187, 125, 62, 1, 1350.00, 12, 1351.33, 185
3, 11:04:00-000, 197, 161, 36, 10, 1347.70, 7, 1351.14, 173
3, 11:05:00-000, 206, 143, 63, 18, 1348.22, 11, 1350.45, 179
3, 11:06:00-000, 217, 163, 54, 3, 1348.67, 10, 1351.20, 201
3, 11:07:00-000, 189, 156, 33, 10, 1350.00, 12, 1352.00, 173
3, 11:08:00-000, 199, 167, 32, 16, 1348.18, 9, 1352.22, 174
3, 11:09:00-000, 195, 148, 47, 20, 1349.85, 9, 1351.67, 170
3, 11:10:00-000, 184, 122, 62, 13, 1346.85, 13, 1350.92, 155
3, 11:11:00-000, 162, 109, 53, 4, 1346.50, 8, 1351.50, 148
3, 11:12:00-000, 194, 128, 66, 2, 1347.00, 10, 1351.90, 182
3, 11:13:00-000, 206, 132, 74, 18, 1346.78, 10, 1350.50, 177
3, 11:14:00-000, 227, 101, 126, 17, 1346.41, 21, 1351.28, 189
3, 11:15:00-000, 191, 95, 96, 6, 1347.17, 1, 1351.00, 183
3, 11:16:00-000, 184, 105, 79, 12, 1348.33, 18, 1351.22, 153
3, 11:17:00-000, 180, 111, 69, 21, 1350.33, 15, 1351.26, 152
3, 11:18:00-000, 186, 125, 61, 4, 1348.00, 14, 1350.64, 159
3, 11:19:00-000, 205, 143, 62, 4, 1351.75, 22, 1352.45, 185
3, 11:20:00-000, 202, 145, 57, 11, 1347.36, 6, 1351.83, 189
3, 11:21:00-000, 192, 153, 39, 8, 1348.00, 4, 1351.00, 178
3, 11:22:00-000, 200, 135, 65, 22, 1346.63, 6, 1351.67, 172
3, 11:23:00-000, 196, 106, 90, 5, 1349.00, 5, 1350.60, 181
3, 11:24:00-000, 207, 141, 66, 13, 1348.31, 19, 1352.16, 180
3, 11:25:00-000, 188, 152, 36, 10, 1347.70, 12, 1351.50, 166
3, 11:26:00-000, 195, 124, 71, 12, 1347.08, 14, 1351.21, 169
3, 11:27:00-000, 194, 138, 56, 6, 1347.67, 10, 1351.50, 166
3, 11:28:00-000, 174, 118, 56, 19, 1350.00, 22, 1351.59, 143
3, 11:29:00-000, 215, 169, 46, 2, 1346.00, 7, 1352.57, 210
3, 11:30:00-000, 224, 204, 20, 18, 1346.44, 12, 1351.67, 190
3, 11:31:00-000, 218, 210, 8, 4, 1347.00, 0, 0.00, 210
3, 11:32:00-000, 196, 149, 47, 18, 1348.05, 4, 1351.25, 179
3, 11:33:00-000, 200, 155, 45, 5, 1347.00, 3, 1349.67, 192
3, 11:34:00-000, 203, 155, 48, 8, 1348.12, 9, 1350.55, 183
3, 11:35:00-000, 205, 134, 71, 4, 1350.50, 17, 1351.41, 180
3, 11:36:00-000, 174, 131, 43, 11, 1349.18, 9, 1350.55, 160
3, 11:37:00-000, 203, 155, 48, 2, 1347.50, 11, 1350.54, 183
3, 11:38:00-000, 200, 171, 29, 6, 1348.50, 5, 1351.40, 200
3, 11:39:00-000, 197, 152, 45, 1, 1351.00, 2, 1351.00, 184
3, 11:40:00-000, 191, 158, 33, 8, 1348.12, 5, 1353.20, 188
3, 11:41:00-000, 194, 176, 18, 5, 1348.60, 5, 1350.20, 174
3, 11:42:00-000, 193, 158, 35, 13, 1347.00, 7, 1351.14, 175
3, 11:43:00-000, 183, 140, 43, 5, 1349.40, 10, 1352.00, 171
3, 11:44:00-000, 208, 152, 56, 19, 1349.89, 7, 1352.00, 169
3, 11:45:00-000, 195, 120, 75, 2, 1349.50, 11, 1351.09, 193
3, 11:46:00-000, 178, 126, 52, 14, 1348.57, 5, 1351.00, 150
3, 11:47:00-000, 193, 135, 58, 9, 1348.00, 3, 1350.00, 197
3, 11:48:00-000, 209, 111, 98, 15, 1349.07, 31, 1351.96, 157
3, 11:49:00-000, 187, 102, 85, 11, 1348.91, 15, 1351.33, 164
3, 11:50:00-000, 213, 140, 73, 12, 1348.50, 11, 1351.27, 190
3, 11:51:00-000, 188, 168, 20, 2, 1349.00, 5, 1351.80, 182
3, 11:52:00-000, 232, 147, 85, 23, 1348.17, 16, 1351.18, 195
3, 11:53:00-000, 181, 120, 61, 3, 1348.00, 22, 1351.77, 155
3, 11:54:00-000, 231, 189, 42, 6, 1350.33, 10, 1350.60, 208
3, 11:55:00-000, 192, 150, 42, 15, 1348.47, 8, 1350.50, 169
3, 11:56:00-000, 209, 165, 44, 15, 1346.73, 12, 1351.92, 187
3, 11:57:00-000, 222, 160, 62, 10, 1350.30, 17, 1351.82, 196
3, 11:58:00-000, 207, 166, 41, 17, 1348.47, 2, 1351.00, 186
3, 11:59:00-000, 185, 107, 78, 4, 1349.00, 6, 1350.00, 178
3, 12:00:00-000, 247, 164, 83, 19, 1347.52, 11, 1350.45, 211
3, 12:01:00-000, 189, 165, 24, 6, 1348.83, 7, 1350.14, 179
3, 12:02:00-000, 212, 170, 42, 11, 1348.73, 8, 1350.00, 186
3, 12:03:00-000, 194, 153, 41, 9, 1347.11, 6, 1352.17, 186
3, 12:04:00-000, 190, 137, 53, 22, 1348.63, 16, 1352.19, 149
3, 12:05:00-000, 223, 110, 113, 10, 1347.90, 12, 1351.00, 202
3, 12:06:00-000, 224, 101, 123, 8, 1345.87, 12, 1350.33, 209
3, 12:07:00-000, 205, 108, 97, 4, 1349.00, 9, 1350.78, 178
3, 12:08:00-000, 191, 128, 63, 7, 1348.29, 20, 1351.05, 176
3, 12:09:00-000, 202, 174, 28, 14, 1349.07, 15, 1352.33, 169
3, 12:10:00-000, 195, 174, 21, 17, 1349.64, 11, 1353.00, 159
3, 12:11:00-000, 176, 159, 17, 5, 1348.80, 5, 1352.20, 178
3, 12:12:00-000, 209, 176, 33, 22, 1350.36, 17, 1353.12, 160
3, 12:13:00-000, 205, 141, 64, 10, 1348.40, 9, 1351.78, 194
3, 12:14:00-000, 196, 150, 46, 10, 1349.60, 22, 1352.04, 169
3, 12:15:00-000, 191, 134, 57, 4, 1348.75, 12, 1350.25, 169
3, 12:16:00-000, 190, 160, 30, 14, 1348.93, 11, 1352.09, 170
3, 12:17:00-000, 211, 162, 49, 9, 1346.89, 0, 0.00, 200
3, 12:18:00-000, 172, 140, 32, 2, 1348.00, 10, 1350.20, 157
3, 12:19:00-000, 194, 170, 24, 7, 1348.71, 11, 1352.36, 179
3, 12:20:00-000, 222, 207, 15, 15, 1347.80, 3, 1351.67, 194
3, 12:21:00-000, 184, 141, 43, 19, 1347.63, 7, 1350.86, 168
3, 12:22:00-000, 205, 145, 60, 4, 1349.25, 18, 1350.61, 186
3, 12:23:00-000, 197, 169, 28, 4, 1349.00, 8, 1350.62, 183
3, 12:24:00-000, 213, 145, 68, 19, 1348.89, 5, 1350.60, 187
3, 12:25:00-000, 211, 164, 47, 5, 1347.80, 8, 1351.37, 200
3, 12:26:00-000, 218, 168, 50, 15, 1348.86, 9, 1351.22, 193
3, 12:27:00-000, 218, 169, 49, 5, 1347.00, 7, 1351.43, 207
3, 12:28:00-000, 176, 100, 76, 6, 1347.00, 3, 1350.00, 167
3, 12:29:00-000, 215, 142, 73, 3, 1348.00, 9, 1350.78, 196
3, 12:30:00-000, 182, 129, 53, 10, 1348.80, 13, 1351.38, 166
3, 12:31:00-000, 157, 144, 13, 0, 0.00, 6, 1352.00, 149
3, 12:32:00-000, 195, 148, 47, 23, 1348.61, 6, 1350.50, 166
3, 12:33:00-000, 225, 138, 87, 4, 1349.50, 1, 1350.00, 215
3, 12:34:00-000, 202, 145, 57, 11, 1348.91, 14, 1351.71, 186
3, 12:35:00-000, 187, 127, 60, 15, 1350.27, 19, 1352.16, 152
3, 12:36:00-000, 198, 150, 48, 19, 1349.68, 25, 1352.36, 149
3, 12:37:00-000, 233, 157, 76, 23, 1349.00, 5, 1352.00, 209
3, 12:38:00-000, 184, 108, 76, 7, 1347.57, 10, 1349.70, 161
3, 12:39:00-000, 190, 126, 64, 4, 1349.25, 20, 1351.30, 170
3, 12:40:00-000, 164, 142, 22, 5, 1347.40, 9, 1350.33, 149
3, 12:41:00-000, 178, 145, 33, 13, 1345.92, 12, 1352.25, 155
3, 12:42:00-000, 187, 138, 49, 9, 1347.67, 3, 1350.67, 174
3, 12:43:00-000, 189, 159, 30, 1, 1346.00, 9, 1351.00, 175
3, 12:44:00-000, 179, 131, 48, 14, 1347.21, 1, 1350.00, 164
3, 12:45:00-000, 236, 165, 71, 6, 1347.17, 7, 1350.43, 226
3, 12:46:00-000, 240, 199, 41, 28, 1349.00, 17, 1351.82, 185
3, 12:47:00-000, 173, 122, 51, 4, 1348.50, 9, 1350.78, 174
3, 12:48:00-000, 188, 163, 25, 4, 1347.25, 13, 1352.61, 171
3, 12:49:00-000, 243, 184, 59, 15, 1348.40, 1, 1350.00, 220
3, 12:50:00-000, 192, 91, 101, 18, 1347.72, 9, 1350.00, 162
3, 12:51:00-000, 182, 76, 106, 1, 1345.00, 10, 1349.70, 172
3, 12:52:00-000, 181, 116, 65, 13, 1347.23, 11, 1351.09, 166
3, 12:53:00-000, 189, 101, 88, 12, 1348.33, 18, 1350.89, 151
3, 12:54:00-000, 202, 139, 63, 4, 1350.00, 7, 1351.57, 199
3, 12:55:00-000, 187, 113, 74, 4, 1348.50, 12, 1351.92, 164
3, 12:56:00-000, 228, 150, 78, 9, 1348.78, 11, 1350.27, 211
3, 12:57:00-000, 185, 132, 53, 15, 1348.20, 19, 1352.10, 147
3, 12:58:00-000, 195, 172, 23, 7, 1349.29, 12, 1351.66, 183
3, 12:59:00-000, 229, 217, 12, 5, 1349.20, 2, 1351.50, 217
3, 13:00:00-000, 207, 164, 43, 8, 1348.12, 10, 1349.80, 184
3, 13:01:00-000, 207, 172, 35, 8, 1348.50, 4, 1349.25, 206
3, 13:02:00-000, 206, 173, 33, 8, 1347.75, 1, 1351.00, 190
3, 13:03:00-000, 149, 113, 36, 1, 1348.00, 0, 0.00, 153
3, 13:04:00-000, 204, 141, 63, 16, 1349.19, 24, 1351.96, 164
3, 13:05:00-000, 156, 138, 18, 3, 1349.67, 5, 1351.00, 150
3, 13:06:00-000, 167, 147, 20, 9, 1348.78, 2, 1351.50, 144
3, 13:07:00-000, 187, 123, 64, 7, 1352.29, 6, 1351.17, 184
3, 13:08:00-000, 196, 170, 26, 8, 1344.00, 12, 1350.50, 176
3, 13:09:00-000, 206, 158, 48, 19, 1348.16, 2, 1350.50, 179
3, 13:10:00-000, 192, 110, 82, 10, 1348.60, 19, 1351.31, 162
3, 13:11:00-000, 206, 168, 38, 6, 1349.00, 9, 1351.67, 197
3, 13:12:00-000, 218, 177, 41, 8, 1353.50, 5, 1351.60, 207
3, 13:13:00-000, 214, 176, 38, 8, 1347.87, 7, 1351.43, 195
3, 13:14:00-000, 229, 177, 52, 12, 1348.42, 18, 1351.00, 203
3, 13:15:00-000, 185, 155, 30, 0, 0.00, 4, 1350.50, 179
3, 13:16:00-000, 190, 144, 46, 16, 1350.31, 11, 1351.36, 164
3, 13:17:00-000, 219, 150, 69, 6, 1348.83, 16, 1351.06, 188
3, 13:18:00-000, 214, 178, 36, 20, 1349.45, 5, 1351.40, 195
3, 13:19:00-000, 184, 133, 51, 5, 1348.40, 10, 1352.40, 168
3, 13:20:00-000, 203, 171, 32, 10, 1347.60, 5, 1352.40, 192
3, 13:21:00-000, 179, 143, 36, 11, 1349.45, 13, 1351.38, 153
3, 13:22:00-000, 195, 134, 61, 12, 1349.75, 9, 1351.22, 176
3, 13:23:00-000, 211, 122, 89, 6, 1347.50, 6, 1350.33, 194
3, 13:24:00-000, 207, 159, 48, 15, 1349.40, 20, 1351.90, 177
3, 13:25:00-000, 189, 138, 51, 6, 1348.00, 2, 1351.00, 181
3, 13:26:00-000, 176, 135, 41, 17, 1348.00, 14, 1351.71, 142
3, 13:27:00-000, 212, 118, 94, 5, 1347.20, 11, 1350.54, 202
3, 13:28:00-000, 221, 162, 59, 14, 1348.43, 20, 1350.50, 178
3, 13:29:00-000, 233, 189, 44, 20, 1349.95, 24, 1351.79, 194
3, 13:30:00-000, 207, 158, 49, 22, 1349.04, 6, 1350.50, 173
3, 13:31:00-000, 227, 146, 81, 17, 1348.70, 23, 1350.56, 190
3, 13:32:00-000, 176, 99, 77, 14, 1347.21, 4, 1350.25, 162
3, 13:33:00-000, 237, 124, 113, 19, 1348.79, 33, 1350.94, 179
3, 13:34:00-000, 191, 112, 79, 7, 1347.43, 11, 1350.82, 164
3, 13:35:00-000, 187, 168, 19, 2, 1348.00, 5, 1350.80, 193
3, 13:36:00-000, 230, 205, 25, 16, 1349.31, 4, 1350.25, 213
3, 13:37:00-000, 196, 142, 54, 12, 1350.75, 8, 1351.50, 175
3, 13:38:00-000, 195, 106, 89, 5, 1346.40, 10, 1350.00, 166
3, 13:39:00-000, 170, 123, 47, 3, 1348.00, 9, 1350.11, 166
3, 13:40:00-000, 207, 153, 54, 13, 1347.46, 9, 1350.78, 191
3, 13:41:00-000, 197, 180, 17, 5, 1352.60, 8, 1351.62, 177
3, 13:42:00-000, 208, 178, 30, 16, 1348.50, 6, 1349.67, 193
3, 13:43:00-000, 216, 150, 66, 14, 1349.93, 11, 1351.64, 180
3, 13:44:00-000, 194, 115, 79, 6, 1346.50, 15, 1350.60, 174
3, 13:45:00-000, 237, 138, 99, 24, 1347.71, 22, 1351.72, 196
3, 13:46:00-000, 197, 142, 55, 15, 1346.40, 17, 1351.70, 168
3, 13:47:00-000, 209, 157, 52, 11, 1348.82, 3, 1350.33, 199
3, 13:48:00-000, 214, 151, 63, 11, 1348.82, 30, 1351.30, 169
3, 13:49:00-000, 172, 123, 49, 15, 1346.66, 11, 1351.45, 149
3, 13:50:00-000, 233, 168, 65, 22, 1347.09, 10, 1350.80, 202
3, 13:51:00-000, 229, 152, 77, 7, 1349.86, 7, 1350.57, 209
3, 13:52:00-000, 190, 135, 55, 7, 1348.00, 9, 1353.00, 180
3, 13:53:00-000, 190, 146, 44, 16, 1349.69, 17, 1351.76, 150
3, 13:54:00-000, 181, 101, 80, 24, 1349.54, 14, 1350.93, 151
3, 13:55:00-000, 234, 117, 117, 2, 1349.00, 3, 1350.33, 212
3, 13:56:00-000, 195, 103, 92, 7, 1348.28, 11, 1351.00, 194
3, 13:57:00-000, 195, 155, 40, 2, 1348.00, 10, 1350.40, 177
3, 13:58:00-000, 205, 133, 72, 25, 1348.60, 18, 1352.05, 166
3, 13:59:00-000, 174, 130, 44, 5, 1348.80, 1, 1352.00, 170
3, 14:00:00-000, 219, 153, 66, 10, 1347.40, 22, 1351.13, 183
3, 14:01:00-000, 188, 136, 52, 10, 1347.40, 7, 1350.86, 171
3, 14:02:00-000, 197, 124, 73, 17, 1348.35, 14, 1350.36, 167
3, 14:03:00-000, 190, 140, 50, 2, 1350.50, 10, 1351.70, 179
3, 14:04:00-000, 183, 147, 36, 19, 1349.26, 17, 1351.47, 144
3, 14:05:00-000, 191, 146, 45, 7, 1348.86, 8, 1350.62, 180
3, 14:06:00-000, 202, 138, 64, 19, 1346.73, 17, 1350.06, 161
3, 14:07:00-000, 216, 153, 63, 9, 1346.33, 8, 1352.25, 195
3, 14:08:00-000, 213, 191, 22, 8, 1349.12, 10, 1352.30, 190
3, 14:09:00-000, 202, 161, 41, 11, 1348.82, 4, 1350.50, 199
3, 14:10:00-000, 221, 150, 71, 26, 1349.15, 25, 1352.00, 173
3, 14:11:00-000, 190, 135, 55, 1, 1347.00, 16, 1351.19, 172
3, 14:12:00-000, 213, 169, 44, 19, 1348.21, 14, 1351.07, 176
3, 14:13:00-000, 199, 155, 44, 8, 1348.25, 6, 1350.17, 183
3, 14:14:00-000, 192, 129, 63, 12, 1348.50, 14, 1351.28, 173
3, 14:15:00-000, 222, 174, 48, 6, 1349.33, 12, 1350.08, 201
3, 14:16:00-000, 198, 147, 51, 16, 1346.19, 16, 1351.00, 159
3, 14:17:00-000, 209, 135, 74, 9, 1346.67, 3, 1349.00, 206
3, 14:18:00-000, 203, 129, 74, 15, 1348.86, 12, 1353.00, 168
3, 14:19:00-000, 212, 175, 37, 0, 0.00, 12, 1351.58, 203
3, 14:20:00-000, 172, 168, 4, 5, 1350.00, 3, 1352.00, 166
3, 14:21:00-000, 234, 212, 22, 8, 1348.50, 3, 1352.00, 225
3, 14:22:00-000, 175, 148, 27, 8, 1348.12, 6, 1352.50, 160
3, 14:23:00-000, 215, 155, 60, 4, 1349.75, 4, 1350.75, 194
3, 14:24:00-000, 240, 169, 71, 10, 1348.60, 15, 1351.13, 222
3, 14:25:00-000, 204, 166, 38, 10, 1348.40, 3, 1350.33, 198
3, 14:26:00-000, 200, 135, 65, 8, 1349.50, 3, 1350.33, 191
3, 14:27:00-000, 215, 144, 71, 5, 1351.80, 14, 1352.50, 191
3, 14:28:00-000, 218, 155, 63, 20, 1351.30, 12, 1352.16, 190
3, 14:29:00-000, 221, 147, 74, 10, 1348.90, 5, 1351.20, 202
3, 14:30:00-000, 217, 190, 27, 10, 1349.70, 20, 1351.55, 183
3, 14:31:00-000, 203, 152, 51, 12, 1345.92, 6, 1350.17, 176
3, 14:32:00-000, 180, 127, 53, 13, 1348.62, 20, 1350.90, 161
3, 14:33:00-000, 169, 137, 32, 13, 1351.92, 5, 1351.20, 153
3, 14:34:00-000, 210, 148, 62, 11, 1349.55, 15, 1351.40, 181
3, 14:35:00-000, 198, 155, 43, 6, 1350.67, 10, 1351.80, 184
3, 14:36:00-000, 224, 180, 44, 6, 1349.00, 11, 1351.18, 207
3, 14:37:00-000, 198, 155, 43, 14, 1348.57, 7, 1351.29, 178
3, 14:38:00-000, 196, 156, 40, 24, 1349.29, 10, 1351.30, 156
3, 14:39:00-000, 179, 114, 65, 1, 1347.00, 7, 1351.00, 177
3, 14:40:00-000, 182, 133, 49, 13, 1349.61, 24, 1350.95, 142
3, 14:41:00-000, 199, 139, 60, 11, 1349.64, 3, 1350.00, 185
3, 14:42:00-000, 196, 156, 40, 13, 1348.38, 13, 1351.46, 173
3, 14:43:00-000, 175, 107, 68, 1, 1345.00, 8, 1351.62, 164
3, 14:44:00-000, 192, 124, 68, 8, 1347.62, 15, 1350.00, 167
3, 14:45:00-000, 223, 181, 42, 8, 1348.13, 4, 1350.25, 210
3, 14:46:00-000, 182, 137, 45, 7, 1346.71, 10, 1350.70, 169
3, 14:47:00-000, 180, 138, 42, 6, 1350.50, 3, 1351.67, 167
3, 14:48:00-000, 224, 180, 44, 19, 1347.52, 7, 1350.86, 201
3, 14:49:00-000, 199, 172, 27, 4, 1352.00, 10, 1352.80, 188
3, 14:50:00-000, 210, 158, 52, 20, 1348.40, 2, 1351.50, 186
3, 14:51:00-000, 190, 127, 63, 9, 1350.00, 23, 1351.26, 161
3, 14:52:00-000, 182, 142, 40, 21, 1347.47, 8, 1351.37, 149
3, 14:53:00-000, 207, 137, 70, 4, 1349.00, 7, 1355.00, 200
3, 14:54:00-000, 216, 126, 90, 14, 1347.64, 13, 1351.69, 178
3, 14:55:00-000, 206, 137, 69, 4, 1349.00, 18, 1351.89, 190
3, 14:56:00-000, 205, 156, 49, 8, 1350.37, 13, 1352.00, 188
3, 14:57:00-000, 205, 182, 23, 7, 1350.00, 9, 1351.66, 180
3, 14:58:00-000, 159, 144, 15, 17, 1349.65, 6, 1351.50, 132
3, 14:59:00-000, 215, 137, 78, 10, 1348.50, 7, 1350.43, 209
3, 15:00:00-000, 189, 121, 68, 11, 1349.64, 25, 1352.28, 156
3, 15:01:00-000, 168, 109, 59, 19, 1347.31, 2, 1350.50, 147
3, 15:02:00-000, 218, 110, 108, 3, 1347.67, 12, 1351.67, 200
3, 15:03:00-000, 219, 139, 80, 14, 1349.57, 17, 1352.23, 187
3, 15:04:00-000, 202, 142, 60, 24, 1347.54, 17, 1350.29, 159
3, 15:05:00-000, 194, 153, 41, 13, 1348.15, 20, 1351.70, 162
3, 15:06:00-000, 184, 153, 31, 14, 1349.50, 7, 1351.86, 155
3, 15:07:00-000, 211, 140, 71, 6, 1349.00, 4, 1351.00, 213
3, 15:08:00-000, 231, 177, 54, 12, 1351.25, 19, 1351.31, 194
3, 15:09:00-000, 207, 159, 48, 10, 1347.80, 6, 1350.83, 198
3, 15:10:00-000, 186, 124, 62, 12, 1349.91, 25, 1351.64, 138
3, 15:11:00-000, 217, 158, 59, 6, 1347.83, 12, 1351.42, 209
3, 15:12:00-000, 190, 159, 31, 16, 1348.50, 3, 1351.33, 170
3, 15:13:00-000, 210, 177, 33, 6, 1348.33, 13, 1350.08, 189
3, 15:14:00-000, 222, 185, 37, 32, 1347.21, 6, 1351.00, 182
3, 15:15:00-000, 171, 106, 65, 6, 1347.50, 1, 1350.00, 168
3, 15:16:00-000, 180, 117, 63, 3, 1350.67, 19, 1352.52, 151
3, 15:17:00-000, 217, 189, 28, 3, 1347.33, 17, 1351.64, 205
3, 15:18:00-000, 191, 178, 13, 26, 1350.38, 7, 1351.29, 154
3, 15:19:00-000, 197, 130, 67, 4, 1345.75, 10, 1350.80, 180
3, 15:20:00-000, 221, 138, 83, 15, 1347.86, 11, 1349.82, 197
3, 15:21:00-000, 182, 111, 71, 3, 1348.33, 14, 1351.07, 169
3, 15:22:00-000, 199, 145, 54, 21, 1348.76, 2, 1351.00, 174
3, 15:23:00-000, 199, 122, 77, 4, 1349.75, 12, 1350.66, 183
3, 15:24:00-000, 171, 89, 82, 8, 1348.87, 11, 1351.18, 154
3, 15:25:00-000, 197, 130, 67, 0, 0.00, 9, 1350.22, 187
3, 15:26:00-000, 196, 150, 46, 22, 1347.36, 16, 1351.31, 161
3, 15:27:00-000, 212, 173, 39, 6, 1348.67, 11, 1351.27, 193
3, 15:28:00-000, 207, 151, 56, 21, 1348.38, 7, 1352.43, 170
3, 15:29:00-000, 214, 164, 50, 5, 1347.80, 16, 1351.19, 199
3, 15:30:00-000, 183, 125, 58, 13, 1347.61, 9, 1351.00, 156
3, 15:31:00-000, 207, 187, 20, 6, 1352.67, 8, 1353.75, 192
3, 15:32:00-000, 164, 127, 37, 8, 1348.00, 12, 1351.33, 151
3, 15:33:00-000, 240, 174, 66, 9, 1348.11, 12, 1351.00, 211
3, 15:34:00-000, 198, 125, 73, 11, 1348.82, 18, 1351.16, 174
3, 15:35:00-000, 220, 180, 40, 16, 1349.69, 11, 1352.36, 197
3, 15:36:00-000, 234, 197, 37, 8, 1347.88, 6, 1352.83, 210
3, 15:37:00-000, 216, 171, 45, 15, 1346.93, 15, 1350.93, 197
3, 15:38:00-000, 199, 162, 37, 19, 1347.94, 16, 1351.75, 164
3, 15:39:00-000, 190, 171, 19, 1, 1348.00, 10, 1352.40, 173
3, 15:40:00-000, 176, 149, 27, 6, 1349.67, 5, 1352.40, 171
3, 15:41:00-000, 203, 176, 27, 15, 1350.33, 5, 1350.80, 183
3, 15:42:00-000, 221, 172, 49, 10, 1347.40, 6, 1351.50, 206
3, 15:43:00-000, 220, 141, 79, 4, 1347.00, 14, 1350.28, 203
3, 15:44:00-000, 201, 130, 71, 8, 1348.75, 6, 1351.00, 181
3, 15:45:00-000, 198, 155, 43, 4, 1348.75, 9, 1352.78, 189
3, 15:46:00-000, 234, 189, 45, 10, 1350.10, 6, 1351.67, 213
3, 15:47:00-000, 212, 148, 64, 2, 1347.50, 5, 1350.00, 204
3, 15:48:00-000, 208, 162, 46, 28, 1349.89, 19, 1350.31, 167
3, 15:49:00-000, 226, 167, 59, 5, 1348.80, 10, 1350.60, 209
3, 15:50:00-000, 179, 120, 59, 12, 1347.67, 9, 1349.44, 160
3, 15:51:00-000, 185, 123, 62, 13, 1346.77, 2, 1351.00, 165
3, 15:52:00-000, 191, 122, 69, 2, 1347.00, 11, 1351.63, 178
3, 15:53:00-000, 186, 109, 77, 17, 1348.59, 8, 1350.25, 165
3, 15:54:00-000, 176, 112, 64, 10, 1349.00, 15, 1351.27, 151
3, 15:55:00-000, 183, 109, 74, 2, 1348.00, 1, 1350.00, 182
3, 15:56:00-000, 167, 114, 53, 9, 1347.89, 12, 1351.08, 146
3, 15:57:00-000, 218, 163, 55, 6, 1348.00, 22, 1351.18, 186
3, 15:58:00-000, 200, 169, 31, 15, 1347.93, 10, 1350.50, 169
3, 15:59:00-000, 231, 193, 38, 5, 1348.00, 7, 1351.71, 222
3, 16:00:00-000, 178, 134, 44, 15, 1349.20, 11, 1351.18, 158
3, 16:01:00-000, 265, 188, 77, 13, 1348.61, 11, 1350.63, 234
3, 16:02:00-000, 219, 147, 72, 26, 1348.69, 22, 1351.72, 173
3, 16:03:00-000, 180, 130, 50, 2, 1349.00, 8, 1350.75, 170
3, 16:04:00-000, 169, 105, 64, 15, 1347.53, 17, 1350.17, 141
3, 16:05:00-000, 195, 149, 46, 4, 1348.25, 3, 1350.33, 186
3, 16:06:00-000, 190, 136, 54, 16, 1348.56, 23, 1351.26, 152
3, 16:07:00-000, 241, 197, 44, 5, 1347.60, 1, 1351.00, 237
3, 16:08:00-000, 186, 142, 44, 6, 1347.33, 12, 1350.91, 167
3, 16:09:00-000, 247, 229, 18, 11, 1348.54, 8, 1352.62, 220
3, 16:10:00-000, 182, 140, 42, 16, 1350.18, 21, 1353.57, 148
3, 16:11:00-000, 182, 161, 21, 3, 1349.67, 8, 1352.25, 178
3, 16:12:00-000, 212, 167, 45, 20, 1347.75, 5, 1351.60, 187
3, 16:13:00-000, 217, 162, 55, 7, 1348.43, 5, 1351.40, 194
3, 16:14:00-000, 193, 148, 45, 9, 1348.78, 10, 1353.50, 172
3, 16:15:00-000, 180, 143, 37, 9, 1350.33, 9, 1351.33, 165
3, 16:16:00-000, 192, 129, 63, 12, 1347.00, 12, 1351.66, 177
3, 16:17:00-000, 220, 155, 65, 11, 1348.63, 10, 1351.40, 193
3, 16:18:00-000, 221, 123, 98, 21, 1348.28, 10, 1351.30, 194
3, 16:19:00-000, 219, 137, 82, 8, 1349.75, 15, 1350.33, 198
3, 16:20:00-000, 234, 127, 107, 25, 1350.24, 8, 1351.12, 193
3, 16:21:00-000, 197, 90, 107, 7, 1349.86, 20, 1350.65, 174
3, 16:22:00-000, 162, 101, 61, 17, 1348.06, 19, 1352.26, 124
3, 16:23:00-000, 205, 168, 37, 1, 1355.00, 4, 1351.50, 207
3, 16:24:00-000, 232, 169, 63, 9, 1349.89, 19, 1351.73, 198
3, 16:25:00-000, 215, 166, 49, 26, 1348.54, 12, 1352.25, 178
3, 16:26:00-000, 197, 129, 68, 11, 1346.09, 5, 1350.20, 182
3, 16:27:00-000, 172, 103, 69, 6, 1346.17, 8, 1350.37, 157
3, 16:28:00-000, 213, 87, 126, 13, 1348.23, 12, 1350.50, 188
3, 16:29:00-000, 170, 77, 93, 11, 1348.82, 6, 1351.50, 159
3, 16:30:00-000, 1, 1, 0, 0, 0.00, 0, 0.00, 0
4, 09:03:00-000, 300, 300, 0, 0, 0.00, 0, 0.00, 291
4, 09:04:00-000, 0, 0, 0, 0, 0.00, 0, 0.00, 9
4, 09:06:00-000, 279, 279, 0, 278, 1351.00, 0, 0.00, 0
4, 09:07:00-000, 4, 0, 4, 0, 0.00, 0, 0.00, 1
4, 09:08:00-000, 36, 27, 9, 11, 1352.91, 13, 1353.00, 12
4, 09:09:00-000, 76, 66, 10, 10, 1371.40, 10, 1371.40, 31
4, 09:10:00-000, 105, 80, 25, 20, 1410.85, 20, 1410.85, 80
4, 09:11:00-000, 55, 44, 11, 15, 1450.00, 15, 1450.00, 26
4, 09:12:00-000, 65, 56, 9, 9, 1470.11, 9, 1470.11, 45
4, 09:13:00-000, 91, 83, 8, 76, 1404.26, 9, 1402.89, 18
4, 09:14:00-000, 95, 82, 13, 71, 1356.11, 13, 1355.15, 8
4, 09:15:00-000, 64, 51, 13, 43, 1356.43, 5, 1355.40, 15
4, 09:16:00-000, 102, 64, 38, 46, 1360.14, 41, 1359.04, 11
4, 09:17:00-000, 87, 48, 39, 41, 1358.43, 41, 1360.26, 7
4, 09:18:00-000, 98, 59, 39, 49, 1356.15, 35, 1356.74, 10
4, 09:19:00-000, 56, 34, 22, 29, 1374.89, 22, 1375.59, 13
4, 09:20:00-000, 123, 52, 71, 57, 1354.90, 64, 1351.08, 0
4, 09:21:00-000, 90, 39, 51, 36, 1351.58, 44, 1351.42, 4
4, 09:22:00-000, 73, 29, 44, 23, 1350.26, 46, 1350.71, 4
4, 09:23:00-000, 67, 31, 36, 34, 1358.58, 28, 1358.67, 11
4, 09:24:00-000, 89, 49, 40, 46, 1353.73, 35, 1356.96, 8
4, 09:25:00-000, 84, 36, 48, 36, 1350.80, 43, 1350.60, 5
4, 09:26:00-000, 92, 38, 54, 36, 1350.08, 49, 1349.87, 8
4, 09:27:00-000, 67, 30, 37, 30, 1351.13, 32, 1351.21, 3
4, 09:28:00-000, 85, 35, 50, 34, 1350.02, 53, 1350.25, 5
4, 09:29:00-000, 86, 43, 43, 43, 1352.25, 38, 1352.23, 2
4, 09:30:00-000, 85, 34, 51, 33, 1350.45, 53, 1351.14, 3
4, 09:31:00-000, 82, 52, 30, 45, 1355.17, 30, 1355.79, 7
4, 09:32:00-000, 92, 39, 53, 38, 1349.97, 44, 1350.26, 2
4, 09:33:00-000, 74, 39, 35, 36, 1353.38, 31, 1351.28, 2
4, 09:34:00-000, 94, 46, 48, 46, 1351.27, 50, 1352.11, 2
4, 09:35:00-000, 88, 55, 33, 50, 1351.61, 27, 1349.92, 14
4, 09:36:00-000, 94, 45, 49, 45, 1350.59, 45, 1351.26, 4
4, 09:37:00-000, 83, 48, 35, 48, 1352.55, 20, 1351.49, 16
4, 09:38:00-000, 65, 38, 27, 35, 1351.76, 29, 1352.13, 2
4, 09:39:00-000, 104, 56, 48, 49, 1351.78, 39, 1351.69, 14
4, 09:40:00-000, 91, 61, 30, 53, 1351.03, 33, 1350.57, 0
4, 09:41:00-000, 78, 32, 46, 34, 1351.61, 39, 1351.66, 10
4, 09:42:00-000, 80, 45, 35, 36, 1352.52, 38, 1352.89, 6
4, 09:43:00-000, 106, 46, 60, 46, 1352.30, 48, 1353.26, 11
4, 09:44:00-000, 67, 31, 36, 27, 1349.88, 41, 1350.04, 1
4, 09:45:00-000, 92, 47, 45, 39, 1353.15, 34, 1352.55, 11
4, 09:46:00-000, 118, 57, 61, 58, 1350.90, 58, 1350.47, 13
4, 09:47:00-000, 68, 38, 30, 38, 1351.49, 28, 1351.71, 2
4, 09:48:00-000, 73, 24, 49, 24, 1351.04, 35, 1351.14, 13
4, 09:49:00-000, 94, 43, 51, 42, 1351.21, 41, 1351.40, 3
4, 09:50:00-000, 74, 29, 45, 30, 1351.16, 41, 1351.45, 7
4, 09:51:00-000, 79, 45, 34, 40, 1350.02, 31, 1349.93, 5
4, 09:52:00-000, 71, 35, 36, 32, 1350.56, 40, 1350.92, 4
4, 09:53:00-000, 65, 28, 37, 23, 1351.08, 26, 1350.46, 11
4, 09:54:00-000, 75, 34, 41, 30, 1352.69, 45, 1353.39, 4
4, 09:55:00-000, 92, 46, 46, 44, 1351.04, 39, 1351.28, 7
4, 09:56:00-000, 79, 43, 36, 44, 1351.02, 33, 1351.18, 5
4, 09:57:00-000, 60, 20, 40, 20, 1350.15, 36, 1349.72, 4
4, 09:58:00-000, 85, 33, 52, 29, 1349.61, 49, 1349.62, 1
4, 09:59:00-000, 94, 54, 40, 46, 1351.84, 29, 1350.79, 14
4, 10:00:00-000, 55, 22, 33, 30, 1349.89, 25, 1350.96, 12
4, 10:01:00-000, 96, 52, 44, 51, 1352.25, 30, 1352.33, 8
4, 10:02:00-000, 115, 55, 60, 51, 1350.70, 60, 1351.05, 1
4, 10:03:00-000, 96, 57, 39, 53, 1350.99, 48, 1350.22, 6
4, 10:04:00-000, 89, 43, 46, 46, 1350.23, 37, 1350.26, 4
4, 10:05:00-000, 100, 40, 60, 38, 1348.94, 55, 1348.79, 6
4, 10:06:00-000, 95, 51, 44, 50, 1352.23, 41, 1352.53, 9
4, 10:07:00-000, 89, 37, 52, 28, 1352.42, 41, 1351.63, 3
4, 10:08:00-000, 73, 33, 40, 37, 1349.72, 43, 1350.71, 9
4, 10:09:00-000, 95, 40, 55, 36, 1350.61, 44, 1350.36, 3
4, 10:10:00-000, 68, 30, 38, 31, 1349.87, 40, 1350.17, 4
4, 10:11:00-000, 63, 20, 43, 17, 1349.76, 32, 1349.68, 7
4, 10:12:00-000, 104, 46, 58, 43, 1349.97, 55, 1350.26, 15
4, 10:13:00-000, 68, 45, 23, 33, 1350.87, 20, 1351.10, 15
4, 10:14:00-000, 86, 38, 48, 37, 1351.88, 41, 1352.14, 5
4, 10:15:00-000, 100, 47, 53, 47, 1350.18, 57, 1350.15, 1
4, 10:16:00-000, 81, 42, 39, 35, 1350.28, 32, 1350.31, 5
4, 10:17:00-000, 70, 39, 31, 37, 1351.97, 29, 1351.96, 12
4, 10:18:00-000, 88, 50, 38, 44, 1351.01, 35, 1351.48, 5
4, 10:19:00-000, 78, 50, 28, 39, 1353.35, 28, 1353.71, 17
4, 10:20:00-000, 91, 48, 43, 45, 1351.64, 43, 1351.92, 0
4, 10:21:00-000, 78, 37, 41, 36, 1352.41, 35, 1352.31, 1
4, 10:22:00-000, 98, 60, 38, 61, 1351.04, 33, 1351.78, 2
4, 10:23:00-000, 78, 41, 37, 28, 1353.78, 32, 1352.40, 15
4, 10:24:00-000, 74, 31, 43, 39, 1350.51, 31, 1350.25, 13
4, 10:25:00-000, 80, 38, 42, 38, 1350.20, 33, 1350.39, 8
4, 10:26:00-000, 77, 36, 41, 34, 1350.47, 37, 1350.59, 7
4, 10:27:00-000, 90, 34, 56, 32, 1349.99, 40, 1350.12, 18
4, 10:28:00-000, 106, 54, 52, 49, 1350.87, 48, 1350.89, 5
4, 10:29:00-000, 75, 38, 37, 31, 1352.48, 32, 1352.31, 11
4, 10:30:00-000, 76, 42, 34, 47, 1352.89, 36, 1353.16, 2
4, 10:31:00-000, 78, 36, 42, 35, 1351.31, 28, 1351.53, 11
4, 10:32:00-000, 78, 37, 41, 37, 1350.02, 48, 1350.55, 0
4, 10:33:00-000, 88, 39, 49, 39, 1349.30, 31, 1349.99, 6
4, 10:34:00-000, 92, 36, 56, 36, 1352.38, 45, 1351.24, 6
4, 10:35:00-000, 100, 45, 55, 45, 1349.75, 57, 1350.04, 13
4, 10:36:00-000, 75, 31, 44, 28, 1349.74, 37, 1349.75, 5
4, 10:37:00-000, 102, 48, 54, 43, 1349.97, 41, 1349.97, 8
4, 10:38:00-000, 97, 49, 48, 48, 1349.74, 53, 1350.65, 7
4, 10:39:00-000, 49, 21, 28, 20, 1353.05, 18, 1352.50, 10
4, 10:40:00-000, 78, 50, 28, 43, 1352.04, 30, 1352.26, 9
4, 10:41:00-000, 89, 41, 48, 39, 1352.04, 30, 1351.93, 6
4, 10:42:00-000, 79, 31, 48, 32, 1349.49, 52, 1349.14, 5
4, 10:43:00-000, 69, 28, 41, 23, 1347.56, 24, 1347.87, 9
4, 10:44:00-000, 107, 39, 68, 41, 1348.85, 62, 1349.63, 1
4, 10:45:00-000, 82, 39, 43, 37, 1347.07, 43, 1347.23, 23
4, 10:46:00-000, 71, 36, 35, 37, 1349.67, 31, 1348.06, 2
4, 10:47:00-000, 75, 30, 45, 29, 1349.92, 33, 1349.63, 8
4, 10:48:00-000, 103, 64, 39, 52, 1352.41, 38, 1350.99, 9
4, 10:49:00-000, 85, 46, 39, 48, 1350.64, 36, 1350.74, 2
4, 10:50:00-000, 74, 30, 44, 31, 1349.12, 43, 1349.55, 1
4, 10:51:00-000, 63, 35, 28, 31, 1350.19, 29, 1350.03, 10
4, 10:52:00-000, 94, 50, 44, 48, 1351.87, 41, 1352.04, 1
4, 10:53:00-000, 83, 27, 56, 26, 1349.80, 45, 1350.10, 6
4, 10:54:00-000, 71, 30, 41, 33, 1349.96, 45, 1350.04, 3
4, 10:55:00-000, 65, 29, 36, 26, 1350.57, 33, 1350.27, 5
4, 10:56:00-000, 79, 39, 40, 40, 1351.12, 30, 1351.19, 0
4, 10:57:00-000, 88, 53, 35, 53, 1350.63, 30, 1350.69, 9
4, 10:58:00-000, 76, 29, 47, 29, 1348.58, 40, 1349.12, 9
4, 10:59:00-000, 89, 55, 34, 43, 1353.06, 36, 1352.08, 10
4, 11:00:00-000, 98, 31, 67, 35, 1348.97, 57, 1348.45, 3
4, 11:01:00-000, 110, 57, 53, 53, 1349.99, 59, 1349.70, 1
4, 11:02:00-000, 87, 41, 46, 47, 1349.71, 39, 1349.86, 7
4, 11:03:00-000, 88, 43, 45, 42, 1352.37, 43, 1352.60, 2
4, 11:04:00-000, 65, 31, 34, 27, 1351.11, 31, 1350.99, 0
4, 11:05:00-000, 111, 56, 55, 60, 1349.77, 55, 1349.10, 5
4, 11:06:00-000, 85, 51, 34, 36, 1352.08, 19, 1351.05, 16
4, 11:07:00-000, 95, 49, 46, 48, 1351.28, 41, 1351.16, 14
4, 11:08:00-000, 65, 40, 25, 28, 1352.31, 20, 1352.75, 18
4, 11:09:00-000, 103, 56, 47, 56, 1351.94, 36, 1351.24, 4
4, 11:10:00-000, 81, 43, 38, 37, 1350.83, 42, 1350.82, 5
4, 11:11:00-000, 77, 36, 41, 32, 1350.31, 31, 1350.35, 7
4, 11:12:00-000, 87, 42, 45, 43, 1349.41, 41, 1350.70, 4
4, 11:13:00-000, 97, 50, 47, 42, 1348.85, 48, 1349.14, 15
4, 11:14:00-000, 88, 45, 43, 45, 1349.64, 36, 1349.91, 8
4, 11:15:00-000, 65, 18, 47, 17, 1348.00, 34, 1349.05, 11
4, 11:16:00-000, 99, 55, 44, 50, 1351.65, 45, 1351.59, 0
4, 11:17:00-000, 84, 42, 42, 40, 1350.57, 28, 1350.17, 19
4, 11:18:00-000, 82, 45, 37, 48, 1351.53, 33, 1350.99, 2
4, 11:19:00-000, 68, 37, 31, 37, 1352.26, 22, 1351.68, 7
4, 11:20:00-000, 103, 49, 54, 46, 1348.45, 46, 1348.97, 13
4, 11:21:00-000, 68, 30, 38, 29, 1350.37, 36, 1350.77, 11
4, 11:22:00-000, 55, 27, 28, 21, 1350.71, 20, 1350.80, 6
4, 11:23:00-000, 93, 35, 58, 34, 1349.38, 49, 1349.07, 7
4, 11:24:00-000, 81, 34, 47, 35, 1351.22, 50, 1351.69, 1
4, 11:25:00-000, 81, 39, 42, 38, 1350.70, 36, 1350.91, 1
4, 11:26:00-000, 105, 53, 52, 52, 1349.51, 43, 1350.53, 15
4, 11:27:00-000, 92, 51, 41, 41, 1351.41, 41, 1351.58, 5
4, 11:28:00-000, 95, 43, 52, 53, 1351.35, 40, 1350.99, 4
4, 11:29:00-000, 82, 34, 48, 32, 1349.93, 53, 1349.65, 6
4, 11:30:00-000, 67, 40, 27, 36, 1351.10, 22, 1351.77, 4
4, 11:31:00-000, 87, 33, 54, 34, 1348.46, 38, 1349.07, 10
4, 11:32:00-000, 83, 49, 34, 49, 1350.93, 38, 1350.68, 0
4, 11:33:00-000, 64, 30, 34, 29, 1348.72, 33, 1348.84, 5
4, 11:34:00-000, 80, 38, 42, 34, 1349.90, 35, 1350.16, 7
4, 11:35:00-000, 88, 45, 43, 46, 1351.49, 43, 1351.20, 4
4, 11:36:00-000, 68, 40, 28, 36, 1350.21, 28, 1350.85, 2
4, 11:37:00-000, 75, 34, 41, 37, 1349.83, 34, 1349.97, 8
4, 11:38:00-000, 83, 38, 45, 36, 1350.02, 40, 1350.12, 1
4, 11:39:00-000, 62, 32, 30, 27, 1350.48, 23, 1350.30, 13
4, 11:40:00-000, 76, 31, 45, 26, 1350.38, 50, 1351.01, 1
4, 11:41:00-000, 68, 24, 44, 30, 1350.83, 35, 1351.05, 2
4, 11:42:00-000, 89, 43, 46, 42, 1350.16, 42, 1350.47, 0
4, 11:43:00-000, 108, 57, 51, 54, 1350.68, 51, 1350.01, 12
4, 11:44:00-000, 74, 26, 48, 29, 1351.72, 33, 1351.60, 3
4, 11:45:00-000, 68, 28, 40, 27, 1350.62, 33, 1350.48, 9
4, 11:46:00-000, 95, 33, 62, 29, 1349.37, 56, 1349.81, 9
4, 11:47:00-000, 85, 41, 44, 36, 1349.61, 45, 1349.99, 9
4, 11:48:00-000, 79, 51, 28, 55, 1351.14, 27, 1351.55, 1
4, 11:49:00-000, 93, 36, 57, 36, 1350.44, 40, 1350.07, 5
4, 11:50:00-000, 76, 41, 35, 35, 1350.34, 37, 1349.99, 10
4, 11:51:00-000, 75, 42, 33, 33, 1350.27, 27, 1350.10, 12
4, 11:52:00-000, 79, 38, 41, 43, 1350.90, 45, 1350.68, 0
4, 11:53:00-000, 88, 46, 42, 46, 1349.88, 28, 1350.07, 3
4, 11:54:00-000, 73, 37, 36, 37, 1350.69, 38, 1351.02, 4
4, 11:55:00-000, 81, 35, 46, 32, 1350.68, 39, 1350.81, 15
4, 11:56:00-000, 89, 42, 47, 42, 1350.11, 46, 1349.99, 2
4, 11:57:00-000, 104, 53, 51, 52, 1352.16, 45, 1352.04, 0
4, 11:58:00-000, 83, 36, 47, 36, 1350.47, 46, 1350.67, 5
4, 11:59:00-000, 88, 42, 46, 42, 1349.73, 47, 1349.82, 3
4, 12:00:00-000, 70, 27, 43, 24, 1348.33, 31, 1348.57, 10
4, 12:01:00-000, 88, 48, 40, 49, 1350.03, 29, 1350.96, 3
4, 12:02:00-000, 76, 29, 47, 29, 1349.13, 55, 1349.73, 3
4, 12:03:00-000, 88, 33, 55, 32, 1350.33, 32, 1351.15, 12
4, 12:04:00-000, 95, 42, 53, 41, 1352.92, 42, 1350.04, 8
4, 12:05:00-000, 78, 37, 41, 35, 1348.59, 36, 1348.49, 15
4, 12:06:00-000, 52, 24, 28, 24, 1349.70, 35, 1350.25, 0
4, 12:07:00-000, 79, 30, 49, 32, 1350.74, 40, 1349.67, 2
4, 12:08:00-000, 93, 52, 41, 52, 1351.22, 49, 1351.73, 0
4, 12:09:00-000, 70, 43, 27, 42, 1351.92, 25, 1352.47, 1
4, 12:10:00-000, 81, 52, 29, 43, 1352.74, 27, 1352.70, 2
4, 12:11:00-000, 105, 46, 59, 49, 1352.36, 55, 1352.70, 10
4, 12:12:00-000, 84, 43, 41, 40, 1351.50, 27, 1350.40, 10
4, 12:13:00-000, 75, 30, 45, 30, 1349.56, 40, 1349.34, 6
4, 12:14:00-000, 80, 42, 38, 41, 1351.97, 39, 1351.40, 6
4, 12:15:00-000, 94, 42, 52, 41, 1350.82, 43, 1351.53, 3
4, 12:16:00-000, 57, 39, 18, 31, 1351.09, 18, 1351.44, 8
4, 12:17:00-000, 96, 44, 52, 48, 1349.99, 46, 1349.71, 2
4, 12:18:00-000, 84, 39, 45, 38, 1350.23, 51, 1350.19, 3
4, 12:19:00-000, 103, 57, 46, 51, 1353.38, 40, 1353.12, 2
4, 12:20:00-000, 87, 45, 42, 46, 1351.88, 36, 1352.27, 5
4, 12:21:00-000, 93, 42, 51, 45, 1350.44, 47, 1350.01, 6
4, 12:22:00-000, 74, 42, 32, 38, 1351.52, 24, 1351.00, 2
4, 12:23:00-000, 90, 55, 35, 39, 1351.35, 42, 1351.71, 13
4, 12:24:00-000, 52, 24, 28, 34, 1350.32, 26, 1350.34, 4
4, 12:25:00-000, 99, 49, 50, 44, 1350.90, 38, 1350.62, 6
4, 12:26:00-000, 75, 36, 39, 35, 1349.99, 43, 1350.20, 0
4, 12:27:00-000, 92, 34, 58, 33, 1350.93, 37, 1350.78, 12
4, 12:28:00-000, 82, 40, 42, 40, 1350.67, 53, 1350.63, 2
4, 12:29:00-000, 60, 21, 39, 22, 1350.54, 33, 1350.66, 2
4, 12:30:00-000, 84, 37, 47, 35, 1350.39, 42, 1350.70, 10
4, 12:31:00-000, 89, 53, 36, 43, 1352.81, 27, 1352.92, 17
4, 12:32:00-000, 87, 42, 45, 42, 1350.16, 33, 1350.20, 6
4, 12:33:00-000, 82, 29, 53, 27, 1349.33, 40, 1349.67, 6
4, 12:34:00-000, 69, 24, 45, 27, 1349.55, 57, 1350.36, 6
4, 12:35:00-000, 123, 64, 59, 63, 1352.91, 40, 1352.32, 10
4, 12:36:00-000, 101, 58, 43, 52, 1353.49, 40, 1353.34, 15
4, 12:37:00-000, 90, 31, 59, 30, 1347.49, 38, 1347.07, 4
4, 12:38:00-000, 78, 35, 43, 41, 1348.41, 56, 1349.19, 1
4, 12:39:00-000, 86, 48, 38, 45, 1351.04, 25, 1349.87, 3
4, 12:40:00-000, 67, 29, 38, 30, 1351.09, 44, 1351.54, 2
4, 12:41:00-000, 80, 49, 31, 39, 1351.89, 32, 1350.71, 3
4, 12:42:00-000, 84, 49, 35, 58, 1350.20, 35, 1350.79, 2
4, 12:43:00-000, 94, 57, 37, 54, 1351.32, 39, 1351.35, 0
4, 12:44:00-000, 101, 39, 62, 38, 1349.65, 51, 1349.75, 8
4, 12:45:00-000, 69, 37, 32, 28, 1350.25, 30, 1350.46, 12
4, 12:46:00-000, 87, 55, 32, 53, 1352.01, 29, 1351.96, 0
4, 12:47:00-000, 73, 38, 35, 39, 1350.53, 28, 1349.92, 7
4, 12:48:00-000, 60, 26, 34, 27, 1351.77, 36, 1351.24, 0
4, 12:49:00-000, 76, 30, 46, 26, 1347.42, 36, 1348.85, 10
4, 12:50:00-000, 79, 35, 44, 35, 1349.39, 38, 1350.07, 4
4, 12:51:00-000, 92, 39, 53, 36, 1348.38, 43, 1348.22, 17
4, 12:52:00-000, 85, 46, 39, 45, 1349.73, 44, 1350.08, 1
4, 12:53:00-000, 98, 44, 54, 41, 1349.84, 44, 1350.79, 1
4, 12:54:00-000, 78, 29, 49, 31, 1350.77, 42, 1351.06, 7
4, 12:55:00-000, 59, 34, 25, 27, 1351.14, 30, 1351.23, 13
4, 12:56:00-000, 73, 22, 51, 23, 1351.56, 38, 1351.10, 2
4, 12:57:00-000, 77, 51, 26, 43, 1350.46, 39, 1350.43, 0
4, 12:58:00-000, 81, 44, 37, 42, 1351.30, 30, 1351.53, 4
4, 12:59:00-000, 79, 38, 41, 38, 1351.47, 40, 1351.71, 8
4, 13:00:00-000, 95, 33, 62, 33, 1348.72, 49, 1348.93, 4
4, 13:01:00-000, 102, 52, 50, 47, 1348.67, 51, 1348.89, 12
4, 13:02:00-000, 83, 41, 42, 38, 1350.44, 35, 1349.91, 1
4, 13:03:00-000, 98, 43, 55, 44, 1349.85, 51, 1349.74, 16
4, 13:04:00-000, 88, 48, 40, 48, 1352.30, 35, 1353.02, 4
4, 13:05:00-000, 82, 50, 32, 41, 1350.80, 31, 1351.54, 4
4, 13:06:00-000, 86, 36, 50, 45, 1349.77, 48, 1349.16, 1
4, 13:07:00-000, 82, 29, 53, 29, 1349.82, 30, 1350.63, 7
4, 13:08:00-000, 90, 45, 45, 43, 1351.30, 56, 1351.58, 3
4, 13:09:00-000, 72, 24, 48, 24, 1349.08, 47, 1349.61, 6
4, 13:10:00-000, 67, 46, 21, 37, 1350.18, 22, 1349.91, 9
4, 13:11:00-000, 99, 57, 42, 53, 1351.88, 36, 1351.94, 2
4, 13:12:00-000, 85, 41, 44, 37, 1350.91, 43, 1351.29, 2
4, 13:13:00-000, 96, 49, 47, 49, 1350.58, 34, 1350.52, 11
4, 13:14:00-000, 75, 46, 29, 43, 1351.64, 31, 1351.99, 5
4, 13:15:00-000, 69, 31, 38, 31, 1350.32, 37, 1350.67, 2
4, 13:16:00-000, 87, 46, 41, 45, 1351.10, 41, 1350.84, 2
4, 13:17:00-000, 78, 49, 29, 42, 1350.06, 31, 1349.44, 10
4, 13:18:00-000, 66, 34, 32, 33, 1351.30, 28, 1351.85, 2
4, 13:19:00-000, 86, 43, 43, 41, 1352.04, 41, 1351.63, 5
4, 13:20:00-000, 78, 31, 47, 30, 1348.86, 37, 1348.75, 7
4, 13:21:00-000, 77, 44, 33, 43, 1352.69, 37, 1353.29, 0
4, 13:22:00-000, 104, 29, 75, 32, 1350.02, 49, 1349.87, 12
4, 13:23:00-000, 94, 39, 55, 38, 1350.07, 61, 1350.35, 5
4, 13:24:00-000, 70, 41, 29, 39, 1351.27, 19, 1350.68, 3
4, 13:25:00-000, 96, 36, 60, 39, 1349.15, 34, 1349.49, 12
4, 13:26:00-000, 93, 48, 45, 48, 1351.16, 69, 1351.22, 1
4, 13:27:00-000, 74, 34, 40, 33, 1350.51, 33, 1351.02, 3
4, 13:28:00-000, 74, 37, 37, 31, 1350.87, 40, 1351.92, 1
4, 13:29:00-000, 97, 49, 48, 46, 1351.53, 35, 1351.62, 8
4, 13:30:00-000, 87, 45, 42, 41, 1350.84, 52, 1350.95, 3
4, 13:31:00-000, 81, 43, 38, 43, 1350.34, 34, 1350.03, 1
4, 13:32:00-000, 70, 36, 34, 34, 1348.08, 36, 1348.80, 1
4, 13:33:00-000, 96, 57, 39, 59, 1351.45, 37, 1350.88, 5
4, 13:34:00-000, 84, 31, 53, 29, 1348.10, 53, 1349.31, 6
4, 13:35:00-000, 83, 47, 36, 36, 1350.88, 34, 1350.93, 3
4, 13:36:00-000, 71, 31, 40, 37, 1351.94, 40, 1351.17, 2
4, 13:37:00-000, 87, 50, 37, 46, 1349.49, 30, 1349.13, 0
4, 13:38:00-000, 89, 41, 48, 45, 1350.04, 54, 1350.53, 1
4, 13:39:00-000, 95, 51, 44, 50, 1350.37, 42, 1349.87, 1
4, 13:40:00-000, 81, 50, 31, 38, 1351.26, 30, 1351.46, 2
4, 13:41:00-000, 82, 53, 29, 57, 1351.79, 27, 1351.74, 6
4, 13:42:00-000, 70, 24, 46, 26, 1350.53, 49, 1350.65, 2
4, 13:43:00-000, 106, 54, 52, 53, 1350.03, 40, 1350.02, 1
4, 13:44:00-000, 81, 32, 49, 31, 1347.51, 49, 1348.44, 2
4, 13:45:00-000, 72, 48, 24, 44, 1351.24, 25, 1350.67, 5
4, 13:46:00-000, 87, 46, 41, 49, 1350.40, 34, 1350.23, 9
4, 13:47:00-000, 109, 44, 65, 45, 1350.99, 60, 1351.29, 0
4, 13:48:00-000, 78, 36, 42, 36, 1350.55, 40, 1351.22, 8
4, 13:49:00-000, 64, 28, 36, 28, 1350.00, 30, 1351.39, 3
4, 13:50:00-000, 70, 33, 37, 32, 1348.50, 35, 1349.54, 4
4, 13:51:00-000, 74, 25, 49, 25, 1349.60, 29, 1350.03, 8
4, 13:52:00-000, 84, 44, 40, 35, 1348.85, 45, 1349.19, 7
4, 13:53:00-000, 83, 40, 43, 37, 1352.53, 29, 1352.72, 16
4, 13:54:00-000, 76, 27, 49, 30, 1350.66, 44, 1351.13, 4
4, 13:55:00-000, 83, 30, 53, 30, 1349.86, 50, 1349.67, 7
4, 13:56:00-000, 90, 45, 45, 43, 1349.27, 52, 1349.85, 0
4, 13:57:00-000, 78, 43, 35, 44, 1350.08, 31, 1349.74, 2
4, 13:58:00-000, 73, 29, 44, 30, 1350.53, 36, 1350.66, 7
4, 13:59:00-000, 96, 35, 61, 35, 1350.65, 42, 1351.63, 3
4, 14:00:00-000, 108, 65, 43, 56, 1350.97, 59, 1350.94, 5
4, 14:01:00-000, 90, 48, 42, 49, 1351.58, 40, 1351.49, 4
4, 14:02:00-000, 56, 26, 30, 27, 1349.84, 31, 1350.06, 1
4, 14:03:00-000, 84, 42, 42, 32, 1352.18, 38, 1350.63, 9
4, 14:04:00-000, 97, 53, 44, 57, 1351.11, 39, 1351.30, 0
4, 14:05:00-000, 70, 33, 37, 33, 1350.57, 34, 1350.32, 1
4, 14:06:00-000, 75, 39, 36, 34, 1350.88, 38, 1350.78, 13
4, 14:07:00-000, 79, 38, 41, 25, 1349.92, 38, 1350.33, 5
4, 14:08:00-000, 88, 51, 37, 57, 1352.41, 37, 1353.16, 3
4, 14:09:00-000, 78, 42, 36, 38, 1349.94, 28, 1350.60, 3
4, 14:10:00-000, 110, 47, 63, 49, 1351.30, 64, 1350.97, 0
4, 14:11:00-000, 86, 38, 48, 36, 1351.22, 48, 1351.47, 8
4, 14:12:00-000, 69, 36, 33, 37, 1351.26, 30, 1351.39, 1
4, 14:13:00-000, 95, 40, 55, 40, 1350.54, 49, 1350.38, 3
4, 14:14:00-000, 72, 36, 36, 35, 1350.65, 40, 1350.54, 2
4, 14:15:00-000, 68, 36, 32, 27, 1350.11, 22, 1349.27, 1
4, 14:16:00-000, 84, 32, 52, 42, 1348.61, 42, 1349.70, 4
4, 14:17:00-000, 86, 41, 45, 28, 1349.21, 44, 1349.44, 2
4, 14:18:00-000, 87, 35, 52, 45, 1349.77, 53, 1350.65, 3
4, 14:19:00-000, 65, 27, 38, 28, 1350.24, 45, 1350.19, 3
4, 14:20:00-000, 72, 40, 32, 39, 1352.09, 22, 1352.31, 5
4, 14:21:00-000, 75, 46, 29, 39, 1350.71, 35, 1350.65, 3
4, 14:22:00-000, 82, 49, 33, 49, 1351.30, 33, 1350.84, 4
4, 14:23:00-000, 81, 40, 41, 38, 1351.55, 33, 1351.81, 3
4, 14:24:00-000, 92, 48, 44, 50, 1351.61, 46, 1350.60, 1
4, 14:25:00-000, 84, 34, 50, 32, 1350.59, 44, 1350.04, 5
4, 14:26:00-000, 78, 42, 36, 41, 1349.97, 32, 1349.87, 5
4, 14:27:00-000, 75, 41, 34, 37, 1351.40, 28, 1351.07, 8
4, 14:28:00-000, 72, 41, 31, 43, 1352.99, 33, 1353.60, 1
4, 14:29:00-000, 92, 46, 46, 43, 1350.32, 36, 1350.69, 8
4, 14:30:00-000, 93, 41, 52, 43, 1352.20, 51, 1351.93, 0
4, 14:31:00-000, 103, 48, 55, 41, 1349.28, 30, 1348.86, 15
4, 14:32:00-000, 75, 37, 38, 43, 1349.81, 53, 1350.33, 3
4, 14:33:00-000, 89, 47, 42, 46, 1352.06, 34, 1351.52, 0
4, 14:34:00-000, 88, 50, 38, 44, 1350.86, 44, 1350.83, 3
4, 14:35:00-000, 59, 39, 20, 40, 1351.02, 17, 1351.35, 3
4, 14:36:00-000, 99, 63, 36, 57, 1350.95, 37, 1350.86, 2
4, 14:37:00-000, 79, 43, 36, 40, 1351.47, 31, 1351.25, 7
4, 14:38:00-000, 77, 21, 56, 25, 1350.96, 46, 1350.77, 6
4, 14:39:00-000, 68, 28, 40, 26, 1350.07, 35, 1349.59, 7
4, 14:40:00-000, 82, 43, 39, 41, 1350.50, 44, 1351.01, 4
4, 14:41:00-000, 97, 39, 58, 40, 1349.74, 35, 1348.65, 0
4, 14:42:00-000, 70, 35, 35, 35, 1352.56, 53, 1351.53, 3
4, 14:43:00-000, 61, 21, 40, 21, 1350.47, 31, 1351.32, 2
4, 14:44:00-000, 95, 41, 54, 39, 1349.63, 48, 1349.51, 7
4, 14:45:00-000, 77, 38, 39, 39, 1349.97, 45, 1349.19, 1
4, 14:46:00-000, 85, 43, 42, 29, 1349.34, 38, 1349.57, 0
4, 14:47:00-000, 77, 38, 39, 39, 1351.15, 42, 1351.01, 11
4, 14:48:00-000, 97, 50, 47, 47, 1349.97, 42, 1349.95, 3
4, 14:49:00-000, 80, 45, 35, 42, 1352.49, 35, 1351.71, 3
4, 14:50:00-000, 79, 29, 50, 31, 1347.61, 45, 1346.59, 5
4, 14:51:00-000, 69, 32, 37, 32, 1350.96, 29, 1350.96, 6
4, 14:52:00-000, 75, 37, 38, 32, 1351.56, 41, 1351.72, 2
4, 14:53:00-000, 88, 30, 58, 27, 1349.00, 53, 1349.63, 7
4, 14:54:00-000, 86, 50, 36, 55, 1351.43, 36, 1351.71, 5
4, 14:55:00-000, 84, 51, 33, 49, 1350.70, 31, 1350.03, 1
4, 14:56:00-000, 75, 46, 29, 36, 1352.05, 27, 1352.29, 5
4, 14:57:00-000, 95, 56, 39, 55, 1351.92, 39, 1351.45, 9
4, 14:58:00-000, 95, 53, 42, 52, 1351.13, 39, 1351.30, 3
4, 14:59:00-000, 68, 34, 34, 31, 1350.44, 25, 1350.71, 10
4, 15:00:00-000, 87, 56, 31, 50, 1351.71, 33, 1351.48, 1
4, 15:01:00-000, 81, 31, 50, 31, 1350.28, 37, 1350.88, 10
4, 15:02:00-000, 73, 31, 42, 28, 1349.92, 41, 1350.75, 3
4, 15:03:00-000, 77, 45, 32, 46, 1353.56, 28, 1352.57, 13
4, 15:04:00-000, 80, 33, 47, 28, 1349.24, 43, 1350.11, 14
4, 15:05:00-000, 95, 54, 41, 54, 1351.05, 36, 1351.77, 2
4, 15:06:00-000, 53, 13, 40, 13, 1347.54, 31, 1349.38, 3
4, 15:07:00-000, 95, 36, 59, 35, 1347.05, 39, 1348.32, 5
4, 15:08:00-000, 81, 31, 50, 31, 1349.67, 68, 1349.06, 2
4, 15:09:00-000, 75, 28, 47, 29, 1348.85, 39, 1348.40, 2
4, 15:10:00-000, 77, 41, 36, 35, 1350.82, 41, 1350.36, 4
4, 15:11:00-000, 102, 51, 51, 51, 1352.26, 49, 1351.83, 7
4, 15:12:00-000, 63, 39, 24, 39, 1350.84, 21, 1350.38, 1
4, 15:13:00-000, 81, 29, 52, 28, 1350.64, 42, 1350.59, 6
4, 15:14:00-000, 82, 48, 34, 44, 1349.11, 34, 1349.40, 11
4, 15:15:00-000, 61, 21, 40, 19, 1348.94, 29, 1350.41, 5
4, 15:16:00-000, 80, 44, 36, 44, 1351.65, 39, 1351.35, 0
4, 15:17:00-000, 79, 40, 39, 36, 1351.88, 34, 1351.84, 3
4, 15:18:00-000, 65, 34, 31, 31, 1352.54, 27, 1353.51, 13
4, 15:19:00-000, 109, 65, 44, 57, 1350.55, 42, 1350.37, 9
4, 15:20:00-000, 75, 30, 45, 33, 1348.72, 43, 1348.53, 3
4, 15:21:00-000, 93, 57, 36, 51, 1350.93, 37, 1350.56, 3
4, 15:22:00-000, 98, 37, 61, 42, 1350.85, 37, 1351.29, 2
4, 15:23:00-000, 70, 39, 31, 39, 1350.71, 31, 1350.83, 17
4, 15:24:00-000, 100, 45, 55, 46, 1350.73, 43, 1350.13, 1
4, 15:25:00-000, 78, 42, 36, 42, 1350.02, 40, 1350.22, 11
4, 15:26:00-000, 84, 39, 45, 33, 1351.30, 37, 1351.48, 4
4, 15:27:00-000, 79, 28, 51, 30, 1350.06, 32, 1350.09, 11
4, 15:28:00-000, 59, 32, 27, 34, 1352.05, 36, 1351.24, 5
4, 15:29:00-000, 95, 42, 53, 39, 1350.12, 41, 1350.68, 2
4, 15:30:00-000, 93, 34, 59, 35, 1347.85, 60, 1349.36, 4
4, 15:31:00-000, 61, 20, 41, 18, 1351.72, 34, 1351.55, 9
4, 15:32:00-000, 89, 32, 57, 32, 1350.09, 46, 1350.77, 16
4, 15:33:00-000, 72, 40, 32, 36, 1350.52, 28, 1350.18, 2
4, 15:34:00-000, 80, 38, 42, 38, 1350.70, 38, 1351.15, 8
4, 15:35:00-000, 74, 41, 33, 40, 1353.49, 32, 1354.53, 1
4, 15:36:00-000, 77, 37, 40, 35, 1349.88, 36, 1349.69, 2
4, 15:37:00-000, 82, 47, 35, 51, 1350.11, 33, 1350.51, 3
4, 15:38:00-000, 91, 54, 37, 50, 1352.41, 39, 1352.53, 4
4, 15:39:00-000, 56, 30, 26, 20, 1351.35, 22, 1349.95, 9
4, 15:40:00-000, 96, 47, 49, 49, 1350.48, 46, 1350.75, 5
4, 15:41:00-000, 97, 47, 50, 43, 1351.43, 40, 1351.22, 0
4, 15:42:00-000, 106, 64, 42, 63, 1351.88, 40, 1351.30, 4
4, 15:43:00-000, 72, 24, 48, 28, 1349.42, 36, 1349.44, 15
4, 15:44:00-000, 65, 24, 41, 24, 1349.37, 42, 1350.44, 2
4, 15:45:00-000, 85, 40, 45, 39, 1350.99, 44, 1351.13, 3
4, 15:46:00-000, 75, 42, 33, 38, 1350.57, 30, 1350.83, 2
4, 15:47:00-000, 99, 58, 41, 46, 1350.60, 35, 1350.48, 1
4, 15:48:00-000, 80, 55, 25, 59, 1350.99, 40, 1352.14, 5
4, 15:49:00-000, 71, 35, 36, 32, 1350.28, 31, 1350.61, 1
4, 15:50:00-000, 78, 36, 42, 38, 1349.02, 39, 1349.22, 6
4, 15:51:00-000, 82, 34, 48, 34, 1349.76, 46, 1349.97, 2
4, 15:52:00-000, 93, 40, 53, 40, 1348.87, 48, 1349.20, 6
4, 15:53:00-000, 78, 32, 46, 30, 1349.73, 38, 1349.99, 0
4, 15:54:00-000, 91, 43, 48, 44, 1350.06, 45, 1351.30, 6
4, 15:55:00-000, 63, 27, 36, 21, 1349.66, 30, 1350.16, 9
4, 15:56:00-000, 89, 50, 39, 49, 1350.58, 47, 1351.10, 1
4, 15:57:00-000, 73, 41, 32, 45, 1352.24, 28, 1351.92, 3
4, 15:58:00-000, 77, 30, 47, 30, 1351.26, 41, 1351.72, 2
4, 15:59:00-000, 73, 32, 41, 32, 1350.74, 38, 1350.31, 4
4, 16:00:00-000, 75, 37, 38, 32, 1350.31, 38, 1350.73, 5
4, 16:01:00-000, 78, 28, 50, 31, 1350.19, 33, 1350.66, 0
4, 16:02:00-000, 89, 46, 43, 35, 1351.22, 58, 1351.54, 4
4, 16:03:00-000, 68, 38, 30, 34, 1349.99, 27, 1350.11, 8
4, 16:04:00-000, 112, 55, 57, 52, 1350.47, 48, 1350.26, 9
4, 16:05:00-000, 88, 37, 51, 38, 1349.15, 45, 1349.57, 8
4, 16:06:00-000, 73, 36, 37, 37, 1350.53, 36, 1350.69, 0
4, 16:07:00-000, 76, 33, 43, 31, 1350.25, 40, 1350.47, 9
4, 16:08:00-000, 87, 36, 51, 38, 1350.23, 50, 1349.97, 0
4, 16:09:00-000, 88, 44, 44, 35, 1351.42, 40, 1350.09, 6
4, 16:10:00-000, 77, 46, 31, 44, 1352.69, 27, 1353.14, 6
4, 16:11:00-000, 64, 32, 32, 31, 1351.90, 25, 1350.59, 12
4, 16:12:00-000, 86, 35, 51, 29, 1350.27, 39, 1350.94, 10
4, 16:13:00-000, 76, 40, 36, 40, 1350.92, 36, 1351.36, 4
4, 16:14:00-000, 79, 40, 39, 40, 1349.02, 46, 1349.93, 0
4, 16:15:00-000, 98, 61, 37, 52, 1350.68, 37, 1350.40, 5
4, 16:16:00-000, 71, 36, 35, 43, 1351.29, 26, 1350.99, 1
4, 16:17:00-000, 61, 40, 21, 31, 1352.25, 27, 1352.51, 2
4, 16:18:00-000, 66, 34, 32, 38, 1349.60, 29, 1349.93, 4
4, 16:19:00-000, 109, 50, 59, 49, 1350.07, 47, 1350.18, 9
4, 16:20:00-000, 93, 42, 51, 43, 1351.16, 47, 1350.63, 1
4, 16:21:00-000, 82, 40, 42, 40, 1349.87, 46, 1349.92, 2
4, 16:22:00-000, 79, 47, 32, 44, 1352.51, 35, 1351.99, 3
4, 16:23:00-000, 75, 40, 35, 43, 1351.92, 28, 1351.42, 0
4, 16:24:00-000, 81, 50, 31, 43, 1350.41, 38, 1350.41, 0
4, 16:25:00-000, 93, 37, 56, 40, 1349.82, 41, 1349.68, 1
4, 16:26:00-000, 69, 27, 42, 24, 1348.83, 50, 1349.87, 9
4, 16:27:00-000, 85, 53, 32, 43, 1350.60, 30, 1350.89, 2
4, 16:28:00-000, 86, 37, 49, 47, 1348.93, 46, 1349.17, 6
4, 16:29:00-000, 92, 45, 47, 43, 1350.16, 37, 1350.29, 2
5, 09:13:00-000, 10361, 5682, 4679, 3904, 1348.11, 3851, 1349.19, 0
5, 09:14:00-000, 0, 0, 0, 0, 0.00, 22, 1357.00, 613
5, 09:15:00-000, 0, 0, 0, 0, 0.00, 43, 1357.00, 1926
5, 09:16:00-000, 0, 0, 0, 0, 0.00, 0, 0.00, 2
5, 09:26:00-000, 10211, 5477, 4734, 3754, 1348.17, 3726, 1348.21, 0
5, 09:27:00-000, 0, 0, 0, 44, 1348.00, 47, 1356.00, 0
5, 09:28:00-000, 0, 0, 0, 0, 0.00, 98, 1356.09, 1917
5, 09:29:00-000, 17, 15, 2, 11, 1351.00, 2, 1351.00, 625
5, 09:30:00-000, 98, 48, 50, 37, 1348.07, 49, 1349.38, 0
5, 09:31:00-000, 0, 0, 0, 0, 0.00, 1, 1359.00, 3
5, 09:32:00-000, 164, 78, 86, 55, 1349.95, 86, 1352.04, 11
5, 09:33:00-000, 364, 224, 140, 147, 1349.36, 140, 1351.38, 17
5, 09:34:00-000, 650, 353, 297, 249, 1349.26, 255, 1349.92, 25
5, 09:35:00-000, 0, 0, 0, 2, 1347.00, 13, 1358.00, 55
5, 09:36:00-000, 883, 472, 411, 349, 1349.02, 356, 1350.60, 71
5, 09:37:00-000, 1135, 623, 512, 448, 1349.14, 450, 1349.61, 122
5, 09:38:00-000, 1399, 741, 658, 533, 1348.08, 576, 1349.22, 171
5, 09:39:00-000, 0, 0, 0, 11, 1346.00, 36, 1357.91, 118
5, 09:40:00-000, 1405, 731, 674, 553, 1348.86, 596, 1349.61, 214
5, 09:41:00-000, 1178, 678, 500, 473, 1349.54, 411, 1349.95, 204
5, 09:42:00-000, 1130, 638, 492, 410, 1349.21, 437, 1350.31, 221
5, 09:43:00-000, 0, 0, 0, 9, 1348.00, 29, 1358.07, 184
5, 09:44:00-000, 1161, 635, 526, 471, 1349.28, 475, 1350.52, 178
5, 09:45:00-000, 906, 499, 407, 393, 1349.34, 329, 1349.46, 182
5, 09:46:00-000, 855, 454, 401, 368, 1349.07, 356, 1349.83, 151
5, 09:47:00-000, 0, 0, 0, 17, 1346.00, 12, 1357.00, 129
5, 09:48:00-000, 957, 529, 428, 411, 1349.41, 377, 1349.85, 106
5, 09:49:00-000, 982, 490, 492, 352, 1348.40, 388, 1348.94, 87
5, 09:50:00-000, 965, 488, 477, 347, 1348.91, 433, 1350.52, 133
5, 09:51:00-000, 0, 0, 0, 21, 1346.00, 29, 1357.38, 173
5, 09:52:00-000, 967, 508, 459, 403, 1348.92, 422, 1350.40, 138
5, 09:53:00-000, 1065, 529, 536, 427, 1348.45, 428, 1349.06, 126
5, 09:54:00-000, 1089, 598, 491, 476, 1348.38, 499, 1350.19, 80
5, 09:55:00-000, 0, 0, 0, 0, 0.00, 10, 1358.00, 108
5, 09:56:00-000, 1134, 559, 575, 464, 1348.46, 471, 1349.26, 124
5, 09:57:00-000, 1076, 515, 561, 364, 1348.80, 483, 1349.59, 148
5, 09:58:00-000, 950, 508, 442, 360, 1349.46, 402, 1349.87, 120
5, 09:59:00-000, 0, 0, 0, 36, 1346.69, 31, 1357.22, 183
5, 10:00:00-000, 1064, 551, 513, 462, 1347.97, 383, 1348.69, 107
5, 10:01:00-000, 1005, 532, 473, 422, 1348.89, 388, 1349.48, 140
5, 10:02:00-000, 1046, 577, 469, 426, 1349.34, 417, 1349.98, 142
5, 10:03:00-000, 0, 0, 0, 9, 1347.00, 11, 1356.45, 156
5, 10:04:00-000, 1031, 524, 507, 398, 1348.64, 417, 1349.79, 152
5, 10:05:00-000, 963, 501, 462, 346, 1348.84, 340, 1349.01, 150
5, 10:06:00-000, 999, 553, 446, 422, 1348.96, 362, 1349.54, 178
5, 10:07:00-000, 3, 0, 3, 31, 1345.48, 10, 1356.00, 169
5, 10:08:00-000, 1075, 547, 528, 439, 1348.47, 462, 1349.92, 171
5, 10:09:00-000, 1035, 494, 541, 384, 1348.29, 427, 1348.44, 147
5, 10:10:00-000, 1120, 599, 521, 428, 1348.93, 466, 1350.37, 128
5, 10:11:00-000, 0, 0, 0, 15, 1347.00, 30, 1357.00, 140
5, 10:12:00-000, 997, 529, 468, 422, 1348.24, 450, 1349.92, 160
5, 10:13:00-000, 1067, 548, 519, 396, 1347.90, 401, 1348.79, 105
5, 10:14:00-000, 1000, 532, 468, 412, 1348.11, 377, 1349.57, 116
5, 10:15:00-000, 5, 5, 0, 15, 1348.13, 57, 1355.71, 154
5, 10:16:00-000, 1008, 494, 514, 421, 1347.88, 417, 1349.18, 162
5, 10:17:00-000, 997, 525, 472, 352, 1348.89, 332, 1348.86, 137
5, 10:18:00-000, 953, 451, 502, 396, 1347.84, 413, 1349.06, 170
5, 10:19:00-000, 0, 0, 0, 32, 1344.12, 25, 1355.36, 150
5, 10:20:00-000, 1077, 565, 512, 439, 1349.05, 437, 1349.83, 128
5, 10:21:00-000, 1058, 577, 481, 402, 1349.09, 393, 1349.66, 154
5, 10:22:00-000, 1002, 509, 493, 422, 1348.34, 452, 1349.79, 123
5, 10:23:00-000, 0, 0, 0, 8, 1344.88, 26, 1356.77, 166
5, 10:24:00-000, 1054, 530, 524, 455, 1348.43, 457, 1349.78, 129
5, 10:25:00-000, 1059, 550, 509, 427, 1348.56, 383, 1349.53, 107
5, 10:26:00-000, 1094, 565, 529, 423, 1349.06, 409, 1349.42, 135
5, 10:27:00-000, 0, 0, 0, 17, 1346.00, 15, 1355.00, 178
5, 10:28:00-000, 1074, 544, 530, 450, 1348.60, 438, 1349.54, 166
5, 10:29:00-000, 915, 484, 431, 364, 1348.42, 349, 1349.09, 153
5, 10:30:00-000, 979, 530, 449, 346, 1349.47, 443, 1351.22, 139
5, 10:31:00-000, 0, 0, 0, 18, 1347.05, 29, 1357.93, 116
5, 10:32:00-000, 1044, 496, 548, 426, 1348.09, 430, 1348.77, 99
5, 10:33:00-000, 1003, 475, 528, 360, 1348.34, 411, 1349.45, 133
5, 10:34:00-000, 954, 531, 423, 414, 1348.66, 362, 1349.69, 183
5, 10:35:00-000, 1, 0, 1, 0, 0.00, 43, 1355.64, 147
5, 10:36:00-000, 1009, 502, 507, 391, 1348.64, 466, 1350.04, 140
5, 10:37:00-000, 915, 479, 436, 355, 1348.85, 346, 1349.41, 115
5, 10:38:00-000, 1137, 606, 531, 445, 1348.67, 416, 1349.97, 137
5, 10:39:00-000, 0, 0, 0, 27, 1346.00, 21, 1356.00, 147
5, 10:40:00-000, 1098, 579, 519, 440, 1349.39, 407, 1349.95, 179
5, 10:41:00-000, 1085, 529, 556, 406, 1348.81, 426, 1349.10, 179
5, 10:42:00-000, 1057, 522, 535, 475, 1348.03, 412, 1348.94, 213
5, 10:43:00-000, 1, 0, 1, 16, 1344.00, 29, 1354.20, 111
5, 10:44:00-000, 1003, 536, 467, 448, 1348.53, 403, 1350.27, 140
5, 10:45:00-000, 995, 473, 522, 348, 1347.55, 347, 1348.04, 122
5, 10:46:00-000, 1061, 578, 483, 419, 1348.62, 385, 1349.75, 151
5, 10:47:00-000, 1, 1, 0, 30, 1345.90, 17, 1356.00, 164
5, 10:48:00-000, 1012, 580, 432, 459, 1349.66, 370, 1350.98, 221
5, 10:49:00-000, 1030, 561, 469, 359, 1349.30, 352, 1349.84, 160
5, 10:50:00-000, 985, 504, 481, 354, 1348.32, 386, 1349.43, 141
5, 10:51:00-000, 0, 0, 0, 57, 1345.68, 14, 1356.00, 205
5, 10:52:00-000, 920, 439, 481, 366, 1348.65, 366, 1349.04, 179
5, 10:53:00-000, 1087, 584, 503, 418, 1349.22, 403, 1349.36, 155
5, 10:54:00-000, 1050, 565, 485, 475, 1348.43, 430, 1349.49, 120
5, 10:55:00-000, 0, 0, 0, 4, 1346.00, 37, 1357.43, 128
5, 10:56:00-000, 1077, 561, 516, 375, 1349.33, 422, 1350.23, 153
5, 10:57:00-000, 1151, 562, 589, 472, 1348.20, 445, 1348.27, 169
5, 10:58:00-000, 881, 409, 472, 357, 1348.29, 450, 1350.34, 170
5, 10:59:00-000, 0, 0, 0, 4, 1345.00, 28, 1357.00, 119
5, 11:00:00-000, 1082, 562, 520, 424, 1348.60, 413, 1349.23, 98
5, 11:01:00-000, 974, 473, 501, 371, 1348.44, 346, 1349.24, 162
5, 11:02:00-000, 1054, 525, 529, 456, 1348.00, 443, 1349.67, 147
5, 11:03:00-000, 0, 0, 0, 21, 1345.00, 17, 1355.70, 160
5, 11:04:00-000, 999, 498, 501, 415, 1348.52, 410, 1348.99, 168
5, 11:05:00-000, 979, 482, 497, 343, 1348.80, 383, 1349.36, 106
5, 11:06:00-000, 1044, 508, 536, 398, 1348.32, 418, 1349.62, 142
5, 11:07:00-000, 6, 0, 6, 35, 1345.42, 27, 1354.26, 161
5, 11:08:00-000, 1103, 563, 540, 468, 1348.58, 434, 1349.46, 145
5, 11:09:00-000, 939, 493, 446, 382, 1349.22, 365, 1349.44, 160
5, 11:10:00-000, 973, 505, 468, 386, 1348.75, 405, 1349.53, 173
5, 11:11:00-000, 2, 2, 0, 48, 1345.30, 20, 1356.00, 107
5, 11:12:00-000, 1081, 566, 515, 436, 1348.98, 423, 1349.68, 108
5, 11:13:00-000, 1080, 534, 546, 406, 1348.72, 427, 1349.11, 147
5, 11:14:00-000, 1150, 552, 598, 455, 1348.51, 402, 1349.30, 160
5, 11:15:00-000, 2, 1, 1, 30, 1344.63, 22, 1354.00, 141
5, 11:16:00-000, 988, 557, 431, 396, 1349.65, 353, 1350.23, 225
5, 11:17:00-000, 1075, 518, 557, 384, 1348.96, 433, 1349.98, 171
5, 11:18:00-000, 965, 503, 462, 365, 1348.96, 393, 1350.01, 188
5, 11:19:00-000, 0, 0, 0, 14, 1346.00, 13, 1356.00, 183
5, 11:20:00-000, 993, 491, 502, 383, 1348.50, 405, 1349.44, 146
5, 11:21:00-000, 1069, 497, 572, 394, 1348.30, 421, 1348.82, 161
5, 11:22:00-000, 1028, 528, 500, 369, 1348.97, 431, 1350.05, 150
5, 11:23:00-000, 2, 1, 1, 1, 1347.00, 43, 1355.88, 151
5, 11:24:00-000, 1034, 520, 514, 410, 1348.65, 431, 1349.57, 189
5, 11:25:00-000, 1042, 535, 507, 419, 1348.38, 390, 1349.32, 145
5, 11:26:00-000, 1041, 539, 502, 473, 1348.38, 427, 1349.47, 128
5, 11:27:00-000, 1, 0, 1, 0, 0.00, 22, 1355.77, 156
5, 11:28:00-000, 1042, 550, 492, 419, 1348.75, 404, 1349.57, 150
5, 11:29:00-000, 1032, 494, 538, 438, 1347.99, 440, 1348.85, 133
5, 11:30:00-000, 1056, 582, 474, 473, 1348.84, 421, 1349.47, 108
5, 11:31:00-000, 0, 0, 0, 14, 1344.00, 0, 0.00, 124
5, 11:32:00-000, 914, 478, 436, 371, 1348.54, 364, 1349.76, 134
5, 11:33:00-000, 1013, 485, 528, 398, 1347.58, 434, 1348.55, 128
5, 11:34:00-000, 1102, 627, 475, 402, 1349.48, 428, 1350.58, 136
5, 11:35:00-000, 0, 0, 0, 38, 1347.00, 0, 0.00, 115
5, 11:36:00-000, 1051, 550, 501, 440, 1349.27, 442, 1349.93, 191
5, 11:37:00-000, 997, 475, 522, 375, 1348.30, 367, 1348.89, 148
5, 11:38:00-000, 1037, 574, 463, 421, 1349.34, 414, 1350.08, 119
5, 11:39:00-000, 14, 5, 9, 37, 1345.24, 19, 1354.95, 179
5, 11:40:00-000, 994, 498, 496, 374, 1347.85, 414, 1349.17, 159
5, 11:41:00-000, 945, 455, 490, 347, 1348.46, 374, 1349.28, 168
5, 11:42:00-000, 955, 472, 483, 340, 1348.60, 378, 1349.28, 130
5, 11:43:00-000, 1, 1, 0, 24, 1346.25, 10, 1354.00, 148
5, 11:44:00-000, 1058, 571, 487, 505, 1348.63, 388, 1349.84, 158
5, 11:45:00-000, 1056, 527, 529, 394, 1349.04, 420, 1349.84, 150
5, 11:46:00-000, 1016, 574, 442, 448, 1349.05, 414, 1350.99, 108
5, 11:47:00-000, 2, 1, 1, 44, 1345.43, 9, 1355.55, 141
5, 11:48:00-000, 1074, 570, 504, 436, 1348.99, 425, 1349.46, 141
5, 11:49:00-000, 932, 455, 477, 339, 1349.03, 385, 1349.47, 161
5, 11:50:00-000, 1077, 578, 499, 444, 1349.16, 386, 1349.94, 154
5, 11:51:00-000, 1, 0, 1, 18, 1346.05, 10, 1356.20, 134
5, 11:52:00-000, 1095, 509, 586, 388, 1347.94, 489, 1348.94, 155
5, 11:53:00-000, 1011, 509, 502, 358, 1348.56, 405, 1349.51, 159
5, 11:54:00-000, 1037, 542, 495, 398, 1348.57, 425, 1349.96, 173
5, 11:55:00-000, 0, 0, 0, 18, 1346.00, 0, 0.00, 189
5, 11:56:00-000, 1054, 534, 520, 421, 1349.22, 423, 1349.92, 176
5, 11:57:00-000, 990, 505, 485, 372, 1348.79, 411, 1349.35, 188
5, 11:58:00-000, 1032, 559, 473, 400, 1349.17, 361, 1349.60, 135
5, 11:59:00-000, 3, 3, 0, 32, 1346.09, 5, 1356.00, 130
5, 12:00:00-000, 953, 443, 510, 396, 1348.42, 416, 1349.75, 181
5, 12:01:00-000, 1013, 523, 490, 396, 1347.88, 370, 1348.47, 150
5, 12:02:00-000, 1057, 518, 539, 338, 1348.57, 428, 1349.50, 137
5, 12:03:00-000, 10, 7, 3, 27, 1344.81, 1, 1349.00, 160
5, 12:04:00-000, 1048, 547, 501, 422, 1348.57, 450, 1349.95, 206
5, 12:05:00-000, 1101, 542, 559, 451, 1348.26, 431, 1348.99, 121
5, 12:06:00-000, 970, 481, 489, 430, 1348.94, 408, 1350.21, 151
5, 12:07:00-000, 1, 0, 1, 6, 1346.00, 15, 1356.00, 135
5, 12:08:00-000, 1076, 562, 514, 379, 1348.75, 397, 1349.61, 135
5, 12:09:00-000, 1061, 579, 482, 415, 1349.22, 393, 1349.47, 218
5, 12:10:00-000, 952, 520, 432, 400, 1348.65, 374, 1349.77, 145
5, 12:11:00-000, 1, 1, 0, 1, 1354.00, 16, 1357.00, 193
5, 12:12:00-000, 1054, 566, 488, 472, 1349.12, 452, 1350.23, 125
5, 12:13:00-000, 1059, 583, 476, 447, 1349.07, 374, 1349.33, 143
5, 12:14:00-000, 1148, 631, 517, 475, 1348.42, 442, 1349.39, 112
5, 12:15:00-000, 0, 0, 0, 0, 0.00, 0, 0.00, 139
5, 12:16:00-000, 1053, 558, 495, 419, 1349.16, 392, 1349.45, 204
5, 12:17:00-000, 959, 483, 476, 345, 1348.82, 395, 1349.43, 197
5, 12:18:00-000, 1070, 530, 540, 464, 1348.73, 505, 1350.22, 122
5, 12:19:00-000, 0, 0, 0, 0, 0.00, 0, 0.00, 132
5, 12:20:00-000, 924, 471, 453, 327, 1349.22, 338, 1347.88, 149
5, 12:21:00-000, 1110, 543, 567, 370, 1348.48, 396, 1348.11, 184
5, 12:22:00-000, 1081, 554, 527, 378, 1349.38, 387, 1349.28, 198
5, 12:23:00-000, 1, 0, 1, 0, 0.00, 28, 1353.89, 240
5, 12:24:00-000, 942, 523, 419, 379, 1350.02, 298, 1349.78, 239
5, 12:25:00-000, 1039, 555, 484, 442, 1348.83, 368, 1348.52, 170
5, 12:26:00-000, 1154, 584, 570, 439, 1348.81, 479, 1349.72, 167
5, 12:27:00-000, 1, 1, 0, 7, 1346.00, 0, 0.00, 179
5, 12:28:00-000, 1018, 542, 476, 398, 1348.67, 360, 1348.88, 182
5, 12:29:00-000, 1033, 560, 473, 401, 1349.82, 371, 1350.01, 247
5, 12:30:00-000, 1072, 560, 512, 416, 1349.13, 427, 1350.34, 162
5, 12:31:00-000, 6, 6, 0, 10, 1346.00, 0, 0.00, 175
5, 12:32:00-000, 1000, 505, 495, 377, 1348.97, 384, 1349.49, 177
5, 12:33:00-000, 1037, 608, 429, 412, 1349.71, 335, 1349.81, 205
5, 12:34:00-000, 988, 499, 489, 424, 1348.77, 375, 1349.40, 190
5, 12:35:00-000, 0, 0, 0, 7, 1346.00, 0, 0.00, 163
5, 12:36:00-000, 1046, 525, 521, 405, 1348.55, 378, 1349.35, 169
5, 12:37:00-000, 998, 488, 510, 357, 1348.60, 377, 1349.09, 198
5, 12:38:00-000, 948, 491, 457, 319, 1348.90, 374, 1349.64, 186
5, 12:39:00-000, 0, 0, 0, 0, 0.00, 43, 1355.95, 175
5, 12:40:00-000, 943, 466, 477, 378, 1348.44, 386, 1349.64, 170
5, 12:41:00-000, 1134, 536, 598, 412, 1347.99, 419, 1348.83, 156
5, 12:42:00-000, 1003, 536, 467, 394, 1349.07, 385, 1349.52, 154
5, 12:43:00-000, 3, 1, 2, 27, 1345.33, 34, 1355.26, 216
5, 12:44:00-000, 1068, 553, 515, 426, 1348.56, 425, 1349.45, 130
5, 12:45:00-000, 1017, 494, 523, 366, 1348.89, 401, 1348.95, 202
5, 12:46:00-000, 1070, 537, 533, 361, 1349.14, 445, 1349.68, 148
5, 12:47:00-000, 6, 5, 1, 27, 1346.22, 1, 1352.00, 153
5, 12:48:00-000, 898, 441, 457, 350, 1348.70, 377, 1349.74, 198
5, 12:49:00-000, 1013, 531, 482, 413, 1348.64, 410, 1349.25, 140
5, 12:50:00-000, 1026, 466, 560, 388, 1348.60, 421, 1349.63, 147
5, 12:51:00-000, 1, 1, 0, 10, 1345.20, 0, 0.00, 135
5, 12:52:00-000, 1092, 595, 497, 467, 1348.57, 426, 1349.11, 158
5, 12:53:00-000, 956, 509, 447, 408, 1348.81, 345, 1349.31, 174
5, 12:54:00-000, 1004, 516, 488, 380, 1348.35, 365, 1349.71, 120
5, 12:55:00-000, 3, 3, 0, 20, 1346.15, 22, 1356.00, 130
5, 12:56:00-000, 1097, 579, 518, 452, 1348.97, 408, 1349.74, 197
5, 12:57:00-000, 1031, 555, 476, 414, 1349.00, 400, 1349.76, 173
5, 12:58:00-000, 1066, 546, 520, 422, 1348.80, 441, 1349.61, 170
5, 12:59:00-000, 2, 0, 2, 2, 1345.00, 29, 1356.55, 118
5, 13:00:00-000, 1032, 549, 483, 418, 1348.76, 388, 1349.87, 172
5, 13:01:00-000, 988, 533, 455, 402, 1349.09, 385, 1349.71, 165
5, 13:02:00-000, 1101, 567, 534, 420, 1348.31, 421, 1349.07, 152
5, 13:03:00-000, 3, 2, 1, 23, 1346.17, 47, 1355.89, 141
5, 13:04:00-000, 1015, 529, 486, 415, 1348.86, 424, 1349.89, 157
5, 13:05:00-000, 1028, 553, 475, 414, 1349.90, 372, 1350.55, 151
5, 13:06:00-000, 959, 492, 467, 440, 1348.26, 362, 1349.60, 153
5, 13:07:00-000, 0, 0, 0, 37, 1343.99, 24, 1354.58, 90
5, 13:08:00-000, 978, 526, 452, 429, 1349.29, 411, 1350.95, 132
5, 13:09:00-000, 1045, 526, 519, 404, 1348.94, 381, 1349.07, 106
5, 13:10:00-000, 1107, 557, 550, 399, 1348.65, 473, 1350.51, 157
5, 13:11:00-000, 2, 0, 2, 0, 0.00, 41, 1356.87, 129
5, 13:12:00-000, 989, 529, 460, 455, 1349.08, 390, 1350.33, 185
5, 13:13:00-000, 1005, 560, 445, 369, 1349.76, 373, 1350.56, 147
5, 13:14:00-000, 1015, 554, 461, 398, 1349.41, 395, 1349.76, 121
5, 13:15:00-000, 2, 0, 2, 29, 1346.00, 1, 1355.00, 179
5, 13:16:00-000, 1139, 562, 577, 451, 1348.04, 459, 1349.20, 142
5, 13:17:00-000, 1116, 480, 636, 365, 1347.55, 443, 1348.52, 193
5, 13:18:00-000, 1011, 542, 469, 386, 1348.93, 420, 1349.95, 184
5, 13:19:00-000, 2, 2, 0, 28, 1345.28, 0, 0.00, 197
5, 13:20:00-000, 1106, 542, 564, 406, 1348.38, 458, 1349.10, 176
5, 13:21:00-000, 1014, 537, 477, 363, 1349.62, 366, 1349.64, 154
5, 13:22:00-000, 915, 486, 429, 381, 1349.08, 365, 1349.98, 198
5, 13:23:00-000, 5, 3, 2, 5, 1346.00, 16, 1356.00, 157
5, 13:24:00-000, 1008, 473, 535, 397, 1348.10, 439, 1350.00, 129
5, 13:25:00-000, 1033, 537, 496, 411, 1348.64, 402, 1349.19, 187
5, 13:26:00-000, 1008, 493, 515, 428, 1348.25, 425, 1349.63, 103
5, 13:27:00-000, 6, 6, 0, 26, 1346.23, 12, 1355.00, 154
5, 13:28:00-000, 1027, 521, 506, 398, 1349.22, 426, 1350.43, 113
5, 13:29:00-000, 1111, 583, 528, 436, 1348.94, 439, 1349.40, 152
5, 13:30:00-000, 1061, 594, 467, 455, 1349.12, 371, 1349.36, 134
5, 13:31:00-000, 0, 0, 0, 0, 0.00, 13, 1354.23, 182
5, 13:32:00-000, 1037, 509, 528, 417, 1348.97, 412, 1349.96, 189
5, 13:33:00-000, 1032, 480, 552, 383, 1347.85, 427, 1348.66, 133
5, 13:34:00-000, 1003, 496, 507, 374, 1348.58, 395, 1350.15, 167
5, 13:35:00-000, 5, 5, 0, 26, 1345.96, 33, 1354.45, 118
5, 13:36:00-000, 1005, 495, 510, 347, 1348.37, 446, 1350.27, 186
5, 13:37:00-000, 1100, 580, 520, 425, 1349.53, 395, 1350.33, 159
5, 13:38:00-000, 1054, 499, 555, 422, 1347.99, 415, 1348.73, 180
5, 13:39:00-000, 2, 0, 2, 2, 1345.00, 29, 1354.37, 176
5, 13:40:00-000, 1068, 568, 500, 452, 1348.97, 418, 1350.37, 149
5, 13:41:00-000, 986, 518, 468, 376, 1348.93, 378, 1349.68, 129
5, 13:42:00-000, 1055, 527, 528, 441, 1348.68, 400, 1349.72, 206
5, 13:43:00-000, 2, 0, 2, 0, 0.00, 19, 1356.00, 150
5, 13:44:00-000, 940, 505, 435, 417, 1348.16, 371, 1349.05, 129
5, 13:45:00-000, 1058, 510, 548, 417, 1348.87, 401, 1349.47, 147
5, 13:46:00-000, 991, 489, 502, 395, 1348.50, 399, 1349.69, 130
5, 13:47:00-000, 1, 1, 0, 1, 1351.00, 20, 1355.90, 134
5, 13:48:00-000, 976, 499, 477, 360, 1348.90, 422, 1349.95, 173
5, 13:49:00-000, 1088, 519, 569, 401, 1348.25, 427, 1348.63, 160
5, 13:50:00-000, 1050, 534, 516, 415, 1348.39, 443, 1349.31, 163
5, 13:51:00-000, 2, 2, 0, 21, 1345.28, 7, 1355.00, 168
5, 13:52:00-000, 1059, 544, 515, 473, 1347.87, 418, 1349.99, 119
5, 13:53:00-000, 1082, 578, 504, 420, 1348.79, 392, 1349.33, 138
5, 13:54:00-000, 1021, 515, 506, 381, 1348.24, 382, 1349.07, 192
5, 13:55:00-000, 5, 2, 3, 17, 1345.17, 17, 1353.82, 166
5, 13:56:00-000, 1101, 578, 523, 441, 1348.98, 435, 1349.82, 158
5, 13:57:00-000, 1048, 554, 494, 423, 1348.85, 418, 1349.80, 186
5, 13:58:00-000, 994, 517, 477, 388, 1349.41, 363, 1350.53, 158
5, 13:59:00-000, 1, 1, 0, 42, 1345.95, 16, 1356.00, 139
5, 14:00:00-000, 986, 472, 514, 400, 1347.99, 400, 1348.29, 145
5, 14:01:00-000, 1017, 500, 517, 342, 1348.71, 369, 1349.19, 179
5, 14:02:00-000, 1036, 548, 488, 398, 1349.46, 402, 1350.08, 174
5, 14:03:00-000, 5, 5, 0, 21, 1347.00, 1, 1351.00, 217
5, 14:04:00-000, 1037, 552, 485, 425, 1349.54, 379, 1350.92, 154
5, 14:05:00-000, 1046, 554, 492, 423, 1348.64, 388, 1348.98, 181
5, 14:06:00-000, 1064, 511, 553, 422, 1347.56, 367, 1348.33, 161
5, 14:07:00-000, 1, 1, 0, 4, 1346.25, 34, 1355.00, 163
5, 14:08:00-000, 990, 543, 447, 381, 1348.98, 369, 1349.62, 199
5, 14:09:00-000, 941, 497, 444, 377, 1349.05, 334, 1349.89, 176
5, 14:10:00-000, 999, 506, 493, 388, 1348.86, 384, 1349.96, 165
5, 14:11:00-000, 3, 1, 2, 21, 1346.00, 41, 1355.68, 160
5, 14:12:00-000, 996, 455, 541, 398, 1348.01, 387, 1349.27, 156
5, 14:13:00-000, 1032, 539, 493, 399, 1348.81, 413, 1349.71, 124
5, 14:14:00-000, 1000, 517, 483, 419, 1348.73, 456, 1350.28, 162
5, 14:15:00-000, 2, 2, 0, 23, 1345.00, 0, 0.00, 117
5, 14:16:00-000, 1021, 564, 457, 437, 1349.47, 352, 1349.97, 137
5, 14:17:00-000, 1015, 532, 483, 425, 1348.71, 368, 1349.24, 181
5, 14:18:00-000, 1077, 552, 525, 418, 1349.43, 469, 1350.58, 142
5, 14:19:00-000, 11, 9, 2, 20, 1347.00, 8, 1355.13, 147
5, 14:20:00-000, 1019, 565, 454, 406, 1348.99, 387, 1349.80, 150
5, 14:21:00-000, 984, 500, 484, 370, 1348.95, 437, 1350.47, 144
5, 14:22:00-000, 1071, 591, 480, 399, 1349.19, 389, 1350.27, 137
5, 14:23:00-000, 1, 0, 1, 7, 1346.00, 2, 1356.00, 148
5, 14:24:00-000, 986, 504, 482, 376, 1348.55, 407, 1349.98, 213
5, 14:25:00-000, 1087, 556, 531, 416, 1349.19, 435, 1349.42, 195
5, 14:26:00-000, 935, 493, 442, 352, 1348.81, 359, 1349.96, 161
5, 14:27:00-000, 0, 0, 0, 15, 1347.00, 23, 1355.95, 154
5, 14:28:00-000, 1075, 579, 496, 442, 1348.49, 455, 1349.88, 149
5, 14:29:00-000, 1020, 509, 511, 383, 1348.65, 373, 1349.51, 130
5, 14:30:00-000, 962, 495, 467, 412, 1348.16, 418, 1349.78, 162
5, 14:31:00-000, 6, 0, 6, 0, 0.00, 26, 1354.46, 172
5, 14:32:00-000, 1025, 546, 479, 428, 1349.50, 410, 1350.55, 126
5, 14:33:00-000, 1093, 628, 465, 415, 1349.86, 453, 1350.54, 110
5, 14:34:00-000, 1056, 506, 550, 425, 1348.45, 441, 1349.10, 125
5, 14:35:00-000, 1, 0, 1, 18, 1346.00, 19, 1355.68, 138
5, 14:36:00-000, 957, 490, 467, 358, 1348.63, 387, 1349.74, 143
5, 14:37:00-000, 987, 487, 500, 375, 1348.87, 412, 1349.81, 174
5, 14:38:00-000, 1075, 553, 522, 414, 1349.83, 474, 1350.86, 160
5, 14:39:00-000, 1, 1, 0, 28, 1346.18, 16, 1355.69, 122
5, 14:40:00-000, 1013, 559, 454, 379, 1349.19, 387, 1349.92, 118
5, 14:41:00-000, 984, 515, 469, 327, 1349.16, 358, 1349.81, 157
5, 14:42:00-000, 1052, 508, 544, 442, 1347.98, 423, 1349.19, 177
5, 14:43:00-000, 8, 5, 3, 0, 0.00, 37, 1353.75, 195
5, 14:44:00-000, 986, 483, 503, 433, 1347.67, 389, 1348.82, 143
5, 14:45:00-000, 1144, 587, 557, 392, 1349.02, 399, 1349.26, 159
5, 14:46:00-000, 1081, 559, 522, 444, 1348.60, 454, 1349.62, 149
5, 14:47:00-000, 1, 1, 0, 50, 1345.15, 24, 1355.00, 224
5, 14:48:00-000, 1015, 531, 484, 412, 1348.64, 440, 1349.13, 129
5, 14:49:00-000, 1047, 595, 452, 394, 1349.35, 358, 1349.64, 129
5, 14:50:00-000, 989, 514, 475, 417, 1348.66, 346, 1349.07, 131
5, 14:51:00-000, 6, 5, 1, 26, 1346.15, 11, 1354.55, 195
5, 14:52:00-000, 1065, 531, 534, 438, 1348.59, 437, 1349.54, 187
5, 14:53:00-000, 1047, 543, 504, 414, 1349.01, 439, 1349.72, 145
5, 14:54:00-000, 1024, 536, 488, 388, 1348.71, 408, 1349.87, 141
5, 14:55:00-000, 1, 0, 1, 1, 1349.00, 21, 1356.09, 121
5, 14:56:00-000, 1143, 613, 530, 444, 1349.52, 494, 1350.58, 174
5, 14:57:00-000, 1034, 534, 500, 435, 1348.69, 377, 1349.97, 153
5, 14:58:00-000, 982, 478, 504, 340, 1349.06, 401, 1350.25, 145
5, 14:59:00-000, 4, 3, 1, 2, 1347.00, 27, 1355.74, 184
5, 15:00:00-000, 1033, 490, 543, 465, 1347.89, 431, 1349.10, 131
5, 15:01:00-000, 1116, 554, 562, 423, 1349.42, 434, 1349.45, 160
5, 15:02:00-000, 944, 475, 469, 402, 1348.44, 367, 1349.76, 138
5, 15:03:00-000, 3, 0, 3, 28, 1345.00, 48, 1356.12, 153
5, 15:04:00-000, 991, 526, 465, 361, 1348.66, 372, 1349.05, 131
5, 15:05:00-000, 1082, 542, 540, 427, 1348.87, 418, 1349.49, 126
5, 15:06:00-000, 1023, 508, 515, 423, 1348.44, 409, 1349.37, 186
5, 15:07:00-000, 1, 0, 1, 30, 1344.40, 14, 1355.00, 144
5, 15:08:00-000, 1014, 491, 523, 416, 1347.41, 389, 1348.77, 154
5, 15:09:00-000, 1040, 581, 459, 459, 1348.31, 378, 1348.72, 167
5, 15:10:00-000, 962, 498, 464, 360, 1349.02, 368, 1349.54, 130
5, 15:11:00-000, 8, 6, 2, 40, 1345.67, 16, 1355.31, 137
5, 15:12:00-000, 1047, 583, 464, 398, 1349.25, 412, 1350.23, 183
5, 15:13:00-000, 1067, 535, 532, 368, 1348.78, 414, 1348.98, 149
5, 15:14:00-000, 1047, 469, 578, 425, 1348.12, 430, 1348.88, 150
5, 15:15:00-000, 1, 1, 0, 10, 1346.00, 11, 1355.00, 191
5, 15:16:00-000, 1092, 596, 496, 456, 1349.51, 466, 1350.33, 152
5, 15:17:00-000, 1006, 516, 490, 438, 1349.53, 386, 1349.71, 156
5, 15:18:00-000, 962, 450, 512, 321, 1349.14, 447, 1350.45, 119
5, 15:19:00-000, 4, 0, 4, 38, 1345.39, 1, 1351.00, 115
5, 15:20:00-000, 1051, 539, 512, 399, 1349.09, 399, 1349.96, 157
5, 15:21:00-000, 1009, 486, 523, 382, 1348.63, 383, 1348.67, 178
5, 15:22:00-000, 1066, 586, 480, 444, 1349.23, 424, 1350.60, 164
5, 15:23:00-000, 5, 5, 0, 5, 1349.60, 9, 1356.00, 114
5, 15:24:00-000, 1038, 521, 517, 488, 1348.42, 409, 1349.70, 167
5, 15:25:00-000, 1023, 526, 497, 396, 1348.82, 380, 1349.26, 168
5, 15:26:00-000, 1060, 535, 525, 410, 1348.46, 429, 1349.15, 153
5, 15:27:00-000, 1, 0, 1, 31, 1345.00, 42, 1355.35, 142
5, 15:28:00-000, 936, 537, 399, 409, 1348.98, 353, 1350.16, 126
5, 15:29:00-000, 971, 484, 487, 375, 1349.04, 363, 1349.49, 126
5, 15:30:00-000, 1081, 558, 523, 444, 1348.68, 452, 1349.76, 145
5, 15:31:00-000, 3, 3, 0, 6, 1345.50, 5, 1357.00, 155
5, 15:32:00-000, 1161, 622, 539, 447, 1349.06, 412, 1349.65, 181
5, 15:33:00-000, 997, 496, 501, 383, 1349.02, 370, 1348.98, 168
5, 15:34:00-000, 981, 504, 477, 379, 1348.91, 400, 1350.55, 225
5, 15:35:00-000, 3, 0, 3, 0, 0.00, 67, 1356.36, 130
5, 15:36:00-000, 1037, 560, 477, 391, 1349.27, 432, 1350.62, 154
5, 15:37:00-000, 998, 513, 485, 388, 1348.74, 348, 1349.07, 144
5, 15:38:00-000, 982, 489, 493, 373, 1348.57, 446, 1350.15, 146
5, 15:39:00-000, 2, 1, 1, 12, 1346.25, 33, 1355.78, 146
5, 15:40:00-000, 1052, 571, 481, 395, 1349.35, 317, 1348.53, 162
5, 15:41:00-000, 1048, 514, 534, 351, 1348.83, 387, 1348.96, 206
5, 15:42:00-000, 1045, 495, 550, 335, 1349.25, 404, 1348.67, 235
5, 15:43:00-000, 3, 1, 2, 1, 1350.00, 0, 0.00, 262
5, 15:44:00-000, 964, 452, 512, 397, 1349.04, 417, 1349.26, 202
5, 15:45:00-000, 1064, 562, 502, 401, 1349.74, 360, 1349.50, 155
5, 15:46:00-000, 875, 460, 415, 364, 1350.13, 297, 1349.61, 166
5, 15:47:00-000, 0, 0, 0, 17, 1346.00, 0, 0.00, 212
5, 15:48:00-000, 925, 474, 451, 318, 1349.08, 355, 1349.23, 192
5, 15:49:00-000, 1096, 574, 522, 394, 1349.24, 397, 1349.63, 153
5, 15:50:00-000, 1053, 539, 514, 373, 1348.97, 391, 1350.02, 168
5, 15:51:00-000, 7, 0, 7, 17, 1346.00, 6, 1351.50, 216
5, 15:52:00-000, 992, 487, 505, 383, 1349.01, 408, 1349.56, 234
5, 15:53:00-000, 1003, 440, 563, 345, 1348.55, 369, 1348.61, 175
5, 15:54:00-000, 1080, 557, 523, 441, 1349.42, 418, 1350.32, 161
5, 15:55:00-000, 1, 1, 0, 31, 1345.70, 0, 0.00, 159
5, 15:56:00-000, 1052, 533, 519, 407, 1349.19, 418, 1350.32, 178
5, 15:57:00-000, 1001, 457, 544, 347, 1348.14, 403, 1348.58, 209
5, 15:58:00-000, 1065, 523, 542, 401, 1348.66, 397, 1349.32, 181
5, 15:59:00-000, 4, 4, 0, 3, 1347.67, 25, 1354.20, 156
5, 16:00:00-000, 950, 497, 453, 387, 1348.70, 402, 1349.96, 145
5, 16:01:00-000, 1024, 532, 492, 387, 1348.66, 372, 1348.68, 187
5, 16:02:00-000, 1015, 512, 503, 342, 1348.89, 359, 1349.54, 143
5, 16:03:00-000, 2, 1, 1, 46, 1345.36, 0, 0.00, 205
5, 16:04:00-000, 1060, 601, 459, 461, 1349.23, 355, 1349.53, 204
5, 16:05:00-000, 1006, 564, 442, 399, 1349.18, 346, 1349.51, 187
5, 16:06:00-000, 1047, 549, 498, 503, 1348.82, 398, 1349.29, 197
5, 16:07:00-000, 0, 0, 0, 0, 0.00, 1, 1355.00, 141
5, 16:08:00-000, 1175, 574, 601, 460, 1348.67, 489, 1349.46, 166
5, 16:09:00-000, 1027, 520, 507, 398, 1349.47, 429, 1349.69, 132
5, 16:10:00-000, 1049, 483, 566, 369, 1348.97, 449, 1349.58, 176
5, 16:11:00-000, 6, 5, 1, 25, 1345.24, 7, 1354.00, 156
5, 16:12:00-000, 1032, 485, 547, 402, 1348.88, 435, 1350.05, 129
5, 16:13:00-000, 960, 510, 450, 407, 1349.07, 334, 1349.80, 143
5, 16:14:00-000, 949, 478, 471, 390, 1348.62, 382, 1349.53, 169
5, 16:15:00-000, 4, 2, 2, 6, 1344.67, 17, 1355.00, 137
5, 16:16:00-000, 945, 487, 458, 393, 1349.22, 396, 1350.21, 143
5, 16:17:00-000, 1053, 542, 511, 411, 1348.76, 409, 1349.62, 112
5, 16:18:00-000, 1094, 499, 595, 407, 1347.90, 457, 1349.17, 120
5, 16:19:00-000, 3, 0, 3, 9, 1346.33, 34, 1353.97, 160
5, 16:20:00-000, 1131, 625, 506, 451, 1349.64, 406, 1350.23, 150
5, 16:21:00-000, 1022, 528, 494, 374, 1349.18, 384, 1349.81, 171
5, 16:22:00-000, 1019, 522, 497, 352, 1349.10, 408, 1350.02, 242
5, 16:23:00-000, 4, 0, 4, 10, 1346.00, 15, 1355.07, 193
5, 16:24:00-000, 1084, 573, 511, 408, 1349.03, 398, 1349.92, 182
5, 16:25:00-000, 1045, 563, 482, 383, 1349.86, 407, 1350.42, 200
5, 16:26:00-000, 1042, 545, 497, 406, 1348.90, 396, 1349.51, 185
5, 16:27:00-000, 1, 0, 1, 51, 1345.74, 4, 1354.00, 178
5, 16:28:00-000, 1121, 533, 588, 420, 1348.67, 457, 1350.25, 178
5, 16:29:00-000, 1021, 513, 508, 372, 1348.61, 358, 1349.04, 157
6, 12:20:00-000, 6946, 3483, 3463, 1651, 1347.68, 1727, 1348.58, 0
6, 12:21:00-000, 0, 0, 0, 82, 1346.00, 87, 1354.00, 0
6, 12:22:00-000, 0, 0, 0, 127, 1346.00, 117, 1354.00, 0
6, 12:23:00-000, 0, 0, 0, 39, 1346.00, 22, 1355.00, 0
6, 12:24:00-000, 0, 0, 0, 17, 1346.00, 126, 1355.00, 0
6, 12:25:00-000, 0, 0, 0, 0, 0.00, 59, 1355.00, 0
6, 12:26:00-000, 0, 0, 0, 1, 1345.00, 20, 1355.00, 0
6, 12:27:00-000, 0, 0, 0, 5, 1345.00, 0, 0.00, 0
6, 12:28:00-000, 0, 0, 0, 45, 1345.00, 0, 0.00, 0
6, 12:30:00-000, 0, 0, 0, 28, 1345.00, 0, 0.00, 0
6, 12:31:00-000, 0, 0, 0, 0, 0.00, 54, 1356.00, 0
6, 12:32:00-000, 0, 0, 0, 47, 1345.00, 1, 1356.00, 0
6, 12:33:00-000, 0, 0, 0, 0, 0.00, 2, 1356.00, 0
6, 12:34:00-000, 0, 0, 0, 0, 0.00, 10, 1356.00, 0
6, 12:35:00-000, 0, 0, 0, 43, 1345.00, 62, 1356.00, 0
6, 12:36:00-000, 0, 0, 0, 0, 0.00, 55, 1356.00, 0
6, 12:37:00-000, 0, 0, 0, 63, 1345.00, 23, 1356.00, 0
6, 12:38:00-000, 0, 0, 0, 7, 1345.00, 35, 1356.00, 0
6, 12:39:00-000, 0, 0, 0, 0, 0.00, 8, 1357.00, 0
6, 12:40:00-000, 0, 0, 0, 17, 1345.00, 0, 0.00, 114
6, 12:41:00-000, 0, 0, 0, 0, 0.00, 0, 0.00, 121
6, 12:42:00-000, 0, 0, 0, 0, 0.00, 0, 0.00, 117
6, 12:43:00-000, 0, 0, 0, 0, 0.00, 0, 0.00, 126
6, 12:44:00-000, 0, 0, 0, 0, 0.00, 0, 0.00, 118
6, 12:45:00-000, 0, 0, 0, 0, 0.00, 0, 0.00, 113
6, 12:46:00-000, 0, 0, 0, 0, 0.00, 0, 0.00, 132
6, 12:47:00-000, 0, 0, 0, 0, 0.00, 0, 0.00, 117
6, 12:48:00-000, 0, 0, 0, 0, 0.00, 0, 0.00, 112
6, 12:49:00-000, 0, 0, 0, 0, 0.00, 0, 0.00, 128
6, 12:50:00-000, 0, 0, 0, 0, 0.00, 0, 0.00, 106
6, 12:51:00-000, 0, 0, 0, 12, 1344.00, 0, 0.00, 133
6, 12:52:00-000, 0, 0, 0, 26, 1344.00, 0, 0.00, 110
6, 12:53:00-000, 0, 0, 0, 13, 1344.00, 0, 0.00, 111
6, 12:54:00-000, 0, 0, 0, 27, 1344.00, 0, 0.00, 120
6, 12:55:00-000, 0, 0, 0, 0, 0.00, 9, 1357.00, 108
6, 12:56:00-000, 0, 0, 0, 0, 0.00, 1, 1357.00, 92
6, 12:57:00-000, 0, 0, 0, 0, 0.00, 0, 0.00, 106
6, 12:58:00-000, 0, 0, 0, 0, 0.00, 0, 0.00, 100
6, 12:59:00-000, 0, 0, 0, 0, 0.00, 2, 1357.00, 92
6, 15:40:00-000, 6935, 3457, 3478, 1703, 1347.78, 1707, 1348.48, 0
6, 15:41:00-000, 0, 0, 0, 37, 1346.00, 14, 1354.00, 0
6, 15:42:00-000, 0, 0, 0, 83, 1346.00, 118, 1354.00, 0
6, 15:43:00-000, 0, 0, 0, 67, 1346.00, 9, 1354.00, 0
6, 15:44:00-000, 0, 0, 0, 49, 1345.58, 101, 1354.14, 0
6, 15:45:00-000, 0, 0, 0, 0, 0.00, 46, 1355.00, 0
6, 15:46:00-000, 0, 0, 0, 0, 0.00, 128, 1355.00, 0
6, 15:48:00-000, 0, 0, 0, 53, 1345.00, 25, 1355.00, 0
6, 15:49:00-000, 0, 0, 0, 6, 1345.00, 5, 1355.00, 0
6, 15:50:00-000, 0, 0, 0, 42, 1345.00, 16, 1355.00, 0
6, 15:52:00-000, 0, 0, 0, 80, 1345.00, 17, 1356.00, 0
6, 15:53:00-000, 0, 0, 0, 28, 1345.00, 0, 0.00, 0
6, 15:54:00-000, 0, 0, 0, 23, 1345.00, 0, 0.00, 0
6, 15:55:00-000, 0, 0, 0, 11, 1344.00, 0, 0.00, 0
6, 15:56:00-000, 0, 0, 0, 0, 0.00, 1, 1356.00, 0
6, 15:57:00-000, 0, 0, 0, 0, 0.00, 5, 1356.00, 0
6, 15:59:00-000, 0, 0, 0, 7, 1344.00, 0, 0.00, 0
6, 16:00:00-000, 4, 4, 0, 1, 1350.00, 1, 1356.00, 127
6, 16:01:00-000, 0, 0, 0, 1, 1345.00, 23, 1356.00, 130
6, 16:02:00-000, 0, 0, 0, 0, 0.00, 45, 1356.00, 105
6, 16:03:00-000, 1, 1, 0, 1, 1349.00, 39, 1356.00, 114
6, 16:04:00-000, 0, 0, 0, 0, 0.00, 11, 1356.00, 124
6, 16:05:00-000, 0, 0, 0, 0, 0.00, 0, 0.00, 129
6, 16:06:00-000, 0, 0, 0, 0, 0.00, 0, 0.00, 138
6, 16:07:00-000, 0, 0, 0, 8, 1344.00, 26, 1356.00, 129
6, 16:08:00-000, 0, 0, 0, 0, 0.00, 0, 0.00, 114
6, 16:09:00-000, 0, 0, 0, 10, 1344.00, 12, 1356.00, 122
6, 16:10:00-000, 0, 0, 0, 0, 0.00, 11, 1357.00, 106
6, 16:11:00-000, 0, 0, 0, 0, 0.00, 0, 0.00, 143
6, 16:12:00-000, 0, 0, 0, 0, 0.00, 0, 0.00, 96
6, 16:13:00-000, 0, 0, 0, 0, 0.00, 0, 0.00, 106
6, 16:14:00-000, 0, 0, 0, 15, 1344.00, 0, 0.00, 98
6, 16:15:00-000, 0, 0, 0, 29, 1344.00, 0, 0.00, 106
6, 16:16:00-000, 0, 0, 0, 0, 0.00, 0, 0.00, 110
6, 16:17:00-000, 0, 0, 0, 0, 0.00, 0, 0.00, 105
6, 16:18:00-000, 0, 0, 0, 0, 0.00, 0, 0.00, 108
6, 16:19:00-000, 0, 0, 0, 0, 0.00, 0, 0.00, 113
6, 16:20:00-000, 14, 12, 2, 5, 1350.20, 0, 0.00, 1
6, 16:21:00-000, 0, 0, 0, 3, 1345.00, 0, 0.00, 0
6, 16:28:00-000, 0, 0, 0, 2, 1344.00, 0, 0.00, 0
8, 09:06:00-000, 3911, 2243, 1668, 0, 0.00, 0, 0.00, 3902
8, 09:07:00-000, 7440, 1062, 6378, 0, 0.00, 0, 0.00, 5925
8, 09:08:00-000, 1, 1, 0, 1, 1353.00, 1, 1352.00, 1523
8, 09:26:00-000, 2501, 1633, 868, 0, 0.00, 0, 0.00, 2501
8, 09:30:00-000, 3393, 1370, 2023, 1, 1347.00, 1, 1349.00, 3391
8, 09:46:00-000, 307, 300, 7, 0, 0.00, 0, 0.00, 307
8, 09:49:00-000, 113, 3, 110, 0, 0.00, 0, 0.00, 113
8, 09:52:00-000, 76, 6, 70, 0, 0.00, 0, 0.00, 76
8, 09:53:00-000, 4705, 1550, 3155, 0, 0.00, 0, 0.00, 4705
8, 09:54:00-000, 1545, 100, 1445, 0, 0.00, 0, 0.00, 1545
8, 09:56:00-000, 921, 16, 905, 0, 0.00, 0, 0.00, 921
8, 09:57:00-000, 4429, 2803, 1626, 0, 0.00, 0, 0.00, 4425
8, 09:58:00-000, 0, 0, 0, 0, 0.00, 0, 0.00, 4
8, 10:00:00-000, 10521, 7423, 3098, 0, 0.00, 0, 0.00, 9935
8, 10:01:00-000, 4098, 3317, 781, 5, 1353.20, 5, 1352.00, 4602
8, 10:02:00-000, 1078, 233, 845, 8, 1349.63, 8, 1352.00, 1134
8, 10:04:00-000, 2127, 2059, 68, 0, 0.00, 0, 0.00, 2127
8, 10:05:00-000, 6222, 2856, 3366, 12, 1347.00, 12, 1349.50, 5997
8, 10:06:00-000, 1976, 1799, 177, 22, 1352.09, 22, 1353.91, 2133
8, 10:08:00-000, 802, 114, 688, 0, 0.00, 0, 0.00, 694
8, 10:09:00-000, 871, 774, 97, 0, 0.00, 0, 0.00, 979
8, 10:12:00-000, 439, 432, 7, 7, 1352.86, 7, 1351.00, 425
8, 10:13:00-000, 6634, 4595, 2039, 0, 0.00, 0, 0.00, 6634
8, 10:14:00-000, 2382, 2019, 363, 0, 0.00, 0, 0.00, 2179
8, 10:15:00-000, 4891, 2239, 2652, 0, 0.00, 0, 0.00, 5094
8, 10:16:00-000, 2419, 934, 1485, 0, 0.00, 0, 0.00, 2419
8, 10:17:00-000, 124, 24, 100, 24, 1351.08, 24, 1352.00, 76
8, 10:18:00-000, 154, 130, 24, 0, 0.00, 0, 0.00, 154
8, 10:20:00-000, 2249, 1154, 1095, 0, 0.00, 0, 0.00, 2248
8, 10:21:00-000, 4773, 2722, 2051, 22, 1354.41, 22, 1352.77, 4730
8, 10:23:00-000, 3860, 299, 3561, 8, 1354.75, 8, 1351.25, 3844
8, 10:24:00-000, 9136, 6620, 2516, 0, 0.00, 0, 0.00, 9136
8, 10:25:00-000, 7865, 4687, 3178, 5, 1349.00, 5, 1350.00, 7855
8, 10:26:00-000, 6531, 1450, 5081, 2, 1349.00, 2, 1348.50, 6527
8, 10:27:00-000, 6793, 1582, 5211, 3, 1350.00, 3, 1349.00, 6787
8, 10:28:00-000, 6802, 3981, 2821, 0, 0.00, 0, 0.00, 6186
8, 10:29:00-000, 2796, 1904, 892, 0, 0.00, 0, 0.00, 3412
8, 10:32:00-000, 3757, 1878, 1879, 10, 1350.00, 14, 1350.79, 3733
8, 10:33:00-000, 2367, 136, 2231, 4, 1351.00, 0, 0.00, 2363
8, 10:34:00-000, 4545, 2941, 1604, 8, 1355.38, 8, 1351.13, 4529
8, 10:35:00-000, 4184, 3318, 866, 9, 1347.89, 9, 1352.00, 4166
8, 10:36:00-000, 1266, 22, 1244, 4, 1350.00, 4, 1347.75, 1258
8, 10:38:00-000, 3599, 1639, 1960, 7, 1348.71, 7, 1351.43, 3585
8, 10:39:00-000, 4173, 1735, 2438, 0, 0.00, 0, 0.00, 4172
8, 10:40:00-000, 4620, 3076, 1544, 0, 0.00, 0, 0.00, 4621
8, 10:41:00-000, 4588, 3288, 1300, 0, 0.00, 0, 0.00, 4588
8, 10:42:00-000, 2718, 1667, 1051, 26, 1347.34, 26, 1350.07, 2666
8, 10:43:00-000, 4006, 1692, 2314, 1, 1348.00, 1, 1346.00, 4004
8, 10:44:00-000, 178, 170, 8, 0, 0.00, 0, 0.00, 178
8, 10:45:00-000, 6265, 2900, 3365, 2, 1351.00, 2, 1353.00, 6261
8, 10:46:00-000, 1960, 1575, 385, 13, 1348.23, 13, 1350.92, 1934
8, 10:47:00-000, 1687, 256, 1431, 0, 0.00, 0, 0.00, 1687
8, 10:50:00-000, 736, 98, 638, 9, 1347.00, 7, 1348.29, 720
8, 10:51:00-000, 2546, 895, 1651, 0, 0.00, 2, 1349.50, 2544
8, 10:53:00-000, 8086, 6776, 1310, 3, 1350.00, 3, 1352.00, 8080
8, 10:54:00-000, 6670, 3994, 2676, 1, 1349.00, 1, 1349.00, 6668
8, 10:56:00-000, 66, 6, 60, 0, 0.00, 0, 0.00, 66
8, 10:57:00-000, 302, 105, 197, 6, 1352.67, 6, 1350.33, 290
8, 10:58:00-000, 2317, 122, 2195, 0, 0.00, 0, 0.00, 2317
8, 10:59:00-000, 4308, 3218, 1090, 1, 1352.00, 1, 1351.00, 4306
8, 11:00:00-000, 3029, 1193, 1836, 12, 1349.75, 12, 1353.00, 3005
8, 11:01:00-000, 4132, 2088, 2044, 2, 1348.00, 2, 1349.00, 4128
8, 11:02:00-000, 1680, 440, 1240, 1, 1349.00, 1, 1350.00, 1678
8, 11:04:00-000, 975, 301, 674, 27, 1352.48, 27, 1352.00, 921
8, 11:05:00-000, 9982, 5147, 4835, 6, 1352.00, 6, 1349.50, 9970
8, 11:06:00-000, 3471, 2662, 809, 0, 0.00, 0, 0.00, 3471
8, 11:07:00-000, 117, 105, 12, 0, 0.00, 0, 0.00, 117
8, 11:09:00-000, 1418, 616, 802, 0, 0.00, 0, 0.00, 1412
8, 11:10:00-000, 2389, 858, 1531, 0, 0.00, 0, 0.00, 2395
8, 11:11:00-000, 2093, 1892, 201, 0, 0.00, 0, 0.00, 2093
8, 11:12:00-000, 7820, 5084, 2736, 13, 1346.00, 13, 1347.00, 6159
8, 11:13:00-000, 9244, 3742, 5502, 11, 1350.54, 10, 1350.00, 9937
8, 11:14:00-000, 2754, 1217, 1537, 2, 1350.00, 3, 1347.00, 3670
8, 11:15:00-000, 5732, 3785, 1947, 0, 0.00, 0, 0.00, 5732
8, 11:17:00-000, 942, 143, 799, 1, 1349.00, 1, 1347.00, 940
8, 11:18:00-000, 1572, 465, 1107, 1, 1354.00, 1, 1350.00, 1263
8, 11:19:00-000, 1480, 1196, 284, 0, 0.00, 0, 0.00, 1677
8, 11:20:00-000, 0, 0, 0, 0, 0.00, 0, 0.00, 110
8, 11:21:00-000, 3424, 2054, 1370, 2, 1353.00, 2, 1352.00, 3420
8, 11:22:00-000, 219, 151, 68, 0, 0.00, 0, 0.00, 219
8, 11:23:00-000, 4264, 2530, 1734, 4, 1350.75, 4, 1350.00, 4256
8, 11:24:00-000, 4535, 379, 4156, 12, 1349.83, 12, 1351.58, 4511
8, 11:25:00-000, 6746, 2741, 4005, 85, 1353.18, 85, 1350.87, 6576
8, 11:26:00-000, 1892, 498, 1394, 13, 1349.00, 13, 1351.46, 1866
8, 11:27:00-000, 939, 49, 890, 49, 1354.61, 49, 1352.00, 841
8, 11:28:00-000, 1174, 1165, 9, 0, 0.00, 0, 0.00, 1174
8, 11:29:00-000, 6174, 3840, 2334, 1, 1351.00, 1, 1350.00, 6172
8, 11:30:00-000, 732, 377, 355, 0, 0.00, 0, 0.00, 660
8, 11:31:00-000, 9522, 9098, 424, 0, 0.00, 0, 0.00, 9535
8, 11:32:00-000, 1626, 755, 871, 19, 1349.58, 19, 1349.32, 1647
8, 11:33:00-000, 7404, 6316, 1088, 1, 1348.00, 1, 1350.00, 7184
8, 11:34:00-000, 6738, 6382, 356, 19, 1349.52, 19, 1351.05, 6918
8, 11:36:00-000, 2295, 1346, 949, 1, 1350.00, 0, 0.00, 2294
8, 11:37:00-000, 2900, 877, 2023, 0, 0.00, 1, 1350.00, 2899
8, 11:38:00-000, 6481, 5933, 548, 35, 1348.37, 35, 1348.00, 6411
8, 11:39:00-000, 815, 810, 5, 0, 0.00, 0, 0.00, 815
8, 11:40:00-000, 1948, 144, 1804, 29, 1353.82, 29, 1353.45, 1890
8, 11:41:00-000, 4104, 3472, 632, 0, 0.00, 0, 0.00, 4083
8, 11:42:00-000, 1553, 76, 1477, 7, 1351.00, 7, 1350.00, 81
8, 11:43:00-000, 4420, 1663, 2757, 3, 1349.33, 4, 1349.25, 5892
8, 11:44:00-000, 949, 941, 8, 1, 1352.00, 0, 0.00, 948
8, 11:45:00-000, 5899, 4816, 1083, 10, 1352.20, 10, 1350.30, 5879
8, 11:47:00-000, 4117, 2746, 1371, 1, 1348.00, 1, 1349.00, 4115
8, 11:48:00-000, 1978, 925, 1053, 20, 1349.05, 20, 1348.35, 1869
8, 11:49:00-000, 60, 10, 50, 0, 0.00, 0, 0.00, 129
8, 11:50:00-000, 939, 28, 911, 0, 0.00, 0, 0.00, 939
8, 11:51:00-000, 7113, 3588, 3525, 0, 0.00, 0, 0.00, 7057
8, 11:52:00-000, 592, 356, 236, 8, 1350.50, 8, 1350.25, 632
8, 11:53:00-000, 1318, 1186, 132, 0, 0.00, 0, 0.00, 1318
8, 11:54:00-000, 354, 191, 163, 0, 0.00, 0, 0.00, 340
8, 11:55:00-000, 2908, 2852, 56, 1, 1351.00, 1, 1352.00, 2920
8, 11:56:00-000, 4237, 2218, 2019, 2, 1350.00, 2, 1349.00, 4233
8, 11:57:00-000, 112, 6, 106, 6, 1350.00, 6, 1347.67, 100
8, 11:58:00-000, 2108, 220, 1888, 0, 0.00, 0, 0.00, 2108
8, 11:59:00-000, 3809, 3343, 466, 11, 1350.54, 11, 1350.09, 3787
8, 12:00:00-000, 8715, 5698, 3017, 1, 1348.00, 1, 1351.00, 8713
8, 12:01:00-000, 5333, 3680, 1653, 5, 1351.20, 5, 1350.80, 5323
8, 12:02:00-000, 9175, 2940, 6235, 16, 1348.56, 18, 1352.22, 9141
8, 12:03:00-000, 5689, 302, 5387, 2, 1353.00, 0, 0.00, 5687
8, 12:04:00-000, 664, 650, 14, 0, 0.00, 0, 0.00, 664
8, 12:05:00-000, 1915, 975, 940, 12, 1345.67, 11, 1346.73, 1892
8, 12:06:00-000, 3495, 1171, 2324, 0, 0.00, 1, 1351.00, 3494
8, 12:07:00-000, 3605, 1712, 1893, 0, 0.00, 0, 0.00, 3529
8, 12:08:00-000, 1686, 818, 868, 21, 1352.71, 21, 1351.95, 1720
8, 12:13:00-000, 2056, 1790, 266, 0, 0.00, 0, 0.00, 2056
8, 12:14:00-000, 2282, 2271, 11, 1, 1356.00, 1, 1351.00, 2280
8, 12:15:00-000, 4527, 3162, 1365, 0, 0.00, 0, 0.00, 4527
8, 12:16:00-000, 4343, 1278, 3065, 0, 0.00, 0, 0.00, 4334
8, 12:17:00-000, 5275, 3286, 1989, 1, 1350.00, 1, 1347.00, 5282
8, 12:24:00-000, 2803, 1390, 1413, 14, 1350.07, 18, 1350.61, 2771
8, 12:25:00-000, 1647, 1546, 101, 5, 1351.80, 0, 0.00, 1642
8, 12:26:00-000, 1557, 830, 727, 0, 0.00, 1, 1350.00, 1556
8, 12:28:00-000, 1418, 8, 1410, 0, 0.00, 0, 0.00, 1418
8, 12:29:00-000, 4061, 1132, 2929, 10, 1351.00, 10, 1351.00, 3978
8, 12:30:00-000, 702, 685, 17, 16, 1352.50, 16, 1351.50, 733
8, 12:32:00-000, 1625, 1538, 87, 0, 0.00, 0, 0.00, 1625
8, 12:33:00-000, 2180, 798, 1382, 0, 0.00, 0, 0.00, 2180
8, 12:34:00-000, 2343, 368, 1975, 6, 1352.33, 9, 1353.00, 2328
8, 12:35:00-000, 57, 7, 50, 3, 1353.00, 0, 0.00, 54
8, 12:39:00-000, 3445, 1658, 1787, 0, 0.00, 0, 0.00, 3445
8, 12:41:00-000, 660, 650, 10, 0, 0.00, 0, 0.00, 660
8, 12:42:00-000, 166, 108, 58, 0, 0.00, 0, 0.00, 166
8, 12:45:00-000, 67, 7, 60, 0, 0.00, 0, 0.00, 67
8, 12:46:00-000, 100, 90, 10, 0, 0.00, 0, 0.00, 100
8, 12:47:00-000, 511, 11, 500, 0, 0.00, 0, 0.00, 511
8, 12:50:00-000, 104, 2, 102, 2, 1349.00, 2, 1345.00, 100
8, 12:52:00-000, 430, 248, 182, 47, 1347.68, 34, 1349.29, 349
8, 12:53:00-000, 1958, 1826, 132, 17, 1352.35, 30, 1348.53, 1911
8, 12:54:00-000, 1991, 1359, 632, 0, 0.00, 0, 0.00, 1991
8, 12:56:00-000, 727, 710, 17, 0, 0.00, 0, 0.00, 727
8, 12:57:00-000, 97, 7, 90, 0, 0.00, 0, 0.00, 97
8, 12:59:00-000, 2243, 2033, 210, 0, 0.00, 0, 0.00, 2243
8, 13:00:00-000, 2333, 1494, 839, 4, 1348.00, 4, 1349.00, 2325
8, 13:01:00-000, 6903, 5824, 1079, 5, 1349.00, 5, 1349.80, 6893
8, 13:02:00-000, 3340, 2625, 715, 1, 1345.00, 0, 0.00, 3278
8, 13:03:00-000, 179, 46, 133, 0, 0.00, 1, 1350.00, 218
8, 13:04:00-000, 153, 96, 57, 7, 1351.57, 7, 1351.00, 160
8, 13:06:00-000, 2339, 3, 2336, 1, 1348.00, 1, 1345.00, 2337
8, 13:07:00-000, 6136, 5130, 1006, 1, 1350.00, 1, 1349.00, 5497
8, 13:08:00-000, 1792, 1754, 38, 4, 1350.00, 4, 1350.00, 2421
8, 13:09:00-000, 6132, 4955, 1177, 16, 1351.75, 16, 1353.00, 6100
8, 13:10:00-000, 2313, 383, 1930, 6, 1350.33, 7, 1350.29, 2300
8, 13:11:00-000, 1, 1, 0, 1, 1350.00, 0, 0.00, 0
8, 13:13:00-000, 2291, 427, 1864, 5, 1350.00, 5, 1348.40, 2281
8, 13:14:00-000, 107, 7, 100, 0, 0.00, 0, 0.00, 107
8, 13:16:00-000, 858, 854, 4, 4, 1353.00, 4, 1353.00, 850
8, 13:18:00-000, 1145, 884, 261, 0, 0.00, 0, 0.00, 1145
8, 13:19:00-000, 2878, 364, 2514, 0, 0.00, 0, 0.00, 2878
8, 13:20:00-000, 201, 92, 109, 12, 1346.67, 12, 1347.50, 177
8, 13:21:00-000, 836, 11, 825, 10, 1349.00, 10, 1349.90, 816
8, 13:22:00-000, 1735, 201, 1534, 4, 1349.00, 4, 1351.00, 1727
8, 13:23:00-000, 7077, 2918, 4159, 1, 1348.00, 1, 1348.00, 7025
8, 13:24:00-000, 315, 280, 35, 7, 1349.00, 7, 1352.14, 351
8, 13:25:00-000, 6791, 4604, 2187, 0, 0.00, 0, 0.00, 6791
8, 13:26:00-000, 3338, 1658, 1680, 51, 1349.86, 55, 1350.01, 3232
8, 13:27:00-000, 971, 92, 879, 13, 1346.15, 9, 1351.00, 831
8, 13:28:00-000, 313, 232, 81, 26, 1351.11, 26, 1351.50, 379
8, 13:29:00-000, 812, 52, 760, 27, 1355.22, 27, 1353.00, 758
8, 13:30:00-000, 5280, 3918, 1362, 12, 1350.25, 12, 1350.50, 5256
8, 13:31:00-000, 2367, 2172, 195, 6, 1351.17, 6, 1351.00, 2355
8, 13:32:00-000, 1911, 27, 1884, 16, 1348.56, 16, 1346.87, 1879
8, 13:33:00-000, 2809, 282, 2527, 0, 0.00, 0, 0.00, 2809
8, 13:34:00-000, 3088, 423, 2665, 11, 1350.09, 13, 1351.00, 3064
8, 13:35:00-000, 2657, 2545, 112, 18, 1352.77, 16, 1352.19, 2623
8, 13:36:00-000, 873, 118, 755, 10, 1351.20, 10, 1350.60, 853
8, 13:37:00-000, 1388, 199, 1189, 47, 1349.00, 47, 1348.36, 1294
8, 13:38:00-000, 8589, 2215, 6374, 0, 0.00, 0, 0.00, 7773
8, 13:39:00-000, 8181, 3118, 5063, 12, 1350.67, 12, 1350.83, 7770
8, 13:40:00-000, 4215, 3335, 880, 14, 1349.71, 17, 1351.41, 5387
8, 13:41:00-000, 6360, 2543, 3817, 4, 1352.75, 1, 1351.00, 5009
8, 13:42:00-000, 6932, 3677, 3255, 11, 1349.45, 12, 1349.58, 8255
8, 13:43:00-000, 1, 1, 0, 1, 1355.00, 0, 0.00, 0
8, 13:44:00-000, 3599, 1694, 1905, 13, 1347.00, 13, 1345.54, 3572
8, 13:45:00-000, 3482, 3088, 394, 1, 1351.00, 1, 1350.00, 3481
8, 13:46:00-000, 272, 102, 170, 10, 1347.40, 10, 1348.40, 252
8, 13:47:00-000, 7064, 5738, 1326, 9, 1351.00, 9, 1351.00, 7046
8, 13:48:00-000, 4155, 2859, 1296, 8, 1349.37, 8, 1350.25, 4139
8, 13:49:00-000, 199, 190, 9, 0, 0.00, 0, 0.00, 199
8, 13:50:00-000, 4406, 543, 3863, 8, 1349.62, 6, 1351.00, 4392
8, 13:51:00-000, 5497, 4068, 1429, 6, 1349.00, 9, 1349.55, 5482
8, 13:52:00-000, 134, 77, 57, 3, 1353.33, 2, 1353.50, 129
8, 13:53:00-000, 962, 950, 12, 1, 1348.00, 1, 1352.00, 960
8, 13:54:00-000, 2743, 1504, 1239, 0, 0.00, 0, 0.00, 2743
8, 13:55:00-000, 5583, 3249, 2334, 0, 0.00, 0, 0.00, 5583
8, 13:56:00-000, 2455, 1261, 1194, 19, 1350.74, 19, 1349.63, 2417
8, 13:57:00-000, 1958, 1047, 911, 1, 1349.00, 1, 1348.00, 1956
8, 13:58:00-000, 1731, 1592, 139, 12, 1348.00, 7, 1350.71, 1712
8, 13:59:00-000, 4971, 2626, 2345, 0, 0.00, 5, 1350.20, 4966
8, 14:00:00-000, 3538, 1057, 2481, 7, 1352.43, 7, 1350.86, 3524
8, 14:01:00-000, 6381, 4698, 1683, 17, 1349.82, 17, 1350.94, 6347
8, 14:02:00-000, 5646, 1270, 4376, 6, 1349.00, 4, 1349.00, 5636
8, 14:03:00-000, 2245, 1922, 323, 1, 1355.00, 3, 1348.00, 2241
8, 14:05:00-000, 9839, 4696, 5143, 0, 0.00, 0, 0.00, 9839
8, 14:06:00-000, 90, 0, 90, 0, 0.00, 0, 0.00, 90
8, 14:07:00-000, 6516, 3066, 3450, 0, 0.00, 0, 0.00, 6516
8, 14:08:00-000, 1634, 1550, 84, 10, 1351.00, 10, 1350.80, 1614
8, 14:09:00-000, 259, 182, 77, 0, 0.00, 0, 0.00, 258
8, 14:10:00-000, 2247, 416, 1831, 8, 1352.75, 9, 1351.22, 2231
8, 14:11:00-000, 1487, 298, 1189, 18, 1352.83, 17, 1351.35, 1452
8, 14:12:00-000, 1793, 1550, 243, 0, 0.00, 0, 0.00, 1793
8, 14:13:00-000, 2453, 2312, 141, 0, 0.00, 0, 0.00, 2453
8, 14:14:00-000, 8704, 3660, 5044, 43, 1356.14, 43, 1350.90, 8618
8, 14:15:00-000, 4197, 3873, 324, 3, 1350.67, 1, 1350.00, 4186
8, 14:16:00-000, 5556, 2728, 2828, 33, 1348.88, 35, 1347.45, 5495
8, 14:17:00-000, 1628, 831, 797, 0, 0.00, 0, 0.00, 1628
8, 14:18:00-000, 9723, 2557, 7166, 13, 1349.85, 13, 1352.46, 9697
8, 14:19:00-000, 8889, 4329, 4560, 1, 1349.00, 6, 1350.17, 8858
8, 14:20:00-000, 594, 10, 584, 9, 1350.67, 4, 1354.25, 605
8, 14:22:00-000, 62, 1, 61, 1, 1351.00, 1, 1349.00, 60
8, 14:23:00-000, 1874, 1747, 127, 0, 0.00, 0, 0.00, 1874
8, 14:24:00-000, 541, 446, 95, 15, 1352.27, 15, 1350.20, 511
8, 14:26:00-000, 22, 1, 21, 1, 1350.00, 1, 1349.00, 20
8, 14:28:00-000, 199, 173, 26, 3, 1353.00, 3, 1350.00, 193
8, 14:29:00-000, 1599, 92, 1507, 0, 0.00, 0, 0.00, 1599
8, 14:30:00-000, 2105, 1611, 494, 0, 0.00, 0, 0.00, 2105
8, 14:31:00-000, 3331, 2799, 532, 1, 1347.00, 2, 1349.00, 3328
8, 14:32:00-000, 3808, 593, 3215, 3, 1352.33, 2, 1351.50, 3803
8, 14:35:00-000, 2554, 2411, 143, 0, 0.00, 0, 0.00, 2554
8, 14:36:00-000, 2915, 1842, 1073, 2, 1349.00, 2, 1350.00, 2911
8, 14:37:00-000, 6447, 4003, 2444, 1, 1354.00, 1, 1351.00, 6445
8, 14:38:00-000, 3325, 1196, 2129, 1, 1349.00, 1, 1348.00, 3323
8, 14:42:00-000, 1938, 959, 979, 1, 1351.00, 1, 1351.00, 1936
8, 14:43:00-000, 6638, 4676, 1962, 5, 1349.80, 5, 1351.00, 6628
8, 14:44:00-000, 1543, 180, 1363, 6, 1346.00, 6, 1349.50, 1531
8, 14:45:00-000, 7575, 2815, 4760, 5, 1345.00, 7, 1352.00, 7563
8, 14:46:00-000, 3255, 585, 2670, 9, 1349.67, 7, 1348.43, 3239
8, 14:47:00-000, 5262, 2745, 2517, 0, 0.00, 0, 0.00, 5262
8, 14:48:00-000, 3811, 2215, 1596, 3, 1349.00, 3, 1350.00, 3805
8, 14:49:00-000, 481, 278, 203, 0, 0.00, 0, 0.00, 481
8, 14:50:00-000, 1579, 1553, 26, 6, 1348.33, 6, 1351.00, 1567
8, 14:51:00-000, 2698, 502, 2196, 0, 0.00, 0, 0.00, 2074
8, 14:52:00-000, 5812, 4212, 1600, 2, 1349.00, 2, 1351.00, 6432
8, 14:53:00-000, 7915, 4417, 3498, 9, 1348.22, 9, 1347.11, 6382
8, 14:54:00-000, 3740, 2001, 1739, 0, 0.00, 0, 0.00, 5255
8, 14:55:00-000, 983, 102, 881, 7, 1352.86, 7, 1352.86, 969
8, 14:56:00-000, 82, 18, 64, 4, 1349.00, 4, 1352.75, 74
8, 14:57:00-000, 3760, 1294, 2466, 0, 0.00, 0, 0.00, 3760
8, 14:58:00-000, 7169, 6068, 1101, 0, 0.00, 0, 0.00, 7169
8, 15:00:00-000, 5088, 2610, 2478, 3, 1352.00, 3, 1352.00, 5082
8, 15:01:00-000, 3484, 2378, 1106, 2, 1348.00, 2, 1349.00, 3480
8, 15:02:00-000, 2522, 1026, 1496, 16, 1348.69, 15, 1351.67, 2491
8, 15:03:00-000, 1638, 1496, 142, 7, 1357.00, 8, 1350.75, 1623
8, 15:04:00-000, 5289, 4064, 1225, 46, 1349.54, 53, 1351.56, 5189
8, 15:05:00-000, 1782, 998, 784, 22, 1354.27, 15, 1349.73, 1746
8, 15:06:00-000, 2616, 2485, 131, 0, 0.00, 0, 0.00, 2616
8, 15:07:00-000, 4824, 1149, 3675, 11, 1348.54, 11, 1346.36, 4802
8, 15:08:00-000, 725, 722, 3, 2, 1353.00, 2, 1352.00, 721
8, 15:09:00-000, 4401, 2081, 2320, 1, 1350.00, 1, 1350.00, 4399
8, 15:10:00-000, 4373, 2077, 2296, 0, 0.00, 0, 0.00, 4313
8, 15:11:00-000, 1833, 258, 1575, 0, 0.00, 0, 0.00, 1893
8, 15:12:00-000, 150, 121, 29, 0, 0.00, 0, 0.00, 150
8, 15:13:00-000, 100, 10, 90, 10, 1349.40, 10, 1353.00, 80
8, 15:14:00-000, 686, 420, 266, 18, 1348.72, 23, 1350.39, 645
8, 15:15:00-000, 2877, 1007, 1870, 15, 1350.53, 10, 1348.90, 2852
8, 15:16:00-000, 81, 11, 70, 8, 1352.25, 8, 1355.00, 65
8, 15:18:00-000, 2147, 1272, 875, 1, 1351.00, 0, 0.00, 2082
8, 15:19:00-000, 11857, 4202, 7655, 5, 1349.20, 5, 1351.80, 11886
8, 15:20:00-000, 2416, 2187, 229, 1, 1348.00, 2, 1349.00, 2438
8, 15:21:00-000, 550, 458, 92, 0, 0.00, 0, 0.00, 550
8, 15:22:00-000, 3104, 220, 2884, 1, 1350.00, 1, 1352.00, 3102
8, 15:23:00-000, 5547, 1968, 3579, 2, 1352.00, 2, 1350.00, 5543
8, 15:24:00-000, 3237, 138, 3099, 1, 1351.00, 0, 0.00, 3236
8, 15:25:00-000, 6432, 794, 5638, 0, 0.00, 1, 1349.00, 6431
8, 15:26:00-000, 5840, 1901, 3939, 17, 1350.41, 15, 1351.80, 5808
8, 15:27:00-000, 7319, 2612, 4707, 6, 1348.67, 8, 1349.37, 7305
8, 15:28:00-000, 5944, 2817, 3127, 1, 1350.00, 1, 1350.00, 5942
8, 15:29:00-000, 3460, 2421, 1039, 0, 0.00, 0, 0.00, 3452
8, 15:30:00-000, 1027, 671, 356, 15, 1349.06, 15, 1349.33, 1005
8, 15:32:00-000, 2807, 1740, 1067, 5, 1351.40, 5, 1351.00, 2797
8, 15:33:00-000, 1982, 130, 1852, 0, 0.00, 0, 0.00, 1982
8, 15:34:00-000, 5195, 53, 5142, 6, 1351.00, 8, 1351.25, 5181
8, 15:35:00-000, 3, 3, 0, 2, 1355.00, 0, 0.00, 1
8, 15:37:00-000, 3050, 2905, 145, 22, 1347.73, 25, 1350.24, 3003
8, 15:38:00-000, 2418, 41, 2377, 36, 1351.83, 33, 1352.33, 2349
8, 15:40:00-000, 2964, 76, 2888, 6, 1349.00, 6, 1349.00, 2952
8, 15:41:00-000, 5468, 2600, 2868, 7, 1348.00, 7, 1351.29, 5454
8, 15:42:00-000, 218, 208, 10, 10, 1351.90, 10, 1351.00, 198
8, 15:43:00-000, 3167, 3140, 27, 0, 0.00, 0, 0.00, 3167
8, 15:44:00-000, 154, 152, 2, 2, 1350.00, 2, 1350.00, 150
8, 15:45:00-000, 877, 204, 673, 0, 0.00, 0, 0.00, 877
8, 15:46:00-000, 152, 150, 2, 1, 1348.00, 1, 1348.00, 150
8, 15:47:00-000, 1500, 1195, 305, 1, 1348.00, 1, 1351.00, 1498
8, 15:49:00-000, 6797, 2457, 4340, 1, 1349.00, 1, 1349.00, 6795
8, 15:52:00-000, 22, 21, 1, 1, 1349.00, 1, 1350.00, 20
8, 15:53:00-000, 338, 333, 5, 3, 1351.00, 3, 1351.00, 332
8, 15:54:00-000, 370, 120, 250, 3, 1349.00, 3, 1349.00, 364
8, 15:55:00-000, 547, 142, 405, 0, 0.00, 0, 0.00, 547
8, 15:58:00-000, 2011, 269, 1742, 6, 1351.00, 6, 1352.00, 1999
8, 16:00:00-000, 68, 8, 60, 8, 1350.88, 8, 1352.00, 52
8, 16:01:00-000, 1419, 63, 1356, 6, 1351.00, 13, 1351.00, 1400
8, 16:02:00-000, 10, 10, 0, 7, 1350.43, 0, 0.00, 3
8, 16:04:00-000, 4776, 1665, 3111, 0, 0.00, 0, 0.00, 4776
8, 16:06:00-000, 149, 28, 121, 1, 1349.00, 1, 1350.00, 147
8, 16:07:00-000, 1938, 333, 1605, 0, 0.00, 0, 0.00, 1938
8, 16:08:00-000, 1606, 1544, 62, 11, 1351.00, 14, 1351.43, 1581
8, 16:09:00-000, 4, 4, 0, 3, 1349.33, 0, 0.00, 1
8, 16:10:00-000, 56, 53, 3, 3, 1352.00, 3, 1352.00, 50
8, 16:11:00-000, 67, 60, 7, 0, 0.00, 0, 0.00, 67
8, 16:12:00-000, 208, 184, 24, 4, 1352.75, 4, 1352.00, 200
8, 16:13:00-000, 2354, 2028, 326, 2, 1352.00, 2, 1351.00, 2350
8, 16:14:00-000, 2912, 1045, 1867, 4, 1350.50, 5, 1349.80, 2903
8, 16:15:00-000, 1, 1, 0, 1, 1352.00, 0, 0.00, 0
8, 16:16:00-000, 606, 233, 373, 0, 0.00, 0, 0.00, 522
8, 16:17:00-000, 1585, 1564, 21, 6, 1351.50, 6, 1352.00, 1657
8, 16:18:00-000, 2326, 1675, 651, 7, 1350.43, 7, 1353.14, 2291
8, 16:19:00-000, 6917, 4797, 2120, 6, 1349.00, 6, 1349.00, 6926
8, 16:20:00-000, 1769, 337, 1432, 3, 1351.00, 3, 1350.00, 1763
8, 16:21:00-000, 3152, 1256, 1896, 7, 1351.71, 7, 1351.00, 2929
8, 16:22:00-000, 4971, 2265, 2706, 2, 1355.00, 2, 1351.00, 5176
8, 16:23:00-000, 1574, 1470, 104, 0, 0.00, 0, 0.00, 1574
8, 16:24:00-000, 1957, 472, 1485, 0, 0.00, 0, 0.00, 1957
8, 16:25:00-000, 1817, 1478, 339, 3, 1350.00, 3, 1348.67, 1811
8, 16:26:00-000, 21, 20, 1, 0, 0.00, 0, 0.00, 21
8, 16:27:00-000, 422, 180, 242, 2, 1352.00, 2, 1354.00, 418
8, 16:28:00-000, 11973, 5918, 6055, 2, 1347.00, 4, 1350.25, 11967
8, 16:29:00-000, 1578, 1547, 31, 16, 1349.50, 14, 1348.14, 1548
