TraderType,Time,EnterQty,BuyEnterQty,SellEnterQty,BuyExecutedQty,BuyExecutedPx,SellExecutedQty,SellExecutedPx,CanceledQty
1, 09:06:00-000, 3094, 3094, 0, 852, 1347.80, 0, 0.00, 0
1, 09:07:00-000, 0, 0, 0, 0, 0.00, 0, 0.00, 2226
1, 09:08:00-000, 0, 0, 0, 0, 0.00, 0, 0.00, 16
1, 09:13:00-000, 3105, 2253, 852, 1019, 1348.18, 852, 1347.76, 0
1, 09:14:00-000, 11, 6, 5, 0, 0.00, 5, 1353.40, 1234
1, 09:15:00-000, 21, 5, 16, 6, 1350.00, 16, 1349.56, 1
1, 09:16:00-000, 178, 131, 47, 37, 1349.18, 47, 1351.99, 32
1, 09:17:00-000, 180, 141, 39, 46, 1350.02, 39, 1354.51, 58
1, 09:18:00-000, 685, 447, 238, 201, 1349.46, 235, 1353.17, 132
1, 09:19:00-000, 357, 231, 126, 42, 1350.73, 129, 1374.96, 200
1, 09:20:00-000, 793, 559, 234, 310, 1349.01, 234, 1349.51, 214
1, 09:21:00-000, 439, 302, 137, 142, 1348.43, 137, 1349.32, 202
1, 09:22:00-000, 521, 348, 173, 173, 1349.49, 173, 1353.58, 211
1, 09:23:00-000, 258, 162, 96, 46, 1350.99, 96, 1357.94, 143
1, 09:24:00-000, 538, 393, 145, 95, 1350.67, 145, 1357.98, 156
1, 09:25:00-000, 297, 223, 74, 55, 1351.21, 72, 1355.97, 247
1, 09:26:00-000, 733, 548, 185, 228, 1349.40, 187, 1349.89, 235
1, 09:27:00-000, 335, 233, 102, 110, 1348.48, 102, 1348.51, 238
1, 09:28:00-000, 730, 530, 200, 181, 1349.42, 200, 1348.24, 233
1, 09:29:00-000, 296, 219, 77, 140, 1348.58, 77, 1347.01, 251
1, 09:30:00-000, 622, 453, 169, 260, 1348.23, 169, 1347.76, 128
1, 09:31:00-000, 316, 245, 71, 64, 1348.91, 71, 1349.59, 160
1, 09:32:00-000, 677, 465, 212, 244, 1348.59, 210, 1349.22, 234
1, 09:33:00-000, 237, 184, 53, 40, 1351.67, 53, 1351.31, 175
1, 09:34:00-000, 598, 381, 217, 235, 1348.91, 217, 1348.84, 172
1, 09:35:00-000, 366, 237, 129, 129, 1348.52, 129, 1348.37, 119
1, 09:36:00-000, 653, 412, 241, 248, 1348.72, 241, 1347.93, 143
1, 09:37:00-000, 221, 143, 78, 90, 1349.17, 78, 1348.81, 126
1, 09:38:00-000, 606, 383, 223, 206, 1348.07, 223, 1348.31, 109
1, 09:39:00-000, 332, 239, 93, 116, 1349.08, 93, 1348.47, 121
1, 09:40:00-000, 649, 436, 213, 266, 1348.29, 213, 1348.21, 147
1, 09:41:00-000, 298, 156, 142, 125, 1347.84, 142, 1348.13, 114
1, 09:42:00-000, 664, 439, 225, 259, 1347.82, 225, 1347.21, 97
1, 09:43:00-000, 298, 173, 125, 124, 1348.20, 125, 1348.48, 131
1, 09:44:00-000, 522, 348, 174, 206, 1348.14, 174, 1347.40, 64
1, 09:45:00-000, 303, 200, 103, 124, 1348.78, 103, 1348.63, 121
1, 09:46:00-000, 685, 405, 280, 305, 1348.45, 280, 1347.79, 105
1, 09:47:00-000, 291, 167, 124, 120, 1348.31, 124, 1347.23, 79
1, 09:48:00-000, 550, 345, 205, 230, 1347.64, 205, 1347.39, 99
1, 09:49:00-000, 304, 164, 140, 97, 1347.61, 140, 1347.28, 90
1, 09:50:00-000, 632, 398, 234, 275, 1347.39, 234, 1346.72, 68
1, 09:51:00-000, 383, 186, 197, 164, 1347.17, 193, 1346.94, 93
1, 09:52:00-000, 558, 349, 209, 161, 1348.35, 213, 1348.23, 105
1, 09:53:00-000, 250, 177, 73, 118, 1348.42, 73, 1348.48, 112
1, 09:54:00-000, 616, 351, 265, 227, 1347.98, 265, 1347.50, 98
1, 09:55:00-000, 277, 138, 139, 107, 1346.94, 139, 1346.08, 80
1, 09:56:00-000, 653, 416, 237, 259, 1347.80, 237, 1347.90, 82
1, 09:57:00-000, 241, 151, 90, 107, 1347.98, 90, 1347.53, 107
1, 09:58:00-000, 652, 403, 249, 266, 1348.11, 249, 1347.87, 74
1, 09:59:00-000, 267, 157, 110, 131, 1348.73, 110, 1347.61, 116
1, 10:00:00-000, 659, 414, 245, 247, 1347.77, 245, 1347.68, 102
1, 10:01:00-000, 229, 131, 98, 74, 1348.83, 98, 1348.47, 102
1, 10:02:00-000, 628, 406, 222, 258, 1348.86, 222, 1349.02, 88
1, 10:03:00-000, 349, 200, 149, 148, 1347.96, 149, 1346.84, 106
1, 10:04:00-000, 678, 377, 301, 264, 1348.06, 301, 1348.24, 64
1, 10:05:00-000, 310, 212, 98, 120, 1348.28, 98, 1347.54, 92
1, 10:06:00-000, 576, 315, 261, 234, 1347.88, 261, 1346.65, 121
1, 10:07:00-000, 341, 217, 124, 118, 1347.75, 124, 1347.30, 70
1, 10:08:00-000, 604, 365, 239, 250, 1348.10, 239, 1348.29, 125
1, 10:09:00-000, 315, 174, 141, 94, 1349.62, 141, 1348.82, 95
1, 10:10:00-000, 574, 327, 247, 226, 1348.29, 247, 1347.38, 75
1, 10:11:00-000, 282, 194, 88, 115, 1348.64, 85, 1347.29, 75
1, 10:12:00-000, 653, 430, 223, 259, 1348.99, 226, 1348.91, 147
1, 10:13:00-000, 327, 198, 129, 136, 1347.72, 129, 1347.32, 110
1, 10:14:00-000, 601, 358, 243, 222, 1348.21, 243, 1348.01, 119
1, 10:15:00-000, 334, 220, 114, 126, 1348.49, 114, 1348.28, 99
1, 10:16:00-000, 612, 336, 276, 247, 1348.14, 276, 1347.69, 99
1, 10:17:00-000, 270, 163, 107, 98, 1348.81, 107, 1348.07, 83
1, 10:18:00-000, 563, 356, 207, 226, 1348.77, 207, 1348.30, 74
1, 10:19:00-000, 274, 163, 111, 102, 1347.75, 111, 1347.10, 103
1, 10:20:00-000, 629, 396, 233, 278, 1348.17, 233, 1347.04, 100
1, 10:21:00-000, 357, 218, 139, 141, 1347.97, 139, 1347.17, 84
1, 10:22:00-000, 676, 410, 266, 267, 1347.13, 266, 1346.64, 114
1, 10:23:00-000, 281, 170, 111, 115, 1347.87, 111, 1347.62, 108
1, 10:24:00-000, 549, 349, 200, 205, 1348.47, 200, 1347.95, 90
1, 10:25:00-000, 269, 141, 128, 132, 1347.22, 128, 1346.28, 78
1, 10:26:00-000, 623, 450, 173, 200, 1349.62, 173, 1349.69, 102
1, 10:27:00-000, 348, 197, 151, 156, 1348.28, 151, 1347.72, 149
1, 10:28:00-000, 587, 330, 257, 243, 1348.08, 257, 1347.39, 77
1, 10:29:00-000, 312, 161, 151, 156, 1347.87, 151, 1346.49, 87
1, 10:30:00-000, 623, 375, 248, 253, 1348.24, 248, 1347.10, 52
1, 10:31:00-000, 321, 175, 146, 140, 1347.69, 142, 1347.60, 79
1, 10:32:00-000, 614, 375, 239, 264, 1347.48, 243, 1346.41, 58
1, 10:33:00-000, 273, 149, 124, 113, 1347.55, 124, 1347.56, 80
1, 10:34:00-000, 715, 396, 319, 312, 1347.47, 319, 1346.54, 64
1, 10:35:00-000, 345, 224, 121, 177, 1348.56, 121, 1348.35, 78
1, 10:36:00-000, 579, 365, 214, 253, 1347.55, 211, 1346.80, 81
1, 10:37:00-000, 280, 166, 114, 89, 1348.67, 117, 1348.53, 82
1, 10:38:00-000, 590, 312, 278, 247, 1347.75, 278, 1347.81, 68
1, 10:39:00-000, 323, 211, 112, 120, 1348.28, 111, 1348.21, 73
1, 10:40:00-000, 647, 376, 271, 233, 1348.90, 272, 1348.34, 122
1, 10:41:00-000, 252, 122, 130, 90, 1348.10, 130, 1346.39, 76
1, 10:42:00-000, 599, 341, 258, 240, 1346.73, 258, 1346.01, 71
1, 10:43:00-000, 388, 219, 169, 171, 1347.34, 169, 1346.50, 74
1, 10:44:00-000, 615, 338, 277, 249, 1348.02, 275, 1346.89, 74
1, 10:45:00-000, 355, 206, 149, 133, 1347.74, 151, 1347.38, 84
1, 10:46:00-000, 576, 385, 191, 256, 1347.99, 191, 1347.50, 113
1, 10:47:00-000, 249, 153, 96, 87, 1347.74, 96, 1347.33, 88
1, 10:48:00-000, 608, 414, 194, 242, 1348.49, 194, 1348.41, 91
1, 10:49:00-000, 324, 172, 152, 114, 1347.88, 149, 1347.59, 135
1, 10:50:00-000, 664, 430, 234, 236, 1347.93, 237, 1346.72, 116
1, 10:51:00-000, 314, 197, 117, 135, 1347.62, 117, 1347.62, 127
1, 10:52:00-000, 629, 367, 262, 261, 1347.65, 262, 1346.52, 72
1, 10:53:00-000, 310, 172, 138, 165, 1348.24, 138, 1347.45, 73
1, 10:54:00-000, 566, 312, 254, 230, 1347.75, 254, 1347.69, 59
1, 10:55:00-000, 279, 166, 113, 121, 1347.82, 113, 1347.26, 56
1, 10:56:00-000, 660, 360, 300, 226, 1347.70, 300, 1347.46, 86
1, 10:57:00-000, 296, 232, 64, 74, 1348.65, 64, 1348.73, 110
1, 10:58:00-000, 611, 326, 285, 258, 1347.51, 285, 1347.77, 145
1, 10:59:00-000, 337, 194, 143, 140, 1347.64, 143, 1346.63, 65
1, 11:00:00-000, 587, 369, 218, 194, 1347.76, 218, 1347.35, 121
1, 11:01:00-000, 243, 132, 111, 117, 1347.31, 111, 1346.39, 111
1, 11:02:00-000, 556, 339, 217, 241, 1347.45, 217, 1346.85, 34
1, 11:03:00-000, 319, 189, 130, 139, 1347.58, 130, 1347.19, 85
1, 11:04:00-000, 661, 408, 253, 274, 1347.69, 253, 1347.25, 82
1, 11:05:00-000, 268, 151, 117, 107, 1347.79, 117, 1347.58, 96
1, 11:06:00-000, 616, 382, 234, 267, 1347.64, 234, 1346.85, 62
1, 11:07:00-000, 288, 158, 130, 137, 1347.87, 130, 1347.93, 88
1, 11:08:00-000, 564, 328, 236, 236, 1347.25, 236, 1347.55, 62
1, 11:09:00-000, 264, 166, 98, 97, 1348.35, 98, 1348.07, 67
1, 11:10:00-000, 634, 377, 257, 280, 1347.92, 257, 1347.34, 80
1, 11:11:00-000, 251, 159, 92, 99, 1348.04, 87, 1347.52, 95
1, 11:12:00-000, 606, 339, 267, 257, 1347.98, 272, 1347.47, 59
1, 11:13:00-000, 304, 196, 108, 134, 1348.67, 108, 1348.17, 66
1, 11:14:00-000, 596, 335, 261, 232, 1347.14, 261, 1346.86, 73
1, 11:15:00-000, 338, 215, 123, 146, 1348.89, 123, 1347.50, 74
1, 11:16:00-000, 624, 367, 257, 235, 1348.07, 257, 1347.84, 116
1, 11:17:00-000, 347, 203, 144, 166, 1347.89, 144, 1347.06, 96
1, 11:18:00-000, 698, 416, 282, 291, 1346.95, 282, 1346.58, 76
1, 11:19:00-000, 262, 159, 103, 104, 1347.34, 103, 1347.32, 79
1, 11:20:00-000, 644, 433, 211, 233, 1348.76, 211, 1347.74, 128
1, 11:21:00-000, 294, 188, 106, 137, 1346.90, 106, 1346.68, 121
1, 11:22:00-000, 681, 340, 341, 278, 1347.81, 341, 1347.12, 91
1, 11:23:00-000, 280, 158, 122, 108, 1348.46, 122, 1346.67, 57
1, 11:24:00-000, 715, 463, 252, 271, 1348.32, 252, 1347.54, 110
1, 11:25:00-000, 289, 165, 124, 122, 1347.56, 124, 1347.22, 99
1, 11:26:00-000, 595, 349, 246, 271, 1348.25, 246, 1347.77, 95
1, 11:27:00-000, 375, 231, 144, 162, 1348.15, 144, 1347.64, 54
1, 11:28:00-000, 627, 377, 250, 251, 1347.96, 250, 1347.90, 96
1, 11:29:00-000, 316, 161, 155, 127, 1347.04, 155, 1346.60, 89
1, 11:30:00-000, 589, 333, 256, 215, 1347.51, 256, 1346.97, 68
1, 11:31:00-000, 373, 221, 152, 152, 1348.53, 152, 1348.49, 88
1, 11:32:00-000, 563, 329, 234, 264, 1347.47, 234, 1346.73, 85
1, 11:33:00-000, 356, 183, 173, 130, 1347.46, 173, 1347.00, 55
1, 11:34:00-000, 614, 395, 219, 268, 1348.28, 219, 1347.59, 89
1, 11:35:00-000, 262, 134, 128, 114, 1347.07, 128, 1346.35, 81
1, 11:36:00-000, 616, 379, 237, 244, 1348.14, 237, 1348.00, 75
1, 11:37:00-000, 357, 196, 161, 134, 1347.45, 161, 1347.33, 81
1, 11:38:00-000, 610, 378, 232, 223, 1348.94, 232, 1348.04, 101
1, 11:39:00-000, 328, 162, 166, 133, 1348.16, 166, 1347.32, 97
1, 11:40:00-000, 537, 298, 239, 218, 1347.79, 239, 1346.70, 83
1, 11:41:00-000, 311, 187, 124, 112, 1347.83, 124, 1347.54, 44
1, 11:42:00-000, 544, 318, 226, 216, 1347.79, 226, 1347.71, 128
1, 11:43:00-000, 291, 189, 102, 126, 1348.08, 102, 1347.60, 67
1, 11:44:00-000, 556, 312, 244, 247, 1348.18, 244, 1347.64, 66
1, 11:45:00-000, 344, 203, 141, 119, 1347.94, 141, 1346.52, 56
1, 11:46:00-000, 578, 343, 235, 259, 1348.34, 235, 1347.82, 102
1, 11:47:00-000, 298, 204, 94, 138, 1347.69, 94, 1347.28, 64
1, 11:48:00-000, 613, 349, 264, 261, 1347.79, 264, 1346.98, 84
1, 11:49:00-000, 276, 156, 120, 124, 1348.58, 120, 1347.63, 73
1, 11:50:00-000, 597, 343, 254, 260, 1348.10, 254, 1347.24, 36
1, 11:51:00-000, 313, 188, 125, 143, 1348.92, 125, 1348.51, 68
1, 11:52:00-000, 614, 383, 231, 277, 1348.79, 231, 1347.36, 78
1, 11:53:00-000, 352, 220, 132, 164, 1348.03, 132, 1347.82, 67
1, 11:54:00-000, 613, 377, 236, 255, 1348.42, 236, 1347.51, 83
1, 11:55:00-000, 275, 140, 135, 124, 1347.96, 135, 1347.26, 110
1, 11:56:00-000, 797, 450, 347, 321, 1347.51, 347, 1345.84, 55
1, 11:57:00-000, 378, 222, 156, 160, 1348.11, 156, 1347.16, 86
1, 11:58:00-000, 545, 366, 179, 249, 1347.77, 179, 1347.54, 70
1, 11:59:00-000, 293, 170, 123, 132, 1348.18, 123, 1347.51, 86
1, 12:00:00-000, 594, 330, 264, 231, 1347.82, 264, 1347.45, 75
1, 12:01:00-000, 270, 122, 148, 125, 1346.45, 148, 1345.66, 66
1, 12:02:00-000, 672, 367, 305, 252, 1347.74, 305, 1346.84, 44
1, 12:03:00-000, 277, 150, 127, 108, 1348.39, 124, 1348.32, 84
1, 12:04:00-000, 693, 392, 301, 297, 1348.49, 304, 1347.71, 70
1, 12:05:00-000, 248, 122, 126, 101, 1346.63, 126, 1347.01, 47
1, 12:06:00-000, 550, 343, 207, 235, 1348.04, 204, 1346.68, 91
1, 12:07:00-000, 319, 186, 133, 138, 1346.96, 136, 1346.69, 66
1, 12:08:00-000, 645, 341, 304, 274, 1347.40, 304, 1346.60, 55
1, 12:09:00-000, 233, 113, 120, 79, 1348.48, 120, 1346.95, 68
1, 12:10:00-000, 582, 346, 236, 226, 1347.32, 236, 1346.87, 49
1, 12:11:00-000, 344, 206, 138, 148, 1348.16, 138, 1348.08, 88
1, 12:12:00-000, 596, 353, 243, 268, 1347.47, 243, 1346.39, 79
1, 12:13:00-000, 303, 178, 125, 127, 1346.99, 125, 1346.74, 66
1, 12:14:00-000, 611, 352, 259, 253, 1347.52, 259, 1347.03, 91
1, 12:15:00-000, 275, 164, 111, 104, 1347.76, 111, 1347.43, 65
1, 12:16:00-000, 590, 348, 242, 251, 1347.54, 242, 1347.25, 83
1, 12:17:00-000, 301, 172, 129, 133, 1348.06, 129, 1347.35, 66
1, 12:18:00-000, 592, 349, 243, 204, 1348.03, 243, 1347.45, 97
1, 12:19:00-000, 343, 201, 142, 151, 1347.19, 142, 1347.40, 78
1, 12:20:00-000, 658, 405, 253, 254, 1348.74, 253, 1347.71, 103
1, 12:21:00-000, 287, 176, 111, 106, 1348.23, 111, 1347.27, 101
1, 12:22:00-000, 695, 409, 286, 269, 1348.26, 286, 1347.20, 118
1, 12:23:00-000, 335, 187, 148, 115, 1348.29, 148, 1347.01, 104
1, 12:24:00-000, 601, 369, 232, 236, 1348.26, 232, 1346.99, 106
1, 12:25:00-000, 291, 190, 101, 92, 1347.97, 101, 1347.24, 110
1, 12:26:00-000, 560, 318, 242, 244, 1347.71, 242, 1346.64, 85
1, 12:27:00-000, 356, 217, 139, 146, 1347.30, 139, 1346.63, 86
1, 12:28:00-000, 649, 437, 212, 260, 1347.96, 212, 1347.16, 88
1, 12:29:00-000, 300, 218, 82, 109, 1349.17, 82, 1348.10, 139
1, 12:30:00-000, 615, 390, 225, 256, 1348.05, 225, 1348.16, 151
1, 12:31:00-000, 275, 163, 112, 97, 1348.44, 112, 1347.39, 91
1, 12:32:00-000, 575, 298, 277, 226, 1348.06, 277, 1346.85, 84
1, 12:33:00-000, 337, 205, 132, 134, 1347.76, 132, 1347.25, 71
1, 12:34:00-000, 655, 394, 261, 263, 1347.46, 261, 1346.50, 102
1, 12:35:00-000, 301, 200, 101, 112, 1348.46, 101, 1347.98, 106
1, 12:36:00-000, 649, 373, 276, 286, 1347.86, 276, 1346.76, 69
1, 12:37:00-000, 332, 206, 126, 130, 1347.80, 126, 1347.56, 101
1, 12:38:00-000, 619, 369, 250, 267, 1347.70, 250, 1346.85, 64
1, 12:39:00-000, 224, 122, 102, 107, 1349.28, 102, 1349.40, 91
1, 12:40:00-000, 537, 353, 184, 188, 1348.78, 184, 1348.08, 67
1, 12:41:00-000, 326, 187, 139, 137, 1348.28, 139, 1347.55, 112
1, 12:42:00-000, 647, 352, 295, 229, 1348.14, 295, 1347.33, 83
1, 12:43:00-000, 303, 190, 113, 147, 1348.24, 113, 1347.15, 105
1, 12:44:00-000, 576, 329, 247, 206, 1348.31, 247, 1346.43, 55
1, 12:45:00-000, 332, 193, 139, 147, 1348.33, 139, 1348.68, 88
1, 12:46:00-000, 638, 432, 206, 222, 1348.53, 206, 1347.84, 106
1, 12:47:00-000, 280, 170, 110, 142, 1348.19, 110, 1347.30, 135
1, 12:48:00-000, 625, 386, 239, 261, 1347.07, 239, 1347.04, 97
1, 12:49:00-000, 287, 165, 122, 105, 1347.62, 122, 1347.70, 106
1, 12:50:00-000, 600, 332, 268, 246, 1347.70, 268, 1347.24, 60
1, 12:51:00-000, 309, 173, 136, 135, 1348.55, 136, 1347.87, 64
1, 12:52:00-000, 538, 339, 199, 208, 1347.81, 199, 1347.78, 95
1, 12:53:00-000, 373, 211, 162, 133, 1347.87, 162, 1347.30, 80
1, 12:54:00-000, 624, 370, 254, 302, 1348.24, 254, 1346.92, 78
1, 12:55:00-000, 280, 194, 86, 106, 1348.34, 86, 1347.92, 54
1, 12:56:00-000, 689, 420, 269, 320, 1348.45, 269, 1347.75, 109
1, 12:57:00-000, 239, 134, 105, 81, 1347.47, 102, 1346.61, 109
1, 12:58:00-000, 568, 336, 232, 208, 1348.65, 235, 1348.00, 69
1, 12:59:00-000, 323, 191, 132, 148, 1347.52, 132, 1347.25, 80
1, 13:00:00-000, 653, 350, 303, 278, 1348.03, 303, 1347.62, 88
1, 13:01:00-000, 337, 195, 142, 158, 1347.87, 142, 1346.95, 40
1, 13:02:00-000, 544, 352, 192, 202, 1348.46, 192, 1347.63, 78
1, 13:03:00-000, 339, 204, 135, 134, 1347.51, 135, 1346.99, 99
1, 13:04:00-000, 620, 357, 263, 292, 1347.92, 263, 1347.30, 94
1, 13:05:00-000, 301, 131, 170, 99, 1346.99, 170, 1345.90, 60
1, 13:06:00-000, 583, 365, 218, 261, 1348.78, 218, 1348.43, 50
1, 13:07:00-000, 266, 126, 140, 103, 1347.83, 140, 1346.88, 72
1, 13:08:00-000, 626, 331, 295, 245, 1348.04, 295, 1348.13, 62
1, 13:09:00-000, 321, 170, 151, 138, 1347.34, 151, 1347.29, 53
1, 13:10:00-000, 638, 381, 257, 279, 1347.75, 257, 1346.65, 66
1, 13:11:00-000, 327, 212, 115, 134, 1348.63, 115, 1348.64, 47
1, 13:12:00-000, 531, 307, 224, 221, 1348.36, 224, 1347.87, 107
1, 13:13:00-000, 261, 127, 134, 106, 1348.10, 134, 1347.04, 86
1, 13:14:00-000, 539, 353, 186, 228, 1348.26, 186, 1347.70, 53
1, 13:15:00-000, 322, 213, 109, 139, 1348.44, 109, 1347.81, 85
1, 13:16:00-000, 705, 396, 309, 296, 1347.72, 309, 1347.40, 99
1, 13:17:00-000, 316, 185, 131, 138, 1348.91, 131, 1347.79, 71
1, 13:18:00-000, 678, 400, 278, 262, 1347.45, 278, 1347.03, 72
1, 13:19:00-000, 305, 188, 117, 156, 1348.43, 117, 1346.65, 98
1, 13:20:00-000, 568, 329, 239, 272, 1347.77, 239, 1347.49, 52
1, 13:21:00-000, 303, 169, 134, 116, 1348.67, 134, 1347.21, 73
1, 13:22:00-000, 549, 317, 232, 215, 1348.48, 232, 1347.25, 56
1, 13:23:00-000, 306, 180, 126, 140, 1347.88, 126, 1347.60, 54
1, 13:24:00-000, 641, 368, 273, 253, 1349.00, 273, 1348.19, 88
1, 13:25:00-000, 262, 135, 127, 110, 1348.52, 127, 1347.42, 105
1, 13:26:00-000, 667, 377, 290, 271, 1348.12, 290, 1346.85, 45
1, 13:27:00-000, 377, 236, 141, 157, 1347.09, 141, 1346.87, 87
1, 13:28:00-000, 529, 312, 217, 248, 1347.70, 217, 1347.07, 81
1, 13:29:00-000, 260, 131, 129, 124, 1347.91, 129, 1346.73, 47
1, 13:30:00-000, 609, 352, 257, 278, 1347.43, 257, 1347.15, 36
1, 13:31:00-000, 276, 151, 125, 101, 1349.42, 125, 1349.25, 49
1, 13:32:00-000, 626, 362, 264, 264, 1347.56, 264, 1346.45, 81
1, 13:33:00-000, 318, 203, 115, 130, 1348.12, 115, 1347.67, 68
1, 13:34:00-000, 668, 410, 258, 290, 1347.23, 258, 1346.75, 85
1, 13:35:00-000, 311, 163, 148, 155, 1346.88, 148, 1346.29, 88
1, 13:36:00-000, 638, 368, 270, 287, 1348.14, 270, 1347.11, 44
1, 13:37:00-000, 308, 174, 134, 105, 1348.44, 134, 1347.24, 80
1, 13:38:00-000, 681, 361, 320, 279, 1347.80, 320, 1347.08, 78
1, 13:39:00-000, 307, 190, 117, 118, 1348.05, 117, 1346.73, 57
1, 13:40:00-000, 614, 363, 251, 267, 1347.92, 251, 1347.12, 98
1, 13:41:00-000, 271, 153, 118, 85, 1348.49, 118, 1347.98, 85
1, 13:42:00-000, 620, 375, 245, 240, 1348.00, 245, 1347.76, 78
1, 13:43:00-000, 243, 131, 112, 98, 1347.49, 112, 1347.16, 100
1, 13:44:00-000, 694, 390, 304, 306, 1347.55, 304, 1346.98, 62
1, 13:45:00-000, 303, 164, 139, 89, 1347.81, 139, 1346.87, 63
1, 13:46:00-000, 599, 366, 233, 278, 1347.79, 233, 1346.95, 102
1, 13:47:00-000, 301, 178, 123, 138, 1348.18, 123, 1347.88, 56
1, 13:48:00-000, 588, 340, 248, 242, 1348.23, 246, 1347.67, 78
1, 13:49:00-000, 339, 219, 120, 147, 1348.52, 122, 1347.29, 75
1, 13:50:00-000, 635, 373, 262, 235, 1348.57, 262, 1347.72, 92
1, 13:51:00-000, 398, 260, 138, 165, 1348.34, 138, 1347.22, 100
1, 13:52:00-000, 517, 281, 236, 237, 1347.58, 236, 1346.91, 98
1, 13:53:00-000, 306, 198, 108, 136, 1347.49, 108, 1347.07, 51
1, 13:54:00-000, 596, 367, 229, 254, 1348.08, 229, 1347.25, 84
1, 13:55:00-000, 315, 188, 127, 150, 1347.63, 127, 1347.21, 83
1, 13:56:00-000, 644, 345, 299, 275, 1347.50, 299, 1346.30, 67
1, 13:57:00-000, 323, 188, 135, 119, 1348.62, 133, 1347.46, 65
1, 13:58:00-000, 663, 377, 286, 268, 1347.50, 288, 1346.68, 59
1, 13:59:00-000, 335, 203, 132, 158, 1347.84, 132, 1347.42, 101
1, 14:00:00-000, 588, 325, 263, 274, 1347.69, 263, 1346.57, 47
1, 14:01:00-000, 286, 178, 108, 129, 1347.18, 108, 1346.27, 63
1, 14:02:00-000, 658, 339, 319, 286, 1346.81, 319, 1346.16, 56
1, 14:03:00-000, 295, 180, 115, 140, 1347.81, 115, 1346.55, 45
1, 14:04:00-000, 616, 350, 266, 271, 1348.65, 266, 1348.19, 54
1, 14:05:00-000, 409, 259, 150, 208, 1347.11, 150, 1346.69, 39
1, 14:06:00-000, 594, 352, 242, 224, 1347.96, 242, 1346.60, 98
1, 14:07:00-000, 344, 190, 154, 141, 1347.23, 154, 1347.09, 73
1, 14:08:00-000, 623, 364, 259, 272, 1347.50, 259, 1346.98, 109
1, 14:09:00-000, 285, 140, 145, 104, 1347.82, 145, 1347.91, 54
1, 14:10:00-000, 640, 332, 308, 268, 1347.00, 308, 1345.96, 49
1, 14:11:00-000, 277, 141, 136, 130, 1346.49, 136, 1345.00, 39
1, 14:12:00-000, 643, 369, 274, 252, 1348.21, 274, 1347.27, 65
1, 14:13:00-000, 281, 180, 101, 89, 1348.35, 101, 1347.32, 93
1, 14:14:00-000, 580, 303, 277, 249, 1347.30, 277, 1346.30, 70
1, 14:15:00-000, 378, 203, 175, 174, 1346.51, 175, 1345.39, 60
1, 14:16:00-000, 661, 380, 281, 283, 1348.07, 281, 1346.99, 61
1, 14:17:00-000, 269, 133, 136, 109, 1347.23, 136, 1346.33, 68
1, 14:18:00-000, 544, 320, 224, 229, 1348.10, 224, 1347.09, 56
1, 14:19:00-000, 298, 162, 136, 122, 1347.21, 135, 1346.55, 64
1, 14:20:00-000, 630, 375, 255, 280, 1348.43, 256, 1347.60, 66
1, 14:21:00-000, 275, 172, 103, 135, 1348.60, 103, 1346.64, 52
1, 14:22:00-000, 700, 416, 284, 307, 1347.24, 284, 1346.52, 53
1, 14:23:00-000, 283, 158, 125, 120, 1346.62, 125, 1346.70, 87
1, 14:24:00-000, 599, 341, 258, 207, 1347.92, 258, 1348.33, 83
1, 14:25:00-000, 269, 161, 108, 133, 1348.12, 108, 1347.60, 94
1, 14:26:00-000, 630, 397, 233, 279, 1347.73, 233, 1347.15, 70
1, 14:27:00-000, 283, 182, 101, 137, 1347.18, 101, 1346.73, 91
1, 14:28:00-000, 656, 383, 273, 251, 1348.24, 273, 1346.99, 80
1, 14:29:00-000, 302, 204, 98, 90, 1349.08, 96, 1348.08, 91
1, 14:30:00-000, 599, 342, 257, 276, 1348.06, 259, 1347.58, 108
1, 14:31:00-000, 368, 201, 167, 166, 1347.76, 167, 1347.45, 56
1, 14:32:00-000, 687, 405, 282, 274, 1348.97, 279, 1348.33, 91
1, 14:33:00-000, 313, 200, 113, 141, 1348.96, 112, 1347.73, 73
1, 14:34:00-000, 608, 335, 273, 278, 1347.12, 277, 1346.88, 78
1, 14:35:00-000, 326, 203, 123, 117, 1347.55, 123, 1347.45, 49
1, 14:36:00-000, 552, 304, 248, 229, 1348.29, 248, 1347.76, 102
1, 14:37:00-000, 362, 245, 117, 177, 1348.24, 117, 1347.77, 69
1, 14:38:00-000, 613, 331, 282, 223, 1347.46, 282, 1346.16, 86
1, 14:39:00-000, 314, 153, 161, 143, 1346.62, 161, 1346.49, 76
1, 14:40:00-000, 652, 366, 286, 274, 1347.38, 286, 1346.46, 45
1, 14:41:00-000, 329, 195, 134, 161, 1347.22, 134, 1347.28, 66
1, 14:42:00-000, 626, 351, 275, 279, 1347.31, 275, 1346.50, 33
1, 14:43:00-000, 277, 178, 99, 90, 1348.41, 99, 1347.29, 71
1, 14:44:00-000, 638, 395, 243, 269, 1348.52, 243, 1348.39, 104
1, 14:45:00-000, 299, 167, 132, 111, 1348.49, 132, 1348.38, 102
1, 14:46:00-000, 658, 350, 308, 269, 1347.70, 308, 1347.15, 80
1, 14:47:00-000, 262, 169, 93, 116, 1347.57, 93, 1347.05, 68
1, 14:48:00-000, 578, 278, 300, 232, 1347.26, 300, 1346.29, 49
1, 14:49:00-000, 350, 226, 124, 157, 1348.28, 124, 1347.79, 63
1, 14:50:00-000, 608, 352, 256, 244, 1347.84, 256, 1347.77, 70
1, 14:51:00-000, 332, 198, 134, 149, 1349.24, 134, 1348.99, 80
1, 14:52:00-000, 632, 360, 272, 297, 1347.33, 272, 1346.68, 62
1, 14:53:00-000, 355, 227, 128, 146, 1347.48, 126, 1347.10, 59
1, 14:54:00-000, 628, 390, 238, 312, 1348.01, 240, 1347.27, 108
1, 14:55:00-000, 286, 195, 91, 127, 1347.41, 91, 1347.16, 70
1, 14:56:00-000, 607, 302, 305, 272, 1347.46, 305, 1345.70, 73
1, 14:57:00-000, 245, 149, 96, 101, 1349.30, 96, 1348.02, 27
1, 14:58:00-000, 666, 380, 286, 291, 1348.37, 282, 1347.20, 66
1, 14:59:00-000, 326, 180, 146, 143, 1346.93, 146, 1346.13, 65
1, 15:00:00-000, 601, 330, 271, 245, 1347.05, 271, 1346.19, 52
1, 15:01:00-000, 292, 157, 135, 124, 1347.84, 135, 1347.66, 78
1, 15:02:00-000, 729, 382, 347, 275, 1347.14, 347, 1346.49, 54
1, 15:03:00-000, 301, 142, 159, 90, 1347.13, 159, 1345.23, 64
1, 15:04:00-000, 613, 339, 274, 244, 1347.47, 274, 1347.02, 76
1, 15:05:00-000, 335, 187, 148, 148, 1347.63, 148, 1346.98, 64
1, 15:06:00-000, 592, 358, 234, 253, 1347.90, 234, 1346.91, 82
1, 15:07:00-000, 287, 176, 111, 123, 1347.77, 111, 1347.24, 68
1, 15:08:00-000, 586, 324, 262, 278, 1347.43, 262, 1345.77, 72
1, 15:09:00-000, 300, 190, 110, 130, 1347.95, 110, 1347.70, 47
1, 15:10:00-000, 670, 418, 252, 300, 1348.48, 252, 1347.80, 66
1, 15:11:00-000, 275, 179, 96, 128, 1348.47, 96, 1348.25, 98
1, 15:12:00-000, 621, 346, 275, 236, 1347.78, 275, 1348.07, 83
1, 15:13:00-000, 290, 151, 139, 126, 1348.26, 139, 1347.57, 73
1, 15:14:00-000, 545, 309, 236, 199, 1348.32, 236, 1347.06, 68
1, 15:15:00-000, 293, 172, 121, 127, 1347.44, 121, 1346.32, 57
1, 15:16:00-000, 632, 329, 303, 258, 1347.88, 303, 1347.70, 75
1, 15:17:00-000, 318, 167, 151, 143, 1347.86, 151, 1346.68, 48
1, 15:18:00-000, 657, 406, 251, 314, 1348.45, 251, 1347.67, 49
1, 15:19:00-000, 308, 194, 114, 143, 1348.93, 112, 1348.34, 66
1, 15:20:00-000, 652, 431, 221, 255, 1348.77, 223, 1348.40, 90
1, 15:21:00-000, 287, 175, 112, 116, 1347.49, 112, 1347.19, 149
1, 15:22:00-000, 635, 379, 256, 238, 1348.60, 256, 1347.69, 92
1, 15:23:00-000, 336, 187, 149, 128, 1347.62, 149, 1347.31, 111
1, 15:24:00-000, 636, 354, 282, 278, 1348.41, 282, 1347.46, 68
1, 15:25:00-000, 339, 189, 150, 131, 1348.86, 150, 1347.80, 67
1, 15:26:00-000, 629, 386, 243, 264, 1347.79, 243, 1347.32, 96
1, 15:27:00-000, 299, 176, 123, 111, 1347.12, 123, 1346.13, 81
1, 15:28:00-000, 629, 373, 256, 226, 1348.30, 256, 1347.56, 92
1, 15:29:00-000, 327, 183, 144, 144, 1348.07, 144, 1347.33, 113
1, 15:30:00-000, 608, 378, 230, 258, 1348.32, 230, 1347.33, 66
1, 15:31:00-000, 302, 168, 134, 145, 1348.42, 134, 1348.05, 76
1, 15:32:00-000, 649, 375, 274, 256, 1347.67, 274, 1346.85, 75
1, 15:33:00-000, 286, 169, 117, 125, 1347.93, 117, 1347.76, 94
1, 15:34:00-000, 723, 393, 330, 280, 1348.03, 330, 1347.16, 74
1, 15:35:00-000, 314, 187, 127, 146, 1347.74, 127, 1346.67, 81
1, 15:36:00-000, 594, 382, 212, 194, 1348.90, 212, 1348.27, 88
1, 15:37:00-000, 307, 184, 123, 137, 1349.24, 123, 1347.97, 106
1, 15:38:00-000, 581, 333, 248, 240, 1348.51, 248, 1347.23, 110
1, 15:39:00-000, 350, 215, 135, 152, 1348.05, 135, 1346.93, 56
1, 15:40:00-000, 620, 356, 264, 189, 1348.61, 264, 1347.31, 130
1, 15:41:00-000, 301, 191, 110, 116, 1348.18, 110, 1347.62, 104
1, 15:42:00-000, 744, 471, 273, 302, 1348.29, 273, 1347.11, 125
1, 15:43:00-000, 324, 214, 110, 105, 1348.69, 110, 1347.53, 132
1, 15:44:00-000, 621, 384, 237, 250, 1348.10, 237, 1346.99, 160
1, 15:45:00-000, 272, 139, 133, 87, 1348.02, 133, 1346.98, 74
1, 15:46:00-000, 600, 384, 216, 225, 1348.72, 216, 1347.23, 92
1, 15:47:00-000, 352, 184, 168, 174, 1348.06, 168, 1347.63, 102
1, 15:48:00-000, 663, 444, 219, 239, 1349.04, 219, 1348.76, 63
1, 15:49:00-000, 363, 234, 129, 160, 1347.93, 129, 1347.02, 155
1, 15:50:00-000, 572, 366, 206, 254, 1348.00, 206, 1347.29, 108
1, 15:51:00-000, 380, 221, 159, 147, 1347.52, 159, 1346.67, 91
1, 15:52:00-000, 535, 334, 201, 196, 1348.11, 201, 1347.95, 104
1, 15:53:00-000, 352, 173, 179, 120, 1349.00, 179, 1347.67, 109
1, 15:54:00-000, 644, 397, 247, 299, 1347.59, 247, 1347.06, 67
1, 15:55:00-000, 299, 140, 159, 94, 1347.86, 159, 1346.28, 90
1, 15:56:00-000, 553, 349, 204, 236, 1347.96, 204, 1347.92, 80
1, 15:57:00-000, 351, 209, 142, 159, 1347.69, 142, 1347.10, 73
1, 15:58:00-000, 674, 415, 259, 259, 1347.84, 259, 1347.78, 89
1, 15:59:00-000, 345, 188, 157, 179, 1347.66, 157, 1347.10, 83
1, 16:00:00-000, 587, 335, 252, 266, 1347.44, 252, 1346.75, 49
1, 16:01:00-000, 367, 239, 128, 119, 1349.06, 128, 1348.50, 80
1, 16:02:00-000, 555, 325, 230, 228, 1348.45, 230, 1347.56, 123
1, 16:03:00-000, 296, 154, 142, 120, 1347.64, 142, 1346.83, 74
1, 16:04:00-000, 591, 318, 273, 231, 1348.00, 273, 1347.46, 55
1, 16:05:00-000, 360, 206, 154, 172, 1348.03, 154, 1346.68, 67
1, 16:06:00-000, 510, 281, 229, 168, 1347.98, 229, 1346.81, 69
1, 16:07:00-000, 354, 224, 130, 174, 1347.30, 130, 1347.17, 81
1, 16:08:00-000, 648, 349, 299, 302, 1347.32, 299, 1346.09, 63
1, 16:09:00-000, 297, 193, 104, 121, 1348.59, 104, 1347.59, 52
1, 16:10:00-000, 642, 407, 235, 242, 1348.08, 235, 1347.36, 80
1, 16:11:00-000, 286, 172, 114, 129, 1348.38, 114, 1348.93, 101
1, 16:12:00-000, 654, 412, 242, 269, 1349.11, 242, 1348.11, 108
1, 16:13:00-000, 288, 161, 127, 136, 1348.21, 127, 1347.48, 85
1, 16:14:00-000, 558, 320, 238, 217, 1347.68, 238, 1346.94, 78
1, 16:15:00-000, 359, 216, 143, 161, 1347.92, 143, 1346.50, 83
1, 16:16:00-000, 665, 413, 252, 267, 1348.04, 252, 1347.42, 88
1, 16:17:00-000, 268, 150, 118, 99, 1348.34, 118, 1347.66, 109
1, 16:18:00-000, 630, 363, 267, 241, 1348.43, 267, 1347.71, 83
1, 16:19:00-000, 323, 162, 161, 132, 1348.09, 161, 1346.83, 51
1, 16:20:00-000, 653, 379, 274, 299, 1347.83, 274, 1346.62, 91
1, 16:21:00-000, 297, 189, 108, 116, 1348.12, 108, 1347.01, 76
1, 16:22:00-000, 584, 342, 242, 279, 1347.85, 242, 1347.49, 92
1, 16:23:00-000, 326, 179, 147, 117, 1347.67, 147, 1347.22, 37
1, 16:24:00-000, 577, 331, 246, 254, 1347.97, 246, 1347.19, 65
1, 16:25:00-000, 293, 196, 97, 120, 1349.24, 97, 1348.14, 78
1, 16:26:00-000, 603, 365, 238, 266, 1348.06, 238, 1347.37, 77
1, 16:27:00-000, 351, 186, 165, 145, 1347.54, 165, 1346.71, 85
1, 16:28:00-000, 545, 315, 230, 211, 1347.68, 230, 1346.53, 49
1, 16:29:00-000, 338, 209, 129, 159, 1348.65, 129, 1348.21, 66
2, 09:06:00-000, 3218, 0, 3218, 0, 0.00, 1177, 1348.59, 0
2, 09:07:00-000, 0, 0, 0, 0, 0.00, 3, 1351.00, 2031
2, 09:08:00-000, 0, 0, 0, 0, 0.00, 0, 0.00, 7
2, 09:13:00-000, 3001, 1180, 1821, 1180, 1352.73, 1483, 1351.32, 0
2, 09:14:00-000, 5, 2, 3, 2, 1353.00, 3, 1354.67, 338
2, 09:15:00-000, 23, 14, 9, 14, 1354.78, 9, 1352.44, 0
2, 09:16:00-000, 179, 81, 98, 81, 1352.90, 96, 1351.81, 0
2, 09:17:00-000, 204, 106, 98, 94, 1354.98, 100, 1352.73, 0
2, 09:18:00-000, 581, 300, 281, 312, 1354.90, 276, 1352.28, 0
2, 09:19:00-000, 412, 247, 165, 244, 1364.57, 170, 1352.50, 0
2, 09:20:00-000, 766, 326, 440, 329, 1354.22, 427, 1353.10, 0
2, 09:21:00-000, 296, 140, 156, 140, 1353.10, 148, 1352.06, 0
2, 09:22:00-000, 530, 278, 252, 277, 1356.29, 273, 1353.56, 0
2, 09:23:00-000, 305, 171, 134, 172, 1356.40, 134, 1353.39, 0
2, 09:24:00-000, 520, 293, 227, 284, 1358.04, 227, 1354.11, 0
2, 09:25:00-000, 287, 140, 147, 149, 1355.40, 130, 1352.90, 0
2, 09:26:00-000, 681, 337, 344, 337, 1353.89, 320, 1352.16, 5
2, 09:27:00-000, 289, 130, 159, 130, 1352.55, 117, 1351.36, 35
2, 09:28:00-000, 579, 263, 316, 263, 1353.74, 263, 1351.82, 43
2, 09:29:00-000, 273, 96, 177, 96, 1352.27, 143, 1351.86, 45
2, 09:30:00-000, 637, 280, 357, 280, 1353.15, 340, 1352.39, 2
2, 09:31:00-000, 284, 142, 142, 142, 1353.58, 123, 1352.99, 50
2, 09:32:00-000, 562, 289, 273, 289, 1354.26, 292, 1352.65, 3
2, 09:33:00-000, 279, 118, 161, 118, 1354.01, 122, 1352.67, 3
2, 09:34:00-000, 758, 352, 406, 352, 1353.56, 375, 1352.68, 19
2, 09:35:00-000, 321, 153, 168, 153, 1352.72, 162, 1351.75, 26
2, 09:36:00-000, 599, 283, 316, 283, 1353.21, 253, 1351.71, 31
2, 09:37:00-000, 223, 115, 108, 115, 1352.93, 114, 1352.14, 41
2, 09:38:00-000, 562, 299, 263, 299, 1353.74, 244, 1351.32, 13
2, 09:39:00-000, 311, 175, 136, 175, 1354.34, 144, 1352.56, 7
2, 09:40:00-000, 586, 233, 353, 233, 1352.54, 255, 1351.02, 26
2, 09:41:00-000, 397, 206, 191, 206, 1352.84, 180, 1351.55, 47
2, 09:42:00-000, 629, 279, 350, 279, 1352.65, 305, 1351.72, 52
2, 09:43:00-000, 314, 157, 157, 157, 1353.23, 130, 1352.21, 27
2, 09:44:00-000, 581, 250, 331, 250, 1352.56, 262, 1351.21, 53
2, 09:45:00-000, 272, 126, 146, 126, 1353.58, 134, 1352.35, 35
2, 09:46:00-000, 616, 247, 369, 247, 1353.13, 288, 1351.86, 57
2, 09:47:00-000, 282, 111, 171, 111, 1351.93, 132, 1351.90, 52
2, 09:48:00-000, 703, 331, 372, 331, 1352.56, 314, 1351.58, 51
2, 09:49:00-000, 311, 136, 175, 136, 1352.37, 120, 1352.12, 41
2, 09:50:00-000, 658, 266, 392, 266, 1352.44, 339, 1350.56, 55
2, 09:51:00-000, 314, 150, 164, 149, 1352.35, 145, 1350.74, 36
2, 09:52:00-000, 545, 260, 285, 261, 1353.06, 244, 1351.82, 34
2, 09:53:00-000, 295, 132, 163, 132, 1353.78, 148, 1352.61, 24
2, 09:54:00-000, 677, 306, 371, 306, 1353.35, 304, 1352.10, 33
2, 09:55:00-000, 347, 164, 183, 164, 1353.10, 175, 1350.89, 55
2, 09:56:00-000, 693, 310, 383, 310, 1353.14, 292, 1350.84, 47
2, 09:57:00-000, 317, 127, 190, 127, 1352.41, 115, 1351.86, 67
2, 09:58:00-000, 633, 325, 308, 325, 1353.33, 287, 1351.12, 69
2, 09:59:00-000, 292, 138, 154, 138, 1354.74, 147, 1352.25, 19
2, 10:00:00-000, 658, 324, 334, 324, 1353.94, 278, 1351.63, 28
2, 10:01:00-000, 380, 166, 214, 166, 1353.05, 166, 1351.68, 36
2, 10:02:00-000, 559, 282, 277, 282, 1353.88, 258, 1352.43, 39
2, 10:03:00-000, 323, 116, 207, 116, 1352.54, 140, 1351.68, 38
2, 10:04:00-000, 560, 286, 274, 286, 1353.60, 263, 1351.85, 47
2, 10:05:00-000, 335, 124, 211, 124, 1352.14, 141, 1350.57, 33
2, 10:06:00-000, 614, 234, 380, 234, 1352.13, 302, 1350.84, 60
2, 10:07:00-000, 316, 137, 179, 137, 1352.47, 136, 1351.58, 74
2, 10:08:00-000, 702, 339, 363, 339, 1353.62, 321, 1351.20, 46
2, 10:09:00-000, 266, 117, 149, 117, 1352.55, 118, 1351.64, 53
2, 10:10:00-000, 660, 292, 368, 292, 1352.08, 291, 1350.89, 39
2, 10:11:00-000, 345, 135, 210, 135, 1352.47, 176, 1352.12, 48
2, 10:12:00-000, 666, 296, 370, 296, 1353.45, 297, 1352.06, 60
2, 10:13:00-000, 282, 107, 175, 107, 1352.09, 129, 1350.93, 55
2, 10:14:00-000, 626, 329, 297, 329, 1354.06, 253, 1352.43, 38
2, 10:15:00-000, 219, 94, 125, 94, 1353.50, 84, 1351.59, 55
2, 10:16:00-000, 622, 337, 285, 337, 1353.64, 250, 1352.04, 53
2, 10:17:00-000, 257, 112, 145, 112, 1352.04, 99, 1351.59, 33
2, 10:18:00-000, 640, 316, 324, 316, 1352.84, 261, 1351.70, 54
2, 10:19:00-000, 275, 121, 154, 121, 1352.61, 118, 1351.31, 51
2, 10:20:00-000, 572, 231, 341, 231, 1353.00, 278, 1351.35, 35
2, 10:21:00-000, 309, 136, 173, 136, 1352.46, 161, 1352.06, 32
2, 10:22:00-000, 641, 288, 353, 288, 1352.58, 252, 1351.11, 51
2, 10:23:00-000, 266, 117, 149, 117, 1352.57, 118, 1352.18, 72
2, 10:24:00-000, 533, 212, 321, 212, 1352.97, 281, 1352.33, 44
2, 10:25:00-000, 337, 144, 193, 144, 1351.71, 156, 1351.22, 53
2, 10:26:00-000, 628, 278, 350, 278, 1353.16, 294, 1351.52, 44
2, 10:27:00-000, 389, 161, 228, 161, 1352.99, 164, 1351.68, 41
2, 10:28:00-000, 595, 266, 329, 266, 1351.50, 256, 1351.50, 70
2, 10:29:00-000, 284, 125, 159, 125, 1353.25, 119, 1351.50, 58
2, 10:30:00-000, 667, 274, 393, 274, 1352.22, 242, 1351.60, 79
2, 10:31:00-000, 293, 122, 171, 122, 1351.98, 110, 1350.72, 119
2, 10:32:00-000, 612, 272, 340, 272, 1352.46, 285, 1350.99, 61
2, 10:33:00-000, 391, 174, 217, 174, 1352.65, 176, 1351.20, 48
2, 10:34:00-000, 726, 296, 430, 296, 1351.88, 333, 1350.85, 77
2, 10:35:00-000, 284, 119, 165, 119, 1353.30, 158, 1351.44, 38
2, 10:36:00-000, 546, 238, 308, 238, 1353.12, 255, 1351.11, 46
2, 10:37:00-000, 307, 150, 157, 150, 1354.13, 133, 1352.36, 35
2, 10:38:00-000, 568, 262, 306, 262, 1352.51, 275, 1351.62, 29
2, 10:39:00-000, 303, 144, 159, 144, 1353.37, 135, 1352.49, 33
2, 10:40:00-000, 655, 313, 342, 313, 1353.27, 288, 1351.95, 33
2, 10:41:00-000, 325, 156, 169, 156, 1352.22, 120, 1351.97, 57
2, 10:42:00-000, 692, 305, 387, 305, 1351.75, 296, 1350.95, 49
2, 10:43:00-000, 278, 120, 158, 120, 1351.34, 137, 1351.05, 78
2, 10:44:00-000, 549, 257, 292, 257, 1351.98, 204, 1351.03, 48
2, 10:45:00-000, 319, 155, 164, 155, 1352.00, 125, 1350.68, 64
2, 10:46:00-000, 598, 282, 316, 282, 1353.31, 234, 1351.77, 62
2, 10:47:00-000, 304, 150, 154, 150, 1352.68, 126, 1351.59, 42
2, 10:48:00-000, 667, 300, 367, 300, 1352.93, 324, 1351.53, 53
2, 10:49:00-000, 286, 112, 174, 112, 1351.97, 120, 1350.39, 39
2, 10:50:00-000, 555, 237, 318, 237, 1352.08, 254, 1351.18, 56
2, 10:51:00-000, 372, 128, 244, 128, 1351.60, 168, 1350.48, 68
2, 10:52:00-000, 611, 241, 370, 241, 1351.91, 228, 1350.97, 125
2, 10:53:00-000, 292, 105, 187, 105, 1351.13, 149, 1351.74, 70
2, 10:54:00-000, 629, 257, 372, 257, 1352.95, 285, 1351.12, 62
2, 10:55:00-000, 329, 162, 167, 162, 1352.76, 180, 1352.02, 42
2, 10:56:00-000, 582, 257, 325, 257, 1352.26, 244, 1351.57, 51
2, 10:57:00-000, 309, 141, 168, 141, 1352.55, 141, 1351.54, 56
2, 10:58:00-000, 656, 273, 383, 273, 1352.34, 263, 1350.86, 48
2, 10:59:00-000, 287, 130, 157, 130, 1351.96, 130, 1351.53, 82
2, 11:00:00-000, 617, 294, 323, 294, 1353.46, 268, 1351.40, 42
2, 11:01:00-000, 271, 130, 141, 130, 1352.51, 114, 1350.48, 55
2, 11:02:00-000, 580, 248, 332, 248, 1352.76, 259, 1351.04, 37
2, 11:03:00-000, 302, 146, 156, 146, 1353.56, 141, 1352.03, 37
2, 11:04:00-000, 600, 258, 342, 258, 1352.45, 293, 1350.73, 59
2, 11:05:00-000, 311, 159, 152, 159, 1352.64, 113, 1351.24, 32
2, 11:06:00-000, 624, 239, 385, 239, 1352.21, 299, 1351.09, 44
2, 11:07:00-000, 303, 140, 163, 140, 1352.39, 105, 1351.55, 57
2, 11:08:00-000, 607, 292, 315, 291, 1352.53, 286, 1351.18, 68
2, 11:09:00-000, 311, 134, 177, 135, 1352.09, 145, 1351.79, 27
2, 11:10:00-000, 650, 247, 403, 247, 1352.04, 305, 1350.67, 54
2, 11:11:00-000, 284, 124, 160, 124, 1352.58, 125, 1351.88, 65
2, 11:12:00-000, 696, 291, 405, 291, 1351.97, 259, 1351.06, 86
2, 11:13:00-000, 309, 122, 187, 122, 1352.15, 166, 1351.37, 90
2, 11:14:00-000, 695, 297, 398, 297, 1352.07, 279, 1350.51, 69
2, 11:15:00-000, 300, 142, 158, 142, 1352.75, 141, 1352.40, 66
2, 11:16:00-000, 638, 255, 383, 255, 1351.81, 298, 1351.14, 69
2, 11:17:00-000, 318, 116, 202, 116, 1352.44, 177, 1351.32, 46
2, 11:18:00-000, 687, 289, 398, 289, 1351.32, 301, 1350.41, 62
2, 11:19:00-000, 384, 194, 190, 194, 1352.49, 163, 1351.83, 53
2, 11:20:00-000, 552, 261, 291, 261, 1352.54, 258, 1352.09, 44
2, 11:21:00-000, 374, 183, 191, 183, 1352.80, 170, 1351.53, 47
2, 11:22:00-000, 631, 293, 338, 289, 1352.42, 281, 1351.56, 10
2, 11:23:00-000, 372, 147, 225, 151, 1351.04, 154, 1350.95, 70
2, 11:24:00-000, 643, 286, 357, 286, 1352.46, 287, 1351.52, 55
2, 11:25:00-000, 351, 181, 170, 181, 1353.72, 172, 1351.57, 42
2, 11:26:00-000, 593, 271, 322, 271, 1353.14, 249, 1351.35, 63
2, 11:27:00-000, 327, 150, 177, 150, 1352.86, 157, 1351.40, 43
2, 11:28:00-000, 576, 271, 305, 271, 1352.22, 233, 1351.08, 53
2, 11:29:00-000, 289, 136, 153, 136, 1352.67, 131, 1351.67, 33
2, 11:30:00-000, 610, 281, 329, 281, 1352.36, 271, 1351.63, 39
2, 11:31:00-000, 284, 133, 151, 133, 1352.87, 137, 1352.08, 50
2, 11:32:00-000, 680, 283, 397, 283, 1351.74, 289, 1350.93, 35
2, 11:33:00-000, 328, 149, 179, 149, 1352.43, 188, 1351.09, 60
2, 11:34:00-000, 574, 239, 335, 239, 1353.14, 251, 1351.67, 31
2, 11:35:00-000, 318, 125, 193, 125, 1351.47, 129, 1350.69, 73
2, 11:36:00-000, 599, 274, 325, 274, 1352.72, 256, 1351.27, 61
2, 11:37:00-000, 269, 130, 139, 130, 1352.85, 140, 1352.93, 43
2, 11:38:00-000, 660, 340, 320, 340, 1353.28, 260, 1351.90, 28
2, 11:39:00-000, 343, 160, 183, 160, 1353.07, 149, 1352.22, 50
2, 11:40:00-000, 602, 252, 350, 252, 1351.97, 234, 1350.62, 70
2, 11:41:00-000, 260, 108, 152, 108, 1351.56, 112, 1351.48, 94
2, 11:42:00-000, 675, 326, 349, 326, 1352.56, 313, 1351.50, 26
2, 11:43:00-000, 271, 92, 179, 92, 1352.40, 92, 1350.85, 46
2, 11:44:00-000, 685, 319, 366, 319, 1352.61, 352, 1351.14, 47
2, 11:45:00-000, 324, 159, 165, 159, 1352.42, 127, 1351.57, 52
2, 11:46:00-000, 602, 240, 362, 240, 1352.02, 212, 1351.66, 60
2, 11:47:00-000, 328, 109, 219, 109, 1352.31, 135, 1350.44, 123
2, 11:48:00-000, 650, 266, 384, 266, 1352.21, 274, 1350.12, 111
2, 11:49:00-000, 260, 137, 123, 137, 1353.67, 133, 1352.23, 55
2, 11:50:00-000, 669, 268, 401, 268, 1351.92, 314, 1351.14, 31
2, 11:51:00-000, 267, 127, 140, 127, 1353.47, 105, 1351.44, 71
2, 11:52:00-000, 587, 268, 319, 268, 1352.38, 251, 1351.50, 65
2, 11:53:00-000, 320, 135, 185, 135, 1352.41, 142, 1350.73, 47
2, 11:54:00-000, 599, 258, 341, 258, 1352.33, 272, 1350.96, 51
2, 11:55:00-000, 357, 130, 227, 130, 1351.73, 151, 1350.59, 57
2, 11:56:00-000, 597, 243, 354, 243, 1351.26, 261, 1350.56, 97
2, 11:57:00-000, 262, 125, 137, 125, 1351.81, 98, 1351.47, 78
2, 11:58:00-000, 722, 289, 433, 289, 1352.57, 328, 1350.76, 53
2, 11:59:00-000, 352, 177, 175, 177, 1353.36, 187, 1352.05, 54
2, 12:00:00-000, 588, 276, 312, 276, 1352.69, 231, 1351.62, 47
2, 12:01:00-000, 279, 129, 150, 129, 1350.92, 110, 1350.38, 59
2, 12:02:00-000, 599, 249, 350, 249, 1352.10, 268, 1351.62, 47
2, 12:03:00-000, 324, 152, 172, 152, 1352.79, 118, 1351.41, 69
2, 12:04:00-000, 514, 204, 310, 204, 1352.68, 255, 1351.50, 73
2, 12:05:00-000, 340, 169, 171, 169, 1353.31, 136, 1351.16, 34
2, 12:06:00-000, 647, 319, 328, 319, 1352.66, 284, 1351.62, 38
2, 12:07:00-000, 306, 122, 184, 122, 1351.69, 142, 1350.34, 50
2, 12:08:00-000, 598, 242, 356, 242, 1351.95, 210, 1350.71, 74
2, 12:09:00-000, 359, 182, 177, 182, 1352.05, 152, 1351.15, 82
2, 12:10:00-000, 596, 253, 343, 253, 1352.11, 257, 1351.29, 76
2, 12:11:00-000, 322, 136, 186, 136, 1351.94, 118, 1351.28, 58
2, 12:12:00-000, 550, 229, 321, 229, 1352.12, 265, 1350.58, 101
2, 12:13:00-000, 329, 132, 197, 132, 1351.96, 132, 1350.98, 29
2, 12:14:00-000, 600, 218, 382, 218, 1351.85, 250, 1351.12, 78
2, 12:15:00-000, 345, 151, 194, 151, 1351.64, 138, 1350.75, 99
2, 12:16:00-000, 574, 262, 312, 262, 1352.74, 268, 1351.13, 52
2, 12:17:00-000, 327, 118, 209, 118, 1352.77, 155, 1350.43, 66
2, 12:18:00-000, 687, 309, 378, 309, 1352.13, 272, 1351.06, 77
2, 12:19:00-000, 333, 148, 185, 148, 1352.03, 166, 1351.01, 67
2, 12:20:00-000, 531, 241, 290, 241, 1352.15, 183, 1350.50, 52
2, 12:21:00-000, 334, 120, 214, 120, 1352.15, 102, 1351.08, 94
2, 12:22:00-000, 632, 287, 345, 287, 1351.85, 232, 1350.47, 118
2, 12:23:00-000, 293, 129, 164, 129, 1352.24, 82, 1350.81, 108
2, 12:24:00-000, 676, 265, 411, 265, 1351.97, 307, 1350.65, 97
2, 12:25:00-000, 297, 123, 174, 123, 1351.50, 133, 1350.62, 89
2, 12:26:00-000, 613, 200, 413, 200, 1351.33, 238, 1350.13, 65
2, 12:27:00-000, 347, 149, 198, 149, 1352.55, 155, 1350.35, 124
2, 12:28:00-000, 600, 225, 375, 225, 1351.38, 272, 1350.69, 95
2, 12:29:00-000, 229, 108, 121, 108, 1352.82, 70, 1351.82, 77
2, 12:30:00-000, 637, 277, 360, 276, 1352.14, 279, 1350.67, 69
2, 12:31:00-000, 269, 113, 156, 114, 1352.37, 104, 1351.10, 70
2, 12:32:00-000, 711, 266, 445, 266, 1352.09, 282, 1350.92, 52
2, 12:33:00-000, 328, 110, 218, 110, 1351.64, 140, 1350.92, 128
2, 12:34:00-000, 692, 230, 462, 230, 1351.82, 322, 1350.74, 94
2, 12:35:00-000, 250, 117, 133, 117, 1352.30, 107, 1351.23, 125
2, 12:36:00-000, 653, 283, 370, 283, 1351.97, 251, 1351.45, 54
2, 12:37:00-000, 340, 132, 208, 132, 1351.55, 201, 1351.25, 89
2, 12:38:00-000, 718, 291, 427, 291, 1352.41, 334, 1351.42, 48
2, 12:39:00-000, 272, 127, 145, 127, 1352.07, 112, 1351.06, 81
2, 12:40:00-000, 723, 312, 411, 312, 1352.71, 283, 1351.28, 66
2, 12:41:00-000, 282, 128, 154, 128, 1353.00, 101, 1350.81, 84
2, 12:42:00-000, 676, 289, 387, 289, 1351.83, 270, 1351.49, 79
2, 12:43:00-000, 288, 90, 198, 90, 1352.20, 130, 1351.07, 90
2, 12:44:00-000, 644, 308, 336, 308, 1352.35, 280, 1351.45, 99
2, 12:45:00-000, 280, 142, 138, 142, 1352.82, 111, 1351.54, 40
2, 12:46:00-000, 685, 332, 353, 332, 1352.54, 258, 1351.17, 35
2, 12:47:00-000, 352, 136, 216, 136, 1351.94, 172, 1350.79, 69
2, 12:48:00-000, 564, 206, 358, 206, 1351.84, 292, 1350.82, 58
2, 12:49:00-000, 295, 148, 147, 148, 1352.18, 102, 1350.66, 65
2, 12:50:00-000, 590, 240, 350, 240, 1351.59, 249, 1351.05, 59
2, 12:51:00-000, 385, 198, 187, 198, 1352.48, 169, 1351.62, 53
2, 12:52:00-000, 641, 281, 360, 281, 1352.93, 342, 1351.78, 51
2, 12:53:00-000, 280, 142, 138, 142, 1352.08, 110, 1350.31, 27
2, 12:54:00-000, 584, 256, 328, 256, 1352.95, 254, 1351.20, 36
2, 12:55:00-000, 277, 127, 150, 127, 1353.36, 112, 1352.23, 46
2, 12:56:00-000, 673, 258, 415, 258, 1352.74, 276, 1351.69, 83
2, 12:57:00-000, 313, 136, 177, 136, 1353.65, 149, 1352.54, 57
2, 12:58:00-000, 572, 305, 267, 305, 1353.29, 251, 1352.50, 69
2, 12:59:00-000, 345, 161, 184, 161, 1353.35, 145, 1351.10, 25
2, 13:00:00-000, 668, 286, 382, 286, 1352.61, 314, 1351.21, 46
2, 13:01:00-000, 299, 116, 183, 116, 1351.91, 183, 1351.31, 31
2, 13:02:00-000, 546, 240, 306, 240, 1352.18, 235, 1351.15, 38
2, 13:03:00-000, 335, 144, 191, 144, 1351.83, 156, 1351.39, 51
2, 13:04:00-000, 600, 252, 348, 252, 1351.61, 272, 1350.79, 66
2, 13:05:00-000, 302, 146, 156, 146, 1350.52, 114, 1350.52, 60
2, 13:06:00-000, 539, 260, 279, 260, 1353.00, 235, 1351.27, 32
2, 13:07:00-000, 340, 154, 186, 149, 1351.83, 150, 1351.75, 47
2, 13:08:00-000, 646, 336, 310, 341, 1352.89, 259, 1351.76, 53
2, 13:09:00-000, 299, 131, 168, 131, 1352.82, 127, 1350.40, 43
2, 13:10:00-000, 639, 280, 359, 280, 1352.23, 275, 1351.53, 48
2, 13:11:00-000, 289, 120, 169, 120, 1352.34, 129, 1351.08, 73
2, 13:12:00-000, 646, 282, 364, 282, 1352.60, 283, 1351.57, 49
2, 13:13:00-000, 337, 137, 200, 137, 1351.14, 147, 1350.87, 68
2, 13:14:00-000, 562, 222, 340, 222, 1352.81, 244, 1351.07, 64
2, 13:15:00-000, 292, 136, 156, 136, 1352.54, 166, 1351.81, 55
2, 13:16:00-000, 563, 233, 330, 233, 1352.52, 256, 1350.38, 43
2, 13:17:00-000, 248, 82, 166, 82, 1352.38, 128, 1350.94, 43
2, 13:18:00-000, 703, 326, 377, 323, 1351.61, 312, 1350.54, 46
2, 13:19:00-000, 245, 103, 142, 106, 1352.79, 105, 1351.30, 63
2, 13:20:00-000, 644, 305, 339, 305, 1353.02, 305, 1351.40, 51
2, 13:21:00-000, 272, 115, 157, 115, 1351.81, 84, 1351.30, 27
2, 13:22:00-000, 579, 235, 344, 235, 1352.53, 271, 1351.75, 72
2, 13:23:00-000, 270, 133, 137, 133, 1352.61, 135, 1352.27, 53
2, 13:24:00-000, 672, 344, 328, 344, 1353.31, 273, 1352.27, 43
2, 13:25:00-000, 307, 160, 147, 155, 1352.23, 130, 1351.36, 32
2, 13:26:00-000, 682, 299, 383, 304, 1352.86, 283, 1351.99, 25
2, 13:27:00-000, 231, 75, 156, 75, 1351.31, 93, 1349.76, 74
2, 13:28:00-000, 652, 282, 370, 282, 1352.28, 288, 1351.24, 77
2, 13:29:00-000, 270, 108, 162, 108, 1352.69, 130, 1351.15, 72
2, 13:30:00-000, 689, 319, 370, 319, 1352.59, 299, 1351.01, 51
2, 13:31:00-000, 346, 158, 188, 158, 1354.55, 176, 1352.24, 55
2, 13:32:00-000, 563, 248, 315, 248, 1351.45, 221, 1350.96, 36
2, 13:33:00-000, 248, 121, 127, 121, 1351.88, 90, 1351.23, 83
2, 13:34:00-000, 566, 242, 324, 242, 1351.94, 238, 1350.49, 37
2, 13:35:00-000, 381, 140, 241, 140, 1352.39, 181, 1350.71, 66
2, 13:36:00-000, 634, 269, 365, 266, 1352.42, 319, 1351.49, 59
2, 13:37:00-000, 239, 101, 138, 104, 1352.00, 78, 1350.92, 71
2, 13:38:00-000, 629, 264, 365, 264, 1351.54, 306, 1351.12, 42
2, 13:39:00-000, 341, 148, 193, 148, 1351.72, 136, 1351.56, 68
2, 13:40:00-000, 605, 265, 340, 265, 1352.38, 222, 1351.26, 91
2, 13:41:00-000, 270, 126, 144, 126, 1352.26, 129, 1351.41, 67
2, 13:42:00-000, 646, 310, 336, 310, 1352.54, 282, 1350.88, 43
2, 13:43:00-000, 254, 101, 153, 101, 1352.57, 106, 1350.87, 55
2, 13:44:00-000, 696, 298, 398, 298, 1351.69, 299, 1350.55, 56
2, 13:45:00-000, 279, 129, 150, 129, 1350.73, 129, 1350.84, 69
2, 13:46:00-000, 654, 262, 392, 262, 1352.04, 254, 1350.79, 59
2, 13:47:00-000, 284, 147, 137, 147, 1353.17, 132, 1352.57, 98
2, 13:48:00-000, 621, 287, 334, 287, 1352.78, 276, 1351.22, 31
2, 13:49:00-000, 248, 108, 140, 108, 1351.92, 111, 1351.14, 48
2, 13:50:00-000, 645, 302, 343, 302, 1352.99, 301, 1351.92, 23
2, 13:51:00-000, 273, 101, 172, 101, 1351.85, 137, 1351.31, 49
2, 13:52:00-000, 593, 270, 323, 270, 1353.18, 261, 1351.47, 37
2, 13:53:00-000, 277, 150, 127, 150, 1352.02, 116, 1350.57, 47
2, 13:54:00-000, 606, 225, 381, 225, 1352.50, 250, 1350.70, 53
2, 13:55:00-000, 346, 145, 201, 145, 1352.40, 171, 1351.12, 81
2, 13:56:00-000, 566, 222, 344, 222, 1351.21, 233, 1350.13, 67
2, 13:57:00-000, 307, 136, 171, 136, 1352.55, 160, 1351.22, 69
2, 13:58:00-000, 593, 261, 332, 261, 1352.35, 254, 1350.86, 53
2, 13:59:00-000, 334, 160, 174, 160, 1353.64, 155, 1350.92, 56
2, 14:00:00-000, 632, 254, 378, 254, 1351.54, 288, 1350.75, 47
2, 14:01:00-000, 343, 160, 183, 160, 1353.48, 153, 1351.84, 41
2, 14:02:00-000, 721, 264, 457, 264, 1351.23, 313, 1350.83, 81
2, 14:03:00-000, 321, 145, 176, 145, 1352.10, 153, 1351.33, 98
2, 14:04:00-000, 601, 309, 292, 309, 1352.61, 225, 1351.64, 62
2, 14:05:00-000, 293, 101, 192, 101, 1351.62, 132, 1350.30, 45
2, 14:06:00-000, 663, 291, 372, 291, 1351.12, 277, 1351.27, 64
2, 14:07:00-000, 360, 172, 188, 172, 1351.87, 105, 1351.24, 91
2, 14:08:00-000, 636, 288, 348, 288, 1352.37, 274, 1351.11, 89
2, 14:09:00-000, 328, 157, 171, 157, 1352.28, 113, 1351.11, 64
2, 14:10:00-000, 681, 241, 440, 241, 1350.58, 233, 1350.02, 96
2, 14:11:00-000, 343, 134, 209, 132, 1350.79, 160, 1350.32, 130
2, 14:12:00-000, 567, 239, 328, 241, 1352.25, 221, 1351.20, 104
2, 14:13:00-000, 237, 115, 122, 115, 1352.16, 107, 1351.67, 74
2, 14:14:00-000, 629, 243, 386, 243, 1351.74, 280, 1350.41, 59
2, 14:15:00-000, 330, 139, 191, 139, 1351.64, 169, 1350.55, 59
2, 14:16:00-000, 644, 265, 379, 265, 1351.92, 286, 1351.45, 63
2, 14:17:00-000, 280, 98, 182, 98, 1351.77, 132, 1350.83, 70
2, 14:18:00-000, 595, 251, 344, 251, 1351.60, 254, 1350.84, 49
2, 14:19:00-000, 306, 149, 157, 149, 1351.59, 129, 1350.66, 88
2, 14:20:00-000, 640, 272, 368, 272, 1351.64, 275, 1350.84, 62
2, 14:21:00-000, 302, 117, 185, 117, 1351.86, 143, 1351.25, 73
2, 14:22:00-000, 661, 311, 350, 311, 1352.00, 254, 1350.47, 69
2, 14:23:00-000, 341, 165, 176, 165, 1352.14, 141, 1351.05, 69
2, 14:24:00-000, 623, 274, 349, 274, 1352.82, 257, 1351.31, 32
2, 14:25:00-000, 303, 108, 195, 108, 1351.33, 97, 1350.47, 87
2, 14:26:00-000, 612, 278, 334, 278, 1352.27, 294, 1350.67, 81
2, 14:27:00-000, 332, 132, 200, 132, 1352.55, 150, 1351.03, 48
2, 14:28:00-000, 584, 241, 343, 241, 1351.43, 273, 1351.14, 63
2, 14:29:00-000, 252, 106, 146, 106, 1353.27, 110, 1351.87, 66
2, 14:30:00-000, 621, 239, 382, 239, 1352.08, 266, 1351.16, 59
2, 14:31:00-000, 361, 154, 207, 154, 1352.24, 155, 1350.98, 73
2, 14:32:00-000, 661, 321, 340, 321, 1353.44, 274, 1351.94, 62
2, 14:33:00-000, 276, 130, 146, 130, 1353.29, 126, 1350.77, 68
2, 14:34:00-000, 549, 241, 308, 241, 1352.11, 251, 1350.83, 34
2, 14:35:00-000, 269, 130, 139, 130, 1352.51, 122, 1351.19, 46
2, 14:36:00-000, 620, 268, 352, 268, 1352.76, 265, 1351.38, 55
2, 14:37:00-000, 319, 125, 194, 125, 1351.91, 139, 1350.40, 56
2, 14:38:00-000, 645, 271, 374, 271, 1351.39, 301, 1350.78, 71
2, 14:39:00-000, 329, 167, 162, 167, 1352.34, 139, 1351.33, 53
2, 14:40:00-000, 601, 207, 394, 207, 1351.49, 254, 1350.69, 68
2, 14:41:00-000, 309, 125, 184, 125, 1351.96, 154, 1350.53, 90
2, 14:42:00-000, 616, 241, 375, 241, 1351.29, 258, 1350.41, 67
2, 14:43:00-000, 329, 160, 169, 160, 1352.77, 148, 1351.59, 79
2, 14:44:00-000, 607, 287, 320, 287, 1353.11, 221, 1352.12, 50
2, 14:45:00-000, 294, 127, 167, 127, 1353.36, 129, 1351.69, 72
2, 14:46:00-000, 697, 301, 396, 301, 1352.23, 287, 1351.40, 73
2, 14:47:00-000, 311, 122, 189, 122, 1352.23, 149, 1351.61, 70
2, 14:48:00-000, 595, 237, 358, 237, 1351.42, 261, 1351.06, 65
2, 14:49:00-000, 338, 145, 193, 145, 1352.67, 156, 1351.35, 63
2, 14:50:00-000, 617, 272, 345, 272, 1351.71, 258, 1351.17, 88
2, 14:51:00-000, 305, 150, 155, 150, 1353.23, 131, 1352.54, 47
2, 14:52:00-000, 601, 242, 359, 242, 1351.50, 245, 1350.26, 70
2, 14:53:00-000, 315, 117, 198, 117, 1351.76, 120, 1350.31, 74
2, 14:54:00-000, 679, 333, 346, 333, 1352.20, 286, 1351.53, 69
2, 14:55:00-000, 335, 136, 199, 136, 1352.26, 154, 1350.99, 74
2, 14:56:00-000, 657, 246, 411, 246, 1351.65, 267, 1350.60, 78
2, 14:57:00-000, 338, 125, 213, 125, 1352.12, 156, 1351.58, 100
2, 14:58:00-000, 747, 307, 440, 307, 1351.61, 323, 1351.17, 73
2, 14:59:00-000, 278, 107, 171, 107, 1351.81, 129, 1350.87, 99
2, 15:00:00-000, 570, 269, 301, 269, 1351.70, 258, 1351.06, 60
2, 15:01:00-000, 331, 155, 176, 155, 1352.29, 161, 1351.02, 36
2, 15:02:00-000, 606, 248, 358, 248, 1350.59, 257, 1350.22, 35
2, 15:03:00-000, 357, 166, 191, 162, 1350.69, 143, 1350.95, 68
2, 15:04:00-000, 650, 299, 351, 303, 1352.87, 271, 1351.60, 87
2, 15:05:00-000, 346, 148, 198, 148, 1351.92, 104, 1351.30, 54
2, 15:06:00-000, 602, 304, 298, 304, 1352.69, 224, 1351.74, 95
2, 15:07:00-000, 333, 109, 224, 109, 1351.41, 152, 1350.19, 69
2, 15:08:00-000, 660, 282, 378, 282, 1351.49, 279, 1350.47, 83
2, 15:09:00-000, 316, 119, 197, 119, 1352.09, 137, 1350.71, 101
2, 15:10:00-000, 608, 249, 359, 249, 1352.30, 281, 1351.64, 61
2, 15:11:00-000, 338, 143, 195, 143, 1352.74, 136, 1351.25, 79
2, 15:12:00-000, 590, 257, 333, 257, 1352.48, 248, 1351.70, 62
2, 15:13:00-000, 347, 127, 220, 127, 1351.38, 183, 1350.96, 54
2, 15:14:00-000, 584, 251, 333, 251, 1351.72, 261, 1350.93, 75
2, 15:15:00-000, 278, 114, 164, 114, 1352.51, 133, 1350.84, 56
2, 15:16:00-000, 723, 367, 356, 367, 1352.55, 274, 1351.99, 34
2, 15:17:00-000, 247, 134, 113, 134, 1351.95, 108, 1351.58, 58
2, 15:18:00-000, 613, 258, 355, 258, 1352.90, 265, 1351.09, 33
2, 15:19:00-000, 289, 136, 153, 136, 1352.80, 139, 1351.63, 73
2, 15:20:00-000, 598, 262, 336, 262, 1352.77, 294, 1351.80, 38
2, 15:21:00-000, 298, 112, 186, 112, 1351.66, 115, 1349.91, 33
2, 15:22:00-000, 542, 252, 290, 252, 1351.65, 208, 1351.33, 83
2, 15:23:00-000, 411, 187, 224, 187, 1352.30, 173, 1351.61, 40
2, 15:24:00-000, 580, 203, 377, 203, 1351.57, 246, 1351.29, 95
2, 15:25:00-000, 293, 150, 143, 150, 1352.59, 129, 1351.75, 62
2, 15:26:00-000, 611, 255, 356, 255, 1352.38, 248, 1350.74, 81
2, 15:27:00-000, 299, 131, 168, 131, 1351.22, 136, 1350.55, 95
2, 15:28:00-000, 635, 281, 354, 281, 1352.14, 262, 1351.28, 58
2, 15:29:00-000, 346, 132, 214, 131, 1352.28, 150, 1351.46, 59
2, 15:30:00-000, 538, 219, 319, 220, 1351.99, 269, 1351.25, 64
2, 15:31:00-000, 326, 140, 186, 140, 1352.43, 144, 1351.47, 41
2, 15:32:00-000, 690, 281, 409, 281, 1352.33, 316, 1350.89, 65
2, 15:33:00-000, 322, 135, 187, 135, 1352.66, 161, 1351.08, 81
2, 15:34:00-000, 615, 246, 369, 246, 1351.95, 235, 1350.77, 56
2, 15:35:00-000, 294, 133, 161, 133, 1351.50, 156, 1351.12, 58
2, 15:36:00-000, 633, 312, 321, 312, 1352.79, 272, 1351.83, 47
2, 15:37:00-000, 306, 115, 191, 115, 1352.12, 120, 1351.05, 54
2, 15:38:00-000, 641, 303, 338, 303, 1352.73, 293, 1351.39, 75
2, 15:39:00-000, 329, 146, 183, 146, 1352.84, 186, 1351.76, 26
2, 15:40:00-000, 662, 270, 392, 270, 1351.35, 227, 1350.71, 62
2, 15:41:00-000, 310, 152, 158, 152, 1351.63, 105, 1349.43, 109
2, 15:42:00-000, 656, 256, 400, 256, 1352.12, 263, 1350.62, 84
2, 15:43:00-000, 305, 162, 143, 162, 1352.24, 96, 1350.88, 110
2, 15:44:00-000, 607, 248, 359, 248, 1352.32, 218, 1349.85, 83
2, 15:45:00-000, 338, 140, 198, 140, 1352.16, 144, 1351.55, 76
2, 15:46:00-000, 653, 263, 390, 263, 1352.25, 250, 1350.23, 94
2, 15:47:00-000, 269, 127, 142, 127, 1353.02, 114, 1350.61, 97
2, 15:48:00-000, 580, 251, 329, 251, 1353.27, 265, 1351.79, 58
2, 15:49:00-000, 315, 114, 201, 114, 1352.87, 160, 1350.58, 71
2, 15:50:00-000, 719, 259, 460, 259, 1352.05, 320, 1350.66, 69
2, 15:51:00-000, 283, 97, 186, 97, 1351.26, 121, 1350.50, 105
2, 15:52:00-000, 690, 281, 409, 281, 1352.55, 294, 1351.54, 69
2, 15:53:00-000, 286, 132, 154, 132, 1351.67, 120, 1351.61, 99
2, 15:54:00-000, 607, 262, 345, 262, 1351.78, 290, 1350.86, 58
2, 15:55:00-000, 324, 154, 170, 154, 1352.48, 124, 1351.89, 43
2, 15:56:00-000, 608, 259, 349, 259, 1352.13, 250, 1350.69, 82
2, 15:57:00-000, 376, 134, 242, 134, 1352.32, 191, 1350.30, 59
2, 15:58:00-000, 653, 328, 325, 328, 1352.57, 322, 1351.31, 32
2, 15:59:00-000, 309, 116, 193, 116, 1352.17, 106, 1350.95, 31
2, 16:00:00-000, 631, 289, 342, 289, 1352.30, 277, 1350.88, 73
2, 16:01:00-000, 249, 120, 129, 120, 1352.79, 105, 1351.64, 86
2, 16:02:00-000, 641, 269, 372, 269, 1352.44, 265, 1350.58, 28
2, 16:03:00-000, 343, 152, 191, 151, 1351.83, 146, 1352.17, 66
2, 16:04:00-000, 645, 292, 353, 293, 1352.73, 258, 1351.21, 90
2, 16:05:00-000, 337, 168, 169, 168, 1352.54, 177, 1351.20, 49
2, 16:06:00-000, 581, 228, 353, 228, 1351.28, 225, 1350.84, 42
2, 16:07:00-000, 316, 147, 169, 147, 1352.05, 136, 1350.58, 66
2, 16:08:00-000, 705, 257, 448, 257, 1351.56, 291, 1350.29, 121
2, 16:09:00-000, 345, 156, 189, 156, 1352.58, 164, 1351.16, 78
2, 16:10:00-000, 598, 257, 341, 257, 1352.66, 247, 1351.16, 54
2, 16:11:00-000, 347, 167, 180, 167, 1352.27, 159, 1351.06, 66
2, 16:12:00-000, 573, 263, 310, 263, 1352.76, 248, 1352.27, 65
2, 16:13:00-000, 340, 146, 194, 146, 1352.54, 147, 1350.79, 47
2, 16:14:00-000, 594, 225, 369, 225, 1351.40, 237, 1350.48, 69
2, 16:15:00-000, 289, 130, 159, 130, 1352.43, 120, 1351.02, 95
2, 16:16:00-000, 609, 290, 319, 290, 1352.06, 255, 1351.79, 61
2, 16:17:00-000, 273, 119, 154, 119, 1353.00, 105, 1350.11, 68
2, 16:18:00-000, 612, 284, 328, 284, 1352.47, 245, 1351.54, 58
2, 16:19:00-000, 282, 122, 160, 122, 1352.48, 134, 1351.28, 59
2, 16:20:00-000, 637, 250, 387, 250, 1351.40, 244, 1350.45, 51
2, 16:21:00-000, 336, 131, 205, 131, 1352.05, 174, 1351.06, 93
2, 16:22:00-000, 527, 200, 327, 200, 1351.94, 263, 1350.62, 70
2, 16:23:00-000, 331, 173, 158, 173, 1352.62, 130, 1351.54, 40
2, 16:24:00-000, 621, 239, 382, 239, 1351.58, 220, 1350.54, 82
2, 16:25:00-000, 334, 139, 195, 139, 1353.02, 190, 1351.94, 78
2, 16:26:00-000, 673, 272, 401, 272, 1352.58, 269, 1351.03, 79
2, 16:27:00-000, 323, 131, 192, 131, 1351.88, 141, 1350.56, 70
2, 16:28:00-000, 598, 279, 319, 279, 1351.91, 244, 1351.15, 99
2, 16:29:00-000, 335, 128, 207, 128, 1351.90, 154, 1351.12, 65
3, 09:00:00-000, 216, 203, 13, 1, 1349.00, 1, 1349.00, 208
3, 09:01:00-000, 178, 178, 0, 0, 0.00, 0, 0.00, 178
3, 09:02:00-000, 165, 165, 0, 0, 0.00, 0, 0.00, 170
3, 09:03:00-000, 190, 190, 0, 0, 0.00, 0, 0.00, 190
3, 09:04:00-000, 178, 178, 0, 0, 0.00, 0, 0.00, 177
3, 09:05:00-000, 220, 220, 0, 0, 0.00, 0, 0.00, 212
3, 09:06:00-000, 163, 163, 0, 0, 0.00, 0, 0.00, 171
3, 09:07:00-000, 183, 183, 0, 0, 0.00, 0, 0.00, 183
3, 09:08:00-000, 221, 221, 0, 0, 0.00, 0, 0.00, 222
3, 09:09:00-000, 189, 189, 0, 0, 0.00, 0, 0.00, 190
3, 09:10:00-000, 228, 228, 0, 0, 0.00, 0, 0.00, 220
3, 09:11:00-000, 149, 149, 0, 0, 0.00, 0, 0.00, 152
3, 09:12:00-000, 178, 178, 0, 2, 1466.00, 0, 0.00, 180
3, 09:13:00-000, 193, 193, 0, 3, 1480.00, 0, 0.00, 187
3, 09:14:00-000, 172, 172, 0, 2, 1354.50, 0, 0.00, 166
3, 09:15:00-000, 198, 198, 0, 2, 1351.50, 0, 0.00, 203
3, 09:16:00-000, 171, 171, 0, 3, 1354.33, 0, 0.00, 163
3, 09:17:00-000, 207, 207, 0, 1, 1354.00, 0, 0.00, 208
3, 09:18:00-000, 183, 183, 0, 2, 1365.50, 0, 0.00, 183
3, 09:19:00-000, 185, 169, 16, 12, 1356.00, 7, 1367.86, 162
3, 09:20:00-000, 188, 182, 6, 19, 1356.37, 2, 1353.50, 162
3, 09:21:00-000, 208, 176, 32, 6, 1350.17, 1, 1350.00, 205
3, 09:22:00-000, 185, 154, 31, 15, 1353.66, 26, 1355.38, 151
3, 09:23:00-000, 210, 193, 17, 5, 1356.20, 0, 0.00, 205
3, 09:24:00-000, 204, 184, 20, 21, 1363.76, 17, 1370.35, 159
3, 09:25:00-000, 260, 237, 23, 8, 1365.37, 8, 1365.50, 247
3, 09:26:00-000, 210, 197, 13, 0, 0.00, 2, 1351.00, 203
3, 09:27:00-000, 209, 183, 26, 12, 1349.58, 2, 1351.00, 198
3, 09:28:00-000, 189, 173, 16, 3, 1345.00, 1, 1350.00, 191
3, 09:29:00-000, 205, 183, 22, 2, 1350.00, 7, 1351.14, 185
3, 09:30:00-000, 237, 206, 31, 0, 0.00, 1, 1350.00, 237
3, 09:31:00-000, 210, 201, 9, 5, 1351.40, 8, 1353.12, 200
3, 09:32:00-000, 199, 180, 19, 9, 1350.11, 4, 1350.75, 191
3, 09:33:00-000, 175, 152, 23, 4, 1351.00, 8, 1352.12, 165
3, 09:34:00-000, 215, 178, 37, 19, 1349.16, 4, 1350.75, 192
3, 09:35:00-000, 206, 163, 43, 3, 1350.33, 11, 1352.09, 186
3, 09:36:00-000, 178, 145, 33, 9, 1352.22, 11, 1354.18, 161
3, 09:37:00-000, 193, 140, 53, 14, 1349.57, 18, 1352.22, 154
3, 09:38:00-000, 191, 136, 55, 15, 1349.67, 13, 1351.46, 170
3, 09:39:00-000, 196, 139, 57, 10, 1348.60, 9, 1351.00, 179
3, 09:40:00-000, 158, 106, 52, 8, 1348.87, 1, 1350.00, 144
3, 09:41:00-000, 214, 147, 67, 3, 1350.33, 12, 1351.83, 201
3, 09:42:00-000, 200, 184, 16, 1, 1350.00, 15, 1353.47, 170
3, 09:43:00-000, 176, 176, 0, 3, 1351.00, 0, 0.00, 184
3, 09:44:00-000, 176, 134, 42, 11, 1351.73, 3, 1349.33, 165
3, 09:45:00-000, 168, 149, 19, 5, 1352.00, 15, 1352.40, 147
3, 09:46:00-000, 254, 198, 56, 12, 1349.83, 16, 1350.56, 222
3, 09:47:00-000, 179, 171, 8, 2, 1352.00, 6, 1354.33, 168
3, 09:48:00-000, 167, 150, 17, 15, 1349.46, 6, 1351.33, 152
3, 09:49:00-000, 196, 153, 43, 4, 1349.00, 4, 1351.00, 190
3, 09:50:00-000, 182, 149, 33, 7, 1347.43, 7, 1350.86, 167
3, 09:51:00-000, 226, 176, 50, 9, 1346.44, 3, 1352.00, 212
3, 09:52:00-000, 221, 128, 93, 12, 1348.33, 14, 1351.07, 198
3, 09:53:00-000, 204, 163, 41, 11, 1349.54, 10, 1352.10, 177
3, 09:54:00-000, 210, 164, 46, 19, 1348.89, 13, 1351.08, 185
3, 09:55:00-000, 168, 140, 28, 10, 1347.70, 16, 1353.87, 136
3, 09:56:00-000, 167, 136, 31, 10, 1348.20, 4, 1352.00, 162
3, 09:57:00-000, 183, 125, 58, 18, 1348.61, 8, 1350.50, 148
3, 09:58:00-000, 198, 108, 90, 11, 1349.09, 17, 1350.29, 178
3, 09:59:00-000, 178, 119, 59, 6, 1347.17, 5, 1351.60, 166
3, 10:00:00-000, 170, 138, 32, 9, 1348.22, 10, 1350.90, 150
3, 10:01:00-000, 228, 165, 63, 8, 1348.25, 10, 1350.90, 204
3, 10:02:00-000, 190, 123, 67, 8, 1349.62, 19, 1351.58, 164
3, 10:03:00-000, 227, 169, 58, 6, 1347.83, 7, 1350.86, 222
3, 10:04:00-000, 200, 167, 33, 6, 1349.67, 10, 1351.30, 175
3, 10:05:00-000, 204, 186, 18, 10, 1347.70, 7, 1351.00, 192
3, 10:06:00-000, 197, 168, 29, 4, 1350.50, 8, 1351.50, 186
3, 10:07:00-000, 186, 171, 15, 5, 1352.20, 4, 1351.00, 176
3, 10:08:00-000, 208, 159, 49, 13, 1348.54, 6, 1349.00, 188
3, 10:09:00-000, 200, 147, 53, 7, 1349.14, 7, 1351.86, 187
3, 10:10:00-000, 195, 148, 47, 23, 1349.08, 12, 1351.42, 155
3, 10:11:00-000, 206, 135, 71, 6, 1346.33, 2, 1351.00, 195
3, 10:12:00-000, 196, 118, 78, 10, 1347.60, 5, 1348.80, 183
3, 10:13:00-000, 179, 123, 56, 9, 1349.78, 15, 1350.80, 164
3, 10:14:00-000, 218, 158, 60, 9, 1349.00, 12, 1352.00, 186
3, 10:15:00-000, 256, 183, 73, 8, 1349.75, 15, 1351.20, 236
3, 10:16:00-000, 186, 158, 28, 4, 1349.50, 13, 1351.54, 174
3, 10:17:00-000, 214, 193, 21, 16, 1352.56, 14, 1352.43, 180
3, 10:18:00-000, 214, 172, 42, 13, 1349.08, 10, 1351.40, 186
3, 10:19:00-000, 179, 147, 32, 1, 1345.00, 11, 1351.36, 179
3, 10:20:00-000, 228, 188, 40, 18, 1348.17, 7, 1351.43, 199
3, 10:21:00-000, 207, 161, 46, 11, 1346.00, 15, 1351.47, 185
3, 10:22:00-000, 216, 151, 65, 16, 1348.44, 11, 1350.91, 186
3, 10:23:00-000, 180, 169, 11, 1, 1351.00, 10, 1351.80, 173
3, 10:24:00-000, 200, 197, 3, 4, 1351.25, 3, 1353.67, 192
3, 10:25:00-000, 218, 214, 4, 9, 1353.67, 2, 1354.50, 206
3, 10:26:00-000, 249, 199, 50, 20, 1349.65, 6, 1351.67, 222
3, 10:27:00-000, 187, 124, 63, 3, 1351.00, 13, 1352.77, 171
3, 10:28:00-000, 214, 164, 50, 18, 1347.94, 13, 1350.84, 180
3, 10:29:00-000, 209, 118, 91, 10, 1350.80, 24, 1351.29, 178
3, 10:30:00-000, 215, 133, 82, 15, 1349.46, 1, 1350.00, 201
3, 10:31:00-000, 186, 118, 68, 19, 1347.32, 11, 1350.09, 152
3, 10:32:00-000, 202, 173, 29, 8, 1349.87, 22, 1352.18, 175
3, 10:33:00-000, 241, 192, 49, 7, 1347.00, 1, 1352.00, 231
3, 10:34:00-000, 191, 152, 39, 14, 1346.64, 3, 1351.00, 177
3, 10:35:00-000, 194, 121, 73, 6, 1350.83, 18, 1351.50, 169
3, 10:36:00-000, 156, 104, 52, 2, 1346.50, 3, 1352.00, 152
3, 10:37:00-000, 173, 130, 43, 10, 1349.20, 14, 1351.78, 146
3, 10:38:00-000, 215, 159, 56, 12, 1349.08, 6, 1350.50, 189
3, 10:39:00-000, 212, 120, 92, 8, 1347.87, 5, 1350.40, 203
3, 10:40:00-000, 209, 126, 83, 6, 1348.00, 19, 1350.79, 181
3, 10:41:00-000, 183, 155, 28, 8, 1350.87, 10, 1351.40, 173
3, 10:42:00-000, 172, 148, 24, 1, 1348.00, 0, 0.00, 173
3, 10:43:00-000, 173, 145, 28, 4, 1349.25, 3, 1352.00, 163
3, 10:44:00-000, 194, 158, 36, 11, 1349.63, 5, 1351.80, 177
3, 10:45:00-000, 196, 166, 30, 5, 1347.00, 8, 1349.50, 187
3, 10:46:00-000, 188, 156, 32, 10, 1351.20, 12, 1353.33, 164
3, 10:47:00-000, 190, 170, 20, 6, 1349.50, 13, 1351.46, 160
3, 10:48:00-000, 210, 165, 45, 11, 1350.09, 8, 1351.37, 203
3, 10:49:00-000, 206, 175, 31, 12, 1347.08, 1, 1353.00, 195
3, 10:50:00-000, 206, 161, 45, 2, 1347.50, 9, 1352.55, 195
3, 10:51:00-000, 193, 159, 34, 10, 1350.00, 2, 1353.00, 179
3, 10:52:00-000, 188, 154, 34, 18, 1347.50, 13, 1351.92, 154
3, 10:53:00-000, 213, 166, 47, 2, 1346.50, 7, 1351.00, 209
3, 10:54:00-000, 219, 171, 48, 9, 1350.44, 7, 1350.71, 203
3, 10:55:00-000, 194, 158, 36, 3, 1349.33, 3, 1351.00, 182
3, 10:56:00-000, 200, 135, 65, 11, 1348.18, 6, 1350.67, 188
3, 10:57:00-000, 200, 118, 82, 5, 1350.80, 18, 1351.55, 176
3, 10:58:00-000, 175, 114, 61, 14, 1349.71, 4, 1352.50, 155
3, 10:59:00-000, 203, 137, 66, 0, 0.00, 5, 1350.00, 194
3, 11:00:00-000, 196, 169, 27, 9, 1347.89, 10, 1350.40, 180
3, 11:01:00-000, 197, 171, 26, 11, 1348.00, 8, 1353.75, 182
3, 11:02:00-000, 184, 138, 46, 16, 1349.37, 12, 1352.33, 150
3, 11:03:00-000, 198, 133, 65, 3, 1350.00, 7, 1350.71, 190
3, 11:04:00-000, 199, 141, 58, 12, 1347.58, 5, 1351.20, 185
3, 11:05:00-000, 254, 200, 54, 1, 1355.00, 6, 1352.17, 241
3, 11:06:00-000, 189, 123, 66, 11, 1347.91, 9, 1350.67, 177
3, 11:07:00-000, 200, 160, 40, 1, 1349.00, 2, 1350.00, 196
3, 11:08:00-000, 206, 125, 81, 14, 1349.71, 13, 1350.00, 176
3, 11:09:00-000, 183, 128, 55, 4, 1345.75, 12, 1352.25, 164
3, 11:10:00-000, 213, 177, 36, 13, 1349.54, 8, 1350.50, 198
3, 11:11:00-000, 195, 157, 38, 13, 1347.61, 11, 1351.09, 168
3, 11:12:00-000, 186, 130, 56, 9, 1348.11, 1, 1352.00, 178
3, 11:13:00-000, 221, 150, 71, 2, 1348.50, 15, 1352.33, 199
3, 11:14:00-000, 195, 112, 83, 16, 1349.12, 14, 1350.28, 171
3, 11:15:00-000, 186, 149, 37, 0, 0.00, 9, 1350.89, 175
3, 11:16:00-000, 198, 151, 47, 13, 1349.31, 8, 1350.38, 176
3, 11:17:00-000, 172, 123, 49, 1, 1347.00, 0, 0.00, 165
3, 11:18:00-000, 219, 156, 63, 7, 1347.00, 15, 1351.13, 194
3, 11:19:00-000, 163, 123, 40, 3, 1349.00, 9, 1351.00, 161
3, 11:20:00-000, 209, 148, 61, 17, 1350.00, 4, 1351.00, 191
3, 11:21:00-000, 195, 149, 46, 10, 1349.70, 12, 1351.17, 167
3, 11:22:00-000, 230, 187, 43, 20, 1346.85, 6, 1354.83, 203
3, 11:23:00-000, 186, 125, 61, 3, 1345.67, 2, 1350.00, 187
3, 11:24:00-000, 188, 94, 94, 3, 1347.00, 12, 1350.67, 173
3, 11:25:00-000, 182, 124, 58, 14, 1347.64, 8, 1351.62, 158
3, 11:26:00-000, 195, 130, 65, 6, 1347.50, 15, 1351.06, 169
3, 11:27:00-000, 197, 156, 41, 1, 1351.00, 9, 1351.55, 195
3, 11:28:00-000, 214, 186, 28, 19, 1348.00, 6, 1351.83, 183
3, 11:29:00-000, 158, 101, 57, 14, 1348.50, 9, 1351.66, 138
3, 11:30:00-000, 189, 120, 69, 14, 1348.50, 15, 1351.33, 161
3, 11:31:00-000, 207, 140, 67, 14, 1350.43, 9, 1351.56, 179
3, 11:32:00-000, 202, 131, 71, 4, 1347.00, 3, 1350.33, 200
3, 11:33:00-000, 220, 176, 44, 10, 1347.90, 12, 1353.42, 198
3, 11:34:00-000, 240, 166, 74, 20, 1347.95, 11, 1351.00, 209
3, 11:35:00-000, 184, 96, 88, 5, 1347.40, 17, 1349.65, 155
3, 11:36:00-000, 199, 168, 31, 4, 1348.25, 20, 1350.60, 178
3, 11:37:00-000, 202, 164, 38, 19, 1348.37, 8, 1351.00, 173
3, 11:38:00-000, 201, 169, 32, 4, 1349.25, 13, 1351.77, 191
3, 11:39:00-000, 211, 162, 49, 10, 1350.60, 3, 1356.00, 191
3, 11:40:00-000, 224, 174, 50, 12, 1346.25, 16, 1350.56, 202
3, 11:41:00-000, 226, 175, 51, 1, 1347.00, 21, 1350.38, 206
3, 11:42:00-000, 192, 170, 22, 18, 1349.55, 6, 1352.67, 168
3, 11:43:00-000, 219, 145, 74, 5, 1349.60, 0, 0.00, 213
3, 11:44:00-000, 223, 149, 74, 21, 1348.14, 16, 1351.87, 184
3, 11:45:00-000, 226, 168, 58, 13, 1350.31, 18, 1352.89, 196
3, 11:46:00-000, 225, 165, 60, 18, 1348.50, 3, 1351.33, 204
3, 11:47:00-000, 227, 145, 82, 8, 1349.25, 8, 1351.50, 198
3, 11:48:00-000, 222, 86, 136, 11, 1348.18, 13, 1351.00, 211
3, 11:49:00-000, 223, 128, 95, 1, 1347.00, 8, 1349.62, 212
3, 11:50:00-000, 179, 118, 61, 5, 1348.80, 5, 1350.80, 170
3, 11:51:00-000, 217, 144, 73, 7, 1349.00, 9, 1351.67, 191
3, 11:52:00-000, 177, 127, 50, 6, 1350.33, 11, 1351.09, 163
3, 11:53:00-000, 209, 172, 37, 3, 1347.67, 4, 1352.50, 205
3, 11:54:00-000, 190, 149, 41, 6, 1349.00, 13, 1351.00, 177
3, 11:55:00-000, 198, 158, 40, 4, 1346.75, 5, 1350.00, 189
3, 11:56:00-000, 203, 149, 54, 13, 1348.15, 12, 1352.17, 178
3, 11:57:00-000, 211, 172, 39, 3, 1348.00, 2, 1348.00, 201
3, 11:58:00-000, 232, 206, 26, 11, 1347.91, 6, 1351.00, 214
3, 11:59:00-000, 199, 145, 54, 3, 1349.00, 3, 1352.00, 195
3, 12:00:00-000, 229, 154, 75, 19, 1348.63, 13, 1351.92, 199
3, 12:01:00-000, 208, 168, 40, 6, 1347.00, 16, 1351.44, 182
3, 12:02:00-000, 249, 211, 38, 14, 1346.64, 15, 1351.40, 225
3, 12:03:00-000, 201, 172, 29, 16, 1348.81, 9, 1352.22, 176
3, 12:04:00-000, 195, 160, 35, 8, 1349.75, 6, 1351.33, 180
3, 12:05:00-000, 207, 156, 51, 4, 1348.00, 0, 0.00, 197
3, 12:06:00-000, 192, 152, 40, 18, 1348.11, 16, 1352.44, 157
3, 12:07:00-000, 196, 156, 40, 6, 1349.33, 5, 1350.60, 194
3, 12:08:00-000, 224, 121, 103, 23, 1347.13, 7, 1350.43, 185
3, 12:09:00-000, 166, 78, 88, 11, 1347.82, 8, 1351.50, 155
3, 12:10:00-000, 207, 115, 92, 11, 1346.54, 11, 1350.45, 182
3, 12:11:00-000, 171, 94, 77, 3, 1347.67, 7, 1350.00, 157
3, 12:12:00-000, 225, 141, 84, 10, 1346.80, 30, 1350.20, 191
3, 12:13:00-000, 197, 146, 51, 16, 1345.56, 0, 0.00, 183
3, 12:14:00-000, 234, 157, 77, 21, 1348.09, 8, 1350.87, 204
3, 12:15:00-000, 222, 114, 108, 8, 1347.00, 6, 1351.00, 207
3, 12:16:00-000, 167, 85, 82, 10, 1348.40, 25, 1350.72, 135
3, 12:17:00-000, 189, 115, 74, 3, 1349.33, 5, 1350.80, 179
3, 12:18:00-000, 186, 127, 59, 8, 1348.87, 14, 1351.50, 154
3, 12:19:00-000, 204, 114, 90, 7, 1349.28, 14, 1353.28, 192
3, 12:20:00-000, 180, 143, 37, 18, 1348.89, 12, 1351.08, 146
3, 12:21:00-000, 174, 101, 73, 3, 1349.00, 2, 1352.00, 172
3, 12:22:00-000, 203, 149, 54, 5, 1351.40, 17, 1351.88, 178
3, 12:23:00-000, 233, 191, 42, 6, 1349.33, 13, 1351.31, 216
3, 12:24:00-000, 181, 162, 19, 12, 1347.66, 3, 1353.00, 167
3, 12:25:00-000, 262, 230, 32, 11, 1350.00, 11, 1351.63, 229
3, 12:26:00-000, 219, 178, 41, 18, 1348.50, 18, 1351.89, 198
3, 12:27:00-000, 214, 181, 33, 10, 1347.10, 3, 1350.67, 190
3, 12:28:00-000, 195, 142, 53, 8, 1348.37, 10, 1350.70, 180
3, 12:29:00-000, 226, 186, 40, 6, 1351.00, 14, 1352.43, 206
3, 12:30:00-000, 189, 152, 37, 15, 1348.33, 6, 1350.50, 174
3, 12:31:00-000, 172, 148, 24, 8, 1349.75, 8, 1352.87, 156
3, 12:32:00-000, 199, 158, 41, 15, 1346.80, 8, 1350.50, 173
3, 12:33:00-000, 217, 156, 61, 3, 1348.33, 5, 1351.60, 207
3, 12:34:00-000, 217, 149, 68, 15, 1347.80, 10, 1351.70, 194
3, 12:35:00-000, 217, 135, 82, 4, 1348.25, 1, 1350.00, 213
3, 12:36:00-000, 202, 101, 101, 8, 1348.25, 18, 1350.05, 179
3, 12:37:00-000, 232, 143, 89, 13, 1347.85, 17, 1351.29, 200
3, 12:38:00-000, 196, 172, 24, 16, 1349.62, 17, 1352.41, 159
3, 12:39:00-000, 182, 164, 18, 6, 1353.67, 12, 1353.33, 165
3, 12:40:00-000, 201, 175, 26, 10, 1349.10, 4, 1351.50, 193
3, 12:41:00-000, 190, 161, 29, 3, 1348.00, 5, 1351.00, 171
3, 12:42:00-000, 203, 170, 33, 20, 1348.90, 9, 1352.22, 179
3, 12:43:00-000, 212, 139, 73, 4, 1350.00, 8, 1351.75, 204
3, 12:44:00-000, 210, 132, 78, 22, 1347.18, 29, 1350.96, 159
3, 12:45:00-000, 200, 144, 56, 24, 1348.83, 17, 1350.76, 161
3, 12:46:00-000, 191, 127, 64, 7, 1349.57, 14, 1351.78, 170
3, 12:47:00-000, 230, 160, 70, 3, 1349.33, 13, 1350.61, 205
3, 12:48:00-000, 218, 179, 39, 12, 1349.42, 24, 1352.16, 180
3, 12:49:00-000, 175, 159, 16, 4, 1348.25, 1, 1352.00, 178
3, 12:50:00-000, 178, 150, 28, 4, 1347.00, 3, 1351.00, 170
3, 12:51:00-000, 199, 169, 30, 10, 1348.60, 8, 1350.00, 182
3, 12:52:00-000, 204, 162, 42, 10, 1348.20, 7, 1353.14, 188
3, 12:53:00-000, 208, 187, 21, 14, 1352.71, 13, 1353.61, 173
3, 12:54:00-000, 197, 183, 14, 10, 1347.80, 5, 1350.60, 187
3, 12:55:00-000, 217, 156, 61, 7, 1350.43, 8, 1351.25, 205
3, 12:56:00-000, 249, 187, 62, 14, 1347.64, 1, 1351.00, 233
3, 12:57:00-000, 189, 127, 62, 5, 1347.80, 12, 1352.33, 174
3, 12:58:00-000, 168, 136, 32, 12, 1348.00, 11, 1351.09, 144
3, 12:59:00-000, 195, 153, 42, 4, 1348.75, 6, 1351.50, 186
3, 13:00:00-000, 224, 182, 42, 17, 1348.65, 4, 1351.75, 202
3, 13:01:00-000, 209, 152, 57, 12, 1346.50, 7, 1351.57, 192
3, 13:02:00-000, 214, 129, 85, 19, 1350.84, 19, 1353.37, 162
3, 13:03:00-000, 219, 151, 68, 2, 1350.00, 10, 1351.50, 221
3, 13:04:00-000, 199, 90, 109, 14, 1346.93, 17, 1351.88, 167
3, 13:05:00-000, 191, 124, 67, 13, 1346.23, 3, 1349.67, 162
3, 13:06:00-000, 170, 96, 74, 21, 1351.19, 19, 1352.84, 140
3, 13:07:00-000, 191, 114, 77, 2, 1348.50, 21, 1351.19, 170
3, 13:08:00-000, 231, 146, 85, 23, 1347.87, 8, 1351.37, 198
3, 13:09:00-000, 202, 147, 55, 1, 1348.00, 8, 1351.12, 190
3, 13:10:00-000, 217, 174, 43, 18, 1349.50, 16, 1352.31, 189
3, 13:11:00-000, 212, 193, 19, 5, 1349.00, 8, 1352.62, 200
3, 13:12:00-000, 235, 175, 60, 14, 1350.43, 23, 1351.30, 194
3, 13:13:00-000, 186, 179, 7, 8, 1349.62, 1, 1353.00, 171
3, 13:14:00-000, 220, 171, 49, 11, 1348.45, 9, 1351.11, 210
3, 13:15:00-000, 209, 152, 57, 3, 1351.00, 11, 1352.54, 192
3, 13:16:00-000, 206, 176, 30, 16, 1349.69, 6, 1351.67, 179
3, 13:17:00-000, 171, 110, 61, 9, 1350.11, 9, 1351.67, 153
3, 13:18:00-000, 184, 101, 83, 7, 1346.86, 8, 1352.00, 176
3, 13:19:00-000, 177, 156, 21, 3, 1346.33, 12, 1350.25, 158
3, 13:20:00-000, 162, 132, 30, 10, 1349.60, 5, 1351.60, 146
3, 13:21:00-000, 230, 181, 49, 14, 1348.86, 4, 1351.50, 218
3, 13:22:00-000, 198, 141, 57, 4, 1348.25, 13, 1351.69, 177
3, 13:23:00-000, 161, 139, 22, 4, 1349.75, 5, 1351.00, 151
3, 13:24:00-000, 176, 150, 26, 11, 1350.27, 13, 1353.15, 147
3, 13:25:00-000, 217, 184, 33, 25, 1353.04, 2, 1353.00, 198
3, 13:26:00-000, 215, 75, 140, 19, 1348.73, 14, 1352.28, 180
3, 13:27:00-000, 198, 67, 131, 6, 1348.00, 5, 1350.80, 187
3, 13:28:00-000, 214, 94, 120, 7, 1348.86, 24, 1350.41, 186
3, 13:29:00-000, 189, 110, 79, 3, 1346.00, 18, 1350.67, 168
3, 13:30:00-000, 189, 141, 48, 11, 1349.45, 11, 1351.18, 165
3, 13:31:00-000, 239, 172, 67, 27, 1351.00, 3, 1351.67, 202
3, 13:32:00-000, 206, 91, 115, 17, 1349.35, 16, 1351.37, 183
3, 13:33:00-000, 155, 93, 62, 4, 1347.75, 13, 1351.38, 137
3, 13:34:00-000, 169, 97, 72, 7, 1347.71, 9, 1350.55, 150
3, 13:35:00-000, 216, 162, 54, 1, 1346.00, 7, 1353.00, 208
3, 13:36:00-000, 199, 124, 75, 6, 1346.17, 7, 1353.29, 189
3, 13:37:00-000, 218, 155, 63, 11, 1347.45, 13, 1351.15, 190
3, 13:38:00-000, 152, 108, 44, 7, 1347.14, 9, 1350.89, 133
3, 13:39:00-000, 212, 143, 69, 5, 1350.20, 15, 1350.67, 196
3, 13:40:00-000, 197, 154, 43, 16, 1347.31, 4, 1351.00, 178
3, 13:41:00-000, 212, 140, 72, 4, 1348.75, 7, 1352.57, 193
3, 13:42:00-000, 201, 140, 61, 14, 1347.43, 11, 1351.54, 186
3, 13:43:00-000, 215, 159, 56, 10, 1347.70, 5, 1350.60, 192
3, 13:44:00-000, 194, 131, 63, 24, 1347.46, 10, 1350.40, 166
3, 13:45:00-000, 189, 101, 88, 4, 1350.50, 13, 1350.84, 175
3, 13:46:00-000, 197, 137, 60, 16, 1346.81, 15, 1350.80, 164
3, 13:47:00-000, 221, 112, 109, 3, 1349.00, 3, 1351.33, 213
3, 13:48:00-000, 181, 125, 56, 10, 1348.60, 23, 1351.82, 142
3, 13:49:00-000, 214, 139, 75, 10, 1348.60, 5, 1352.00, 208
3, 13:50:00-000, 188, 99, 89, 11, 1348.27, 11, 1351.54, 165
3, 13:51:00-000, 172, 109, 63, 5, 1348.00, 3, 1349.33, 161
3, 13:52:00-000, 203, 150, 53, 6, 1349.33, 21, 1352.62, 175
3, 13:53:00-000, 202, 174, 28, 3, 1348.67, 2, 1352.00, 201
3, 13:54:00-000, 206, 172, 34, 11, 1349.27, 12, 1352.33, 180
3, 13:55:00-000, 239, 235, 4, 2, 1344.00, 1, 1351.00, 235
3, 13:56:00-000, 197, 146, 51, 21, 1348.81, 9, 1350.55, 172
3, 13:57:00-000, 204, 152, 52, 7, 1346.29, 7, 1350.71, 183
3, 13:58:00-000, 220, 144, 76, 29, 1347.07, 15, 1350.20, 182
3, 13:59:00-000, 197, 103, 94, 8, 1345.75, 12, 1351.75, 172
3, 14:00:00-000, 249, 124, 125, 9, 1346.67, 3, 1352.67, 243
3, 14:01:00-000, 209, 113, 96, 5, 1345.80, 17, 1352.00, 176
3, 14:02:00-000, 171, 124, 47, 17, 1348.12, 18, 1351.22, 148
3, 14:03:00-000, 205, 149, 56, 6, 1350.17, 10, 1352.70, 177
3, 14:04:00-000, 206, 146, 60, 10, 1348.80, 8, 1350.62, 198
3, 14:05:00-000, 208, 108, 100, 12, 1346.58, 10, 1348.70, 179
3, 14:06:00-000, 208, 138, 70, 22, 1346.77, 21, 1351.24, 170
3, 14:07:00-000, 188, 116, 72, 4, 1346.75, 4, 1350.00, 179
3, 14:08:00-000, 207, 148, 59, 11, 1348.45, 21, 1352.47, 175
3, 14:09:00-000, 202, 165, 37, 8, 1348.12, 12, 1350.92, 182
3, 14:10:00-000, 203, 176, 27, 10, 1346.60, 3, 1350.67, 194
3, 14:11:00-000, 178, 151, 27, 14, 1348.78, 7, 1351.57, 150
3, 14:12:00-000, 246, 164, 82, 25, 1348.60, 18, 1351.22, 210
3, 14:13:00-000, 226, 145, 81, 10, 1352.30, 19, 1350.79, 192
3, 14:14:00-000, 193, 142, 51, 4, 1348.25, 7, 1350.86, 187
3, 14:15:00-000, 203, 113, 90, 4, 1346.50, 0, 0.00, 197
3, 14:16:00-000, 189, 121, 68, 21, 1347.33, 16, 1350.87, 155
3, 14:17:00-000, 207, 124, 83, 6, 1348.67, 11, 1350.09, 180
3, 14:18:00-000, 211, 154, 57, 21, 1348.24, 16, 1351.25, 166
3, 14:19:00-000, 222, 122, 100, 2, 1350.50, 10, 1351.80, 223
3, 14:20:00-000, 209, 161, 48, 17, 1348.17, 17, 1352.06, 174
3, 14:21:00-000, 180, 110, 70, 9, 1347.44, 3, 1351.33, 172
3, 14:22:00-000, 205, 121, 84, 3, 1346.33, 17, 1350.12, 185
3, 14:23:00-000, 189, 168, 21, 2, 1348.00, 8, 1351.50, 178
3, 14:24:00-000, 181, 157, 24, 13, 1349.30, 2, 1353.00, 166
3, 14:25:00-000, 202, 133, 69, 5, 1347.40, 2, 1350.50, 197
3, 14:26:00-000, 201, 125, 76, 17, 1347.53, 9, 1350.89, 170
3, 14:27:00-000, 209, 92, 117, 5, 1347.00, 6, 1350.17, 193
3, 14:28:00-000, 187, 111, 76, 2, 1346.00, 7, 1351.14, 177
3, 14:29:00-000, 174, 115, 59, 6, 1349.83, 9, 1351.44, 167
3, 14:30:00-000, 206, 144, 62, 23, 1348.65, 24, 1351.29, 161
3, 14:31:00-000, 193, 131, 62, 4, 1350.50, 16, 1352.00, 164
3, 14:32:00-000, 179, 160, 19, 10, 1347.70, 5, 1351.00, 174
3, 14:33:00-000, 191, 137, 54, 12, 1346.58, 2, 1351.50, 173
3, 14:34:00-000, 193, 127, 66, 21, 1347.47, 14, 1350.93, 156
3, 14:35:00-000, 205, 140, 65, 7, 1348.28, 15, 1351.20, 182
3, 14:36:00-000, 171, 137, 34, 2, 1350.50, 6, 1351.33, 170
3, 14:37:00-000, 212, 186, 26, 0, 0.00, 5, 1351.20, 207
3, 14:38:00-000, 196, 168, 28, 8, 1349.75, 5, 1352.20, 179
3, 14:39:00-000, 207, 161, 46, 3, 1348.00, 10, 1351.20, 188
3, 14:40:00-000, 206, 160, 46, 16, 1350.06, 7, 1350.57, 184
3, 14:41:00-000, 196, 153, 43, 13, 1348.15, 6, 1350.50, 179
3, 14:42:00-000, 203, 114, 89, 19, 1346.68, 6, 1351.33, 176
3, 14:43:00-000, 233, 138, 95, 2, 1349.00, 22, 1352.27, 216
3, 14:44:00-000, 224, 171, 53, 25, 1349.08, 24, 1352.58, 174
3, 14:45:00-000, 192, 142, 50, 11, 1348.54, 6, 1350.50, 167
3, 14:46:00-000, 201, 134, 67, 19, 1347.68, 15, 1350.27, 176
3, 14:47:00-000, 188, 148, 40, 3, 1348.67, 10, 1350.60, 170
3, 14:48:00-000, 210, 121, 89, 19, 1347.63, 6, 1349.00, 190
3, 14:49:00-000, 175, 71, 104, 16, 1348.93, 8, 1352.00, 147
3, 14:50:00-000, 190, 78, 112, 11, 1347.27, 21, 1351.62, 156
3, 14:51:00-000, 220, 140, 80, 2, 1348.00, 10, 1350.80, 210
3, 14:52:00-000, 205, 104, 101, 6, 1347.00, 8, 1351.75, 187
3, 14:53:00-000, 215, 153, 62, 11, 1347.54, 4, 1350.50, 210
3, 14:54:00-000, 195, 124, 71, 11, 1347.45, 7, 1350.43, 177
3, 14:55:00-000, 184, 127, 57, 3, 1347.00, 9, 1349.00, 155
3, 14:56:00-000, 215, 134, 81, 7, 1346.00, 13, 1350.07, 198
3, 14:57:00-000, 213, 156, 57, 2, 1348.00, 15, 1352.00, 210
3, 14:58:00-000, 194, 152, 42, 15, 1348.87, 7, 1351.00, 171
3, 14:59:00-000, 165, 129, 36, 8, 1348.25, 14, 1350.93, 130
3, 15:00:00-000, 195, 144, 51, 11, 1348.18, 10, 1352.50, 188
3, 15:01:00-000, 198, 190, 8, 9, 1351.33, 1, 1348.00, 177
3, 15:02:00-000, 184, 148, 36, 15, 1348.93, 9, 1350.55, 168
3, 15:03:00-000, 254, 179, 75, 5, 1346.40, 14, 1350.50, 229
3, 15:04:00-000, 204, 165, 39, 17, 1346.94, 12, 1352.25, 184
3, 15:05:00-000, 183, 160, 23, 10, 1350.40, 17, 1351.17, 153
3, 15:06:00-000, 202, 141, 61, 27, 1347.03, 11, 1351.82, 156
3, 15:07:00-000, 203, 149, 54, 7, 1346.57, 2, 1351.50, 205
3, 15:08:00-000, 196, 112, 84, 9, 1346.67, 19, 1350.68, 157
3, 15:09:00-000, 203, 124, 79, 27, 1347.37, 13, 1352.00, 173
3, 15:10:00-000, 204, 134, 70, 1, 1348.00, 13, 1350.84, 188
3, 15:11:00-000, 207, 151, 56, 3, 1349.33, 9, 1351.78, 188
3, 15:12:00-000, 208, 159, 49, 20, 1351.10, 15, 1352.80, 183
3, 15:13:00-000, 239, 202, 37, 12, 1351.00, 20, 1352.10, 204
3, 15:14:00-000, 196, 159, 37, 30, 1348.36, 9, 1349.11, 153
3, 15:15:00-000, 209, 128, 81, 3, 1347.00, 8, 1350.37, 198
3, 15:16:00-000, 210, 132, 78, 14, 1349.43, 23, 1352.35, 172
3, 15:17:00-000, 210, 121, 89, 14, 1348.43, 8, 1350.88, 195
3, 15:18:00-000, 204, 112, 92, 14, 1348.86, 20, 1351.75, 172
3, 15:19:00-000, 239, 122, 117, 6, 1348.50, 10, 1350.50, 218
3, 15:20:00-000, 185, 138, 47, 7, 1351.57, 16, 1351.62, 156
3, 15:21:00-000, 217, 182, 35, 9, 1349.11, 3, 1350.33, 210
3, 15:22:00-000, 203, 176, 27, 14, 1347.00, 5, 1351.00, 182
3, 15:23:00-000, 214, 172, 42, 11, 1347.00, 8, 1352.25, 196
3, 15:24:00-000, 211, 129, 82, 21, 1347.43, 16, 1351.75, 179
3, 15:25:00-000, 203, 127, 76, 4, 1346.00, 17, 1351.58, 177
3, 15:26:00-000, 196, 145, 51, 5, 1349.00, 8, 1351.87, 184
3, 15:27:00-000, 240, 192, 48, 6, 1347.67, 11, 1353.00, 228
3, 15:28:00-000, 196, 145, 51, 21, 1347.95, 7, 1351.57, 162
3, 15:29:00-000, 225, 168, 57, 7, 1348.57, 8, 1350.75, 210
3, 15:30:00-000, 237, 154, 83, 11, 1347.27, 4, 1350.50, 229
3, 15:31:00-000, 191, 127, 64, 4, 1349.25, 12, 1350.67, 168
3, 15:32:00-000, 202, 138, 64, 5, 1348.00, 10, 1351.70, 188
3, 15:33:00-000, 198, 151, 47, 7, 1349.14, 10, 1351.90, 184
3, 15:34:00-000, 203, 154, 49, 12, 1346.75, 8, 1351.62, 178
3, 15:35:00-000, 207, 143, 64, 1, 1346.00, 7, 1351.43, 205
3, 15:36:00-000, 224, 212, 12, 4, 1349.00, 8, 1351.87, 203
3, 15:37:00-000, 193, 149, 44, 18, 1349.83, 5, 1350.00, 173
3, 15:38:00-000, 201, 134, 67, 20, 1347.35, 12, 1351.00, 175
3, 15:39:00-000, 229, 113, 116, 9, 1346.67, 17, 1351.00, 205
3, 15:40:00-000, 207, 153, 54, 14, 1348.93, 8, 1351.75, 182
3, 15:41:00-000, 209, 136, 73, 9, 1347.44, 14, 1350.57, 186
3, 15:42:00-000, 203, 115, 88, 12, 1348.58, 6, 1350.67, 181
3, 15:43:00-000, 186, 119, 67, 3, 1348.00, 9, 1351.00, 180
3, 15:44:00-000, 202, 162, 40, 5, 1348.20, 9, 1351.67, 188
3, 15:45:00-000, 212, 145, 67, 10, 1347.20, 4, 1351.50, 194
3, 15:46:00-000, 184, 147, 37, 8, 1349.62, 21, 1351.09, 152
3, 15:47:00-000, 225, 158, 67, 11, 1349.54, 7, 1350.71, 204
3, 15:48:00-000, 187, 141, 46, 9, 1348.55, 10, 1351.30, 177
3, 15:49:00-000, 190, 112, 78, 12, 1348.83, 9, 1350.22, 170
3, 15:50:00-000, 159, 106, 53, 3, 1349.00, 7, 1351.00, 146
3, 15:51:00-000, 170, 123, 47, 9, 1347.22, 4, 1350.75, 151
3, 15:52:00-000, 196, 138, 58, 19, 1349.37, 12, 1350.75, 173
3, 15:53:00-000, 232, 154, 78, 38, 1348.94, 21, 1351.90, 172
3, 15:54:00-000, 171, 70, 101, 7, 1348.71, 30, 1351.66, 137
3, 15:55:00-000, 211, 135, 76, 11, 1347.09, 6, 1350.50, 192
3, 15:56:00-000, 222, 150, 72, 14, 1349.07, 18, 1351.55, 191
3, 15:57:00-000, 237, 187, 50, 8, 1347.62, 7, 1350.71, 219
3, 15:58:00-000, 224, 166, 58, 32, 1347.53, 16, 1350.68, 178
3, 15:59:00-000, 204, 124, 80, 3, 1346.67, 15, 1350.87, 188
3, 16:00:00-000, 193, 110, 83, 13, 1347.85, 17, 1351.53, 160
3, 16:01:00-000, 192, 125, 67, 14, 1349.50, 8, 1351.00, 169
3, 16:02:00-000, 191, 128, 63, 17, 1349.00, 14, 1350.50, 159
3, 16:03:00-000, 216, 164, 52, 1, 1351.00, 21, 1351.76, 184
3, 16:04:00-000, 217, 175, 42, 16, 1348.25, 2, 1351.50, 206
3, 16:05:00-000, 226, 163, 63, 6, 1347.17, 5, 1352.40, 221
3, 16:06:00-000, 199, 139, 60, 20, 1348.25, 20, 1350.75, 155
3, 16:07:00-000, 196, 132, 64, 1, 1348.00, 19, 1350.63, 174
3, 16:08:00-000, 214, 137, 77, 21, 1346.76, 15, 1350.86, 184
3, 16:09:00-000, 198, 143, 55, 16, 1346.94, 4, 1352.00, 180
3, 16:10:00-000, 198, 136, 62, 1, 1348.00, 10, 1350.20, 181
3, 16:11:00-000, 184, 146, 38, 5, 1349.60, 6, 1350.67, 169
3, 16:12:00-000, 194, 122, 72, 24, 1348.46, 13, 1350.69, 164
3, 16:13:00-000, 197, 115, 82, 7, 1348.00, 11, 1351.00, 181
3, 16:14:00-000, 233, 179, 54, 13, 1347.23, 13, 1350.54, 208
3, 16:15:00-000, 176, 131, 45, 1, 1348.00, 9, 1350.78, 158
3, 16:16:00-000, 192, 121, 71, 10, 1351.80, 20, 1352.85, 164
3, 16:17:00-000, 221, 198, 23, 10, 1350.60, 14, 1352.36, 203
3, 16:18:00-000, 201, 162, 39, 27, 1347.96, 2, 1350.50, 167
3, 16:19:00-000, 202, 122, 80, 12, 1349.83, 16, 1351.25, 176
3, 16:20:00-000, 199, 128, 71, 14, 1346.78, 22, 1350.86, 155
3, 16:21:00-000, 219, 163, 56, 5, 1348.40, 7, 1351.43, 216
3, 16:22:00-000, 191, 128, 63, 14, 1349.50, 19, 1352.79, 158
3, 16:23:00-000, 206, 164, 42, 18, 1350.94, 13, 1353.54, 163
3, 16:24:00-000, 186, 145, 41, 7, 1348.43, 11, 1352.09, 174
3, 16:25:00-000, 205, 161, 44, 14, 1348.00, 4, 1350.50, 190
3, 16:26:00-000, 197, 185, 12, 13, 1347.77, 5, 1350.60, 177
3, 16:27:00-000, 240, 184, 56, 1, 1349.00, 0, 0.00, 241
3, 16:28:00-000, 239, 145, 94, 21, 1348.52, 33, 1351.87, 189
3, 16:29:00-000, 235, 142, 93, 9, 1349.00, 12, 1351.50, 212
4, 09:03:00-000, 298, 298, 0, 0, 0.00, 0, 0.00, 297
4, 09:04:00-000, 0, 0, 0, 0, 0.00, 0, 0.00, 1
4, 09:06:00-000, 326, 326, 0, 325, 1351.00, 0, 0.00, 0
4, 09:07:00-000, 4, 4, 0, 3, 1351.00, 0, 0.00, 1
4, 09:08:00-000, 44, 35, 9, 9, 1352.22, 9, 1352.22, 10
4, 09:09:00-000, 88, 53, 35, 29, 1364.79, 29, 1364.79, 24
4, 09:10:00-000, 117, 97, 20, 26, 1379.53, 26, 1379.53, 73
4, 09:11:00-000, 88, 73, 15, 15, 1430.00, 15, 1430.00, 65
4, 09:12:00-000, 77, 52, 25, 23, 1449.04, 25, 1450.40, 29
4, 09:13:00-000, 104, 77, 27, 70, 1401.51, 27, 1379.14, 9
4, 09:14:00-000, 77, 63, 14, 51, 1356.44, 5, 1353.80, 19
4, 09:15:00-000, 77, 60, 17, 46, 1355.36, 13, 1353.23, 15
4, 09:16:00-000, 80, 47, 33, 43, 1352.60, 21, 1352.95, 4
4, 09:17:00-000, 73, 47, 26, 34, 1361.05, 36, 1361.11, 24
4, 09:18:00-000, 108, 47, 61, 42, 1363.47, 46, 1363.95, 3
4, 09:19:00-000, 88, 59, 29, 50, 1360.33, 42, 1359.71, 15
4, 09:20:00-000, 81, 47, 34, 33, 1353.21, 28, 1353.14, 9
4, 09:21:00-000, 82, 41, 41, 41, 1351.55, 43, 1351.48, 5
4, 09:22:00-000, 98, 54, 44, 45, 1355.21, 38, 1355.63, 12
4, 09:23:00-000, 72, 39, 33, 37, 1353.86, 30, 1353.46, 7
4, 09:24:00-000, 81, 32, 49, 34, 1368.58, 45, 1368.57, 2
4, 09:25:00-000, 69, 32, 37, 32, 1356.96, 34, 1358.43, 6
4, 09:26:00-000, 78, 38, 40, 37, 1351.10, 35, 1351.22, 2
4, 09:27:00-000, 87, 41, 46, 36, 1350.66, 44, 1350.83, 3
4, 09:28:00-000, 85, 25, 60, 31, 1350.03, 50, 1349.77, 4
4, 09:29:00-000, 89, 36, 53, 36, 1350.49, 51, 1349.93, 3
4, 09:30:00-000, 72, 28, 44, 28, 1350.10, 49, 1349.69, 4
4, 09:31:00-000, 98, 50, 48, 46, 1353.28, 45, 1353.62, 4
4, 09:32:00-000, 72, 38, 34, 35, 1351.85, 24, 1352.54, 6
4, 09:33:00-000, 98, 54, 44, 51, 1352.27, 43, 1351.83, 13
4, 09:34:00-000, 88, 38, 50, 38, 1351.41, 48, 1351.18, 1
4, 09:35:00-000, 84, 39, 45, 38, 1351.76, 30, 1352.36, 0
4, 09:36:00-000, 88, 43, 45, 44, 1352.49, 48, 1352.37, 10
4, 09:37:00-000, 110, 64, 46, 60, 1351.41, 44, 1351.04, 8
4, 09:38:00-000, 80, 42, 38, 40, 1351.24, 33, 1351.42, 2
4, 09:39:00-000, 88, 37, 51, 36, 1350.63, 45, 1350.19, 7
4, 09:40:00-000, 67, 23, 44, 24, 1350.12, 42, 1350.40, 3
4, 09:41:00-000, 91, 45, 46, 42, 1350.99, 40, 1351.32, 5
4, 09:42:00-000, 85, 53, 32, 51, 1352.58, 38, 1352.10, 4
4, 09:43:00-000, 61, 27, 34, 20, 1353.15, 24, 1353.16, 7
4, 09:44:00-000, 94, 26, 68, 27, 1349.74, 51, 1348.68, 13
4, 09:45:00-000, 119, 71, 48, 60, 1351.84, 50, 1351.67, 12
4, 09:46:00-000, 64, 33, 31, 39, 1351.84, 24, 1349.75, 6
4, 09:47:00-000, 88, 47, 41, 45, 1352.50, 33, 1352.18, 3
4, 09:48:00-000, 68, 34, 34, 27, 1350.51, 32, 1351.31, 12
4, 09:49:00-000, 81, 41, 40, 37, 1350.05, 31, 1349.93, 13
4, 09:50:00-000, 90, 45, 45, 50, 1350.19, 41, 1350.09, 2
4, 09:51:00-000, 92, 37, 55, 32, 1350.15, 47, 1350.16, 3
4, 09:52:00-000, 90, 40, 50, 45, 1351.28, 55, 1351.05, 0
4, 09:53:00-000, 59, 31, 28, 31, 1351.80, 26, 1351.46, 5
4, 09:54:00-000, 104, 60, 44, 55, 1351.12, 46, 1351.27, 1
4, 09:55:00-000, 63, 25, 38, 25, 1354.04, 20, 1351.70, 11
4, 09:56:00-000, 71, 30, 41, 29, 1351.44, 46, 1351.75, 3
4, 09:57:00-000, 101, 55, 46, 47, 1349.31, 38, 1349.81, 10
4, 09:58:00-000, 65, 25, 40, 27, 1350.14, 34, 1351.44, 7
4, 09:59:00-000, 86, 35, 51, 34, 1349.29, 39, 1349.92, 12
4, 10:00:00-000, 86, 54, 32, 45, 1350.66, 37, 1350.40, 4
4, 10:01:00-000, 66, 31, 35, 36, 1350.66, 31, 1349.80, 3
4, 10:02:00-000, 72, 45, 27, 42, 1351.06, 23, 1351.39, 7
4, 10:03:00-000, 89, 43, 46, 38, 1350.21, 44, 1349.83, 4
4, 10:04:00-000, 60, 27, 33, 30, 1351.43, 32, 1352.75, 3
4, 10:05:00-000, 84, 41, 43, 40, 1350.67, 35, 1350.22, 9
4, 10:06:00-000, 80, 35, 45, 33, 1350.87, 43, 1350.90, 4
4, 10:07:00-000, 61, 31, 30, 29, 1351.48, 21, 1351.61, 8
4, 10:08:00-000, 85, 31, 54, 28, 1350.78, 36, 1351.05, 9
4, 10:09:00-000, 86, 45, 41, 45, 1351.19, 46, 1351.29, 10
4, 10:10:00-000, 85, 39, 46, 38, 1352.33, 39, 1352.58, 11
4, 10:11:00-000, 76, 29, 47, 29, 1350.82, 29, 1351.24, 8
4, 10:12:00-000, 84, 30, 54, 28, 1348.89, 58, 1348.44, 3
4, 10:13:00-000, 87, 43, 44, 38, 1350.86, 36, 1351.10, 16
4, 10:14:00-000, 74, 39, 35, 37, 1350.94, 30, 1351.06, 0
4, 10:15:00-000, 63, 34, 29, 35, 1350.14, 26, 1349.80, 5
4, 10:16:00-000, 63, 29, 34, 26, 1352.07, 36, 1352.33, 3
4, 10:17:00-000, 118, 48, 70, 48, 1352.76, 49, 1353.38, 18
4, 10:18:00-000, 89, 50, 39, 49, 1350.81, 42, 1349.80, 2
4, 10:19:00-000, 72, 28, 44, 29, 1352.75, 36, 1353.38, 3
4, 10:20:00-000, 93, 39, 54, 34, 1350.94, 47, 1350.74, 4
4, 10:21:00-000, 90, 45, 45, 45, 1351.21, 49, 1350.17, 9
4, 10:22:00-000, 89, 35, 54, 33, 1349.51, 33, 1350.05, 14
4, 10:23:00-000, 110, 68, 42, 66, 1350.67, 49, 1350.65, 4
4, 10:24:00-000, 84, 65, 19, 39, 1354.51, 21, 1353.76, 13
4, 10:25:00-000, 93, 51, 42, 50, 1354.89, 30, 1354.20, 23
4, 10:26:00-000, 86, 41, 45, 41, 1351.41, 39, 1351.89, 0
4, 10:27:00-000, 91, 51, 40, 50, 1351.55, 39, 1352.02, 7
4, 10:28:00-000, 73, 34, 39, 33, 1351.30, 38, 1351.23, 0
4, 10:29:00-000, 75, 40, 35, 33, 1350.45, 29, 1350.82, 5
4, 10:30:00-000, 92, 43, 49, 46, 1350.30, 52, 1350.80, 4
4, 10:31:00-000, 93, 43, 50, 38, 1348.68, 42, 1350.35, 7
4, 10:32:00-000, 93, 57, 36, 57, 1352.39, 31, 1352.77, 0
4, 10:33:00-000, 81, 33, 48, 37, 1351.13, 50, 1351.19, 9
4, 10:34:00-000, 87, 47, 40, 43, 1349.90, 30, 1350.23, 4
4, 10:35:00-000, 75, 45, 30, 44, 1351.54, 31, 1351.57, 11
4, 10:36:00-000, 71, 32, 39, 23, 1349.00, 32, 1349.09, 6
4, 10:37:00-000, 86, 40, 46, 38, 1350.67, 34, 1350.14, 10
4, 10:38:00-000, 86, 28, 58, 27, 1351.18, 50, 1351.51, 4
4, 10:39:00-000, 95, 46, 49, 40, 1349.62, 45, 1349.95, 16
4, 10:40:00-000, 92, 42, 50, 48, 1350.31, 45, 1350.48, 5
4, 10:41:00-000, 58, 26, 32, 25, 1351.44, 24, 1351.75, 13
4, 10:42:00-000, 119, 56, 63, 52, 1350.74, 60, 1351.01, 5
4, 10:43:00-000, 73, 31, 42, 29, 1350.79, 27, 1351.48, 11
4, 10:44:00-000, 91, 45, 46, 43, 1351.97, 50, 1351.55, 5
4, 10:45:00-000, 67, 26, 41, 19, 1350.05, 31, 1349.35, 17
4, 10:46:00-000, 101, 47, 54, 43, 1352.41, 40, 1351.69, 8
4, 10:47:00-000, 73, 41, 32, 41, 1350.55, 31, 1350.77, 6
4, 10:48:00-000, 85, 42, 43, 45, 1350.08, 38, 1350.68, 0
4, 10:49:00-000, 68, 18, 50, 18, 1348.27, 27, 1348.03, 22
4, 10:50:00-000, 98, 46, 52, 43, 1350.48, 57, 1349.80, 5
4, 10:51:00-000, 81, 33, 48, 32, 1351.37, 34, 1352.08, 10
4, 10:52:00-000, 85, 46, 39, 42, 1351.59, 41, 1351.46, 2
4, 10:53:00-000, 94, 59, 35, 47, 1350.86, 39, 1350.76, 12
4, 10:54:00-000, 85, 36, 49, 42, 1350.75, 39, 1351.12, 0
4, 10:55:00-000, 68, 31, 37, 30, 1351.03, 36, 1350.82, 5
4, 10:56:00-000, 80, 42, 38, 40, 1350.42, 33, 1350.42, 11
4, 10:57:00-000, 79, 40, 39, 39, 1351.53, 39, 1350.58, 2
4, 10:58:00-000, 81, 40, 41, 36, 1351.85, 32, 1350.77, 2
4, 10:59:00-000, 72, 40, 32, 34, 1349.26, 29, 1349.30, 13
4, 11:00:00-000, 86, 45, 41, 44, 1350.26, 40, 1350.59, 3
4, 11:01:00-000, 93, 55, 38, 46, 1351.86, 38, 1350.94, 5
4, 11:02:00-000, 72, 34, 38, 45, 1351.61, 37, 1350.10, 2
4, 11:03:00-000, 70, 34, 36, 34, 1350.85, 26, 1351.19, 3
4, 11:04:00-000, 71, 32, 39, 28, 1349.10, 31, 1349.51, 8
4, 11:05:00-000, 106, 65, 41, 51, 1353.52, 41, 1352.31, 8
4, 11:06:00-000, 69, 23, 46, 37, 1350.13, 41, 1350.09, 7
4, 11:07:00-000, 74, 27, 47, 27, 1349.70, 35, 1349.34, 3
4, 11:08:00-000, 81, 31, 50, 31, 1351.77, 54, 1350.73, 2
4, 11:09:00-000, 86, 46, 40, 41, 1351.28, 39, 1350.91, 3
4, 11:10:00-000, 74, 36, 38, 32, 1350.24, 30, 1350.63, 4
4, 11:11:00-000, 114, 59, 55, 54, 1350.66, 57, 1350.69, 16
4, 11:12:00-000, 88, 26, 62, 28, 1350.50, 49, 1350.32, 4
4, 11:13:00-000, 84, 48, 36, 36, 1352.27, 24, 1349.62, 13
4, 11:14:00-000, 117, 51, 66, 55, 1348.59, 57, 1350.48, 15
4, 11:15:00-000, 63, 39, 24, 33, 1350.90, 27, 1351.11, 6
4, 11:16:00-000, 104, 48, 56, 48, 1350.34, 43, 1350.20, 7
4, 11:17:00-000, 79, 31, 48, 31, 1348.22, 40, 1348.02, 12
4, 11:18:00-000, 80, 33, 47, 32, 1350.06, 40, 1350.59, 3
4, 11:19:00-000, 87, 54, 33, 48, 1350.72, 35, 1350.39, 12
4, 11:20:00-000, 67, 25, 42, 30, 1350.49, 31, 1350.51, 2
4, 11:21:00-000, 96, 43, 53, 38, 1351.28, 49, 1350.60, 10
4, 11:22:00-000, 91, 44, 47, 46, 1353.90, 26, 1353.15, 17
4, 11:23:00-000, 89, 33, 56, 30, 1349.36, 34, 1349.49, 19
4, 11:24:00-000, 73, 42, 31, 47, 1350.40, 34, 1350.99, 0
4, 11:25:00-000, 86, 24, 62, 23, 1349.08, 35, 1349.45, 11
4, 11:26:00-000, 72, 34, 38, 34, 1351.91, 60, 1351.77, 2
4, 11:27:00-000, 90, 43, 47, 34, 1351.08, 40, 1350.89, 6
4, 11:28:00-000, 76, 36, 40, 33, 1350.24, 37, 1350.97, 6
4, 11:29:00-000, 96, 56, 40, 58, 1351.32, 40, 1351.32, 4
4, 11:30:00-000, 68, 41, 27, 33, 1350.48, 31, 1351.09, 10
4, 11:31:00-000, 86, 48, 38, 47, 1350.63, 26, 1349.84, 1
4, 11:32:00-000, 82, 38, 44, 33, 1350.03, 46, 1349.91, 3
4, 11:33:00-000, 71, 42, 29, 35, 1352.82, 27, 1352.37, 18
4, 11:34:00-000, 77, 41, 36, 40, 1350.82, 33, 1351.24, 1
4, 11:35:00-000, 86, 42, 44, 38, 1349.70, 42, 1349.54, 3
4, 11:36:00-000, 73, 34, 39, 37, 1350.89, 38, 1350.94, 2
4, 11:37:00-000, 83, 40, 43, 40, 1350.89, 34, 1350.20, 7
4, 11:38:00-000, 66, 38, 28, 27, 1351.25, 30, 1350.89, 9
4, 11:39:00-000, 105, 49, 56, 47, 1352.07, 38, 1351.02, 10
4, 11:40:00-000, 73, 33, 40, 38, 1350.02, 42, 1350.16, 3
4, 11:41:00-000, 62, 34, 28, 26, 1351.26, 25, 1349.99, 7
4, 11:42:00-000, 84, 47, 37, 44, 1353.29, 28, 1353.78, 11
4, 11:43:00-000, 86, 30, 56, 25, 1348.99, 41, 1351.02, 23
4, 11:44:00-000, 75, 41, 34, 40, 1351.04, 37, 1350.91, 3
4, 11:45:00-000, 86, 39, 47, 41, 1351.48, 40, 1351.89, 1
4, 11:46:00-000, 70, 25, 45, 26, 1350.19, 46, 1351.38, 1
4, 11:47:00-000, 62, 31, 31, 30, 1350.36, 32, 1349.62, 0
4, 11:48:00-000, 88, 30, 58, 31, 1348.99, 36, 1349.74, 8
4, 11:49:00-000, 116, 51, 65, 51, 1348.64, 57, 1348.85, 18
4, 11:50:00-000, 64, 27, 37, 24, 1350.04, 40, 1350.49, 2
4, 11:51:00-000, 70, 31, 39, 27, 1350.55, 34, 1350.61, 1
4, 11:52:00-000, 81, 43, 38, 48, 1351.18, 38, 1351.33, 1
4, 11:53:00-000, 63, 31, 32, 29, 1350.30, 32, 1350.59, 3
4, 11:54:00-000, 75, 43, 32, 43, 1352.08, 33, 1350.87, 3
4, 11:55:00-000, 86, 49, 37, 43, 1349.46, 33, 1349.36, 5
4, 11:56:00-000, 78, 51, 27, 46, 1351.43, 31, 1351.54, 2
4, 11:57:00-000, 74, 23, 51, 23, 1350.00, 31, 1350.41, 17
4, 11:58:00-000, 81, 39, 42, 37, 1350.59, 37, 1350.53, 10
4, 11:59:00-000, 58, 32, 26, 27, 1349.66, 30, 1349.46, 3
4, 12:00:00-000, 86, 37, 49, 39, 1350.99, 33, 1351.26, 13
4, 12:01:00-000, 77, 51, 26, 43, 1351.34, 25, 1351.59, 10
4, 12:02:00-000, 52, 31, 21, 32, 1350.21, 17, 1350.06, 2
4, 12:03:00-000, 76, 40, 36, 40, 1351.64, 34, 1351.70, 3
4, 12:04:00-000, 80, 31, 49, 27, 1350.51, 38, 1351.39, 14
4, 12:05:00-000, 65, 28, 37, 28, 1348.39, 33, 1348.72, 3
4, 12:06:00-000, 80, 29, 51, 30, 1352.26, 46, 1352.32, 4
4, 12:07:00-000, 103, 48, 55, 46, 1351.19, 45, 1351.19, 10
4, 12:08:00-000, 85, 42, 43, 38, 1348.57, 41, 1349.53, 6
4, 12:09:00-000, 73, 25, 48, 26, 1349.88, 32, 1349.96, 16
4, 12:10:00-000, 95, 33, 62, 34, 1349.58, 60, 1350.06, 9
4, 12:11:00-000, 76, 31, 45, 27, 1349.03, 32, 1349.52, 0
4, 12:12:00-000, 104, 45, 59, 49, 1349.93, 65, 1350.30, 0
4, 12:13:00-000, 74, 40, 34, 33, 1349.90, 32, 1350.25, 5
4, 12:14:00-000, 69, 37, 32, 42, 1348.80, 33, 1349.54, 3
4, 12:15:00-000, 99, 46, 53, 45, 1348.66, 42, 1349.09, 7
4, 12:16:00-000, 95, 51, 44, 51, 1350.79, 38, 1350.65, 0
4, 12:17:00-000, 77, 36, 41, 37, 1349.62, 29, 1349.65, 11
4, 12:18:00-000, 85, 36, 49, 36, 1350.16, 53, 1349.88, 5
4, 12:19:00-000, 79, 53, 26, 43, 1352.50, 24, 1352.12, 3
4, 12:20:00-000, 88, 45, 43, 54, 1350.36, 41, 1350.50, 1
4, 12:21:00-000, 77, 20, 57, 20, 1349.30, 33, 1349.02, 15
4, 12:22:00-000, 80, 35, 45, 35, 1352.85, 43, 1351.09, 8
4, 12:23:00-000, 107, 48, 59, 44, 1350.52, 44, 1350.42, 10
4, 12:24:00-000, 92, 52, 40, 35, 1350.59, 46, 1351.16, 8
4, 12:25:00-000, 75, 41, 34, 46, 1351.82, 35, 1352.02, 8
4, 12:26:00-000, 70, 29, 41, 26, 1350.57, 40, 1350.12, 1
4, 12:27:00-000, 83, 39, 44, 36, 1349.10, 39, 1349.40, 9
4, 12:28:00-000, 88, 50, 38, 51, 1350.32, 41, 1350.26, 1
4, 12:29:00-000, 84, 43, 41, 39, 1352.71, 33, 1352.02, 1
4, 12:30:00-000, 70, 36, 34, 35, 1350.88, 37, 1350.67, 3
4, 12:31:00-000, 97, 45, 52, 46, 1353.25, 40, 1352.74, 9
4, 12:32:00-000, 119, 50, 69, 45, 1350.10, 58, 1350.27, 8
4, 12:33:00-000, 70, 34, 36, 29, 1349.13, 39, 1349.66, 13
4, 12:34:00-000, 68, 29, 39, 35, 1349.08, 29, 1349.03, 3
4, 12:35:00-000, 89, 34, 55, 34, 1349.23, 41, 1349.41, 6
4, 12:36:00-000, 89, 36, 53, 36, 1351.99, 66, 1351.45, 0
4, 12:37:00-000, 78, 44, 34, 44, 1351.35, 34, 1350.85, 4
4, 12:38:00-000, 84, 54, 30, 51, 1352.50, 30, 1352.53, 0
4, 12:39:00-000, 80, 51, 29, 45, 1354.21, 27, 1354.03, 9
4, 12:40:00-000, 75, 33, 42, 30, 1350.03, 37, 1350.62, 5
4, 12:41:00-000, 86, 45, 41, 40, 1351.22, 33, 1350.63, 6
4, 12:42:00-000, 97, 48, 49, 45, 1351.10, 49, 1351.05, 9
4, 12:43:00-000, 77, 23, 54, 29, 1351.82, 36, 1351.44, 2
4, 12:44:00-000, 73, 36, 37, 36, 1348.66, 44, 1349.90, 5
4, 12:45:00-000, 92, 42, 50, 41, 1350.84, 34, 1350.70, 0
4, 12:46:00-000, 61, 25, 36, 26, 1350.69, 49, 1350.36, 0
4, 12:47:00-000, 69, 36, 33, 36, 1350.19, 38, 1350.15, 0
4, 12:48:00-000, 81, 55, 26, 46, 1352.25, 22, 1351.86, 6
4, 12:49:00-000, 86, 29, 57, 33, 1351.08, 49, 1350.95, 5
4, 12:50:00-000, 82, 43, 39, 42, 1350.16, 45, 1349.77, 0
4, 12:51:00-000, 81, 37, 44, 35, 1348.79, 33, 1348.81, 2
4, 12:52:00-000, 73, 53, 20, 51, 1353.87, 28, 1351.81, 6
4, 12:53:00-000, 68, 49, 19, 41, 1352.92, 14, 1353.43, 5
4, 12:54:00-000, 94, 45, 49, 44, 1350.86, 50, 1351.37, 5
4, 12:55:00-000, 89, 35, 54, 35, 1352.08, 40, 1351.52, 11
4, 12:56:00-000, 87, 44, 43, 37, 1350.70, 46, 1351.47, 7
4, 12:57:00-000, 83, 45, 38, 46, 1350.03, 33, 1349.21, 3
4, 12:58:00-000, 108, 58, 50, 53, 1351.18, 40, 1350.69, 6
4, 12:59:00-000, 99, 48, 51, 41, 1351.77, 49, 1351.48, 17
4, 13:00:00-000, 105, 44, 61, 45, 1351.13, 53, 1351.58, 0
4, 13:01:00-000, 91, 38, 53, 34, 1350.93, 56, 1350.11, 11
4, 13:02:00-000, 66, 35, 31, 36, 1352.33, 20, 1352.70, 5
4, 13:03:00-000, 95, 43, 52, 42, 1351.97, 48, 1351.64, 8
4, 13:04:00-000, 64, 35, 29, 33, 1349.81, 28, 1348.50, 2
4, 13:05:00-000, 90, 29, 61, 29, 1349.27, 51, 1349.42, 12
4, 13:06:00-000, 94, 52, 42, 47, 1351.44, 42, 1351.90, 0
4, 13:07:00-000, 89, 47, 42, 49, 1350.83, 36, 1351.02, 7
4, 13:08:00-000, 84, 42, 42, 34, 1349.99, 43, 1350.18, 2
4, 13:09:00-000, 78, 34, 44, 28, 1350.67, 46, 1351.34, 13
4, 13:10:00-000, 94, 53, 41, 48, 1352.49, 41, 1352.43, 3
4, 13:11:00-000, 80, 50, 30, 43, 1352.34, 28, 1352.21, 3
4, 13:12:00-000, 75, 45, 30, 54, 1351.01, 29, 1351.20, 0
4, 13:13:00-000, 71, 39, 32, 30, 1350.86, 25, 1350.47, 0
4, 13:14:00-000, 103, 42, 61, 50, 1349.63, 66, 1350.34, 1
4, 13:15:00-000, 92, 53, 39, 48, 1351.61, 38, 1350.91, 5
4, 13:16:00-000, 80, 36, 44, 36, 1350.52, 38, 1351.04, 5
4, 13:17:00-000, 62, 38, 24, 37, 1351.02, 16, 1351.00, 6
4, 13:18:00-000, 75, 37, 38, 26, 1350.11, 39, 1350.61, 15
4, 13:19:00-000, 103, 50, 53, 48, 1351.14, 53, 1350.46, 4
4, 13:20:00-000, 85, 48, 37, 46, 1351.04, 26, 1351.23, 6
4, 13:21:00-000, 65, 29, 36, 24, 1350.66, 34, 1350.55, 8
4, 13:22:00-000, 87, 46, 41, 50, 1351.79, 45, 1351.75, 1
4, 13:23:00-000, 87, 35, 52, 34, 1350.85, 48, 1350.66, 0
4, 13:24:00-000, 72, 36, 36, 30, 1354.16, 33, 1353.66, 2
4, 13:25:00-000, 72, 42, 30, 34, 1351.58, 33, 1349.75, 9
4, 13:26:00-000, 79, 33, 46, 39, 1348.61, 40, 1349.04, 2
4, 13:27:00-000, 63, 27, 36, 26, 1349.46, 34, 1349.61, 3
4, 13:28:00-000, 87, 43, 44, 43, 1349.85, 41, 1350.58, 3
4, 13:29:00-000, 81, 44, 37, 39, 1348.79, 37, 1348.13, 7
4, 13:30:00-000, 90, 49, 41, 45, 1350.48, 28, 1350.85, 10
4, 13:31:00-000, 100, 51, 49, 54, 1351.62, 48, 1351.83, 6
4, 13:32:00-000, 57, 36, 21, 34, 1350.96, 21, 1350.38, 0
4, 13:33:00-000, 94, 53, 41, 52, 1350.76, 40, 1350.17, 4
4, 13:34:00-000, 88, 33, 55, 32, 1349.43, 44, 1349.38, 2
4, 13:35:00-000, 78, 25, 53, 25, 1348.67, 37, 1349.05, 10
4, 13:36:00-000, 76, 35, 41, 33, 1348.26, 53, 1349.01, 7
4, 13:37:00-000, 73, 35, 38, 27, 1350.11, 24, 1350.08, 12
4, 13:38:00-000, 80, 37, 43, 46, 1349.99, 38, 1350.91, 1
4, 13:39:00-000, 100, 40, 60, 40, 1351.24, 49, 1349.69, 8
4, 13:40:00-000, 80, 30, 50, 23, 1349.39, 47, 1349.97, 5
4, 13:41:00-000, 80, 32, 48, 29, 1348.96, 42, 1349.40, 13
4, 13:42:00-000, 89, 49, 40, 49, 1350.20, 48, 1350.07, 0
4, 13:43:00-000, 82, 31, 51, 33, 1351.84, 35, 1352.42, 4
4, 13:44:00-000, 89, 47, 42, 38, 1349.52, 47, 1350.54, 10
4, 13:45:00-000, 84, 45, 39, 43, 1351.32, 28, 1350.46, 13
4, 13:46:00-000, 103, 47, 56, 50, 1351.35, 48, 1351.68, 3
4, 13:47:00-000, 95, 44, 51, 40, 1349.49, 47, 1349.63, 6
4, 13:48:00-000, 88, 46, 42, 49, 1351.17, 44, 1351.67, 1
4, 13:49:00-000, 67, 29, 38, 26, 1349.84, 33, 1350.17, 2
4, 13:50:00-000, 100, 52, 48, 52, 1349.45, 43, 1348.62, 5
4, 13:51:00-000, 97, 42, 55, 37, 1349.34, 53, 1349.44, 9
4, 13:52:00-000, 70, 29, 41, 33, 1350.30, 37, 1350.62, 1
4, 13:53:00-000, 83, 45, 38, 36, 1351.16, 36, 1350.66, 5
4, 13:54:00-000, 91, 50, 41, 46, 1351.75, 31, 1351.86, 10
4, 13:55:00-000, 81, 45, 36, 42, 1350.94, 47, 1350.93, 7
4, 13:56:00-000, 86, 52, 34, 44, 1350.08, 37, 1350.21, 7
4, 13:57:00-000, 92, 37, 55, 38, 1349.62, 40, 1349.44, 3
4, 13:58:00-000, 90, 40, 50, 39, 1349.79, 57, 1350.34, 1
4, 13:59:00-000, 80, 52, 28, 49, 1351.44, 31, 1351.12, 2
4, 14:00:00-000, 79, 34, 45, 27, 1347.96, 34, 1348.99, 6
4, 14:01:00-000, 82, 53, 29, 49, 1350.28, 30, 1349.80, 5
4, 14:02:00-000, 104, 46, 58, 49, 1350.89, 62, 1351.57, 5
4, 14:03:00-000, 85, 43, 42, 40, 1351.09, 30, 1350.83, 6
4, 14:04:00-000, 74, 41, 33, 43, 1350.41, 33, 1351.05, 2
4, 14:05:00-000, 96, 44, 52, 44, 1347.79, 47, 1348.12, 3
4, 14:06:00-000, 68, 32, 36, 32, 1350.06, 39, 1349.79, 2
4, 14:07:00-000, 89, 27, 62, 27, 1349.22, 46, 1349.73, 1
4, 14:08:00-000, 73, 43, 30, 37, 1351.29, 44, 1350.92, 0
4, 14:09:00-000, 60, 23, 37, 26, 1350.57, 28, 1351.17, 11
4, 14:10:00-000, 76, 37, 39, 33, 1349.39, 38, 1348.76, 5
4, 14:11:00-000, 77, 50, 27, 46, 1352.91, 24, 1352.33, 4
4, 14:12:00-000, 86, 56, 30, 54, 1350.51, 31, 1349.44, 2
4, 14:13:00-000, 79, 35, 44, 40, 1351.47, 24, 1352.33, 9
4, 14:14:00-000, 99, 54, 45, 42, 1350.06, 50, 1350.91, 7
4, 14:15:00-000, 78, 30, 48, 34, 1347.32, 41, 1347.21, 7
4, 14:16:00-000, 86, 34, 52, 36, 1351.33, 35, 1351.31, 1
4, 14:17:00-000, 89, 45, 44, 34, 1347.38, 46, 1347.30, 16
4, 14:18:00-000, 84, 43, 41, 53, 1350.18, 39, 1351.07, 2
4, 14:19:00-000, 92, 44, 48, 44, 1351.06, 33, 1350.51, 5
4, 14:20:00-000, 78, 42, 36, 40, 1352.72, 37, 1351.51, 0
4, 14:21:00-000, 59, 27, 32, 27, 1349.18, 26, 1349.34, 4
4, 14:22:00-000, 121, 54, 67, 51, 1349.21, 67, 1350.21, 6
4, 14:23:00-000, 72, 48, 24, 33, 1351.45, 31, 1349.67, 9
4, 14:24:00-000, 76, 26, 50, 40, 1352.11, 34, 1353.05, 7
4, 14:25:00-000, 72, 24, 48, 24, 1348.70, 41, 1348.55, 12
4, 14:26:00-000, 79, 28, 51, 28, 1349.78, 38, 1350.41, 6
4, 14:27:00-000, 89, 46, 43, 46, 1349.08, 38, 1349.18, 5
4, 14:28:00-000, 89, 35, 54, 34, 1349.94, 56, 1349.49, 1
4, 14:29:00-000, 99, 44, 55, 44, 1350.70, 56, 1351.15, 5
4, 14:30:00-000, 83, 48, 35, 49, 1350.38, 38, 1350.47, 0
4, 14:31:00-000, 91, 55, 36, 49, 1351.15, 35, 1351.48, 0
4, 14:32:00-000, 66, 32, 34, 31, 1349.96, 31, 1351.45, 1
4, 14:33:00-000, 79, 36, 43, 34, 1348.14, 31, 1348.16, 4
4, 14:34:00-000, 124, 54, 70, 55, 1349.77, 72, 1350.59, 8
4, 14:35:00-000, 81, 44, 37, 40, 1352.77, 38, 1352.44, 2
4, 14:36:00-000, 85, 45, 40, 43, 1350.64, 44, 1351.58, 6
4, 14:37:00-000, 95, 37, 58, 35, 1349.88, 43, 1350.16, 4
4, 14:38:00-000, 88, 51, 37, 42, 1351.44, 49, 1351.85, 1
4, 14:39:00-000, 73, 45, 28, 39, 1351.74, 27, 1352.00, 9
4, 14:40:00-000, 93, 51, 42, 56, 1350.33, 31, 1349.70, 6
4, 14:41:00-000, 90, 42, 48, 40, 1350.04, 45, 1350.28, 3
4, 14:42:00-000, 69, 34, 35, 35, 1349.77, 30, 1350.29, 8
4, 14:43:00-000, 65, 38, 27, 38, 1352.52, 25, 1351.56, 3
4, 14:44:00-000, 109, 57, 52, 57, 1351.06, 55, 1351.10, 2
4, 14:45:00-000, 79, 38, 41, 38, 1350.83, 38, 1350.89, 3
4, 14:46:00-000, 101, 50, 51, 41, 1348.70, 50, 1349.67, 4
4, 14:47:00-000, 118, 54, 64, 60, 1350.81, 51, 1350.76, 2
4, 14:48:00-000, 66, 29, 37, 23, 1348.69, 41, 1349.67, 6
4, 14:49:00-000, 61, 39, 22, 40, 1351.29, 13, 1348.77, 5
4, 14:50:00-000, 92, 44, 48, 46, 1350.91, 44, 1351.10, 4
4, 14:51:00-000, 74, 40, 34, 37, 1350.64, 38, 1350.70, 5
4, 14:52:00-000, 64, 28, 36, 26, 1347.15, 25, 1347.36, 12
4, 14:53:00-000, 84, 30, 54, 32, 1348.81, 42, 1349.21, 1
4, 14:54:00-000, 77, 19, 58, 20, 1349.75, 54, 1350.51, 7
4, 14:55:00-000, 95, 33, 62, 33, 1349.14, 45, 1348.59, 7
4, 14:56:00-000, 74, 39, 35, 35, 1349.85, 49, 1350.42, 2
4, 14:57:00-000, 96, 52, 44, 52, 1351.09, 45, 1350.12, 1
4, 14:58:00-000, 63, 31, 32, 31, 1351.28, 26, 1351.34, 1
4, 14:59:00-000, 95, 63, 32, 53, 1349.37, 39, 1349.45, 3
4, 15:00:00-000, 95, 55, 40, 51, 1349.74, 36, 1349.13, 11
4, 15:01:00-000, 82, 36, 46, 34, 1351.14, 38, 1351.18, 9
4, 15:02:00-000, 79, 40, 39, 41, 1350.41, 38, 1350.57, 7
4, 15:03:00-000, 74, 39, 35, 35, 1352.05, 26, 1351.50, 3
4, 15:04:00-000, 68, 38, 30, 35, 1352.82, 37, 1352.48, 2
4, 15:05:00-000, 78, 38, 40, 41, 1351.18, 39, 1351.35, 2
4, 15:06:00-000, 98, 43, 55, 35, 1351.08, 47, 1350.78, 8
4, 15:07:00-000, 71, 30, 41, 38, 1350.52, 35, 1350.05, 3
4, 15:08:00-000, 99, 43, 56, 40, 1348.99, 55, 1349.24, 0
4, 15:09:00-000, 65, 26, 39, 24, 1350.70, 37, 1350.05, 2
4, 15:10:00-000, 108, 66, 42, 58, 1350.34, 47, 1348.67, 1
4, 15:11:00-000, 70, 25, 45, 35, 1350.48, 31, 1350.61, 7
4, 15:12:00-000, 94, 69, 25, 50, 1353.27, 32, 1351.68, 13
4, 15:13:00-000, 82, 49, 33, 50, 1352.03, 31, 1351.41, 1
4, 15:14:00-000, 98, 38, 60, 43, 1349.18, 50, 1349.53, 3
4, 15:15:00-000, 69, 39, 30, 40, 1350.52, 30, 1350.36, 3
4, 15:16:00-000, 89, 46, 43, 40, 1350.77, 32, 1351.74, 6
4, 15:17:00-000, 89, 40, 49, 45, 1349.55, 47, 1350.01, 5
4, 15:18:00-000, 81, 38, 43, 39, 1351.07, 25, 1351.00, 15
4, 15:19:00-000, 71, 41, 30, 37, 1350.88, 33, 1351.11, 1
4, 15:20:00-000, 94, 38, 56, 39, 1350.10, 52, 1350.18, 3
4, 15:21:00-000, 75, 25, 50, 28, 1350.24, 39, 1350.07, 3
4, 15:22:00-000, 92, 37, 55, 37, 1347.48, 58, 1348.32, 8
4, 15:23:00-000, 82, 40, 42, 35, 1351.51, 30, 1351.26, 1
4, 15:24:00-000, 76, 31, 45, 33, 1350.12, 37, 1350.26, 10
4, 15:25:00-000, 86, 38, 48, 38, 1349.10, 39, 1348.68, 13
4, 15:26:00-000, 76, 44, 32, 41, 1350.65, 36, 1350.55, 3
4, 15:27:00-000, 75, 42, 33, 37, 1352.32, 36, 1350.63, 6
4, 15:28:00-000, 91, 41, 50, 41, 1351.21, 45, 1351.39, 3
4, 15:29:00-000, 63, 27, 36, 29, 1350.48, 32, 1350.34, 5
4, 15:30:00-000, 91, 39, 52, 39, 1349.10, 43, 1349.44, 1
4, 15:31:00-000, 91, 49, 42, 48, 1350.55, 48, 1350.34, 3
4, 15:32:00-000, 86, 33, 53, 34, 1347.41, 41, 1348.19, 7
4, 15:33:00-000, 63, 34, 29, 27, 1350.40, 33, 1348.84, 3
4, 15:34:00-000, 80, 34, 46, 36, 1349.24, 36, 1349.96, 3
4, 15:35:00-000, 84, 44, 40, 37, 1350.10, 44, 1348.97, 10
4, 15:36:00-000, 69, 31, 38, 31, 1350.89, 36, 1351.22, 2
4, 15:37:00-000, 76, 41, 35, 34, 1350.14, 31, 1350.57, 3
4, 15:38:00-000, 99, 48, 51, 51, 1350.91, 53, 1351.90, 2
4, 15:39:00-000, 82, 49, 33, 45, 1350.57, 26, 1350.84, 5
4, 15:40:00-000, 88, 44, 44, 46, 1350.86, 42, 1350.30, 8
4, 15:41:00-000, 75, 42, 33, 38, 1350.44, 28, 1349.96, 4
4, 15:42:00-000, 96, 36, 60, 34, 1349.96, 47, 1350.36, 6
4, 15:43:00-000, 50, 24, 26, 25, 1350.15, 28, 1350.53, 11
4, 15:44:00-000, 87, 47, 40, 41, 1350.51, 34, 1350.76, 0
4, 15:45:00-000, 81, 41, 40, 42, 1350.21, 48, 1350.91, 1
4, 15:46:00-000, 89, 48, 41, 53, 1351.65, 32, 1350.81, 11
4, 15:47:00-000, 79, 47, 32, 42, 1350.49, 27, 1350.11, 1
4, 15:48:00-000, 104, 42, 62, 43, 1350.13, 41, 1349.50, 12
4, 15:49:00-000, 86, 44, 42, 45, 1349.77, 40, 1349.42, 12
4, 15:50:00-000, 80, 35, 45, 34, 1351.11, 48, 1351.45, 1
4, 15:51:00-000, 81, 31, 50, 30, 1350.83, 39, 1351.25, 3
4, 15:52:00-000, 78, 31, 47, 31, 1350.38, 42, 1350.94, 11
4, 15:53:00-000, 98, 48, 50, 42, 1351.57, 50, 1351.89, 2
4, 15:54:00-000, 74, 32, 42, 40, 1350.04, 42, 1347.75, 0
4, 15:55:00-000, 104, 35, 69, 32, 1350.71, 47, 1351.03, 1
4, 15:56:00-000, 87, 48, 39, 48, 1350.55, 57, 1351.31, 4
4, 15:57:00-000, 59, 38, 21, 37, 1350.62, 20, 1350.40, 0
4, 15:58:00-000, 80, 43, 37, 47, 1350.03, 31, 1349.93, 1
4, 15:59:00-000, 61, 30, 31, 28, 1349.21, 24, 1348.79, 3
4, 16:00:00-000, 114, 55, 59, 47, 1348.42, 54, 1349.10, 10
4, 16:01:00-000, 78, 37, 41, 42, 1351.04, 40, 1351.29, 5
4, 16:02:00-000, 54, 31, 23, 30, 1350.66, 22, 1350.95, 3
4, 16:03:00-000, 102, 75, 27, 67, 1353.36, 22, 1352.36, 4
4, 16:04:00-000, 89, 42, 47, 50, 1350.19, 43, 1349.50, 8
4, 16:05:00-000, 99, 42, 57, 41, 1349.48, 49, 1349.46, 2
4, 16:06:00-000, 86, 33, 53, 34, 1349.97, 48, 1350.43, 8
4, 16:07:00-000, 103, 41, 62, 34, 1349.55, 46, 1350.06, 3
4, 16:08:00-000, 83, 36, 47, 42, 1350.68, 43, 1351.88, 10
4, 16:09:00-000, 76, 23, 53, 23, 1348.17, 46, 1349.23, 5
4, 16:10:00-000, 92, 47, 45, 44, 1350.15, 51, 1350.33, 5
4, 16:11:00-000, 98, 47, 51, 46, 1350.95, 48, 1350.99, 2
4, 16:12:00-000, 89, 38, 51, 43, 1349.88, 46, 1350.43, 2
4, 16:13:00-000, 64, 31, 33, 30, 1350.33, 31, 1350.77, 6
4, 16:14:00-000, 95, 53, 42, 46, 1350.91, 39, 1350.25, 0
4, 16:15:00-000, 83, 47, 36, 38, 1351.26, 41, 1351.82, 9
4, 16:16:00-000, 74, 33, 41, 32, 1349.99, 38, 1350.07, 0
4, 16:17:00-000, 80, 43, 37, 50, 1352.27, 25, 1351.56, 10
4, 16:18:00-000, 93, 44, 49, 43, 1349.53, 57, 1350.15, 1
4, 16:19:00-000, 77, 36, 41, 33, 1351.24, 29, 1351.55, 4
4, 16:20:00-000, 70, 31, 39, 32, 1350.18, 45, 1350.44, 3
4, 16:21:00-000, 93, 45, 48, 46, 1350.06, 42, 1350.04, 1
4, 16:22:00-000, 82, 51, 31, 39, 1350.10, 31, 1350.48, 7
4, 16:23:00-000, 84, 53, 31, 43, 1353.83, 29, 1352.99, 10
4, 16:24:00-000, 69, 29, 40, 39, 1351.69, 22, 1351.49, 2
4, 16:25:00-000, 87, 43, 44, 43, 1350.22, 47, 1349.69, 3
4, 16:26:00-000, 95, 44, 51, 38, 1350.41, 49, 1351.01, 9
4, 16:27:00-000, 80, 36, 44, 39, 1349.71, 38, 1349.36, 7
4, 16:28:00-000, 88, 51, 37, 44, 1351.47, 37, 1351.05, 7
4, 16:29:00-000, 74, 30, 44, 38, 1350.89, 31, 1350.74, 0
5, 09:13:00-000, 10236, 5599, 4637, 3869, 1348.19, 3779, 1349.39, 0
5, 09:14:00-000, 0, 0, 0, 0, 0.00, 42, 1357.00, 581
5, 09:15:00-000, 0, 0, 0, 5, 1347.00, 35, 1357.00, 1920
5, 09:16:00-000, 0, 0, 0, 0, 0.00, 0, 0.00, 5
5, 09:26:00-000, 10359, 5714, 4645, 3733, 1348.45, 3791, 1348.56, 0
5, 09:27:00-000, 0, 0, 0, 0, 0.00, 23, 1356.00, 0
5, 09:28:00-000, 4, 3, 1, 118, 1348.08, 82, 1356.36, 1954
5, 09:29:00-000, 18, 11, 7, 11, 1350.82, 7, 1350.71, 662
5, 09:30:00-000, 71, 28, 43, 21, 1349.09, 30, 1351.33, 0
5, 09:31:00-000, 0, 0, 0, 0, 0.00, 10, 1357.10, 0
5, 09:32:00-000, 163, 70, 93, 49, 1350.97, 96, 1353.41, 5
5, 09:33:00-000, 394, 247, 147, 146, 1350.40, 133, 1351.71, 10
5, 09:34:00-000, 594, 295, 299, 241, 1349.62, 241, 1350.52, 27
5, 09:35:00-000, 0, 0, 0, 20, 1347.00, 11, 1356.00, 47
5, 09:36:00-000, 1008, 522, 486, 382, 1348.58, 413, 1350.20, 110
5, 09:37:00-000, 1180, 620, 560, 431, 1349.17, 456, 1349.44, 120
5, 09:38:00-000, 1335, 700, 635, 558, 1348.98, 605, 1350.30, 145
5, 09:39:00-000, 0, 0, 0, 5, 1346.00, 51, 1357.84, 154
5, 09:40:00-000, 1267, 687, 580, 475, 1349.11, 495, 1349.61, 167
5, 09:41:00-000, 1276, 654, 622, 519, 1348.86, 521, 1349.38, 196
5, 09:42:00-000, 1259, 675, 584, 493, 1349.32, 500, 1349.89, 180
5, 09:43:00-000, 0, 0, 0, 0, 0.00, 25, 1357.12, 179
5, 09:44:00-000, 971, 488, 483, 388, 1348.34, 392, 1349.58, 166
5, 09:45:00-000, 916, 523, 393, 323, 1349.68, 336, 1350.06, 186
5, 09:46:00-000, 865, 457, 408, 346, 1348.67, 341, 1349.98, 144
5, 09:47:00-000, 0, 0, 0, 21, 1345.52, 4, 1357.00, 163
5, 09:48:00-000, 872, 430, 442, 309, 1348.22, 355, 1349.28, 163
5, 09:49:00-000, 967, 512, 455, 395, 1348.77, 374, 1349.27, 142
5, 09:50:00-000, 1035, 529, 506, 433, 1348.35, 410, 1349.49, 142
5, 09:51:00-000, 0, 0, 0, 51, 1345.56, 17, 1356.00, 108
5, 09:52:00-000, 1081, 636, 445, 460, 1350.09, 413, 1351.19, 108
5, 09:53:00-000, 973, 510, 463, 358, 1348.88, 393, 1349.05, 172
5, 09:54:00-000, 1102, 600, 502, 461, 1348.75, 440, 1349.95, 163
5, 09:55:00-000, 0, 0, 0, 73, 1345.33, 29, 1357.27, 112
5, 09:56:00-000, 1129, 591, 538, 430, 1349.09, 459, 1350.44, 130
5, 09:57:00-000, 1182, 550, 632, 408, 1348.84, 456, 1349.06, 150
5, 09:58:00-000, 1003, 536, 467, 413, 1348.86, 455, 1350.61, 155
5, 09:59:00-000, 0, 0, 0, 25, 1345.00, 33, 1357.54, 180
5, 10:00:00-000, 959, 472, 487, 385, 1348.57, 440, 1350.67, 115
5, 10:01:00-000, 1064, 571, 493, 421, 1348.88, 400, 1349.57, 129
5, 10:02:00-000, 1042, 553, 489, 375, 1349.41, 443, 1350.33, 139
5, 10:03:00-000, 0, 0, 0, 41, 1346.31, 9, 1358.00, 147
5, 10:04:00-000, 1085, 578, 507, 453, 1349.28, 433, 1350.41, 148
5, 10:05:00-000, 1039, 529, 510, 365, 1348.53, 378, 1349.13, 157
5, 10:06:00-000, 1015, 545, 470, 495, 1348.29, 386, 1349.38, 159
5, 10:07:00-000, 0, 0, 0, 17, 1345.00, 21, 1356.00, 144
5, 10:08:00-000, 1157, 650, 507, 452, 1348.77, 480, 1350.40, 118
5, 10:09:00-000, 1029, 556, 473, 397, 1348.96, 348, 1349.41, 156
5, 10:10:00-000, 997, 530, 467, 454, 1348.87, 431, 1350.02, 182
5, 10:11:00-000, 0, 0, 0, 4, 1346.00, 10, 1356.00, 177
5, 10:12:00-000, 991, 558, 433, 400, 1348.91, 407, 1349.99, 114
5, 10:13:00-000, 1032, 569, 463, 388, 1349.35, 369, 1349.65, 149
5, 10:14:00-000, 1044, 514, 530, 423, 1348.62, 482, 1350.36, 137
5, 10:15:00-000, 1, 1, 0, 0, 0.00, 24, 1357.00, 141
5, 10:16:00-000, 954, 470, 484, 399, 1348.00, 438, 1350.09, 121
5, 10:17:00-000, 940, 491, 449, 344, 1348.65, 349, 1349.05, 120
5, 10:18:00-000, 1030, 533, 497, 364, 1348.01, 448, 1349.59, 136
5, 10:19:00-000, 0, 0, 0, 32, 1346.00, 9, 1357.00, 138
5, 10:20:00-000, 1052, 580, 472, 432, 1349.18, 428, 1350.23, 176
5, 10:21:00-000, 1024, 583, 441, 394, 1349.19, 363, 1349.37, 150
5, 10:22:00-000, 1015, 489, 526, 408, 1348.23, 450, 1349.59, 150
5, 10:23:00-000, 0, 0, 0, 0, 0.00, 11, 1355.36, 123
5, 10:24:00-000, 937, 543, 394, 371, 1349.33, 326, 1349.74, 170
5, 10:25:00-000, 943, 464, 479, 372, 1348.62, 391, 1349.47, 168
5, 10:26:00-000, 1051, 551, 500, 383, 1348.84, 410, 1349.83, 120
5, 10:27:00-000, 0, 0, 0, 23, 1347.08, 26, 1357.00, 159
5, 10:28:00-000, 1028, 517, 511, 404, 1348.61, 400, 1349.02, 183
5, 10:29:00-000, 1001, 517, 484, 415, 1348.31, 416, 1349.31, 149
5, 10:30:00-000, 1031, 491, 540, 371, 1348.02, 416, 1349.29, 125
5, 10:31:00-000, 0, 0, 0, 5, 1346.00, 19, 1355.00, 144
5, 10:32:00-000, 1067, 488, 579, 451, 1347.72, 471, 1349.14, 134
5, 10:33:00-000, 1112, 583, 529, 441, 1349.06, 421, 1349.58, 138
5, 10:34:00-000, 1003, 491, 512, 427, 1348.15, 407, 1349.33, 156
5, 10:35:00-000, 0, 0, 0, 0, 0.00, 18, 1356.00, 185
5, 10:36:00-000, 1010, 520, 490, 382, 1348.17, 397, 1349.50, 131
5, 10:37:00-000, 1015, 579, 436, 404, 1349.21, 393, 1350.08, 146
5, 10:38:00-000, 1112, 609, 503, 453, 1349.51, 392, 1349.96, 172
5, 10:39:00-000, 0, 0, 0, 2, 1346.00, 18, 1356.11, 163
5, 10:40:00-000, 1024, 567, 457, 424, 1348.94, 400, 1350.45, 169
5, 10:41:00-000, 1021, 500, 521, 382, 1348.24, 377, 1349.27, 172
5, 10:42:00-000, 1007, 512, 495, 435, 1347.90, 419, 1348.94, 144
5, 10:43:00-000, 0, 0, 0, 17, 1344.00, 5, 1355.00, 173
5, 10:44:00-000, 978, 480, 498, 376, 1347.70, 402, 1349.47, 172
5, 10:45:00-000, 990, 512, 478, 390, 1348.01, 387, 1348.85, 143
5, 10:46:00-000, 1027, 515, 512, 348, 1348.94, 462, 1350.25, 103
5, 10:47:00-000, 0, 0, 0, 14, 1346.00, 32, 1355.68, 145
5, 10:48:00-000, 1149, 615, 534, 432, 1349.17, 466, 1349.85, 183
5, 10:49:00-000, 1039, 546, 493, 385, 1348.90, 344, 1349.59, 152
5, 10:50:00-000, 1024, 534, 490, 453, 1348.73, 414, 1349.70, 169
5, 10:51:00-000, 0, 0, 0, 16, 1346.00, 0, 0.00, 192
5, 10:52:00-000, 982, 482, 500, 382, 1348.03, 400, 1349.31, 163
5, 10:53:00-000, 1085, 553, 532, 422, 1349.30, 408, 1349.07, 179
5, 10:54:00-000, 953, 537, 416, 407, 1349.14, 360, 1350.42, 147
5, 10:55:00-000, 0, 0, 0, 21, 1345.71, 5, 1357.00, 142
5, 10:56:00-000, 1020, 561, 459, 426, 1348.87, 377, 1349.84, 139
5, 10:57:00-000, 1099, 628, 471, 396, 1349.62, 393, 1349.97, 188
5, 10:58:00-000, 1084, 514, 570, 456, 1348.10, 453, 1349.05, 146
5, 10:59:00-000, 0, 0, 0, 22, 1345.27, 19, 1355.00, 174
5, 11:00:00-000, 1020, 537, 483, 444, 1348.62, 449, 1350.31, 134
5, 11:01:00-000, 951, 421, 530, 359, 1348.22, 392, 1349.26, 122
5, 11:02:00-000, 1095, 583, 512, 441, 1348.77, 454, 1349.79, 137
5, 11:03:00-000, 0, 0, 0, 10, 1345.00, 40, 1356.74, 132
5, 11:04:00-000, 957, 462, 495, 361, 1348.33, 351, 1349.51, 151
5, 11:05:00-000, 1005, 524, 481, 387, 1348.60, 428, 1349.54, 169
5, 11:06:00-000, 1099, 536, 563, 437, 1348.40, 408, 1348.94, 114
5, 11:07:00-000, 0, 0, 0, 0, 0.00, 33, 1355.00, 180
5, 11:08:00-000, 1051, 551, 500, 442, 1348.72, 425, 1349.47, 154
5, 11:09:00-000, 1010, 523, 487, 364, 1348.61, 347, 1348.63, 164
5, 11:10:00-000, 1041, 579, 462, 427, 1349.02, 399, 1349.90, 158
5, 11:11:00-000, 0, 0, 0, 1, 1346.00, 11, 1355.18, 168
5, 11:12:00-000, 1002, 544, 458, 383, 1348.83, 387, 1349.98, 202
5, 11:13:00-000, 911, 474, 437, 349, 1349.11, 330, 1349.37, 175
5, 11:14:00-000, 1103, 568, 535, 473, 1348.48, 462, 1349.54, 132
5, 11:15:00-000, 0, 0, 0, 14, 1346.00, 35, 1355.91, 134
5, 11:16:00-000, 1021, 561, 460, 417, 1349.37, 362, 1349.90, 179
5, 11:17:00-000, 1016, 515, 501, 447, 1348.58, 400, 1348.80, 126
5, 11:18:00-000, 1050, 507, 543, 375, 1348.21, 356, 1348.93, 136
5, 11:19:00-000, 5, 5, 0, 0, 0.00, 39, 1355.00, 160
5, 11:20:00-000, 1012, 534, 478, 355, 1348.82, 392, 1349.71, 209
5, 11:21:00-000, 942, 489, 453, 385, 1349.32, 416, 1349.81, 197
5, 11:22:00-000, 1054, 550, 504, 456, 1348.29, 435, 1349.67, 109
5, 11:23:00-000, 0, 0, 0, 31, 1344.00, 11, 1354.54, 120
5, 11:24:00-000, 1133, 543, 590, 432, 1348.46, 454, 1349.41, 132
5, 11:25:00-000, 983, 525, 458, 408, 1348.70, 409, 1349.68, 146
5, 11:26:00-000, 1002, 521, 481, 404, 1348.69, 416, 1349.98, 136
5, 11:27:00-000, 1, 1, 0, 23, 1345.00, 20, 1356.20, 125
5, 11:28:00-000, 1037, 543, 494, 383, 1348.82, 431, 1349.61, 157
5, 11:29:00-000, 964, 484, 480, 382, 1348.40, 382, 1349.15, 164
5, 11:30:00-000, 1016, 522, 494, 426, 1349.05, 396, 1350.03, 137
5, 11:31:00-000, 0, 0, 0, 0, 0.00, 21, 1356.00, 143
5, 11:32:00-000, 1087, 543, 544, 393, 1348.67, 406, 1349.48, 148
5, 11:33:00-000, 999, 565, 434, 454, 1349.12, 378, 1350.00, 181
5, 11:34:00-000, 998, 506, 492, 351, 1348.78, 404, 1349.77, 145
5, 11:35:00-000, 0, 0, 0, 34, 1345.32, 0, 0.00, 139
5, 11:36:00-000, 1027, 526, 501, 412, 1348.80, 422, 1349.76, 172
5, 11:37:00-000, 1071, 587, 484, 417, 1349.73, 395, 1349.81, 173
5, 11:38:00-000, 1026, 500, 526, 413, 1348.82, 472, 1350.70, 134
5, 11:39:00-000, 4, 2, 2, 39, 1345.51, 33, 1357.00, 142
5, 11:40:00-000, 1070, 521, 549, 439, 1347.86, 428, 1349.15, 127
5, 11:41:00-000, 1021, 557, 464, 419, 1348.77, 384, 1348.89, 120
5, 11:42:00-000, 969, 491, 478, 396, 1348.48, 427, 1349.57, 150
5, 11:43:00-000, 0, 0, 0, 0, 0.00, 13, 1356.00, 139
5, 11:44:00-000, 1043, 535, 508, 449, 1349.03, 427, 1350.17, 132
5, 11:45:00-000, 1011, 500, 511, 415, 1348.73, 421, 1349.69, 128
5, 11:46:00-000, 980, 469, 511, 352, 1348.55, 399, 1349.03, 115
5, 11:47:00-000, 0, 0, 0, 7, 1345.57, 23, 1354.56, 141
5, 11:48:00-000, 1081, 543, 538, 460, 1348.21, 442, 1349.77, 147
5, 11:49:00-000, 945, 487, 458, 373, 1348.73, 368, 1349.56, 115
5, 11:50:00-000, 1046, 520, 526, 430, 1348.22, 374, 1348.84, 152
5, 11:51:00-000, 0, 0, 0, 11, 1346.00, 42, 1356.00, 131
5, 11:52:00-000, 1077, 513, 564, 360, 1348.12, 428, 1349.64, 179
5, 11:53:00-000, 1063, 523, 540, 388, 1349.12, 409, 1349.55, 215
5, 11:54:00-000, 1058, 542, 516, 423, 1348.51, 428, 1349.78, 172
5, 11:55:00-000, 0, 0, 0, 35, 1345.60, 15, 1355.73, 144
5, 11:56:00-000, 1031, 528, 503, 455, 1347.88, 427, 1349.47, 158
5, 11:57:00-000, 980, 511, 469, 368, 1348.89, 392, 1349.48, 114
5, 11:58:00-000, 994, 527, 467, 376, 1349.32, 412, 1350.24, 125
5, 11:59:00-000, 1, 0, 1, 30, 1346.30, 26, 1356.27, 156
5, 12:00:00-000, 984, 479, 505, 370, 1349.34, 394, 1350.60, 157
5, 12:01:00-000, 1054, 507, 547, 425, 1348.23, 429, 1348.83, 154
5, 12:02:00-000, 1059, 562, 497, 433, 1348.86, 375, 1349.80, 151
5, 12:03:00-000, 0, 0, 0, 7, 1345.00, 38, 1356.00, 111
5, 12:04:00-000, 1015, 586, 429, 446, 1348.63, 379, 1349.35, 179
5, 12:05:00-000, 1038, 508, 530, 424, 1348.17, 431, 1349.36, 133
5, 12:06:00-000, 1091, 546, 545, 440, 1348.97, 492, 1350.07, 120
5, 12:07:00-000, 5, 5, 0, 23, 1344.00, 7, 1356.00, 133
5, 12:08:00-000, 935, 445, 490, 381, 1348.00, 396, 1349.42, 143
5, 12:09:00-000, 1173, 561, 612, 479, 1348.99, 465, 1349.83, 123
5, 12:10:00-000, 999, 515, 484, 416, 1348.44, 376, 1349.11, 143
5, 12:11:00-000, 1, 0, 1, 0, 0.00, 19, 1355.10, 145
5, 12:12:00-000, 974, 498, 476, 406, 1348.11, 360, 1349.18, 155
5, 12:13:00-000, 1130, 540, 590, 451, 1348.49, 469, 1348.75, 151
5, 12:14:00-000, 941, 504, 437, 355, 1348.32, 349, 1348.52, 131
5, 12:15:00-000, 1, 1, 0, 19, 1345.26, 20, 1355.00, 191
5, 12:16:00-000, 1068, 549, 519, 416, 1348.30, 417, 1349.38, 135
5, 12:17:00-000, 1039, 528, 511, 415, 1348.84, 388, 1349.61, 174
5, 12:18:00-000, 1024, 560, 464, 424, 1349.01, 399, 1350.43, 173
5, 12:19:00-000, 0, 0, 0, 10, 1345.10, 13, 1355.84, 133
5, 12:20:00-000, 1012, 498, 514, 355, 1349.61, 343, 1348.84, 188
5, 12:21:00-000, 960, 433, 527, 304, 1349.31, 384, 1348.48, 186
5, 12:22:00-000, 980, 467, 513, 355, 1348.16, 362, 1348.20, 225
5, 12:23:00-000, 0, 0, 0, 0, 0.00, 0, 0.00, 203
5, 12:24:00-000, 1049, 514, 535, 370, 1349.09, 397, 1349.56, 191
5, 12:25:00-000, 1115, 519, 596, 391, 1348.60, 398, 1348.93, 203
5, 12:26:00-000, 1016, 478, 538, 341, 1348.76, 383, 1348.81, 241
5, 12:27:00-000, 1, 0, 1, 0, 0.00, 43, 1353.93, 225
5, 12:28:00-000, 1043, 524, 519, 422, 1349.10, 410, 1348.87, 203
5, 12:29:00-000, 985, 514, 471, 329, 1348.76, 338, 1348.75, 162
5, 12:30:00-000, 1092, 551, 541, 420, 1348.99, 372, 1348.63, 191
5, 12:31:00-000, 0, 0, 0, 33, 1346.00, 0, 0.00, 206
5, 12:32:00-000, 1016, 564, 452, 446, 1349.92, 392, 1350.51, 231
5, 12:33:00-000, 1148, 595, 553, 436, 1348.93, 401, 1349.01, 177
5, 12:34:00-000, 1036, 580, 456, 435, 1348.38, 378, 1348.89, 143
5, 12:35:00-000, 0, 0, 0, 8, 1345.00, 25, 1354.80, 203
5, 12:36:00-000, 980, 500, 480, 413, 1348.37, 414, 1349.41, 174
5, 12:37:00-000, 890, 477, 413, 361, 1349.18, 302, 1348.89, 136
5, 12:38:00-000, 1023, 526, 497, 420, 1348.35, 404, 1348.95, 134
5, 12:39:00-000, 0, 0, 0, 0, 0.00, 0, 0.00, 166
5, 12:40:00-000, 1010, 551, 459, 372, 1349.43, 323, 1349.63, 168
5, 12:41:00-000, 1053, 514, 539, 398, 1348.65, 412, 1349.50, 185
5, 12:42:00-000, 984, 494, 490, 428, 1348.08, 388, 1348.99, 198
5, 12:43:00-000, 1, 1, 0, 20, 1345.30, 3, 1355.00, 173
5, 12:44:00-000, 1079, 529, 550, 422, 1348.43, 421, 1349.25, 131
5, 12:45:00-000, 953, 461, 492, 312, 1348.90, 365, 1349.43, 174
5, 12:46:00-000, 1058, 563, 495, 417, 1349.85, 420, 1350.58, 176
5, 12:47:00-000, 1, 0, 1, 26, 1346.04, 10, 1355.50, 160
5, 12:48:00-000, 990, 508, 482, 417, 1348.78, 365, 1348.69, 160
5, 12:49:00-000, 1016, 508, 508, 366, 1348.56, 382, 1349.32, 166
5, 12:50:00-000, 976, 486, 490, 402, 1348.74, 369, 1349.44, 192
5, 12:51:00-000, 0, 0, 0, 13, 1345.00, 45, 1355.13, 136
5, 12:52:00-000, 1089, 590, 499, 466, 1349.64, 440, 1350.32, 133
5, 12:53:00-000, 1087, 559, 528, 392, 1348.67, 423, 1349.89, 132
5, 12:54:00-000, 1143, 510, 633, 447, 1347.73, 496, 1349.25, 172
5, 12:55:00-000, 2, 2, 0, 2, 1350.00, 31, 1356.00, 167
5, 12:56:00-000, 1003, 509, 494, 352, 1349.28, 389, 1350.04, 187
5, 12:57:00-000, 864, 429, 435, 362, 1348.43, 334, 1349.05, 153
5, 12:58:00-000, 1095, 572, 523, 428, 1348.73, 458, 1349.87, 157
5, 12:59:00-000, 2, 0, 2, 17, 1345.00, 30, 1356.59, 133
5, 13:00:00-000, 948, 519, 429, 400, 1349.33, 352, 1350.60, 158
5, 13:01:00-000, 981, 524, 457, 430, 1349.22, 362, 1349.23, 129
5, 13:02:00-000, 1035, 557, 478, 391, 1349.07, 422, 1350.03, 160
5, 13:03:00-000, 1, 1, 0, 27, 1346.00, 0, 0.00, 104
5, 13:04:00-000, 1043, 503, 540, 410, 1348.49, 421, 1349.14, 163
5, 13:05:00-000, 1095, 554, 541, 473, 1348.63, 422, 1349.28, 165
5, 13:06:00-000, 948, 468, 480, 331, 1349.23, 406, 1350.50, 137
5, 13:07:00-000, 0, 0, 0, 44, 1345.49, 0, 0.00, 137
5, 13:08:00-000, 891, 454, 437, 353, 1348.65, 391, 1350.13, 150
5, 13:09:00-000, 1087, 566, 521, 444, 1349.20, 410, 1349.90, 131
5, 13:10:00-000, 1030, 470, 560, 418, 1348.38, 454, 1349.42, 110
5, 13:11:00-000, 1, 0, 1, 0, 0.00, 22, 1355.77, 136
5, 13:12:00-000, 1053, 539, 514, 432, 1349.24, 444, 1350.15, 155
5, 13:13:00-000, 925, 461, 464, 385, 1348.59, 359, 1349.12, 130
5, 13:14:00-000, 1014, 527, 487, 384, 1348.85, 390, 1349.67, 118
5, 13:15:00-000, 1, 1, 0, 9, 1347.67, 11, 1355.73, 149
5, 13:16:00-000, 1058, 518, 540, 450, 1348.58, 423, 1349.88, 130
5, 13:17:00-000, 1040, 534, 506, 413, 1348.73, 394, 1349.25, 157
5, 13:18:00-000, 1036, 501, 535, 430, 1347.76, 411, 1348.76, 158
5, 13:19:00-000, 6, 6, 0, 18, 1345.33, 44, 1355.54, 138
5, 13:20:00-000, 1051, 532, 519, 422, 1349.18, 480, 1350.30, 143
5, 13:21:00-000, 870, 434, 436, 340, 1348.52, 353, 1349.35, 128
5, 13:22:00-000, 1054, 609, 445, 456, 1349.41, 399, 1350.33, 108
5, 13:23:00-000, 0, 0, 0, 6, 1346.00, 3, 1356.67, 80
5, 13:24:00-000, 1018, 532, 486, 406, 1348.79, 452, 1350.52, 161
5, 13:25:00-000, 1013, 490, 523, 390, 1349.34, 422, 1350.49, 164
5, 13:26:00-000, 995, 494, 501, 403, 1348.16, 409, 1349.75, 118
5, 13:27:00-000, 0, 0, 0, 13, 1345.00, 4, 1355.00, 103
5, 13:28:00-000, 1038, 517, 521, 413, 1348.71, 423, 1349.44, 165
5, 13:29:00-000, 996, 526, 470, 409, 1348.80, 369, 1349.49, 161
5, 13:30:00-000, 1103, 545, 558, 423, 1348.74, 481, 1349.96, 122
5, 13:31:00-000, 1, 1, 0, 12, 1344.75, 58, 1356.63, 156
5, 13:32:00-000, 1036, 519, 517, 440, 1348.75, 423, 1349.99, 141
5, 13:33:00-000, 1040, 486, 554, 360, 1348.24, 409, 1348.80, 124
5, 13:34:00-000, 1059, 544, 515, 411, 1348.75, 433, 1349.68, 124
5, 13:35:00-000, 4, 1, 3, 56, 1345.92, 4, 1355.00, 165
5, 13:36:00-000, 969, 514, 455, 424, 1348.83, 367, 1349.68, 169
5, 13:37:00-000, 932, 435, 497, 359, 1348.48, 357, 1349.30, 140
5, 13:38:00-000, 1053, 578, 475, 452, 1349.22, 375, 1350.21, 126
5, 13:39:00-000, 1, 0, 1, 28, 1345.39, 22, 1355.54, 144
5, 13:40:00-000, 1045, 531, 514, 400, 1348.19, 447, 1349.38, 156
5, 13:41:00-000, 1131, 622, 509, 434, 1348.88, 382, 1349.24, 129
5, 13:42:00-000, 1065, 524, 541, 431, 1348.61, 458, 1349.95, 188
5, 13:43:00-000, 1, 0, 1, 27, 1345.78, 11, 1356.00, 166
5, 13:44:00-000, 1084, 563, 521, 417, 1348.60, 423, 1349.46, 147
5, 13:45:00-000, 1067, 530, 537, 428, 1348.17, 384, 1348.66, 166
5, 13:46:00-000, 1069, 520, 549, 397, 1348.09, 454, 1349.07, 208
5, 13:47:00-000, 8, 7, 1, 6, 1351.50, 29, 1354.96, 186
5, 13:48:00-000, 929, 511, 418, 374, 1348.88, 372, 1350.38, 162
5, 13:49:00-000, 1056, 526, 530, 402, 1348.85, 422, 1349.27, 126
5, 13:50:00-000, 939, 501, 438, 384, 1348.64, 367, 1350.15, 136
5, 13:51:00-000, 1, 0, 1, 24, 1345.16, 1, 1349.00, 153
5, 13:52:00-000, 945, 492, 453, 391, 1348.52, 382, 1349.96, 155
5, 13:53:00-000, 951, 449, 502, 311, 1348.55, 374, 1349.37, 139
5, 13:54:00-000, 1083, 541, 542, 452, 1348.37, 466, 1349.51, 152
5, 13:55:00-000, 2, 2, 0, 17, 1345.17, 9, 1356.00, 135
5, 13:56:00-000, 1076, 499, 577, 437, 1347.53, 422, 1348.86, 143
5, 13:57:00-000, 1072, 599, 473, 433, 1348.87, 393, 1349.54, 153
5, 13:58:00-000, 1108, 551, 557, 452, 1348.06, 435, 1349.29, 154
5, 13:59:00-000, 1, 0, 1, 13, 1345.00, 58, 1356.15, 152
5, 14:00:00-000, 1012, 486, 526, 417, 1348.45, 393, 1349.35, 161
5, 14:01:00-000, 1105, 546, 559, 456, 1348.82, 491, 1349.42, 139
5, 14:02:00-000, 954, 483, 471, 417, 1348.84, 321, 1349.36, 130
5, 14:03:00-000, 3, 0, 3, 8, 1344.00, 31, 1354.42, 130
5, 14:04:00-000, 1011, 484, 527, 368, 1348.56, 469, 1349.97, 138
5, 14:05:00-000, 986, 451, 535, 378, 1348.37, 404, 1348.36, 131
5, 14:06:00-000, 1110, 552, 558, 411, 1348.33, 400, 1348.91, 141
5, 14:07:00-000, 0, 0, 0, 8, 1345.00, 44, 1354.14, 135
5, 14:08:00-000, 1050, 546, 504, 427, 1349.00, 437, 1350.01, 163
5, 14:09:00-000, 1053, 535, 518, 423, 1348.66, 420, 1349.29, 159
5, 14:10:00-000, 958, 437, 521, 395, 1347.23, 365, 1348.55, 148
5, 14:11:00-000, 0, 0, 0, 33, 1343.42, 28, 1353.85, 143
5, 14:12:00-000, 1117, 581, 536, 439, 1348.28, 467, 1349.58, 157
5, 14:13:00-000, 1065, 543, 522, 406, 1348.84, 409, 1349.35, 156
5, 14:14:00-000, 925, 507, 418, 453, 1348.56, 377, 1349.88, 125
5, 14:15:00-000, 0, 0, 0, 44, 1343.68, 10, 1356.00, 140
5, 14:16:00-000, 1012, 497, 515, 392, 1348.04, 379, 1348.83, 114
5, 14:17:00-000, 1029, 503, 526, 449, 1348.46, 371, 1348.94, 108
5, 14:18:00-000, 1123, 557, 566, 423, 1348.07, 444, 1348.86, 179
5, 14:19:00-000, 1, 1, 0, 26, 1345.19, 36, 1354.58, 134
5, 14:20:00-000, 1016, 501, 515, 375, 1348.48, 399, 1349.54, 175
5, 14:21:00-000, 1003, 511, 492, 376, 1349.34, 389, 1349.77, 183
5, 14:22:00-000, 1029, 492, 537, 409, 1347.55, 461, 1349.09, 159
5, 14:23:00-000, 0, 0, 0, 16, 1344.00, 29, 1356.00, 144
5, 14:24:00-000, 1048, 559, 489, 433, 1349.77, 417, 1350.73, 119
5, 14:25:00-000, 1036, 501, 535, 358, 1348.54, 379, 1348.95, 140
5, 14:26:00-000, 1048, 517, 531, 417, 1348.54, 450, 1349.54, 169
5, 14:27:00-000, 1, 0, 1, 0, 0.00, 20, 1355.50, 154
5, 14:28:00-000, 1143, 590, 553, 475, 1348.08, 394, 1348.74, 182
5, 14:29:00-000, 927, 517, 410, 371, 1349.87, 346, 1350.43, 187
5, 14:30:00-000, 940, 457, 483, 356, 1348.64, 359, 1349.31, 177
5, 14:31:00-000, 1, 1, 0, 25, 1345.48, 22, 1354.50, 121
5, 14:32:00-000, 1072, 551, 521, 453, 1348.70, 500, 1350.41, 161
5, 14:33:00-000, 956, 464, 492, 360, 1348.34, 406, 1349.56, 110
5, 14:34:00-000, 997, 513, 484, 397, 1348.86, 378, 1349.49, 114
5, 14:35:00-000, 4, 0, 4, 23, 1346.00, 19, 1355.47, 144
5, 14:36:00-000, 1050, 584, 466, 397, 1349.67, 376, 1350.94, 153
5, 14:37:00-000, 1065, 492, 573, 386, 1348.42, 419, 1348.80, 177
5, 14:38:00-000, 1077, 557, 520, 512, 1348.13, 419, 1349.34, 182
5, 14:39:00-000, 1, 1, 0, 18, 1343.89, 33, 1355.27, 140
5, 14:40:00-000, 1024, 517, 507, 421, 1348.50, 396, 1349.55, 150
5, 14:41:00-000, 980, 499, 481, 367, 1348.17, 367, 1348.28, 156
5, 14:42:00-000, 1085, 566, 519, 384, 1349.00, 385, 1349.85, 160
5, 14:43:00-000, 0, 0, 0, 42, 1346.54, 42, 1354.59, 145
5, 14:44:00-000, 950, 456, 494, 306, 1348.49, 401, 1349.64, 185
5, 14:45:00-000, 1003, 512, 491, 377, 1348.88, 359, 1349.47, 172
5, 14:46:00-000, 1107, 546, 561, 432, 1348.24, 402, 1349.27, 199
5, 14:47:00-000, 3, 2, 1, 1, 1348.00, 1, 1350.00, 192
5, 14:48:00-000, 1026, 534, 492, 471, 1348.58, 378, 1349.49, 208
5, 14:49:00-000, 1042, 522, 520, 359, 1348.49, 410, 1349.22, 147
5, 14:50:00-000, 1057, 563, 494, 432, 1348.59, 426, 1348.91, 183
5, 14:51:00-000, 0, 0, 0, 1, 1346.00, 26, 1356.00, 164
5, 14:52:00-000, 1047, 494, 553, 430, 1347.34, 451, 1348.34, 137
5, 14:53:00-000, 1078, 538, 540, 368, 1348.01, 382, 1348.43, 134
5, 14:54:00-000, 1003, 465, 538, 355, 1348.77, 444, 1349.57, 163
5, 14:55:00-000, 6, 5, 1, 13, 1346.54, 13, 1355.77, 215
5, 14:56:00-000, 1070, 530, 540, 488, 1347.73, 414, 1349.26, 155
5, 14:57:00-000, 988, 569, 419, 358, 1349.48, 326, 1349.87, 176
5, 14:58:00-000, 1016, 475, 541, 407, 1348.09, 413, 1349.15, 112
5, 14:59:00-000, 12, 6, 6, 34, 1346.23, 17, 1352.35, 210
5, 15:00:00-000, 1093, 537, 556, 472, 1348.00, 473, 1348.96, 158
5, 15:01:00-000, 1058, 590, 468, 388, 1349.57, 375, 1350.22, 113
5, 15:02:00-000, 981, 510, 471, 417, 1347.96, 349, 1348.98, 143
5, 15:03:00-000, 0, 0, 0, 66, 1343.40, 12, 1354.92, 198
5, 15:04:00-000, 1023, 536, 487, 435, 1349.22, 440, 1350.50, 127
5, 15:05:00-000, 959, 461, 498, 331, 1348.14, 370, 1348.93, 126
5, 15:06:00-000, 1015, 478, 537, 329, 1347.56, 434, 1349.33, 140
5, 15:07:00-000, 2, 2, 0, 26, 1345.27, 3, 1355.00, 162
5, 15:08:00-000, 1021, 496, 525, 424, 1348.25, 416, 1349.77, 172
5, 15:09:00-000, 955, 471, 484, 360, 1349.25, 363, 1349.40, 150
5, 15:10:00-000, 1115, 557, 558, 385, 1348.97, 400, 1349.72, 178
5, 15:11:00-000, 6, 1, 5, 4, 1347.25, 41, 1354.02, 174
5, 15:12:00-000, 1018, 521, 497, 426, 1349.52, 419, 1350.25, 169
5, 15:13:00-000, 1116, 612, 504, 439, 1349.44, 381, 1349.70, 182
5, 15:14:00-000, 999, 487, 512, 417, 1348.31, 384, 1349.46, 174
5, 15:15:00-000, 2, 2, 0, 36, 1345.75, 28, 1354.96, 194
5, 15:16:00-000, 969, 460, 509, 376, 1348.69, 427, 1349.88, 129
5, 15:17:00-000, 1009, 488, 521, 368, 1348.54, 386, 1349.25, 136
5, 15:18:00-000, 1045, 515, 530, 391, 1348.95, 455, 1350.23, 131
5, 15:19:00-000, 4, 3, 1, 0, 0.00, 28, 1356.00, 161
5, 15:20:00-000, 967, 516, 451, 376, 1349.55, 354, 1350.14, 162
5, 15:21:00-000, 966, 485, 481, 356, 1348.93, 352, 1349.54, 177
5, 15:22:00-000, 1111, 571, 540, 441, 1348.84, 455, 1349.65, 173
5, 15:23:00-000, 2, 2, 0, 23, 1345.82, 24, 1355.41, 111
5, 15:24:00-000, 1062, 573, 489, 428, 1349.11, 382, 1349.54, 178
5, 15:25:00-000, 1037, 507, 530, 403, 1347.85, 391, 1348.59, 169
5, 15:26:00-000, 1048, 492, 556, 385, 1348.42, 415, 1349.71, 186
5, 15:27:00-000, 6, 6, 0, 38, 1345.15, 17, 1356.00, 169
5, 15:28:00-000, 998, 502, 496, 409, 1349.20, 408, 1350.28, 187
5, 15:29:00-000, 1084, 580, 504, 414, 1348.98, 391, 1349.38, 168
5, 15:30:00-000, 992, 537, 455, 394, 1349.10, 376, 1349.71, 155
5, 15:31:00-000, 1, 0, 1, 16, 1346.00, 16, 1355.87, 184
5, 15:32:00-000, 1053, 532, 521, 472, 1348.36, 406, 1349.60, 130
5, 15:33:00-000, 968, 505, 463, 392, 1348.87, 365, 1349.38, 147
5, 15:34:00-000, 1029, 515, 514, 420, 1348.41, 385, 1349.77, 122
5, 15:35:00-000, 0, 0, 0, 22, 1344.00, 5, 1354.00, 136
5, 15:36:00-000, 1012, 529, 483, 392, 1349.20, 405, 1350.44, 175
5, 15:37:00-000, 964, 488, 476, 352, 1349.75, 377, 1350.42, 171
5, 15:38:00-000, 1060, 520, 540, 450, 1348.79, 458, 1350.19, 167
5, 15:39:00-000, 1, 0, 1, 21, 1345.00, 9, 1356.44, 114
5, 15:40:00-000, 1111, 574, 537, 337, 1348.91, 324, 1348.48, 152
5, 15:41:00-000, 1030, 509, 521, 390, 1348.70, 312, 1347.99, 269
5, 15:42:00-000, 1107, 503, 604, 363, 1348.46, 426, 1348.68, 296
5, 15:43:00-000, 3, 2, 1, 0, 0.00, 0, 0.00, 253
5, 15:44:00-000, 970, 485, 485, 367, 1348.87, 372, 1348.60, 253
5, 15:45:00-000, 978, 500, 478, 381, 1349.41, 370, 1349.68, 182
5, 15:46:00-000, 1023, 564, 459, 405, 1349.65, 324, 1348.73, 182
5, 15:47:00-000, 2, 1, 1, 21, 1346.00, 1, 1349.00, 172
5, 15:48:00-000, 1022, 604, 418, 422, 1350.19, 328, 1349.69, 193
5, 15:49:00-000, 1025, 554, 471, 405, 1349.28, 375, 1349.62, 226
5, 15:50:00-000, 1133, 579, 554, 464, 1348.82, 414, 1349.21, 176
5, 15:51:00-000, 3, 3, 0, 19, 1346.37, 0, 0.00, 166
5, 15:52:00-000, 996, 559, 437, 385, 1349.66, 363, 1350.34, 210
5, 15:53:00-000, 1121, 566, 555, 432, 1349.10, 394, 1349.55, 190
5, 15:54:00-000, 1032, 502, 530, 363, 1348.62, 434, 1348.59, 179
5, 15:55:00-000, 1, 0, 1, 0, 0.00, 2, 1350.00, 216
5, 15:56:00-000, 958, 500, 458, 361, 1348.77, 359, 1348.92, 202
5, 15:57:00-000, 1017, 502, 515, 394, 1349.05, 388, 1349.57, 171
5, 15:58:00-000, 1099, 543, 556, 420, 1349.20, 423, 1349.54, 167
5, 15:59:00-000, 1, 0, 1, 3, 1346.00, 0, 0.00, 183
5, 16:00:00-000, 958, 471, 487, 376, 1348.18, 384, 1349.35, 177
5, 16:01:00-000, 988, 499, 489, 360, 1349.23, 374, 1349.84, 168
5, 16:02:00-000, 969, 492, 477, 390, 1348.30, 389, 1349.85, 175
5, 16:03:00-000, 1, 1, 0, 20, 1345.00, 28, 1355.82, 135
5, 16:04:00-000, 1045, 506, 539, 419, 1348.70, 438, 1350.31, 138
5, 16:05:00-000, 975, 500, 475, 377, 1348.82, 402, 1349.45, 154
5, 16:06:00-000, 1022, 500, 522, 389, 1349.17, 369, 1349.44, 136
5, 16:07:00-000, 2, 1, 1, 1, 1346.00, 22, 1354.54, 158
5, 16:08:00-000, 1019, 465, 554, 389, 1347.92, 427, 1348.46, 170
5, 16:09:00-000, 985, 513, 472, 397, 1349.26, 395, 1349.84, 170
5, 16:10:00-000, 1104, 599, 505, 426, 1349.16, 419, 1350.29, 124
5, 16:11:00-000, 0, 0, 0, 0, 0.00, 20, 1355.70, 115
5, 16:12:00-000, 1033, 511, 522, 373, 1348.92, 423, 1349.82, 230
5, 16:13:00-000, 1050, 548, 502, 401, 1348.99, 404, 1349.76, 150
5, 16:14:00-000, 1084, 527, 557, 429, 1348.41, 403, 1349.35, 197
5, 16:15:00-000, 1, 1, 0, 26, 1345.00, 43, 1354.50, 160
5, 16:16:00-000, 1013, 502, 511, 377, 1349.05, 411, 1349.67, 143
5, 16:17:00-000, 1082, 545, 537, 418, 1349.34, 433, 1350.52, 174
5, 16:18:00-000, 1027, 512, 515, 397, 1348.93, 419, 1350.14, 164
5, 16:19:00-000, 0, 0, 0, 53, 1345.43, 16, 1356.00, 153
5, 16:20:00-000, 1037, 480, 557, 381, 1348.33, 389, 1349.44, 139
5, 16:21:00-000, 942, 494, 448, 376, 1348.23, 343, 1348.57, 187
5, 16:22:00-000, 1018, 497, 521, 387, 1348.91, 364, 1349.33, 180
5, 16:23:00-000, 1, 0, 1, 31, 1345.00, 62, 1354.86, 155
5, 16:24:00-000, 1084, 525, 559, 412, 1349.03, 452, 1350.18, 152
5, 16:25:00-000, 984, 526, 458, 358, 1349.72, 336, 1350.10, 144
5, 16:26:00-000, 993, 470, 523, 362, 1348.52, 390, 1349.83, 141
5, 16:27:00-000, 4, 0, 4, 55, 1345.34, 27, 1354.00, 155
5, 16:28:00-000, 1036, 500, 536, 413, 1347.87, 424, 1349.09, 207
5, 16:29:00-000, 1023, 525, 498, 375, 1349.14, 383, 1349.34, 162
6, 12:20:00-000, 6944, 3459, 3485, 1562, 1348.02, 1652, 1348.62, 0
6, 12:21:00-000, 0, 0, 0, 136, 1347.00, 57, 1354.00, 0
6, 12:22:00-000, 0, 0, 0, 92, 1346.00, 103, 1354.00, 0
6, 12:23:00-000, 0, 0, 0, 53, 1346.00, 60, 1354.00, 0
6, 12:24:00-000, 0, 0, 0, 84, 1346.00, 17, 1354.00, 0
6, 12:25:00-000, 0, 0, 0, 15, 1346.00, 0, 0.00, 0
6, 12:26:00-000, 0, 0, 0, 92, 1345.00, 0, 0.00, 0
6, 12:27:00-000, 0, 0, 0, 38, 1345.00, 0, 0.00, 0
6, 12:28:00-000, 0, 0, 0, 16, 1345.00, 37, 1355.00, 0
6, 12:29:00-000, 0, 0, 0, 0, 0.00, 54, 1355.00, 0
6, 12:30:00-000, 0, 0, 0, 0, 0.00, 76, 1355.00, 0
6, 12:31:00-000, 0, 0, 0, 0, 0.00, 41, 1355.00, 0
6, 12:32:00-000, 0, 0, 0, 53, 1345.00, 34, 1355.00, 0
6, 12:33:00-000, 0, 0, 0, 5, 1345.00, 0, 0.00, 0
6, 12:34:00-000, 0, 0, 0, 22, 1345.00, 0, 0.00, 0
6, 12:36:00-000, 0, 0, 0, 0, 0.00, 1, 1356.00, 0
6, 12:38:00-000, 0, 0, 0, 6, 1344.00, 16, 1356.00, 0
6, 12:39:00-000, 0, 0, 0, 0, 0.00, 32, 1356.00, 0
6, 12:40:00-000, 0, 0, 0, 0, 0.00, 81, 1356.00, 108
6, 12:41:00-000, 0, 0, 0, 0, 0.00, 16, 1356.00, 125
6, 12:42:00-000, 0, 0, 0, 0, 0.00, 0, 0.00, 123
6, 12:43:00-000, 0, 0, 0, 0, 0.00, 0, 0.00, 133
6, 12:44:00-000, 0, 0, 0, 44, 1344.00, 17, 1356.00, 154
6, 12:45:00-000, 0, 0, 0, 0, 0.00, 0, 0.00, 131
6, 12:46:00-000, 0, 0, 0, 0, 0.00, 57, 1356.00, 115
6, 12:47:00-000, 0, 0, 0, 0, 0.00, 0, 0.00, 116
6, 12:48:00-000, 0, 0, 0, 0, 0.00, 0, 0.00, 133
6, 12:49:00-000, 0, 0, 0, 0, 0.00, 0, 0.00, 98
6, 12:50:00-000, 0, 0, 0, 0, 0.00, 0, 0.00, 128
6, 12:51:00-000, 0, 0, 0, 0, 0.00, 0, 0.00, 97
6, 12:52:00-000, 0, 0, 0, 0, 0.00, 0, 0.00, 106
6, 12:53:00-000, 0, 0, 0, 0, 0.00, 0, 0.00, 133
6, 12:54:00-000, 0, 0, 0, 0, 0.00, 0, 0.00, 113
6, 12:55:00-000, 0, 0, 0, 0, 0.00, 0, 0.00, 98
6, 12:56:00-000, 0, 0, 0, 0, 0.00, 0, 0.00, 109
6, 12:57:00-000, 0, 0, 0, 0, 0.00, 0, 0.00, 115
6, 12:58:00-000, 0, 0, 0, 0, 0.00, 11, 1357.00, 116
6, 12:59:00-000, 0, 0, 0, 0, 0.00, 9, 1357.67, 103
6, 13:00:00-000, 0, 0, 0, 0, 0.00, 0, 0.00, 1
6, 15:40:00-000, 6947, 3361, 3586, 1584, 1347.56, 1575, 1348.05, 0
6, 15:41:00-000, 0, 0, 0, 11, 1346.73, 147, 1353.00, 0
6, 15:42:00-000, 0, 0, 0, 101, 1346.00, 53, 1353.85, 0
6, 15:43:00-000, 0, 0, 0, 23, 1346.00, 74, 1354.00, 0
6, 15:44:00-000, 0, 0, 0, 95, 1346.00, 137, 1354.00, 0
6, 15:45:00-000, 0, 0, 0, 39, 1346.00, 0, 0.00, 0
6, 15:46:00-000, 0, 0, 0, 61, 1345.00, 172, 1355.00, 0
6, 15:47:00-000, 0, 0, 0, 1, 1345.00, 59, 1355.00, 0
6, 15:48:00-000, 0, 0, 0, 0, 0.00, 101, 1355.75, 0
6, 15:49:00-000, 0, 0, 0, 0, 0.00, 23, 1356.00, 0
6, 15:50:00-000, 0, 0, 0, 0, 0.00, 19, 1356.00, 0
6, 15:51:00-000, 0, 0, 0, 21, 1345.00, 0, 0.00, 0
6, 15:54:00-000, 0, 0, 0, 72, 1345.00, 0, 0.00, 0
6, 15:55:00-000, 0, 0, 0, 68, 1345.00, 21, 1356.00, 0
6, 15:56:00-000, 0, 0, 0, 1, 1345.00, 31, 1356.00, 0
6, 15:57:00-000, 0, 0, 0, 16, 1345.00, 0, 0.00, 0
6, 15:58:00-000, 0, 0, 0, 0, 0.00, 35, 1356.00, 0
6, 15:59:00-000, 0, 0, 0, 0, 0.00, 27, 1356.00, 0
6, 16:00:00-000, 2, 2, 0, 1, 1349.00, 8, 1356.00, 119
6, 16:01:00-000, 0, 0, 0, 0, 0.00, 0, 0.00, 107
6, 16:02:00-000, 0, 0, 0, 0, 0.00, 14, 1356.00, 132
6, 16:03:00-000, 0, 0, 0, 0, 0.00, 0, 0.00, 102
6, 16:04:00-000, 0, 0, 0, 5, 1344.00, 0, 0.00, 125
6, 16:05:00-000, 0, 0, 0, 23, 1344.00, 0, 0.00, 110
6, 16:06:00-000, 0, 0, 0, 48, 1344.00, 0, 0.00, 112
6, 16:07:00-000, 0, 0, 0, 0, 0.00, 0, 0.00, 107
6, 16:08:00-000, 0, 0, 0, 64, 1344.00, 0, 0.00, 110
6, 16:09:00-000, 0, 0, 0, 0, 0.00, 0, 0.00, 107
6, 16:10:00-000, 0, 0, 0, 0, 0.00, 8, 1357.00, 100
6, 16:11:00-000, 0, 0, 0, 0, 0.00, 0, 0.00, 111
6, 16:12:00-000, 0, 0, 0, 0, 0.00, 0, 0.00, 92
6, 16:13:00-000, 0, 0, 0, 0, 0.00, 0, 0.00, 101
6, 16:14:00-000, 0, 0, 0, 0, 0.00, 0, 0.00, 125
6, 16:15:00-000, 0, 0, 0, 0, 0.00, 0, 0.00, 123
6, 16:16:00-000, 0, 0, 0, 0, 0.00, 0, 0.00, 108
6, 16:17:00-000, 1, 0, 1, 0, 0.00, 1, 1352.00, 97
6, 16:18:00-000, 0, 0, 0, 0, 0.00, 0, 0.00, 119
6, 16:19:00-000, 0, 0, 0, 0, 0.00, 0, 0.00, 101
6, 16:20:00-000, 14, 6, 8, 4, 1345.50, 4, 1352.00, 2
6, 16:21:00-000, 0, 0, 0, 0, 0.00, 0, 0.00, 1
6, 16:23:00-000, 0, 0, 0, 0, 0.00, 1, 1356.00, 0
8, 09:06:00-000, 94, 4, 90, 0, 0.00, 0, 0.00, 94
8, 09:07:00-000, 5668, 3122, 2546, 0, 0.00, 0, 0.00, 5330
8, 09:08:00-000, 0, 0, 0, 0, 0.00, 0, 0.00, 338
8, 09:16:00-000, 725, 5, 720, 0, 0.00, 0, 0.00, 725
8, 09:30:00-000, 4953, 860, 4093, 23, 1354.17, 23, 1352.00, 4907
8, 09:41:00-000, 823, 38, 785, 0, 0.00, 0, 0.00, 823
8, 09:48:00-000, 4121, 3227, 894, 5, 1350.00, 5, 1349.60, 4111
8, 09:49:00-000, 5630, 3788, 1842, 2, 1351.00, 2, 1351.00, 5618
8, 09:50:00-000, 1715, 1498, 217, 7, 1351.00, 7, 1349.00, 1709
8, 09:51:00-000, 4685, 1788, 2897, 1, 1349.00, 1, 1350.00, 4616
8, 09:52:00-000, 4, 0, 4, 4, 1350.00, 4, 1347.00, 63
8, 09:56:00-000, 128, 40, 88, 0, 0.00, 0, 0.00, 128
8, 09:57:00-000, 2808, 2700, 108, 0, 0.00, 0, 0.00, 2808
8, 09:58:00-000, 3616, 2874, 742, 9, 1352.00, 9, 1350.00, 3598
8, 10:00:00-000, 1222, 1117, 105, 5, 1354.60, 5, 1351.00, 1212
8, 10:01:00-000, 1931, 357, 1574, 0, 0.00, 0, 0.00, 1931
8, 10:03:00-000, 1734, 24, 1710, 0, 0.00, 0, 0.00, 1728
8, 10:04:00-000, 9, 0, 9, 5, 1351.00, 5, 1351.20, 5
8, 10:05:00-000, 2158, 1754, 404, 0, 0.00, 0, 0.00, 2158
8, 10:06:00-000, 526, 525, 1, 0, 0.00, 0, 0.00, 526
8, 10:07:00-000, 3920, 2677, 1243, 0, 0.00, 0, 0.00, 3913
8, 10:08:00-000, 810, 63, 747, 3, 1351.00, 3, 1350.33, 811
8, 10:10:00-000, 3904, 764, 3140, 7, 1351.00, 20, 1352.00, 3877
8, 10:11:00-000, 5379, 1399, 3980, 13, 1356.00, 0, 0.00, 5366
8, 10:15:00-000, 494, 253, 241, 9, 1348.00, 9, 1350.67, 476
8, 10:19:00-000, 1275, 1096, 179, 0, 0.00, 0, 0.00, 1275
8, 10:22:00-000, 222, 220, 2, 0, 0.00, 0, 0.00, 222
8, 10:23:00-000, 5611, 2380, 3231, 2, 1351.00, 2, 1351.00, 5590
8, 10:24:00-000, 0, 0, 0, 0, 0.00, 0, 0.00, 17
8, 10:28:00-000, 776, 6, 770, 0, 0.00, 0, 0.00, 776
8, 10:29:00-000, 7667, 5559, 2108, 9, 1354.22, 9, 1352.00, 7649
8, 10:30:00-000, 4792, 2352, 2440, 15, 1346.73, 15, 1347.66, 4762
8, 10:31:00-000, 6406, 5214, 1192, 40, 1348.90, 40, 1347.60, 6320
8, 10:32:00-000, 115, 15, 100, 6, 1355.33, 6, 1350.00, 109
8, 10:33:00-000, 5371, 4038, 1333, 0, 0.00, 0, 0.00, 5371
8, 10:34:00-000, 9163, 1810, 7353, 0, 0.00, 0, 0.00, 9163
8, 10:35:00-000, 1217, 34, 1183, 0, 0.00, 0, 0.00, 1217
8, 10:36:00-000, 1439, 444, 995, 5, 1348.80, 5, 1350.00, 1429
8, 10:38:00-000, 9338, 4535, 4803, 0, 0.00, 0, 0.00, 8380
8, 10:39:00-000, 1858, 1825, 33, 4, 1353.25, 4, 1351.50, 2808
8, 10:42:00-000, 4503, 4237, 266, 29, 1351.03, 29, 1351.34, 4445
8, 10:43:00-000, 1083, 1061, 22, 0, 0.00, 0, 0.00, 1083
8, 10:44:00-000, 21, 1, 20, 0, 0.00, 0, 0.00, 21
8, 10:45:00-000, 770, 760, 10, 0, 0.00, 0, 0.00, 770
8, 10:47:00-000, 1761, 10, 1751, 0, 0.00, 0, 0.00, 1761
8, 10:50:00-000, 1829, 649, 1180, 9, 1347.33, 9, 1351.67, 1811
8, 10:51:00-000, 105, 91, 14, 4, 1352.25, 4, 1348.00, 97
8, 10:53:00-000, 10882, 4967, 5915, 0, 0.00, 0, 0.00, 10882
8, 10:54:00-000, 6799, 3643, 3156, 3, 1351.00, 3, 1350.33, 6730
8, 10:55:00-000, 171, 100, 71, 0, 0.00, 0, 0.00, 234
8, 10:56:00-000, 2038, 734, 1304, 0, 0.00, 0, 0.00, 2033
8, 10:57:00-000, 0, 0, 0, 0, 0.00, 0, 0.00, 5
8, 10:59:00-000, 2809, 1199, 1610, 7, 1349.71, 7, 1350.00, 2795
8, 11:00:00-000, 4584, 1870, 2714, 3, 1349.00, 3, 1349.33, 4570
8, 11:01:00-000, 3634, 1628, 2006, 0, 0.00, 0, 0.00, 3642
8, 11:02:00-000, 2623, 962, 1661, 29, 1349.34, 41, 1351.21, 2553
8, 11:03:00-000, 363, 199, 164, 12, 1355.08, 0, 0.00, 351
8, 11:04:00-000, 106, 90, 16, 16, 1348.00, 16, 1348.25, 74
8, 11:05:00-000, 241, 113, 128, 17, 1348.29, 17, 1351.41, 207
8, 11:06:00-000, 9155, 3654, 5501, 16, 1350.06, 16, 1351.00, 9113
8, 11:07:00-000, 2792, 1075, 1717, 0, 0.00, 0, 0.00, 2802
8, 11:08:00-000, 1023, 798, 225, 0, 0.00, 0, 0.00, 1023
8, 11:10:00-000, 5785, 4063, 1722, 1, 1351.00, 1, 1351.00, 5783
8, 11:11:00-000, 5191, 1842, 3349, 0, 0.00, 0, 0.00, 5191
8, 11:14:00-000, 2785, 1928, 857, 0, 0.00, 0, 0.00, 2781
8, 11:15:00-000, 1179, 891, 288, 32, 1355.00, 32, 1352.68, 1119
8, 11:16:00-000, 55, 50, 5, 0, 0.00, 0, 0.00, 55
8, 11:17:00-000, 7031, 2745, 4286, 3, 1349.00, 3, 1347.00, 6454
8, 11:18:00-000, 5579, 3742, 1837, 9, 1351.44, 9, 1350.55, 6132
8, 11:19:00-000, 8561, 3683, 4878, 2, 1353.00, 2, 1352.00, 8557
8, 11:20:00-000, 5799, 2554, 3245, 0, 0.00, 0, 0.00, 5799
8, 11:21:00-000, 48, 40, 8, 0, 0.00, 0, 0.00, 48
8, 11:22:00-000, 359, 199, 160, 0, 0.00, 0, 0.00, 359
8, 11:23:00-000, 4767, 1554, 3213, 5, 1348.00, 5, 1347.60, 4757
8, 11:24:00-000, 2982, 2498, 484, 0, 0.00, 0, 0.00, 2982
8, 11:25:00-000, 3240, 1010, 2230, 1, 1351.00, 1, 1352.00, 3238
8, 11:26:00-000, 1311, 141, 1170, 0, 0.00, 0, 0.00, 1311
8, 11:27:00-000, 60, 0, 60, 0, 0.00, 0, 0.00, 60
8, 11:28:00-000, 8305, 3931, 4374, 1, 1353.00, 1, 1352.00, 8303
8, 11:29:00-000, 1867, 275, 1592, 1, 1354.00, 1, 1352.00, 1865
8, 11:30:00-000, 6347, 3358, 2989, 49, 1352.50, 49, 1352.48, 6249
8, 11:31:00-000, 3476, 3249, 227, 0, 0.00, 1, 1351.00, 3475
8, 11:32:00-000, 7113, 2384, 4729, 1, 1351.00, 0, 0.00, 7105
8, 11:33:00-000, 3182, 2863, 319, 14, 1356.00, 14, 1351.00, 3161
8, 11:34:00-000, 3092, 131, 2961, 0, 0.00, 0, 0.00, 3091
8, 11:35:00-000, 7922, 6036, 1886, 17, 1347.76, 17, 1351.76, 6883
8, 11:36:00-000, 1105, 1057, 48, 16, 1349.31, 14, 1351.14, 2081
8, 11:37:00-000, 2, 0, 2, 0, 0.00, 2, 1353.00, 0
8, 11:40:00-000, 8738, 5460, 3278, 38, 1348.02, 38, 1348.71, 8660
8, 11:41:00-000, 7164, 5599, 1565, 0, 0.00, 0, 0.00, 7166
8, 11:42:00-000, 113, 102, 11, 0, 0.00, 0, 0.00, 113
8, 11:43:00-000, 5920, 4411, 1509, 1, 1350.00, 1, 1348.00, 5915
8, 11:44:00-000, 3139, 2846, 293, 12, 1352.33, 12, 1352.00, 3118
8, 11:45:00-000, 8684, 7579, 1105, 11, 1353.82, 11, 1351.54, 8662
8, 11:46:00-000, 6052, 4747, 1305, 16, 1350.81, 16, 1350.88, 6020
8, 11:47:00-000, 909, 900, 9, 0, 0.00, 0, 0.00, 909
8, 11:48:00-000, 6356, 2851, 3505, 12, 1346.58, 12, 1346.83, 6332
8, 11:49:00-000, 1555, 1550, 5, 2, 1348.00, 2, 1348.50, 1551
8, 11:50:00-000, 7371, 3475, 3896, 1, 1345.00, 1, 1349.00, 7369
8, 11:51:00-000, 5437, 1593, 3844, 1, 1352.00, 1, 1351.00, 5414
8, 11:52:00-000, 2445, 1644, 801, 3, 1348.67, 3, 1351.00, 2460
8, 11:53:00-000, 3601, 1202, 2399, 0, 0.00, 0, 0.00, 3394
8, 11:54:00-000, 3230, 2491, 739, 8, 1349.12, 11, 1352.64, 3418
8, 11:55:00-000, 8901, 7468, 1433, 3, 1351.33, 0, 0.00, 8898
8, 11:56:00-000, 294, 103, 191, 21, 1350.14, 21, 1351.57, 252
8, 11:57:00-000, 389, 278, 111, 7, 1349.86, 7, 1350.00, 375
8, 11:58:00-000, 4968, 4100, 868, 4, 1349.00, 4, 1348.00, 4960
8, 12:00:00-000, 5049, 1927, 3122, 0, 0.00, 0, 0.00, 5049
8, 12:01:00-000, 724, 4, 720, 0, 0.00, 0, 0.00, 724
8, 12:02:00-000, 3436, 35, 3401, 0, 0.00, 0, 0.00, 3415
8, 12:03:00-000, 2145, 2120, 25, 0, 0.00, 0, 0.00, 2166
8, 12:04:00-000, 879, 312, 567, 3, 1350.00, 3, 1351.67, 873
8, 12:05:00-000, 1396, 318, 1078, 16, 1351.50, 16, 1346.87, 1364
8, 12:06:00-000, 758, 666, 92, 0, 0.00, 0, 0.00, 0
8, 12:07:00-000, 6493, 4554, 1939, 0, 0.00, 0, 0.00, 7251
8, 12:08:00-000, 2050, 1152, 898, 6, 1348.17, 6, 1348.50, 2038
8, 12:09:00-000, 3953, 414, 3539, 0, 0.00, 0, 0.00, 3953
8, 12:10:00-000, 3767, 3580, 187, 27, 1352.26, 27, 1351.04, 3713
8, 12:11:00-000, 3679, 889, 2790, 4, 1349.00, 4, 1346.75, 3671
8, 12:12:00-000, 4336, 81, 4255, 3, 1346.67, 2, 1349.00, 4331
8, 12:13:00-000, 3403, 1626, 1777, 13, 1347.38, 14, 1346.21, 3376
8, 12:14:00-000, 3443, 1836, 1607, 31, 1345.97, 21, 1348.90, 3391
8, 12:15:00-000, 71, 9, 62, 2, 1349.00, 12, 1346.08, 57
8, 12:16:00-000, 5234, 2407, 2827, 0, 0.00, 0, 0.00, 5224
8, 12:17:00-000, 5156, 2345, 2811, 22, 1349.04, 22, 1349.41, 5122
8, 12:18:00-000, 4008, 2262, 1746, 9, 1349.33, 9, 1347.11, 3990
8, 12:19:00-000, 3685, 1853, 1832, 11, 1349.00, 11, 1345.18, 3663
8, 12:20:00-000, 2034, 1187, 847, 0, 0.00, 0, 0.00, 2034
8, 12:21:00-000, 165, 160, 5, 0, 0.00, 0, 0.00, 165
8, 12:22:00-000, 767, 760, 7, 0, 0.00, 0, 0.00, 767
8, 12:23:00-000, 785, 697, 88, 0, 0.00, 0, 0.00, 778
8, 12:24:00-000, 1021, 915, 106, 15, 1352.80, 15, 1350.33, 998
8, 12:25:00-000, 161, 121, 40, 0, 0.00, 0, 0.00, 161
8, 12:27:00-000, 633, 620, 13, 0, 0.00, 0, 0.00, 0
8, 12:28:00-000, 0, 0, 0, 0, 0.00, 0, 0.00, 633
8, 12:30:00-000, 1169, 1150, 19, 0, 0.00, 7, 1352.00, 1162
8, 12:31:00-000, 7, 7, 0, 7, 1353.71, 0, 0.00, 0
8, 12:33:00-000, 2459, 1730, 729, 0, 0.00, 0, 0.00, 1566
8, 12:34:00-000, 180, 15, 165, 5, 1349.00, 5, 1345.00, 1063
8, 12:35:00-000, 5131, 1925, 3206, 0, 0.00, 0, 0.00, 5125
8, 12:36:00-000, 1190, 280, 910, 1, 1348.00, 1, 1346.00, 1194
8, 12:41:00-000, 2586, 1621, 965, 0, 0.00, 0, 0.00, 2483
8, 12:42:00-000, 234, 123, 111, 7, 1349.71, 7, 1351.71, 323
8, 12:44:00-000, 434, 421, 13, 0, 0.00, 0, 0.00, 434
8, 12:45:00-000, 2847, 656, 2191, 0, 0.00, 0, 0.00, 2847
8, 12:46:00-000, 1481, 1480, 1, 0, 0.00, 0, 0.00, 1481
8, 12:48:00-000, 100, 20, 80, 20, 1350.00, 20, 1353.00, 60
8, 12:49:00-000, 2419, 307, 2112, 2, 1350.00, 2, 1349.50, 2415
8, 12:50:00-000, 3243, 1929, 1314, 1, 1349.00, 1, 1346.00, 3241
8, 12:51:00-000, 1775, 35, 1740, 0, 0.00, 0, 0.00, 1775
8, 12:52:00-000, 22, 21, 1, 1, 1354.00, 1, 1351.00, 20
8, 12:54:00-000, 785, 131, 654, 0, 0.00, 0, 0.00, 785
8, 12:55:00-000, 91, 90, 1, 0, 0.00, 0, 0.00, 90
8, 12:56:00-000, 5148, 3078, 2070, 13, 1351.08, 13, 1351.38, 5123
8, 12:57:00-000, 193, 115, 78, 0, 0.00, 0, 0.00, 193
8, 12:58:00-000, 1797, 1780, 17, 0, 0.00, 0, 0.00, 1538
8, 12:59:00-000, 6484, 2301, 4183, 5, 1349.00, 5, 1351.20, 6733
8, 13:00:00-000, 579, 570, 9, 0, 0.00, 0, 0.00, 579
8, 13:01:00-000, 973, 274, 699, 3, 1351.00, 3, 1351.00, 967
8, 13:05:00-000, 725, 35, 690, 5, 1345.80, 5, 1353.00, 715
8, 13:06:00-000, 50, 50, 0, 0, 0.00, 0, 0.00, 50
8, 13:07:00-000, 1506, 416, 1090, 0, 0.00, 0, 0.00, 1506
8, 13:08:00-000, 9450, 1956, 7494, 2, 1349.00, 2, 1351.00, 9446
8, 13:09:00-000, 7927, 789, 7138, 0, 0.00, 0, 0.00, 7825
8, 13:10:00-000, 1071, 112, 959, 2, 1355.00, 2, 1351.50, 1169
8, 13:11:00-000, 1570, 1570, 0, 0, 0.00, 0, 0.00, 1570
8, 13:12:00-000, 1991, 1864, 127, 2, 1352.00, 2, 1351.00, 1905
8, 13:13:00-000, 2896, 426, 2470, 6, 1350.67, 6, 1351.00, 2966
8, 13:14:00-000, 1862, 342, 1520, 6, 1349.00, 6, 1351.00, 1850
8, 13:15:00-000, 4166, 1264, 2902, 1, 1355.00, 1, 1354.00, 4164
8, 13:16:00-000, 4611, 2435, 2176, 2, 1351.00, 1, 1350.00, 4608
8, 13:17:00-000, 2629, 133, 2496, 0, 0.00, 1, 1347.00, 1741
8, 13:18:00-000, 705, 404, 301, 0, 0.00, 0, 0.00, 1592
8, 13:19:00-000, 3244, 588, 2656, 3, 1352.00, 3, 1351.00, 3238
8, 13:20:00-000, 3349, 1883, 1466, 0, 0.00, 0, 0.00, 3349
8, 13:21:00-000, 4530, 2772, 1758, 10, 1349.20, 10, 1350.80, 2991
8, 13:22:00-000, 4074, 3914, 160, 14, 1351.00, 14, 1352.00, 5565
8, 13:23:00-000, 5231, 4135, 1096, 3, 1352.00, 3, 1350.00, 5225
8, 13:25:00-000, 69, 9, 60, 0, 0.00, 0, 0.00, 69
8, 13:26:00-000, 782, 781, 1, 1, 1350.00, 1, 1352.00, 780
8, 13:27:00-000, 3190, 749, 2441, 5, 1349.80, 5, 1350.60, 3180
8, 13:28:00-000, 2816, 1559, 1257, 5, 1348.20, 5, 1349.40, 2806
8, 13:29:00-000, 1440, 1430, 10, 0, 0.00, 0, 0.00, 1430
8, 13:30:00-000, 3543, 485, 3058, 13, 1350.46, 13, 1350.77, 3527
8, 13:31:00-000, 3663, 2932, 731, 89, 1351.26, 31, 1351.48, 3183
8, 13:32:00-000, 1614, 1253, 361, 3, 1354.00, 61, 1348.37, 1910
8, 13:33:00-000, 3672, 2033, 1639, 0, 0.00, 0, 0.00, 3672
8, 13:34:00-000, 8824, 2922, 5902, 2, 1350.00, 2, 1351.00, 8820
8, 13:36:00-000, 5908, 4178, 1730, 2, 1354.50, 2, 1350.00, 5904
8, 13:37:00-000, 3868, 1241, 2627, 5, 1348.00, 5, 1348.00, 3849
8, 13:38:00-000, 2696, 2243, 453, 35, 1350.03, 35, 1347.25, 2635
8, 13:39:00-000, 136, 97, 39, 0, 0.00, 0, 0.00, 136
8, 13:40:00-000, 8730, 3463, 5267, 3, 1347.00, 3, 1349.67, 8724
8, 13:41:00-000, 1659, 1644, 15, 4, 1351.00, 4, 1351.00, 1651
8, 13:42:00-000, 6038, 2602, 3436, 9, 1351.89, 9, 1349.56, 6020
8, 13:43:00-000, 5221, 1577, 3644, 6, 1349.17, 6, 1350.67, 4945
8, 13:44:00-000, 4344, 238, 4106, 15, 1347.26, 15, 1349.73, 4578
8, 13:45:00-000, 10175, 4552, 5623, 5, 1350.60, 5, 1350.40, 10165
8, 13:46:00-000, 6620, 3000, 3620, 6, 1349.50, 5, 1351.60, 6509
8, 13:47:00-000, 6897, 1452, 5445, 2, 1352.00, 2, 1348.50, 6902
8, 13:48:00-000, 1981, 152, 1829, 5, 1356.00, 6, 1350.67, 2061
8, 13:49:00-000, 2410, 26, 2384, 4, 1348.00, 4, 1348.00, 2402
8, 13:50:00-000, 2592, 2580, 12, 0, 0.00, 0, 0.00, 2592
8, 13:51:00-000, 2401, 2073, 328, 0, 0.00, 0, 0.00, 987
8, 13:52:00-000, 2457, 313, 2144, 6, 1352.00, 6, 1351.00, 3859
8, 13:53:00-000, 3011, 219, 2792, 1, 1348.00, 1, 1353.00, 3009
8, 13:54:00-000, 1236, 851, 385, 1, 1348.00, 1, 1351.00, 1234
8, 13:55:00-000, 3638, 360, 3278, 0, 0.00, 1, 1352.00, 3637
8, 13:56:00-000, 121, 81, 40, 9, 1350.11, 8, 1353.00, 104
8, 13:57:00-000, 3006, 1683, 1323, 0, 0.00, 0, 0.00, 3006
8, 13:58:00-000, 6540, 2619, 3921, 5, 1350.00, 5, 1350.20, 6530
8, 13:59:00-000, 1697, 1546, 151, 0, 0.00, 0, 0.00, 1697
8, 14:00:00-000, 2312, 1810, 502, 0, 0.00, 0, 0.00, 2242
8, 14:01:00-000, 8045, 3385, 4660, 10, 1346.30, 10, 1348.10, 8095
8, 14:02:00-000, 7031, 3649, 3382, 2, 1350.50, 2, 1350.00, 7027
8, 14:03:00-000, 1405, 277, 1128, 7, 1347.57, 7, 1347.71, 1391
8, 14:04:00-000, 3462, 2159, 1303, 1, 1348.00, 1, 1351.00, 3460
8, 14:05:00-000, 6059, 3457, 2602, 19, 1347.00, 19, 1348.42, 6021
8, 14:06:00-000, 8413, 5365, 3048, 4, 1350.75, 5, 1350.80, 8404
8, 14:07:00-000, 5832, 3794, 2038, 9, 1350.89, 8, 1352.00, 5095
8, 14:08:00-000, 115, 92, 23, 14, 1353.57, 14, 1352.57, 807
8, 14:09:00-000, 1513, 127, 1386, 0, 0.00, 0, 0.00, 1513
8, 14:12:00-000, 348, 254, 94, 1, 1349.00, 1, 1352.00, 346
8, 14:13:00-000, 9362, 5064, 4298, 2, 1353.00, 2, 1351.00, 8800
8, 14:14:00-000, 3197, 1605, 1592, 0, 0.00, 0, 0.00, 3734
8, 14:15:00-000, 5212, 3342, 1870, 3, 1345.00, 3, 1346.00, 5208
8, 14:16:00-000, 1732, 258, 1474, 12, 1347.67, 12, 1347.66, 1727
8, 14:17:00-000, 1310, 71, 1239, 0, 0.00, 0, 0.00, 1199
8, 14:18:00-000, 1308, 853, 455, 3, 1352.00, 3, 1351.00, 1413
8, 14:19:00-000, 9130, 5052, 4078, 2, 1350.00, 2, 1351.00, 8389
8, 14:20:00-000, 328, 90, 238, 5, 1349.00, 5, 1347.40, 988
8, 14:21:00-000, 4859, 3089, 1770, 1, 1348.00, 1, 1347.00, 4924
8, 14:22:00-000, 3489, 1023, 2466, 7, 1349.00, 5, 1347.00, 3477
8, 14:23:00-000, 1746, 1004, 742, 3, 1352.33, 5, 1348.20, 1738
8, 14:24:00-000, 95, 5, 90, 1, 1350.00, 0, 0.00, 94
8, 14:25:00-000, 220, 69, 151, 0, 0.00, 1, 1349.00, 219
8, 14:26:00-000, 7446, 4012, 3434, 28, 1348.00, 23, 1347.00, 7395
8, 14:27:00-000, 2334, 893, 1441, 0, 0.00, 5, 1347.60, 2329
8, 14:28:00-000, 2282, 141, 2141, 7, 1348.00, 7, 1349.86, 2268
8, 14:29:00-000, 3829, 319, 3510, 0, 0.00, 0, 0.00, 3641
8, 14:30:00-000, 3816, 1853, 1963, 23, 1350.43, 20, 1349.65, 3961
8, 14:31:00-000, 176, 10, 166, 4, 1346.00, 7, 1349.00, 165
8, 14:32:00-000, 2633, 295, 2338, 37, 1355.38, 37, 1352.00, 2550
8, 14:33:00-000, 3889, 1934, 1955, 24, 1348.66, 24, 1347.29, 3850
8, 14:34:00-000, 7455, 4227, 3228, 4, 1354.00, 4, 1351.00, 6061
8, 14:35:00-000, 5409, 4399, 1010, 8, 1353.62, 8, 1354.00, 6779
8, 14:36:00-000, 1117, 985, 132, 7, 1351.29, 7, 1352.43, 1103
8, 14:37:00-000, 8098, 3324, 4774, 1, 1349.00, 1, 1349.00, 8096
8, 14:38:00-000, 1054, 250, 804, 48, 1352.04, 48, 1350.87, 958
8, 14:39:00-000, 2273, 2165, 108, 0, 0.00, 0, 0.00, 2273
8, 14:40:00-000, 3942, 2587, 1355, 0, 0.00, 0, 0.00, 3942
8, 14:41:00-000, 3034, 1307, 1727, 0, 0.00, 0, 0.00, 3034
8, 14:42:00-000, 8207, 942, 7265, 4, 1349.50, 8, 1349.88, 8195
8, 14:43:00-000, 1738, 1724, 14, 4, 1350.00, 0, 0.00, 1734
8, 14:44:00-000, 1916, 177, 1739, 3, 1349.00, 3, 1351.00, 1832
8, 14:45:00-000, 2574, 1899, 675, 2, 1352.00, 2, 1351.00, 2572
8, 14:46:00-000, 5331, 5053, 278, 14, 1351.21, 14, 1350.00, 5379
8, 14:47:00-000, 4221, 641, 3580, 9, 1347.67, 7, 1350.29, 4205
8, 14:48:00-000, 5649, 3849, 1800, 11, 1349.18, 7, 1349.71, 5631
8, 14:49:00-000, 1861, 1713, 148, 2, 1348.00, 8, 1347.25, 1851
8, 14:50:00-000, 6849, 2073, 4776, 7, 1351.43, 7, 1350.71, 6835
8, 14:51:00-000, 2697, 1039, 1658, 0, 0.00, 0, 0.00, 2697
8, 14:52:00-000, 931, 26, 905, 5, 1349.00, 5, 1344.00, 768
8, 14:53:00-000, 2027, 1479, 548, 1, 1351.00, 1, 1351.00, 2178
8, 14:54:00-000, 5418, 1604, 3814, 14, 1349.36, 14, 1351.07, 5389
8, 14:55:00-000, 2120, 872, 1248, 0, 0.00, 0, 0.00, 2121
8, 14:56:00-000, 1697, 1587, 110, 9, 1350.44, 9, 1351.44, 1679
8, 14:57:00-000, 1086, 16, 1070, 9, 1351.22, 9, 1353.00, 1068
8, 14:58:00-000, 2513, 1312, 1201, 11, 1348.27, 11, 1346.73, 2491
8, 14:59:00-000, 1623, 1258, 365, 6, 1351.67, 6, 1352.00, 1611
8, 15:00:00-000, 3948, 1597, 2351, 1, 1347.00, 1, 1351.00, 3946
8, 15:01:00-000, 6531, 3890, 2641, 0, 0.00, 0, 0.00, 6531
8, 15:02:00-000, 2453, 1131, 1322, 5, 1349.80, 1, 1350.00, 2447
8, 15:03:00-000, 2575, 175, 2400, 6, 1350.00, 10, 1348.70, 2559
8, 15:04:00-000, 3024, 2820, 204, 0, 0.00, 0, 0.00, 3024
8, 15:05:00-000, 982, 397, 585, 2, 1351.50, 2, 1352.50, 978
8, 15:06:00-000, 5082, 2774, 2308, 3, 1347.67, 1, 1353.00, 5078
8, 15:07:00-000, 4477, 523, 3954, 2, 1349.00, 2, 1353.00, 4473
8, 15:08:00-000, 1536, 33, 1503, 1, 1345.00, 3, 1348.00, 1532
8, 15:09:00-000, 3977, 1511, 2466, 14, 1348.14, 14, 1348.36, 3949
8, 15:10:00-000, 1564, 68, 1496, 1, 1355.00, 1, 1352.00, 1562
8, 15:11:00-000, 851, 850, 1, 0, 0.00, 0, 0.00, 851
8, 15:13:00-000, 874, 62, 812, 4, 1349.00, 4, 1353.50, 866
8, 15:14:00-000, 1132, 258, 874, 0, 0.00, 0, 0.00, 1132
8, 15:15:00-000, 5075, 2810, 2265, 1, 1351.00, 1, 1351.00, 5073
8, 15:16:00-000, 2825, 981, 1844, 8, 1349.00, 4, 1350.00, 2024
8, 15:17:00-000, 10338, 4865, 5473, 2, 1355.00, 6, 1349.33, 11119
8, 15:18:00-000, 2185, 1717, 468, 1, 1348.00, 1, 1355.00, 2175
8, 15:19:00-000, 4010, 2850, 1160, 5, 1351.80, 5, 1352.20, 4008
8, 15:21:00-000, 810, 0, 810, 0, 0.00, 0, 0.00, 810
8, 15:22:00-000, 1249, 1023, 226, 9, 1348.89, 9, 1349.67, 1231
8, 15:23:00-000, 1163, 860, 303, 10, 1353.60, 10, 1352.20, 1143
8, 15:24:00-000, 3282, 2265, 1017, 20, 1350.40, 20, 1349.50, 3242
8, 15:25:00-000, 2119, 1703, 416, 0, 0.00, 0, 0.00, 1966
8, 15:26:00-000, 5198, 3809, 1389, 4, 1353.50, 4, 1350.00, 5322
8, 15:27:00-000, 3180, 2980, 200, 7, 1354.86, 7, 1351.00, 3187
8, 15:28:00-000, 3545, 1418, 2127, 0, 0.00, 0, 0.00, 3545
8, 15:29:00-000, 2651, 1740, 911, 4, 1350.50, 4, 1349.50, 2643
8, 15:30:00-000, 1848, 182, 1666, 0, 0.00, 0, 0.00, 1752
8, 15:31:00-000, 4242, 2400, 1842, 1, 1348.00, 0, 0.00, 4337
8, 15:32:00-000, 103, 5, 98, 5, 1350.00, 6, 1347.67, 92
8, 15:34:00-000, 6275, 2827, 3448, 7, 1348.00, 7, 1352.43, 6261
8, 15:35:00-000, 796, 88, 708, 0, 0.00, 0, 0.00, 0
8, 15:36:00-000, 2045, 1008, 1037, 1, 1349.00, 1, 1350.00, 2839
8, 15:37:00-000, 3697, 2663, 1034, 1, 1351.00, 1, 1350.00, 3695
8, 15:38:00-000, 21, 20, 1, 0, 0.00, 0, 0.00, 21
8, 15:39:00-000, 187, 93, 94, 1, 1349.00, 1, 1349.00, 185
8, 15:43:00-000, 549, 173, 376, 0, 0.00, 1, 1350.00, 548
8, 15:44:00-000, 2026, 214, 1812, 4, 1350.50, 3, 1350.33, 2019
8, 15:45:00-000, 1723, 1635, 88, 13, 1348.00, 13, 1346.61, 1697
8, 15:48:00-000, 303, 3, 300, 0, 0.00, 0, 0.00, 303
8, 15:50:00-000, 1234, 94, 1140, 0, 0.00, 0, 0.00, 1234
8, 15:51:00-000, 2315, 737, 1578, 0, 0.00, 0, 0.00, 2215
8, 15:52:00-000, 0, 0, 0, 0, 0.00, 0, 0.00, 100
8, 15:53:00-000, 1515, 5, 1510, 0, 0.00, 0, 0.00, 1515
8, 15:55:00-000, 2600, 813, 1787, 5, 1351.20, 5, 1353.00, 2590
8, 15:56:00-000, 1117, 337, 780, 6, 1352.83, 6, 1351.00, 1105
8, 15:57:00-000, 987, 922, 65, 3, 1348.00, 3, 1349.00, 981
8, 15:58:00-000, 911, 717, 194, 1, 1348.00, 1, 1348.00, 909
8, 15:59:00-000, 36, 6, 30, 0, 0.00, 0, 0.00, 36
8, 16:01:00-000, 178, 95, 83, 1, 1349.00, 1, 1352.00, 94
8, 16:02:00-000, 0, 0, 0, 0, 0.00, 0, 0.00, 82
8, 16:03:00-000, 1568, 1560, 8, 0, 0.00, 0, 0.00, 1568
8, 16:04:00-000, 84, 81, 3, 1, 1351.00, 1, 1352.00, 82
8, 16:05:00-000, 1264, 24, 1240, 0, 0.00, 0, 0.00, 1264
8, 16:06:00-000, 959, 11, 948, 8, 1348.00, 4, 1348.75, 947
8, 16:07:00-000, 4, 0, 4, 0, 0.00, 4, 1346.75, 0
8, 16:08:00-000, 2214, 4, 2210, 0, 0.00, 0, 0.00, 2214
8, 16:09:00-000, 187, 25, 162, 1, 1347.00, 1, 1348.00, 185
8, 16:10:00-000, 1848, 1703, 145, 3, 1352.00, 3, 1352.00, 1842
8, 16:11:00-000, 2877, 1907, 970, 8, 1351.50, 8, 1351.63, 2849
8, 16:12:00-000, 4511, 3905, 606, 12, 1351.25, 12, 1349.50, 4499
8, 16:13:00-000, 2044, 1830, 214, 9, 1352.44, 9, 1351.00, 2026
8, 16:14:00-000, 4552, 2984, 1568, 0, 0.00, 0, 0.00, 4552
8, 16:15:00-000, 687, 385, 302, 0, 0.00, 0, 0.00, 687
8, 16:16:00-000, 5078, 1858, 3220, 0, 0.00, 0, 0.00, 5078
8, 16:18:00-000, 1692, 1505, 187, 4, 1351.75, 6, 1349.17, 1682
8, 16:19:00-000, 5033, 1208, 3825, 12, 1349.33, 8, 1352.00, 4913
8, 16:20:00-000, 1080, 564, 516, 1, 1351.00, 3, 1347.67, 1176
8, 16:21:00-000, 3454, 1757, 1697, 0, 0.00, 0, 0.00, 3377
8, 16:22:00-000, 6338, 3534, 2804, 8, 1349.25, 8, 1346.75, 6399
8, 16:23:00-000, 4173, 3273, 900, 5, 1356.00, 5, 1351.00, 4163
8, 16:24:00-000, 1522, 1455, 67, 39, 1351.30, 39, 1350.10, 1444
8, 16:25:00-000, 4940, 3001, 1939, 0, 0.00, 0, 0.00, 4934
8, 16:26:00-000, 1976, 168, 1808, 2, 1353.00, 2, 1352.00, 1978
8, 16:27:00-000, 5276, 4657, 619, 0, 0.00, 0, 0.00, 5276
8, 16:28:00-000, 2850, 1053, 1797, 1, 1348.00, 1, 1352.00, 2848
8, 16:29:00-000, 3486, 2432, 1054, 7, 1352.00, 7, 1351.71, 3472
