TraderType,Time,EnterQty,BuyEnterQty,SellEnterQty,BuyExecutedQty,BuyExecutedPx,SellExecutedQty,SellExecutedPx,CanceledQty
1, 09:06:00-000, 3020, 3020, 0, 904, 1347.91, 0, 0.00, 0
1, 09:07:00-000, 0, 0, 0, 0, 0.00, 0, 0.00, 2107
1, 09:08:00-000, 0, 0, 0, 0, 0.00, 0, 0.00, 9
1, 09:13:00-000, 3139, 2235, 904, 901, 1348.64, 904, 1348.40, 0
1, 09:14:00-000, 9, 9, 0, 0, 0.00, 0, 0.00, 1334
1, 09:15:00-000, 9, 8, 1, 2, 1353.50, 1, 1354.00, 8
1, 09:16:00-000, 226, 180, 46, 21, 1347.28, 46, 1364.43, 24
1, 09:17:00-000, 224, 175, 49, 44, 1353.04, 49, 1361.66, 118
1, 09:18:00-000, 629, 434, 195, 196, 1350.11, 193, 1352.59, 176
1, 09:19:00-000, 388, 257, 131, 163, 1348.91, 133, 1349.08, 173
1, 09:20:00-000, 713, 514, 199, 290, 1348.47, 199, 1348.43, 203
1, 09:21:00-000, 405, 299, 106, 137, 1349.22, 106, 1349.04, 152
1, 09:22:00-000, 585, 377, 208, 235, 1348.38, 208, 1348.52, 154
1, 09:23:00-000, 251, 181, 70, 103, 1348.93, 70, 1349.46, 146
1, 09:24:00-000, 520, 357, 163, 188, 1348.33, 163, 1351.21, 92
1, 09:25:00-000, 281, 187, 94, 35, 1349.94, 94, 1385.85, 149
1, 09:26:00-000, 676, 458, 218, 241, 1348.94, 217, 1351.58, 214
1, 09:27:00-000, 290, 214, 76, 78, 1348.33, 76, 1348.19, 168
1, 09:28:00-000, 700, 385, 315, 223, 1348.06, 315, 1348.09, 155
1, 09:29:00-000, 269, 167, 102, 123, 1347.76, 102, 1348.12, 107
1, 09:30:00-000, 614, 385, 229, 268, 1347.46, 229, 1346.77, 71
1, 09:31:00-000, 327, 234, 93, 106, 1348.29, 93, 1348.14, 127
1, 09:32:00-000, 594, 415, 179, 236, 1348.53, 179, 1348.41, 142
1, 09:33:00-000, 331, 224, 107, 134, 1347.94, 107, 1347.64, 140
1, 09:34:00-000, 568, 346, 222, 181, 1348.40, 222, 1348.91, 169
1, 09:35:00-000, 319, 199, 120, 128, 1347.68, 120, 1347.09, 98
1, 09:36:00-000, 611, 346, 265, 242, 1347.55, 265, 1347.77, 123
1, 09:37:00-000, 256, 154, 102, 102, 1347.97, 102, 1347.99, 54
1, 09:38:00-000, 635, 394, 241, 230, 1348.33, 238, 1348.54, 101
1, 09:39:00-000, 320, 206, 114, 126, 1347.44, 117, 1346.71, 116
1, 09:40:00-000, 602, 382, 220, 211, 1348.31, 220, 1348.13, 155
1, 09:41:00-000, 316, 197, 119, 124, 1347.81, 119, 1348.13, 94
1, 09:42:00-000, 590, 381, 209, 175, 1349.02, 209, 1348.80, 127
1, 09:43:00-000, 360, 259, 101, 119, 1347.32, 101, 1347.61, 161
1, 09:44:00-000, 570, 369, 201, 229, 1349.61, 201, 1349.38, 168
1, 09:45:00-000, 311, 183, 128, 119, 1348.62, 128, 1347.80, 92
1, 09:46:00-000, 599, 384, 215, 267, 1348.12, 215, 1347.97, 103
1, 09:47:00-000, 286, 169, 117, 119, 1348.03, 117, 1347.00, 96
1, 09:48:00-000, 615, 385, 230, 218, 1348.62, 230, 1348.55, 88
1, 09:49:00-000, 379, 268, 111, 130, 1349.60, 111, 1348.83, 115
1, 09:50:00-000, 533, 330, 203, 247, 1348.33, 203, 1348.44, 143
1, 09:51:00-000, 286, 162, 124, 114, 1348.02, 124, 1349.01, 83
1, 09:52:00-000, 633, 414, 219, 252, 1349.18, 219, 1349.35, 86
1, 09:53:00-000, 275, 153, 122, 124, 1348.17, 122, 1347.91, 93
1, 09:54:00-000, 650, 415, 235, 274, 1348.47, 235, 1348.71, 102
1, 09:55:00-000, 323, 196, 127, 133, 1348.36, 127, 1348.93, 97
1, 09:56:00-000, 653, 380, 273, 265, 1348.14, 273, 1347.87, 115
1, 09:57:00-000, 285, 170, 115, 110, 1348.47, 115, 1347.09, 72
1, 09:58:00-000, 583, 365, 218, 179, 1348.67, 215, 1348.35, 107
1, 09:59:00-000, 329, 171, 158, 150, 1347.18, 161, 1346.21, 108
1, 10:00:00-000, 624, 373, 251, 248, 1347.51, 251, 1347.39, 71
1, 10:01:00-000, 308, 162, 146, 111, 1347.88, 146, 1347.99, 93
1, 10:02:00-000, 627, 396, 231, 205, 1348.92, 231, 1348.53, 73
1, 10:03:00-000, 262, 170, 92, 111, 1349.50, 92, 1349.54, 167
1, 10:04:00-000, 628, 381, 247, 260, 1348.99, 247, 1348.31, 80
1, 10:05:00-000, 277, 152, 125, 122, 1347.86, 125, 1347.37, 88
1, 10:06:00-000, 627, 375, 252, 239, 1348.12, 252, 1347.69, 85
1, 10:07:00-000, 301, 179, 122, 113, 1348.82, 122, 1348.56, 106
1, 10:08:00-000, 570, 339, 231, 192, 1348.90, 231, 1348.36, 94
1, 10:09:00-000, 254, 162, 92, 74, 1348.72, 92, 1348.08, 124
1, 10:10:00-000, 637, 374, 263, 254, 1347.94, 263, 1347.48, 97
1, 10:11:00-000, 275, 186, 89, 140, 1348.51, 89, 1347.49, 97
1, 10:12:00-000, 627, 386, 241, 261, 1347.58, 241, 1347.37, 74
1, 10:13:00-000, 312, 195, 117, 145, 1347.91, 117, 1347.42, 89
1, 10:14:00-000, 685, 428, 257, 285, 1347.81, 257, 1347.36, 93
1, 10:15:00-000, 336, 218, 118, 120, 1347.57, 118, 1347.19, 100
1, 10:16:00-000, 549, 293, 256, 209, 1348.40, 256, 1347.29, 136
1, 10:17:00-000, 267, 167, 100, 107, 1348.52, 100, 1347.95, 74
1, 10:18:00-000, 594, 341, 253, 230, 1348.13, 253, 1347.97, 79
1, 10:19:00-000, 319, 189, 130, 117, 1347.26, 130, 1347.55, 80
1, 10:20:00-000, 655, 425, 230, 272, 1347.93, 230, 1347.78, 90
1, 10:21:00-000, 325, 205, 120, 113, 1349.13, 120, 1348.46, 125
1, 10:22:00-000, 616, 387, 229, 243, 1348.26, 229, 1348.29, 155
1, 10:23:00-000, 387, 235, 152, 144, 1348.16, 152, 1348.53, 100
1, 10:24:00-000, 625, 407, 218, 246, 1348.17, 218, 1347.64, 122
1, 10:25:00-000, 294, 195, 99, 118, 1348.70, 99, 1348.13, 129
1, 10:26:00-000, 504, 293, 211, 201, 1347.80, 211, 1347.83, 65
1, 10:27:00-000, 302, 183, 119, 115, 1348.62, 119, 1348.75, 93
1, 10:28:00-000, 669, 425, 244, 251, 1348.45, 244, 1348.00, 104
1, 10:29:00-000, 321, 209, 112, 135, 1348.56, 112, 1347.89, 131
1, 10:30:00-000, 667, 437, 230, 289, 1348.19, 230, 1347.95, 119
1, 10:31:00-000, 331, 199, 132, 104, 1348.46, 132, 1348.10, 113
1, 10:32:00-000, 582, 348, 234, 255, 1348.24, 234, 1347.92, 90
1, 10:33:00-000, 268, 148, 120, 43, 1348.27, 120, 1349.02, 109
1, 10:34:00-000, 748, 420, 328, 310, 1348.02, 328, 1347.82, 101
1, 10:35:00-000, 277, 187, 90, 114, 1348.23, 90, 1347.94, 115
1, 10:36:00-000, 627, 362, 265, 228, 1348.49, 265, 1348.52, 93
1, 10:37:00-000, 292, 162, 130, 124, 1346.88, 130, 1347.37, 93
1, 10:38:00-000, 540, 336, 204, 200, 1347.90, 204, 1347.28, 71
1, 10:39:00-000, 292, 168, 124, 108, 1348.15, 124, 1347.67, 102
1, 10:40:00-000, 648, 416, 232, 251, 1347.39, 232, 1347.17, 136
1, 10:41:00-000, 268, 155, 113, 111, 1347.19, 113, 1347.18, 107
1, 10:42:00-000, 632, 394, 238, 242, 1348.14, 238, 1347.66, 81
1, 10:43:00-000, 337, 206, 131, 110, 1348.93, 131, 1347.83, 117
1, 10:44:00-000, 608, 377, 231, 283, 1347.87, 231, 1347.30, 120
1, 10:45:00-000, 298, 179, 119, 97, 1348.11, 119, 1347.70, 67
1, 10:46:00-000, 601, 395, 206, 263, 1348.04, 206, 1346.99, 104
1, 10:47:00-000, 290, 154, 136, 122, 1346.82, 136, 1346.41, 87
1, 10:48:00-000, 599, 378, 221, 247, 1348.70, 221, 1347.69, 80
1, 10:49:00-000, 305, 199, 106, 115, 1348.61, 106, 1347.75, 108
1, 10:50:00-000, 563, 329, 234, 232, 1348.81, 234, 1348.43, 95
1, 10:51:00-000, 283, 156, 127, 125, 1347.68, 127, 1346.72, 71
1, 10:52:00-000, 629, 361, 268, 287, 1347.86, 264, 1346.86, 50
1, 10:53:00-000, 283, 151, 132, 111, 1348.00, 136, 1346.79, 71
1, 10:54:00-000, 689, 409, 280, 275, 1348.05, 280, 1347.01, 72
1, 10:55:00-000, 338, 215, 123, 125, 1348.66, 121, 1348.23, 87
1, 10:56:00-000, 612, 347, 265, 254, 1348.31, 267, 1347.51, 96
1, 10:57:00-000, 261, 162, 99, 86, 1349.08, 99, 1348.42, 100
1, 10:58:00-000, 534, 262, 272, 233, 1347.55, 268, 1346.96, 48
1, 10:59:00-000, 286, 145, 141, 135, 1346.04, 145, 1345.51, 51
1, 11:00:00-000, 626, 415, 211, 278, 1348.17, 211, 1346.97, 43
1, 11:01:00-000, 306, 186, 120, 153, 1348.01, 120, 1347.56, 90
1, 11:02:00-000, 613, 360, 253, 290, 1347.74, 253, 1345.96, 64
1, 11:03:00-000, 333, 184, 149, 134, 1346.87, 149, 1346.50, 49
1, 11:04:00-000, 560, 334, 226, 200, 1348.11, 226, 1347.61, 91
1, 11:05:00-000, 279, 166, 113, 119, 1347.50, 113, 1346.90, 70
1, 11:06:00-000, 677, 355, 322, 268, 1348.45, 322, 1347.30, 72
1, 11:07:00-000, 311, 166, 145, 127, 1346.79, 145, 1346.37, 87
1, 11:08:00-000, 618, 368, 250, 265, 1347.48, 250, 1347.28, 78
1, 11:09:00-000, 318, 192, 126, 155, 1348.49, 123, 1347.57, 68
1, 11:10:00-000, 559, 346, 213, 258, 1348.47, 216, 1347.74, 54
1, 11:11:00-000, 336, 203, 133, 117, 1347.63, 133, 1347.73, 73
1, 11:12:00-000, 680, 371, 309, 275, 1347.92, 309, 1347.57, 92
1, 11:13:00-000, 364, 224, 140, 144, 1348.97, 140, 1348.06, 97
1, 11:14:00-000, 590, 360, 230, 241, 1347.83, 230, 1347.72, 99
1, 11:15:00-000, 283, 171, 112, 91, 1347.24, 112, 1347.79, 88
1, 11:16:00-000, 678, 411, 267, 242, 1348.70, 267, 1347.94, 136
1, 11:17:00-000, 273, 164, 109, 70, 1347.49, 109, 1348.53, 121
1, 11:18:00-000, 589, 354, 235, 257, 1347.85, 235, 1347.60, 99
1, 11:19:00-000, 314, 205, 109, 134, 1348.31, 109, 1347.90, 78
1, 11:20:00-000, 671, 355, 316, 274, 1348.08, 316, 1347.13, 96
1, 11:21:00-000, 316, 183, 133, 101, 1348.58, 133, 1347.47, 75
1, 11:22:00-000, 645, 472, 173, 270, 1348.17, 173, 1347.24, 109
1, 11:23:00-000, 268, 174, 94, 124, 1347.96, 94, 1348.12, 136
1, 11:24:00-000, 626, 373, 253, 250, 1348.40, 253, 1348.13, 88
1, 11:25:00-000, 339, 166, 173, 131, 1347.45, 173, 1347.00, 90
1, 11:26:00-000, 554, 308, 246, 223, 1347.88, 246, 1347.35, 75
1, 11:27:00-000, 255, 133, 122, 101, 1348.25, 122, 1348.32, 65
1, 11:28:00-000, 644, 371, 273, 240, 1348.05, 273, 1347.98, 65
1, 11:29:00-000, 275, 157, 118, 101, 1348.25, 118, 1347.67, 92
1, 11:30:00-000, 662, 400, 262, 271, 1347.80, 262, 1346.92, 88
1, 11:31:00-000, 356, 194, 162, 152, 1347.04, 162, 1346.29, 92
1, 11:32:00-000, 625, 396, 229, 286, 1348.27, 229, 1347.19, 86
1, 11:33:00-000, 279, 176, 103, 122, 1347.70, 103, 1347.38, 80
1, 11:34:00-000, 502, 341, 161, 182, 1348.68, 161, 1347.84, 72
1, 11:35:00-000, 303, 194, 109, 152, 1348.76, 109, 1348.22, 85
1, 11:36:00-000, 656, 379, 277, 263, 1347.11, 277, 1346.78, 97
1, 11:37:00-000, 326, 210, 116, 140, 1348.93, 116, 1347.50, 109
1, 11:38:00-000, 626, 330, 296, 246, 1348.07, 296, 1347.99, 66
1, 11:39:00-000, 343, 206, 137, 140, 1348.36, 137, 1347.66, 79
1, 11:40:00-000, 581, 369, 212, 216, 1348.25, 212, 1347.92, 119
1, 11:41:00-000, 375, 169, 206, 153, 1347.10, 206, 1346.48, 79
1, 11:42:00-000, 618, 351, 267, 239, 1347.89, 267, 1346.77, 63
1, 11:43:00-000, 308, 220, 88, 137, 1348.67, 88, 1347.28, 103
1, 11:44:00-000, 672, 394, 278, 292, 1347.90, 278, 1347.31, 92
1, 11:45:00-000, 267, 184, 83, 119, 1348.45, 83, 1347.29, 98
1, 11:46:00-000, 632, 411, 221, 232, 1347.86, 221, 1347.18, 76
1, 11:47:00-000, 339, 171, 168, 130, 1348.01, 168, 1348.36, 133
1, 11:48:00-000, 688, 428, 260, 302, 1348.15, 260, 1347.86, 93
1, 11:49:00-000, 315, 212, 103, 123, 1348.51, 103, 1347.49, 101
1, 11:50:00-000, 681, 404, 277, 266, 1348.10, 277, 1347.22, 132
1, 11:51:00-000, 277, 171, 106, 107, 1348.02, 106, 1347.20, 101
1, 11:52:00-000, 603, 354, 249, 247, 1347.66, 249, 1347.06, 71
1, 11:53:00-000, 359, 183, 176, 164, 1347.70, 176, 1347.18, 84
1, 11:54:00-000, 683, 427, 256, 265, 1347.57, 256, 1346.86, 61
1, 11:55:00-000, 284, 160, 124, 129, 1348.00, 124, 1347.87, 106
1, 11:56:00-000, 564, 346, 218, 222, 1348.51, 218, 1347.68, 89
1, 11:57:00-000, 366, 207, 159, 143, 1347.46, 159, 1346.12, 92
1, 11:58:00-000, 611, 367, 244, 242, 1348.35, 244, 1348.13, 77
1, 11:59:00-000, 271, 147, 124, 112, 1346.91, 124, 1346.72, 88
1, 12:00:00-000, 629, 359, 270, 289, 1348.32, 270, 1347.69, 82
1, 12:01:00-000, 316, 178, 138, 107, 1348.14, 138, 1347.45, 58
1, 12:02:00-000, 646, 405, 241, 270, 1348.94, 241, 1348.18, 81
1, 12:03:00-000, 285, 158, 127, 141, 1347.93, 127, 1347.42, 90
1, 12:04:00-000, 557, 320, 237, 213, 1348.13, 237, 1347.96, 67
1, 12:05:00-000, 309, 149, 160, 112, 1346.94, 160, 1347.28, 77
1, 12:06:00-000, 622, 331, 291, 273, 1348.21, 291, 1346.85, 29
1, 12:07:00-000, 303, 195, 108, 146, 1347.48, 108, 1347.02, 57
1, 12:08:00-000, 633, 394, 239, 279, 1348.37, 239, 1347.32, 70
1, 12:09:00-000, 271, 180, 91, 96, 1348.65, 91, 1348.42, 108
1, 12:10:00-000, 611, 346, 265, 281, 1347.71, 265, 1347.26, 90
1, 12:11:00-000, 275, 165, 110, 107, 1347.91, 110, 1347.42, 66
1, 12:12:00-000, 605, 313, 292, 268, 1347.85, 292, 1347.29, 58
1, 12:13:00-000, 292, 192, 100, 129, 1348.76, 100, 1348.11, 48
1, 12:14:00-000, 601, 297, 304, 260, 1346.84, 304, 1346.70, 59
1, 12:15:00-000, 297, 158, 139, 121, 1346.11, 139, 1345.09, 30
1, 12:16:00-000, 679, 422, 257, 252, 1348.61, 257, 1347.74, 73
1, 12:17:00-000, 301, 179, 122, 133, 1347.43, 122, 1347.44, 113
1, 12:18:00-000, 511, 309, 202, 185, 1347.74, 202, 1347.17, 109
1, 12:19:00-000, 324, 148, 176, 140, 1347.05, 176, 1345.65, 67
1, 12:20:00-000, 645, 401, 244, 178, 1348.33, 244, 1347.20, 97
1, 12:21:00-000, 288, 160, 128, 84, 1348.59, 128, 1347.52, 148
1, 12:22:00-000, 575, 308, 267, 210, 1348.01, 267, 1347.06, 100
1, 12:23:00-000, 266, 168, 98, 112, 1347.84, 98, 1347.19, 74
1, 12:24:00-000, 649, 390, 259, 228, 1348.38, 259, 1347.29, 97
1, 12:25:00-000, 314, 232, 82, 107, 1348.46, 82, 1347.79, 127
1, 12:26:00-000, 641, 403, 238, 236, 1348.00, 238, 1346.93, 174
1, 12:27:00-000, 299, 212, 87, 142, 1349.25, 87, 1348.07, 101
1, 12:28:00-000, 594, 380, 214, 245, 1347.51, 214, 1346.85, 110
1, 12:29:00-000, 319, 207, 112, 133, 1347.73, 112, 1347.37, 94
1, 12:30:00-000, 635, 424, 211, 269, 1348.17, 211, 1347.93, 133
1, 12:31:00-000, 304, 187, 117, 156, 1347.61, 117, 1347.09, 78
1, 12:32:00-000, 649, 424, 225, 304, 1349.10, 225, 1348.08, 89
1, 12:33:00-000, 279, 167, 112, 124, 1347.76, 112, 1346.98, 87
1, 12:34:00-000, 595, 317, 278, 222, 1348.28, 278, 1347.27, 78
1, 12:35:00-000, 294, 184, 110, 133, 1349.09, 110, 1347.65, 78
1, 12:36:00-000, 565, 331, 234, 217, 1348.60, 233, 1347.66, 72
1, 12:37:00-000, 280, 176, 104, 133, 1348.21, 105, 1347.63, 55
1, 12:38:00-000, 562, 296, 266, 263, 1347.78, 266, 1346.99, 50
1, 12:39:00-000, 307, 169, 138, 141, 1347.67, 138, 1347.01, 41
1, 12:40:00-000, 570, 293, 277, 209, 1348.07, 277, 1348.14, 72
1, 12:41:00-000, 305, 152, 153, 114, 1347.24, 153, 1345.78, 45
1, 12:42:00-000, 568, 336, 232, 253, 1347.65, 232, 1346.97, 68
1, 12:43:00-000, 284, 154, 130, 101, 1347.78, 130, 1346.24, 52
1, 12:44:00-000, 509, 283, 226, 214, 1348.34, 226, 1347.77, 79
1, 12:45:00-000, 280, 144, 136, 98, 1347.38, 136, 1346.70, 47
1, 12:46:00-000, 557, 309, 248, 224, 1348.22, 248, 1347.43, 61
1, 12:47:00-000, 339, 198, 141, 117, 1348.17, 141, 1348.11, 67
1, 12:48:00-000, 588, 347, 241, 225, 1347.70, 241, 1347.07, 119
1, 12:49:00-000, 360, 215, 145, 147, 1348.10, 145, 1347.59, 93
1, 12:50:00-000, 550, 341, 209, 232, 1347.71, 209, 1346.86, 94
1, 12:51:00-000, 330, 225, 105, 121, 1348.29, 105, 1347.69, 79
1, 12:52:00-000, 644, 411, 233, 258, 1348.95, 233, 1348.34, 100
1, 12:53:00-000, 255, 161, 94, 135, 1348.16, 94, 1348.57, 126
1, 12:54:00-000, 623, 366, 257, 243, 1347.62, 257, 1347.95, 69
1, 12:55:00-000, 292, 176, 116, 109, 1348.28, 116, 1347.41, 102
1, 12:56:00-000, 706, 470, 236, 298, 1348.43, 236, 1347.44, 125
1, 12:57:00-000, 316, 214, 102, 170, 1348.38, 102, 1347.47, 91
1, 12:58:00-000, 679, 445, 234, 253, 1348.56, 231, 1347.92, 122
1, 12:59:00-000, 273, 161, 112, 131, 1348.06, 115, 1347.67, 123
1, 13:00:00-000, 584, 331, 253, 264, 1347.71, 253, 1347.38, 60
1, 13:01:00-000, 284, 161, 123, 92, 1348.58, 123, 1347.10, 71
1, 13:02:00-000, 607, 311, 296, 227, 1347.55, 296, 1346.44, 63
1, 13:03:00-000, 310, 213, 97, 117, 1348.65, 97, 1347.10, 74
1, 13:04:00-000, 672, 370, 302, 324, 1347.51, 302, 1346.76, 81
1, 13:05:00-000, 363, 215, 148, 165, 1348.57, 148, 1346.22, 54
1, 13:06:00-000, 569, 310, 259, 232, 1347.65, 259, 1347.42, 89
1, 13:07:00-000, 398, 243, 155, 134, 1348.07, 155, 1347.65, 39
1, 13:08:00-000, 593, 380, 213, 233, 1348.97, 213, 1348.34, 134
1, 13:09:00-000, 295, 168, 127, 142, 1348.60, 127, 1347.81, 94
1, 13:10:00-000, 624, 309, 315, 253, 1347.32, 315, 1347.13, 87
1, 13:11:00-000, 301, 183, 118, 141, 1347.95, 118, 1346.81, 43
1, 13:12:00-000, 570, 339, 231, 220, 1347.69, 231, 1346.69, 61
1, 13:13:00-000, 286, 160, 126, 90, 1349.50, 126, 1349.84, 95
1, 13:14:00-000, 706, 392, 314, 317, 1348.21, 314, 1348.05, 73
1, 13:15:00-000, 269, 166, 103, 97, 1348.63, 103, 1347.96, 73
1, 13:16:00-000, 622, 424, 198, 283, 1348.69, 198, 1348.16, 81
1, 13:17:00-000, 351, 210, 141, 148, 1347.82, 141, 1347.40, 107
1, 13:18:00-000, 691, 423, 268, 278, 1348.22, 268, 1347.43, 90
1, 13:19:00-000, 321, 199, 122, 119, 1348.32, 122, 1348.03, 121
1, 13:20:00-000, 584, 344, 240, 277, 1348.47, 240, 1347.62, 95
1, 13:21:00-000, 284, 162, 122, 121, 1347.38, 122, 1346.28, 66
1, 13:22:00-000, 723, 446, 277, 267, 1347.85, 277, 1347.07, 71
1, 13:23:00-000, 284, 177, 107, 108, 1348.18, 107, 1348.26, 143
1, 13:24:00-000, 669, 363, 306, 312, 1347.69, 306, 1346.58, 61
1, 13:25:00-000, 304, 167, 137, 90, 1349.39, 137, 1348.62, 65
1, 13:26:00-000, 632, 403, 229, 276, 1348.13, 229, 1347.23, 93
1, 13:27:00-000, 337, 183, 154, 159, 1347.98, 154, 1348.34, 86
1, 13:28:00-000, 568, 293, 275, 186, 1347.95, 275, 1347.44, 74
1, 13:29:00-000, 314, 162, 152, 96, 1347.88, 152, 1347.60, 92
1, 13:30:00-000, 618, 361, 257, 254, 1348.39, 257, 1347.65, 73
1, 13:31:00-000, 305, 163, 142, 109, 1347.99, 142, 1347.35, 99
1, 13:32:00-000, 610, 350, 260, 278, 1347.40, 260, 1345.89, 48
1, 13:33:00-000, 281, 179, 102, 81, 1348.90, 102, 1348.32, 70
1, 13:34:00-000, 626, 375, 251, 273, 1347.91, 251, 1347.51, 106
1, 13:35:00-000, 321, 201, 120, 128, 1348.72, 119, 1348.31, 93
1, 13:36:00-000, 637, 389, 248, 257, 1348.22, 249, 1347.53, 106
1, 13:37:00-000, 298, 196, 102, 91, 1348.47, 102, 1348.17, 100
1, 13:38:00-000, 585, 367, 218, 199, 1348.61, 218, 1348.69, 98
1, 13:39:00-000, 343, 212, 131, 105, 1349.31, 131, 1349.41, 168
1, 13:40:00-000, 590, 376, 214, 244, 1348.33, 214, 1347.71, 100
1, 13:41:00-000, 265, 174, 91, 109, 1347.57, 91, 1347.33, 145
1, 13:42:00-000, 559, 327, 232, 219, 1348.11, 232, 1347.13, 75
1, 13:43:00-000, 295, 174, 121, 140, 1347.96, 121, 1347.59, 88
1, 13:44:00-000, 638, 411, 227, 239, 1348.51, 227, 1347.89, 83
1, 13:45:00-000, 344, 232, 112, 141, 1348.85, 112, 1348.56, 119
1, 13:46:00-000, 565, 331, 234, 218, 1348.35, 234, 1348.16, 108
1, 13:47:00-000, 335, 192, 143, 145, 1348.06, 143, 1347.68, 92
1, 13:48:00-000, 663, 396, 267, 302, 1347.31, 267, 1346.91, 73
1, 13:49:00-000, 305, 173, 132, 110, 1347.75, 132, 1346.63, 82
1, 13:50:00-000, 587, 363, 224, 212, 1348.28, 224, 1348.04, 84
1, 13:51:00-000, 280, 184, 96, 113, 1348.76, 96, 1348.90, 128
1, 13:52:00-000, 694, 394, 300, 246, 1348.62, 300, 1347.91, 108
1, 13:53:00-000, 370, 230, 140, 173, 1348.23, 140, 1347.22, 99
1, 13:54:00-000, 564, 357, 207, 225, 1349.59, 207, 1349.10, 93
1, 13:55:00-000, 361, 202, 159, 139, 1348.25, 159, 1348.05, 92
1, 13:56:00-000, 642, 388, 254, 306, 1347.53, 254, 1347.18, 76
1, 13:57:00-000, 251, 147, 104, 121, 1348.34, 104, 1347.92, 77
1, 13:58:00-000, 650, 391, 259, 217, 1348.59, 259, 1348.71, 87
1, 13:59:00-000, 361, 208, 153, 164, 1347.11, 152, 1347.37, 100
1, 14:00:00-000, 582, 329, 253, 251, 1347.90, 254, 1346.91, 97
1, 14:01:00-000, 309, 172, 137, 129, 1348.06, 137, 1346.77, 52
1, 14:02:00-000, 608, 384, 224, 261, 1347.88, 224, 1347.26, 65
1, 14:03:00-000, 269, 147, 122, 119, 1347.17, 122, 1346.32, 92
1, 14:04:00-000, 578, 334, 244, 250, 1347.74, 244, 1347.17, 59
1, 14:05:00-000, 313, 161, 152, 141, 1348.21, 152, 1347.41, 49
1, 14:06:00-000, 586, 355, 231, 251, 1348.51, 231, 1348.10, 46
1, 14:07:00-000, 371, 209, 162, 147, 1347.76, 162, 1347.59, 73
1, 14:08:00-000, 577, 373, 204, 208, 1348.51, 204, 1348.37, 116
1, 14:09:00-000, 311, 168, 143, 141, 1347.90, 143, 1347.00, 93
1, 14:10:00-000, 650, 374, 276, 304, 1347.72, 276, 1346.79, 70
1, 14:11:00-000, 338, 197, 141, 154, 1347.56, 141, 1346.91, 62
1, 14:12:00-000, 662, 365, 297, 296, 1347.54, 297, 1347.15, 71
1, 14:13:00-000, 361, 204, 157, 126, 1347.44, 157, 1347.21, 45
1, 14:14:00-000, 606, 330, 276, 253, 1347.52, 276, 1346.56, 78
1, 14:15:00-000, 299, 187, 112, 148, 1348.72, 112, 1347.80, 59
1, 14:16:00-000, 670, 408, 262, 280, 1348.39, 262, 1348.23, 63
1, 14:17:00-000, 303, 200, 103, 122, 1348.04, 103, 1347.02, 119
1, 14:18:00-000, 626, 308, 318, 266, 1347.36, 318, 1346.74, 78
1, 14:19:00-000, 259, 122, 137, 93, 1346.85, 137, 1346.84, 43
1, 14:20:00-000, 606, 330, 276, 274, 1347.64, 276, 1347.19, 54
1, 14:21:00-000, 341, 211, 130, 141, 1348.14, 130, 1346.89, 38
1, 14:22:00-000, 638, 385, 253, 263, 1347.73, 253, 1347.04, 70
1, 14:23:00-000, 303, 171, 132, 123, 1347.48, 132, 1346.91, 96
1, 14:24:00-000, 674, 407, 267, 281, 1348.11, 267, 1347.72, 75
1, 14:25:00-000, 342, 188, 154, 129, 1347.88, 154, 1347.45, 89
1, 14:26:00-000, 493, 280, 213, 199, 1347.78, 213, 1347.27, 118
1, 14:27:00-000, 294, 161, 133, 117, 1347.43, 133, 1346.43, 53
1, 14:28:00-000, 653, 396, 257, 236, 1348.07, 255, 1347.85, 67
1, 14:29:00-000, 295, 187, 108, 154, 1348.65, 110, 1347.64, 109
1, 14:30:00-000, 644, 373, 271, 292, 1347.70, 271, 1346.93, 51
1, 14:31:00-000, 274, 153, 121, 97, 1347.82, 121, 1347.17, 89
1, 14:32:00-000, 642, 392, 250, 277, 1348.70, 250, 1348.05, 64
1, 14:33:00-000, 242, 147, 95, 151, 1348.40, 95, 1346.93, 63
1, 14:34:00-000, 674, 399, 275, 286, 1347.91, 275, 1347.32, 47
1, 14:35:00-000, 318, 157, 161, 163, 1346.99, 161, 1346.16, 62
1, 14:36:00-000, 513, 324, 189, 189, 1349.56, 189, 1348.56, 61
1, 14:37:00-000, 308, 178, 130, 156, 1347.85, 130, 1346.86, 81
1, 14:38:00-000, 642, 375, 267, 227, 1348.44, 267, 1347.43, 93
1, 14:39:00-000, 406, 218, 188, 180, 1347.90, 188, 1347.68, 100
1, 14:40:00-000, 684, 374, 310, 305, 1347.25, 310, 1346.12, 48
1, 14:41:00-000, 286, 187, 99, 120, 1349.09, 99, 1348.12, 68
1, 14:42:00-000, 535, 297, 238, 202, 1347.96, 238, 1347.24, 76
1, 14:43:00-000, 310, 185, 125, 114, 1347.74, 125, 1347.07, 87
1, 14:44:00-000, 680, 380, 300, 298, 1348.04, 300, 1346.88, 90
1, 14:45:00-000, 379, 217, 162, 159, 1347.73, 162, 1347.80, 69
1, 14:46:00-000, 638, 386, 252, 248, 1348.55, 252, 1348.36, 96
1, 14:47:00-000, 267, 156, 111, 108, 1347.83, 111, 1347.06, 87
1, 14:48:00-000, 630, 370, 260, 291, 1347.23, 260, 1346.25, 63
1, 14:49:00-000, 295, 141, 154, 123, 1348.13, 154, 1346.81, 69
1, 14:50:00-000, 610, 329, 281, 252, 1347.29, 281, 1346.64, 29
1, 14:51:00-000, 322, 204, 118, 154, 1348.21, 118, 1347.64, 50
1, 14:52:00-000, 504, 276, 228, 218, 1348.09, 228, 1346.76, 64
1, 14:53:00-000, 300, 170, 130, 133, 1348.53, 130, 1347.34, 62
1, 14:54:00-000, 540, 292, 248, 220, 1347.90, 248, 1347.52, 53
1, 14:55:00-000, 334, 193, 141, 155, 1348.09, 141, 1347.20, 49
1, 14:56:00-000, 691, 433, 258, 284, 1347.88, 258, 1347.24, 76
1, 14:57:00-000, 309, 177, 132, 132, 1347.00, 132, 1346.94, 92
1, 14:58:00-000, 600, 316, 284, 255, 1347.79, 284, 1346.73, 83
1, 14:59:00-000, 348, 220, 128, 176, 1348.26, 128, 1346.99, 40
1, 15:00:00-000, 537, 286, 251, 241, 1347.58, 251, 1346.75, 47
1, 15:01:00-000, 250, 145, 105, 131, 1347.75, 105, 1347.69, 48
1, 15:02:00-000, 606, 357, 249, 256, 1347.70, 249, 1346.99, 29
1, 15:03:00-000, 263, 138, 125, 97, 1348.35, 125, 1348.11, 71
1, 15:04:00-000, 666, 389, 277, 277, 1347.89, 277, 1346.62, 98
1, 15:05:00-000, 305, 170, 135, 109, 1348.03, 135, 1347.14, 75
1, 15:06:00-000, 593, 317, 276, 265, 1347.89, 276, 1346.93, 67
1, 15:07:00-000, 283, 180, 103, 109, 1348.98, 103, 1347.84, 45
1, 15:08:00-000, 625, 364, 261, 260, 1348.68, 261, 1348.61, 89
1, 15:09:00-000, 278, 144, 134, 97, 1348.43, 134, 1347.33, 70
1, 15:10:00-000, 647, 367, 280, 255, 1347.03, 280, 1346.68, 73
1, 15:11:00-000, 341, 218, 123, 155, 1348.44, 123, 1346.95, 79
1, 15:12:00-000, 653, 409, 244, 306, 1348.26, 244, 1347.03, 75
1, 15:13:00-000, 278, 169, 109, 102, 1348.55, 109, 1348.48, 114
1, 15:14:00-000, 599, 360, 239, 239, 1348.50, 239, 1348.35, 66
1, 15:15:00-000, 272, 157, 115, 120, 1348.56, 115, 1347.36, 107
1, 15:16:00-000, 604, 354, 250, 219, 1348.42, 250, 1347.91, 67
1, 15:17:00-000, 331, 195, 136, 162, 1347.66, 136, 1346.73, 75
1, 15:18:00-000, 613, 349, 264, 236, 1347.83, 264, 1347.25, 85
1, 15:19:00-000, 313, 165, 148, 125, 1346.89, 148, 1346.32, 75
1, 15:20:00-000, 643, 351, 292, 260, 1347.95, 292, 1346.81, 95
1, 15:21:00-000, 331, 180, 151, 126, 1348.07, 149, 1347.87, 72
1, 15:22:00-000, 609, 348, 261, 261, 1347.42, 263, 1347.22, 49
1, 15:23:00-000, 291, 153, 138, 123, 1347.15, 138, 1346.50, 72
1, 15:24:00-000, 627, 437, 190, 207, 1348.69, 190, 1348.13, 87
1, 15:25:00-000, 287, 178, 109, 129, 1348.53, 106, 1348.60, 146
1, 15:26:00-000, 580, 329, 251, 217, 1348.18, 254, 1347.79, 96
1, 15:27:00-000, 230, 131, 99, 114, 1348.10, 99, 1347.79, 83
1, 15:28:00-000, 704, 446, 258, 264, 1349.16, 258, 1348.27, 100
1, 15:29:00-000, 277, 143, 134, 112, 1348.96, 134, 1347.38, 97
1, 15:30:00-000, 606, 379, 227, 234, 1348.34, 227, 1347.65, 84
1, 15:31:00-000, 264, 161, 103, 98, 1349.27, 103, 1348.55, 104
1, 15:32:00-000, 671, 390, 281, 275, 1348.03, 281, 1347.66, 107
1, 15:33:00-000, 357, 216, 141, 150, 1347.50, 141, 1346.91, 81
1, 15:34:00-000, 604, 408, 196, 264, 1349.00, 196, 1347.99, 104
1, 15:35:00-000, 317, 182, 135, 147, 1348.09, 135, 1347.80, 69
1, 15:36:00-000, 526, 301, 225, 235, 1347.98, 225, 1346.80, 77
1, 15:37:00-000, 291, 193, 98, 132, 1347.01, 98, 1346.76, 60
1, 15:38:00-000, 611, 335, 276, 247, 1348.62, 276, 1347.37, 83
1, 15:39:00-000, 335, 213, 122, 126, 1348.27, 122, 1346.72, 53
1, 15:40:00-000, 621, 350, 271, 213, 1348.61, 271, 1347.69, 114
1, 15:41:00-000, 252, 154, 98, 108, 1348.81, 98, 1347.74, 119
1, 15:42:00-000, 644, 322, 322, 255, 1348.14, 322, 1346.68, 64
1, 15:43:00-000, 314, 198, 116, 86, 1348.34, 116, 1346.94, 60
1, 15:44:00-000, 644, 414, 230, 260, 1348.82, 230, 1347.43, 128
1, 15:45:00-000, 276, 148, 128, 154, 1347.84, 128, 1347.41, 106
1, 15:46:00-000, 578, 374, 204, 245, 1348.28, 204, 1347.12, 67
1, 15:47:00-000, 325, 199, 126, 104, 1348.23, 126, 1346.98, 95
1, 15:48:00-000, 671, 421, 250, 288, 1348.94, 250, 1347.64, 106
1, 15:49:00-000, 312, 189, 123, 113, 1348.21, 123, 1347.43, 105
1, 15:50:00-000, 571, 323, 248, 232, 1348.85, 248, 1347.41, 85
1, 15:51:00-000, 326, 172, 154, 123, 1347.23, 154, 1345.91, 88
1, 15:52:00-000, 633, 395, 238, 254, 1348.19, 238, 1348.30, 86
1, 15:53:00-000, 277, 179, 98, 101, 1347.22, 98, 1346.66, 93
1, 15:54:00-000, 640, 385, 255, 253, 1348.64, 255, 1346.60, 121
1, 15:55:00-000, 327, 181, 146, 128, 1347.20, 146, 1345.83, 97
1, 15:56:00-000, 611, 354, 257, 246, 1347.88, 257, 1345.69, 70
1, 15:57:00-000, 334, 196, 138, 116, 1348.34, 138, 1348.52, 82
1, 15:58:00-000, 619, 392, 227, 228, 1348.66, 227, 1348.21, 127
1, 15:59:00-000, 268, 173, 95, 129, 1348.25, 95, 1347.52, 79
1, 16:00:00-000, 648, 382, 266, 258, 1348.39, 266, 1347.41, 80
1, 16:01:00-000, 267, 149, 118, 123, 1347.56, 118, 1346.46, 113
1, 16:02:00-000, 543, 321, 222, 263, 1347.75, 222, 1347.29, 47
1, 16:03:00-000, 234, 166, 68, 114, 1348.51, 68, 1348.11, 55
1, 16:04:00-000, 675, 405, 270, 280, 1348.31, 270, 1347.67, 69
1, 16:05:00-000, 333, 208, 125, 119, 1348.30, 125, 1348.70, 89
1, 16:06:00-000, 666, 375, 291, 296, 1347.68, 291, 1347.23, 99
1, 16:07:00-000, 293, 125, 168, 96, 1347.18, 168, 1346.87, 80
1, 16:08:00-000, 604, 366, 238, 225, 1348.98, 238, 1348.68, 62
1, 16:09:00-000, 291, 182, 109, 117, 1348.22, 109, 1347.50, 115
1, 16:10:00-000, 646, 383, 263, 256, 1348.61, 263, 1347.37, 106
1, 16:11:00-000, 265, 149, 116, 122, 1348.49, 116, 1346.71, 77
1, 16:12:00-000, 619, 396, 223, 277, 1348.56, 223, 1347.94, 68
1, 16:13:00-000, 305, 172, 133, 122, 1348.27, 133, 1347.96, 75
1, 16:14:00-000, 658, 400, 258, 275, 1348.36, 258, 1347.63, 103
1, 16:15:00-000, 307, 217, 90, 135, 1348.62, 90, 1348.05, 100
1, 16:16:00-000, 653, 397, 256, 263, 1347.91, 256, 1347.61, 70
1, 16:17:00-000, 341, 211, 130, 107, 1349.05, 130, 1348.38, 137
1, 16:18:00-000, 635, 365, 270, 235, 1348.35, 270, 1347.38, 103
1, 16:19:00-000, 335, 183, 152, 151, 1348.07, 152, 1347.58, 106
1, 16:20:00-000, 541, 310, 231, 180, 1348.35, 231, 1347.31, 96
1, 16:21:00-000, 338, 176, 162, 138, 1347.54, 162, 1347.09, 73
1, 16:22:00-000, 632, 364, 268, 268, 1347.67, 268, 1346.88, 44
1, 16:23:00-000, 335, 179, 156, 181, 1347.41, 152, 1346.37, 74
1, 16:24:00-000, 595, 374, 221, 232, 1348.63, 225, 1348.29, 52
1, 16:25:00-000, 291, 185, 106, 131, 1348.92, 106, 1348.05, 116
1, 16:26:00-000, 522, 317, 205, 219, 1347.96, 205, 1347.47, 65
1, 16:27:00-000, 308, 157, 151, 124, 1348.08, 151, 1346.99, 92
1, 16:28:00-000, 619, 339, 280, 261, 1347.43, 280, 1346.23, 47
1, 16:29:00-000, 264, 129, 135, 97, 1347.91, 135, 1347.39, 45
2, 09:06:00-000, 2973, 0, 2973, 0, 0.00, 1202, 1348.59, 0
2, 09:07:00-000, 0, 0, 0, 0, 0.00, 1, 1352.00, 1761
2, 09:08:00-000, 0, 0, 0, 0, 0.00, 0, 0.00, 9
2, 09:13:00-000, 3046, 1203, 1843, 1203, 1352.95, 1454, 1351.30, 0
2, 09:14:00-000, 6, 3, 3, 3, 1357.33, 22, 1356.86, 370
2, 09:15:00-000, 41, 25, 16, 25, 1357.72, 15, 1353.73, 0
2, 09:16:00-000, 179, 102, 77, 98, 1359.29, 78, 1352.80, 0
2, 09:17:00-000, 193, 99, 94, 101, 1357.78, 94, 1353.37, 0
2, 09:18:00-000, 603, 282, 321, 284, 1354.52, 305, 1353.66, 0
2, 09:19:00-000, 402, 192, 210, 190, 1352.96, 224, 1352.31, 0
2, 09:20:00-000, 850, 349, 501, 351, 1353.52, 453, 1352.48, 7
2, 09:21:00-000, 300, 149, 151, 149, 1354.48, 173, 1353.91, 5
2, 09:22:00-000, 672, 303, 369, 303, 1353.07, 343, 1352.39, 1
2, 09:23:00-000, 296, 146, 150, 146, 1354.71, 165, 1353.82, 8
2, 09:24:00-000, 479, 264, 215, 226, 1356.60, 219, 1352.98, 14
2, 09:25:00-000, 320, 179, 141, 198, 1375.63, 141, 1362.98, 0
2, 09:26:00-000, 678, 366, 312, 385, 1355.61, 272, 1354.36, 0
2, 09:27:00-000, 334, 170, 164, 170, 1353.10, 128, 1350.89, 40
2, 09:28:00-000, 581, 273, 308, 273, 1352.92, 235, 1351.19, 44
2, 09:29:00-000, 351, 180, 171, 180, 1353.78, 180, 1352.98, 23
2, 09:30:00-000, 698, 296, 402, 296, 1352.96, 331, 1352.41, 16
2, 09:31:00-000, 306, 159, 147, 159, 1354.06, 177, 1353.44, 27
2, 09:32:00-000, 674, 321, 353, 321, 1353.53, 339, 1352.62, 27
2, 09:33:00-000, 283, 132, 151, 132, 1352.33, 115, 1351.07, 12
2, 09:34:00-000, 541, 252, 289, 252, 1353.11, 274, 1352.55, 29
2, 09:35:00-000, 321, 107, 214, 107, 1352.41, 159, 1350.91, 27
2, 09:36:00-000, 569, 264, 305, 264, 1352.94, 278, 1351.26, 47
2, 09:37:00-000, 407, 207, 200, 207, 1353.19, 178, 1351.73, 22
2, 09:38:00-000, 634, 328, 306, 328, 1352.91, 253, 1351.70, 41
2, 09:39:00-000, 299, 103, 196, 103, 1352.13, 133, 1350.71, 44
2, 09:40:00-000, 697, 342, 355, 342, 1352.61, 332, 1351.83, 40
2, 09:41:00-000, 266, 135, 131, 135, 1353.47, 99, 1351.52, 46
2, 09:42:00-000, 633, 318, 315, 318, 1353.66, 257, 1352.18, 45
2, 09:43:00-000, 292, 122, 170, 122, 1352.82, 135, 1351.20, 49
2, 09:44:00-000, 688, 328, 360, 328, 1353.35, 326, 1352.15, 47
2, 09:45:00-000, 355, 155, 200, 155, 1352.07, 175, 1351.50, 15
2, 09:46:00-000, 651, 264, 387, 263, 1352.58, 325, 1350.64, 31
2, 09:47:00-000, 342, 149, 193, 150, 1352.85, 142, 1351.79, 42
2, 09:48:00-000, 522, 245, 277, 245, 1352.69, 250, 1351.87, 60
2, 09:49:00-000, 340, 149, 191, 149, 1352.69, 168, 1352.05, 32
2, 09:50:00-000, 629, 305, 324, 305, 1353.69, 304, 1351.13, 37
2, 09:51:00-000, 297, 167, 130, 167, 1354.23, 120, 1352.10, 5
2, 09:52:00-000, 617, 311, 306, 311, 1353.71, 252, 1352.23, 17
2, 09:53:00-000, 328, 100, 228, 100, 1351.49, 157, 1350.84, 42
2, 09:54:00-000, 629, 282, 347, 282, 1352.56, 312, 1351.65, 67
2, 09:55:00-000, 320, 190, 130, 190, 1354.31, 129, 1350.98, 40
2, 09:56:00-000, 609, 277, 332, 277, 1352.63, 287, 1351.14, 12
2, 09:57:00-000, 331, 151, 180, 151, 1352.66, 136, 1351.55, 45
2, 09:58:00-000, 621, 321, 300, 321, 1353.13, 280, 1352.04, 33
2, 09:59:00-000, 295, 110, 185, 110, 1351.13, 117, 1350.71, 32
2, 10:00:00-000, 590, 258, 332, 258, 1352.32, 272, 1351.22, 59
2, 10:01:00-000, 288, 106, 182, 106, 1352.57, 128, 1350.38, 63
2, 10:02:00-000, 605, 331, 274, 331, 1354.59, 265, 1352.14, 49
2, 10:03:00-000, 253, 120, 133, 120, 1354.64, 129, 1352.66, 19
2, 10:04:00-000, 642, 307, 335, 307, 1352.81, 255, 1351.95, 11
2, 10:05:00-000, 313, 148, 165, 148, 1352.93, 174, 1352.18, 49
2, 10:06:00-000, 630, 259, 371, 259, 1352.79, 299, 1351.17, 21
2, 10:07:00-000, 330, 159, 171, 159, 1351.73, 156, 1351.99, 54
2, 10:08:00-000, 579, 275, 304, 273, 1352.78, 268, 1351.80, 37
2, 10:09:00-000, 262, 115, 147, 117, 1353.52, 118, 1353.05, 25
2, 10:10:00-000, 523, 241, 282, 241, 1353.00, 228, 1351.05, 25
2, 10:11:00-000, 342, 131, 211, 131, 1352.67, 155, 1351.05, 35
2, 10:12:00-000, 670, 329, 341, 329, 1352.57, 283, 1351.25, 86
2, 10:13:00-000, 324, 153, 171, 153, 1353.60, 143, 1352.43, 26
2, 10:14:00-000, 584, 273, 311, 273, 1353.41, 286, 1351.56, 21
2, 10:15:00-000, 302, 113, 189, 113, 1352.47, 146, 1351.37, 50
2, 10:16:00-000, 595, 234, 361, 234, 1351.90, 245, 1351.39, 83
2, 10:17:00-000, 328, 131, 197, 131, 1352.36, 172, 1351.62, 42
2, 10:18:00-000, 689, 304, 385, 304, 1352.85, 277, 1351.67, 58
2, 10:19:00-000, 324, 165, 159, 165, 1353.35, 120, 1352.51, 100
2, 10:20:00-000, 606, 251, 355, 251, 1352.63, 325, 1351.47, 55
2, 10:21:00-000, 230, 111, 119, 111, 1353.76, 100, 1352.27, 24
2, 10:22:00-000, 645, 286, 359, 286, 1352.95, 301, 1351.68, 36
2, 10:23:00-000, 362, 162, 200, 162, 1353.21, 196, 1351.47, 30
2, 10:24:00-000, 631, 301, 330, 301, 1354.03, 255, 1351.39, 27
2, 10:25:00-000, 357, 142, 215, 142, 1352.99, 200, 1351.40, 47
2, 10:26:00-000, 628, 260, 368, 260, 1352.84, 255, 1351.46, 37
2, 10:27:00-000, 307, 168, 139, 168, 1353.03, 120, 1351.92, 77
2, 10:28:00-000, 655, 312, 343, 312, 1352.90, 306, 1351.88, 58
2, 10:29:00-000, 284, 131, 153, 131, 1353.41, 123, 1351.28, 35
2, 10:30:00-000, 592, 256, 336, 256, 1352.87, 268, 1351.37, 27
2, 10:31:00-000, 277, 136, 141, 136, 1352.97, 110, 1351.78, 71
2, 10:32:00-000, 690, 306, 384, 306, 1352.43, 300, 1350.61, 61
2, 10:33:00-000, 358, 164, 194, 164, 1351.95, 166, 1351.30, 54
2, 10:34:00-000, 607, 290, 317, 290, 1353.49, 251, 1352.18, 22
2, 10:35:00-000, 329, 157, 172, 157, 1351.96, 174, 1351.60, 28
2, 10:36:00-000, 641, 266, 375, 266, 1352.41, 293, 1351.84, 49
2, 10:37:00-000, 299, 116, 183, 116, 1351.75, 129, 1349.58, 69
2, 10:38:00-000, 584, 258, 326, 258, 1352.50, 242, 1351.06, 55
2, 10:39:00-000, 308, 151, 157, 151, 1351.91, 122, 1351.92, 68
2, 10:40:00-000, 547, 225, 322, 225, 1351.80, 207, 1350.10, 77
2, 10:41:00-000, 352, 168, 184, 168, 1353.25, 145, 1351.05, 71
2, 10:42:00-000, 641, 299, 342, 299, 1353.63, 287, 1352.06, 64
2, 10:43:00-000, 271, 128, 143, 128, 1353.30, 118, 1352.95, 43
2, 10:44:00-000, 649, 248, 401, 248, 1352.01, 280, 1351.27, 43
2, 10:45:00-000, 330, 151, 179, 151, 1352.51, 192, 1352.20, 68
2, 10:46:00-000, 695, 249, 446, 249, 1351.40, 323, 1350.91, 63
2, 10:47:00-000, 314, 133, 181, 133, 1351.36, 126, 1350.08, 78
2, 10:48:00-000, 621, 292, 329, 292, 1352.59, 262, 1351.64, 78
2, 10:49:00-000, 285, 111, 174, 111, 1351.79, 92, 1350.48, 55
2, 10:50:00-000, 569, 274, 295, 274, 1352.46, 255, 1351.18, 77
2, 10:51:00-000, 315, 162, 153, 162, 1353.77, 128, 1352.03, 30
2, 10:52:00-000, 620, 272, 348, 272, 1352.08, 221, 1351.65, 48
2, 10:53:00-000, 304, 140, 164, 140, 1353.68, 126, 1352.08, 100
2, 10:54:00-000, 657, 282, 375, 282, 1351.60, 284, 1351.13, 73
2, 10:55:00-000, 284, 113, 171, 113, 1351.81, 113, 1351.96, 74
2, 10:56:00-000, 587, 272, 315, 272, 1352.90, 254, 1350.99, 67
2, 10:57:00-000, 287, 127, 160, 127, 1353.02, 137, 1351.83, 49
2, 10:58:00-000, 602, 233, 369, 229, 1352.06, 249, 1350.84, 51
2, 10:59:00-000, 289, 117, 172, 121, 1350.47, 129, 1350.38, 70
2, 11:00:00-000, 694, 311, 383, 311, 1352.35, 305, 1350.97, 86
2, 11:01:00-000, 286, 116, 170, 116, 1352.68, 101, 1350.51, 63
2, 11:02:00-000, 589, 212, 377, 212, 1351.34, 301, 1350.86, 65
2, 11:03:00-000, 300, 131, 169, 131, 1350.98, 131, 1350.54, 66
2, 11:04:00-000, 552, 251, 301, 251, 1352.79, 252, 1351.37, 51
2, 11:05:00-000, 246, 109, 137, 109, 1351.73, 97, 1351.30, 46
2, 11:06:00-000, 672, 277, 395, 277, 1352.43, 297, 1351.31, 43
2, 11:07:00-000, 323, 133, 190, 133, 1351.80, 147, 1351.42, 59
2, 11:08:00-000, 704, 321, 383, 321, 1352.58, 329, 1351.40, 76
2, 11:09:00-000, 281, 109, 172, 109, 1351.83, 145, 1351.86, 45
2, 11:10:00-000, 588, 247, 341, 247, 1353.19, 293, 1351.34, 47
2, 11:11:00-000, 408, 191, 217, 191, 1353.18, 197, 1351.27, 41
2, 11:12:00-000, 584, 273, 311, 273, 1352.51, 245, 1351.86, 44
2, 11:13:00-000, 241, 124, 117, 124, 1353.30, 108, 1351.58, 34
2, 11:14:00-000, 641, 296, 345, 296, 1351.77, 260, 1351.01, 44
2, 11:15:00-000, 327, 168, 159, 168, 1352.68, 141, 1352.07, 26
2, 11:16:00-000, 548, 254, 294, 254, 1352.66, 221, 1352.17, 54
2, 11:17:00-000, 324, 144, 180, 144, 1352.27, 156, 1351.93, 43
2, 11:18:00-000, 754, 352, 402, 352, 1352.75, 352, 1351.38, 42
2, 11:19:00-000, 283, 124, 159, 124, 1354.08, 145, 1352.70, 49
2, 11:20:00-000, 557, 237, 320, 237, 1352.88, 257, 1351.40, 27
2, 11:21:00-000, 281, 113, 168, 113, 1352.10, 134, 1351.89, 43
2, 11:22:00-000, 576, 227, 349, 227, 1352.76, 290, 1351.28, 57
2, 11:23:00-000, 298, 154, 144, 154, 1353.51, 127, 1351.59, 55
2, 11:24:00-000, 620, 306, 314, 306, 1352.91, 265, 1351.85, 24
2, 11:25:00-000, 323, 180, 143, 180, 1352.23, 122, 1350.80, 41
2, 11:26:00-000, 662, 306, 356, 306, 1353.18, 290, 1351.75, 39
2, 11:27:00-000, 322, 157, 165, 157, 1352.70, 139, 1352.38, 39
2, 11:28:00-000, 547, 261, 286, 261, 1353.33, 280, 1351.85, 26
2, 11:29:00-000, 295, 144, 151, 144, 1352.74, 106, 1351.46, 16
2, 11:30:00-000, 687, 267, 420, 267, 1352.39, 328, 1351.61, 28
2, 11:31:00-000, 261, 105, 156, 105, 1351.59, 113, 1351.16, 102
2, 11:32:00-000, 654, 283, 371, 283, 1351.94, 313, 1351.08, 44
2, 11:33:00-000, 317, 123, 194, 123, 1352.16, 141, 1351.09, 48
2, 11:34:00-000, 546, 257, 289, 257, 1353.36, 220, 1351.70, 74
2, 11:35:00-000, 323, 142, 181, 142, 1352.63, 153, 1351.42, 52
2, 11:36:00-000, 586, 266, 320, 266, 1352.32, 251, 1351.12, 50
2, 11:37:00-000, 294, 131, 163, 131, 1352.55, 130, 1352.00, 36
2, 11:38:00-000, 665, 339, 326, 339, 1352.63, 264, 1351.66, 65
2, 11:39:00-000, 342, 149, 193, 149, 1351.59, 153, 1351.09, 55
2, 11:40:00-000, 589, 282, 307, 282, 1353.38, 261, 1351.79, 51
2, 11:41:00-000, 249, 110, 139, 110, 1350.89, 96, 1350.14, 29
2, 11:42:00-000, 608, 234, 374, 234, 1351.14, 285, 1350.67, 50
2, 11:43:00-000, 245, 98, 147, 98, 1352.71, 113, 1351.94, 62
2, 11:44:00-000, 644, 269, 375, 269, 1352.71, 298, 1351.11, 56
2, 11:45:00-000, 326, 154, 172, 154, 1353.12, 160, 1352.19, 60
2, 11:46:00-000, 598, 248, 350, 248, 1353.11, 251, 1350.82, 55
2, 11:47:00-000, 270, 149, 121, 149, 1353.44, 134, 1352.60, 51
2, 11:48:00-000, 573, 256, 317, 256, 1353.08, 243, 1351.55, 27
2, 11:49:00-000, 259, 110, 149, 110, 1351.54, 129, 1350.44, 38
2, 11:50:00-000, 655, 276, 379, 276, 1352.50, 291, 1351.04, 37
2, 11:51:00-000, 271, 143, 128, 143, 1352.35, 114, 1351.94, 82
2, 11:52:00-000, 609, 262, 347, 262, 1351.76, 244, 1350.55, 44
2, 11:53:00-000, 343, 140, 203, 137, 1351.06, 140, 1349.45, 67
2, 11:54:00-000, 543, 235, 308, 238, 1351.98, 239, 1350.90, 76
2, 11:55:00-000, 287, 130, 157, 130, 1352.59, 123, 1352.03, 58
2, 11:56:00-000, 639, 307, 332, 307, 1352.35, 249, 1351.39, 60
2, 11:57:00-000, 287, 101, 186, 101, 1351.09, 117, 1350.72, 61
2, 11:58:00-000, 696, 300, 396, 300, 1352.00, 306, 1351.02, 96
2, 11:59:00-000, 245, 117, 128, 117, 1352.65, 121, 1351.08, 59
2, 12:00:00-000, 631, 300, 331, 300, 1352.97, 281, 1351.74, 11
2, 12:01:00-000, 303, 123, 180, 123, 1352.01, 156, 1350.63, 53
2, 12:02:00-000, 514, 196, 318, 195, 1352.00, 214, 1351.51, 44
2, 12:03:00-000, 256, 93, 163, 94, 1351.98, 111, 1350.64, 91
2, 12:04:00-000, 626, 253, 373, 253, 1351.98, 274, 1351.01, 55
2, 12:05:00-000, 357, 168, 189, 168, 1351.62, 140, 1350.60, 72
2, 12:06:00-000, 666, 292, 374, 292, 1351.66, 287, 1350.58, 74
2, 12:07:00-000, 359, 157, 202, 157, 1352.16, 167, 1350.82, 62
2, 12:08:00-000, 584, 240, 344, 240, 1352.41, 308, 1350.83, 67
2, 12:09:00-000, 314, 134, 180, 133, 1352.96, 167, 1351.25, 16
2, 12:10:00-000, 553, 202, 351, 203, 1351.90, 245, 1350.73, 51
2, 12:11:00-000, 240, 121, 119, 121, 1352.25, 124, 1351.77, 47
2, 12:12:00-000, 667, 317, 350, 317, 1352.15, 252, 1350.79, 41
2, 12:13:00-000, 417, 199, 218, 199, 1352.79, 189, 1351.63, 58
2, 12:14:00-000, 507, 214, 293, 214, 1351.98, 186, 1351.05, 55
2, 12:15:00-000, 378, 184, 194, 184, 1351.61, 151, 1351.03, 71
2, 12:16:00-000, 604, 310, 294, 310, 1352.41, 263, 1351.36, 60
2, 12:17:00-000, 334, 149, 185, 149, 1351.72, 152, 1350.41, 51
2, 12:18:00-000, 634, 300, 334, 300, 1352.12, 276, 1351.34, 31
2, 12:19:00-000, 284, 105, 179, 105, 1351.95, 131, 1350.25, 53
2, 12:20:00-000, 654, 305, 349, 305, 1351.93, 234, 1350.76, 65
2, 12:21:00-000, 243, 91, 152, 91, 1351.71, 122, 1351.30, 92
2, 12:22:00-000, 581, 232, 349, 232, 1351.83, 195, 1350.69, 84
2, 12:23:00-000, 349, 120, 229, 120, 1352.18, 107, 1349.89, 106
2, 12:24:00-000, 591, 240, 351, 240, 1351.42, 242, 1350.15, 144
2, 12:25:00-000, 416, 197, 219, 197, 1352.68, 159, 1350.72, 89
2, 12:26:00-000, 669, 235, 434, 235, 1351.68, 296, 1350.64, 96
2, 12:27:00-000, 338, 159, 179, 159, 1352.82, 128, 1350.53, 103
2, 12:28:00-000, 608, 247, 361, 247, 1351.73, 250, 1350.72, 83
2, 12:29:00-000, 275, 79, 196, 79, 1351.38, 124, 1350.20, 62
2, 12:30:00-000, 627, 243, 384, 243, 1351.56, 291, 1351.01, 78
2, 12:31:00-000, 329, 149, 180, 149, 1352.41, 138, 1350.86, 73
2, 12:32:00-000, 684, 256, 428, 256, 1352.57, 295, 1351.82, 96
2, 12:33:00-000, 320, 144, 176, 144, 1353.16, 163, 1350.50, 92
2, 12:34:00-000, 649, 270, 379, 270, 1352.16, 282, 1351.31, 51
2, 12:35:00-000, 316, 128, 188, 128, 1352.14, 137, 1352.22, 58
2, 12:36:00-000, 638, 283, 355, 283, 1352.29, 268, 1351.41, 89
2, 12:37:00-000, 328, 139, 189, 139, 1351.98, 146, 1350.72, 61
2, 12:38:00-000, 653, 292, 361, 292, 1352.44, 234, 1351.12, 78
2, 12:39:00-000, 267, 117, 150, 117, 1352.14, 121, 1351.07, 87
2, 12:40:00-000, 592, 235, 357, 235, 1352.40, 274, 1351.39, 35
2, 12:41:00-000, 271, 107, 164, 107, 1352.40, 127, 1351.53, 63
2, 12:42:00-000, 579, 271, 308, 271, 1351.97, 267, 1351.06, 68
2, 12:43:00-000, 298, 122, 176, 122, 1350.56, 108, 1350.63, 39
2, 12:44:00-000, 728, 303, 425, 303, 1352.65, 320, 1351.34, 84
2, 12:45:00-000, 355, 151, 204, 151, 1352.33, 176, 1350.82, 81
2, 12:46:00-000, 699, 291, 408, 291, 1352.25, 341, 1351.19, 49
2, 12:47:00-000, 258, 110, 148, 110, 1352.08, 97, 1351.64, 52
2, 12:48:00-000, 564, 221, 343, 221, 1351.82, 246, 1351.04, 69
2, 12:49:00-000, 287, 143, 144, 143, 1353.09, 118, 1351.59, 68
2, 12:50:00-000, 573, 257, 316, 257, 1352.79, 246, 1350.48, 43
2, 12:51:00-000, 355, 155, 200, 155, 1352.67, 147, 1351.72, 58
2, 12:52:00-000, 662, 318, 344, 318, 1352.69, 308, 1352.53, 40
2, 12:53:00-000, 304, 162, 142, 162, 1353.64, 112, 1351.56, 48
2, 12:54:00-000, 609, 316, 293, 316, 1353.72, 242, 1351.85, 30
2, 12:55:00-000, 318, 103, 215, 103, 1351.48, 119, 1351.05, 60
2, 12:56:00-000, 664, 264, 400, 264, 1352.30, 335, 1350.87, 64
2, 12:57:00-000, 302, 123, 179, 123, 1352.50, 126, 1351.18, 82
2, 12:58:00-000, 598, 288, 310, 288, 1352.71, 243, 1351.58, 61
2, 12:59:00-000, 324, 150, 174, 150, 1352.80, 140, 1351.39, 60
2, 13:00:00-000, 729, 330, 399, 330, 1352.75, 313, 1351.52, 57
2, 13:01:00-000, 273, 107, 166, 107, 1352.29, 131, 1351.72, 48
2, 13:02:00-000, 556, 236, 320, 236, 1351.67, 233, 1350.84, 64
2, 13:03:00-000, 272, 83, 189, 83, 1350.54, 107, 1351.51, 79
2, 13:04:00-000, 661, 248, 413, 248, 1351.26, 301, 1350.72, 106
2, 13:05:00-000, 335, 128, 207, 128, 1352.59, 164, 1350.97, 72
2, 13:06:00-000, 672, 309, 363, 309, 1351.61, 303, 1350.64, 69
2, 13:07:00-000, 344, 170, 174, 170, 1352.75, 130, 1351.89, 43
2, 13:08:00-000, 687, 296, 391, 296, 1352.73, 314, 1351.83, 45
2, 13:09:00-000, 303, 117, 186, 117, 1352.07, 174, 1351.65, 66
2, 13:10:00-000, 643, 260, 383, 260, 1351.81, 232, 1350.15, 50
2, 13:11:00-000, 266, 116, 150, 114, 1352.09, 123, 1351.25, 101
2, 13:12:00-000, 654, 282, 372, 284, 1352.27, 296, 1351.39, 72
2, 13:13:00-000, 341, 171, 170, 171, 1353.56, 126, 1351.39, 44
2, 13:14:00-000, 580, 267, 313, 267, 1353.02, 276, 1351.74, 54
2, 13:15:00-000, 287, 132, 155, 132, 1353.25, 125, 1352.00, 53
2, 13:16:00-000, 627, 292, 335, 292, 1353.76, 296, 1352.40, 40
2, 13:17:00-000, 267, 125, 142, 125, 1352.62, 86, 1350.72, 28
2, 13:18:00-000, 650, 299, 351, 299, 1352.42, 265, 1351.13, 60
2, 13:19:00-000, 286, 119, 167, 119, 1351.88, 137, 1351.55, 77
2, 13:20:00-000, 663, 302, 361, 302, 1352.67, 305, 1351.82, 32
2, 13:21:00-000, 376, 160, 216, 160, 1352.66, 165, 1351.82, 48
2, 13:22:00-000, 558, 219, 339, 219, 1351.67, 237, 1350.96, 75
2, 13:23:00-000, 337, 170, 167, 170, 1352.94, 132, 1351.82, 58
2, 13:24:00-000, 545, 199, 346, 199, 1351.60, 204, 1349.46, 90
2, 13:25:00-000, 391, 208, 183, 208, 1352.08, 173, 1351.49, 91
2, 13:26:00-000, 623, 261, 362, 261, 1352.70, 289, 1351.64, 45
2, 13:27:00-000, 361, 161, 200, 161, 1352.18, 163, 1350.45, 48
2, 13:28:00-000, 670, 248, 422, 248, 1351.47, 282, 1350.97, 54
2, 13:29:00-000, 289, 100, 189, 100, 1351.49, 147, 1351.75, 90
2, 13:30:00-000, 686, 329, 357, 329, 1351.94, 291, 1351.22, 77
2, 13:31:00-000, 300, 148, 152, 148, 1353.10, 114, 1350.65, 69
2, 13:32:00-000, 611, 240, 371, 240, 1351.19, 280, 1351.07, 68
2, 13:33:00-000, 279, 125, 154, 125, 1352.53, 128, 1352.15, 36
2, 13:34:00-000, 734, 282, 452, 282, 1351.75, 294, 1350.87, 94
2, 13:35:00-000, 325, 166, 159, 166, 1352.77, 149, 1351.85, 62
2, 13:36:00-000, 587, 267, 320, 267, 1352.01, 236, 1351.15, 65
2, 13:37:00-000, 276, 135, 141, 135, 1352.68, 138, 1352.26, 61
2, 13:38:00-000, 669, 302, 367, 302, 1352.73, 286, 1351.66, 50
2, 13:39:00-000, 292, 152, 140, 152, 1353.98, 120, 1352.70, 45
2, 13:40:00-000, 688, 329, 359, 329, 1352.63, 305, 1351.82, 55
2, 13:41:00-000, 327, 122, 205, 122, 1351.19, 120, 1350.62, 39
2, 13:42:00-000, 579, 216, 363, 216, 1351.28, 245, 1350.92, 78
2, 13:43:00-000, 285, 127, 158, 127, 1352.28, 131, 1351.43, 88
2, 13:44:00-000, 630, 277, 353, 277, 1352.61, 265, 1351.75, 61
2, 13:45:00-000, 281, 134, 147, 134, 1353.72, 129, 1351.90, 75
2, 13:46:00-000, 630, 259, 371, 259, 1352.94, 283, 1351.45, 48
2, 13:47:00-000, 314, 136, 178, 136, 1352.29, 138, 1351.72, 62
2, 13:48:00-000, 672, 249, 423, 249, 1351.90, 267, 1351.35, 79
2, 13:49:00-000, 276, 108, 168, 108, 1351.63, 165, 1351.15, 91
2, 13:50:00-000, 540, 245, 295, 245, 1352.28, 228, 1351.11, 50
2, 13:51:00-000, 326, 171, 155, 171, 1353.44, 132, 1351.76, 40
2, 13:52:00-000, 529, 277, 252, 277, 1352.45, 231, 1351.72, 34
2, 13:53:00-000, 314, 150, 164, 150, 1353.04, 146, 1351.20, 21
2, 13:54:00-000, 623, 274, 349, 274, 1352.10, 304, 1351.77, 36
2, 13:55:00-000, 352, 161, 191, 161, 1353.21, 145, 1351.97, 30
2, 13:56:00-000, 609, 281, 328, 281, 1352.32, 242, 1350.52, 59
2, 13:57:00-000, 260, 105, 155, 105, 1352.32, 121, 1350.98, 78
2, 13:58:00-000, 537, 283, 254, 283, 1353.52, 189, 1352.18, 44
2, 13:59:00-000, 287, 128, 159, 128, 1352.35, 144, 1350.74, 42
2, 14:00:00-000, 646, 257, 389, 257, 1351.49, 265, 1350.63, 50
2, 14:01:00-000, 267, 117, 150, 117, 1352.28, 118, 1351.03, 76
2, 14:02:00-000, 626, 223, 403, 223, 1351.87, 261, 1350.88, 83
2, 14:03:00-000, 307, 107, 200, 107, 1350.97, 124, 1350.53, 86
2, 14:04:00-000, 641, 286, 355, 284, 1351.96, 262, 1350.97, 102
2, 14:05:00-000, 329, 120, 209, 122, 1351.71, 171, 1351.88, 56
2, 14:06:00-000, 610, 264, 346, 264, 1352.43, 282, 1351.26, 66
2, 14:07:00-000, 284, 125, 159, 125, 1352.50, 120, 1351.01, 75
2, 14:08:00-000, 613, 253, 360, 253, 1352.95, 236, 1351.56, 66
2, 14:09:00-000, 321, 129, 192, 129, 1352.30, 128, 1351.65, 84
2, 14:10:00-000, 659, 250, 409, 250, 1351.68, 351, 1350.60, 71
2, 14:11:00-000, 290, 112, 178, 112, 1351.97, 138, 1351.33, 62
2, 14:12:00-000, 691, 325, 366, 325, 1351.84, 301, 1351.01, 51
2, 14:13:00-000, 254, 111, 143, 111, 1351.39, 105, 1350.19, 43
2, 14:14:00-000, 608, 251, 357, 251, 1351.31, 255, 1350.81, 79
2, 14:15:00-000, 298, 127, 171, 127, 1352.55, 117, 1351.48, 60
2, 14:16:00-000, 730, 382, 348, 382, 1353.07, 300, 1351.82, 58
2, 14:17:00-000, 323, 132, 191, 132, 1352.88, 125, 1350.25, 41
2, 14:18:00-000, 641, 326, 315, 321, 1351.62, 244, 1350.65, 90
2, 14:19:00-000, 286, 100, 186, 105, 1351.23, 113, 1350.80, 53
2, 14:20:00-000, 604, 221, 383, 221, 1351.90, 310, 1350.95, 61
2, 14:21:00-000, 343, 110, 233, 110, 1351.80, 128, 1351.42, 73
2, 14:22:00-000, 681, 282, 399, 282, 1350.96, 301, 1350.50, 108
2, 14:23:00-000, 316, 122, 194, 122, 1351.37, 161, 1350.78, 101
2, 14:24:00-000, 660, 302, 358, 302, 1352.46, 277, 1351.48, 46
2, 14:25:00-000, 304, 122, 182, 122, 1352.72, 118, 1351.48, 81
2, 14:26:00-000, 635, 267, 368, 267, 1352.11, 275, 1351.37, 59
2, 14:27:00-000, 312, 119, 193, 119, 1351.19, 128, 1351.31, 89
2, 14:28:00-000, 610, 286, 324, 286, 1352.41, 283, 1351.20, 61
2, 14:29:00-000, 309, 130, 179, 130, 1352.89, 176, 1350.76, 46
2, 14:30:00-000, 624, 227, 397, 227, 1351.50, 291, 1351.00, 46
2, 14:31:00-000, 276, 157, 119, 157, 1352.88, 115, 1351.37, 63
2, 14:32:00-000, 601, 270, 331, 270, 1353.28, 288, 1351.76, 27
2, 14:33:00-000, 319, 160, 159, 160, 1352.49, 113, 1350.38, 37
2, 14:34:00-000, 639, 263, 376, 263, 1352.57, 277, 1351.10, 47
2, 14:35:00-000, 349, 140, 209, 140, 1351.52, 122, 1350.05, 88
2, 14:36:00-000, 655, 291, 364, 291, 1352.68, 283, 1351.97, 97
2, 14:37:00-000, 264, 134, 130, 134, 1353.93, 115, 1351.90, 54
2, 14:38:00-000, 674, 342, 332, 342, 1352.69, 253, 1351.78, 51
2, 14:39:00-000, 293, 136, 157, 136, 1353.40, 143, 1352.22, 38
2, 14:40:00-000, 611, 251, 360, 251, 1351.66, 282, 1350.37, 57
2, 14:41:00-000, 288, 121, 167, 121, 1352.66, 114, 1351.58, 49
2, 14:42:00-000, 623, 253, 370, 253, 1351.92, 261, 1351.00, 75
2, 14:43:00-000, 301, 155, 146, 155, 1352.39, 151, 1351.34, 54
2, 14:44:00-000, 637, 253, 384, 253, 1351.58, 275, 1350.99, 56
2, 14:45:00-000, 294, 131, 163, 131, 1352.20, 135, 1351.21, 74
2, 14:46:00-000, 552, 298, 254, 298, 1353.70, 257, 1352.38, 33
2, 14:47:00-000, 340, 139, 201, 139, 1351.94, 149, 1350.50, 10
2, 14:48:00-000, 635, 234, 401, 234, 1351.28, 305, 1350.38, 71
2, 14:49:00-000, 324, 172, 152, 172, 1352.23, 121, 1351.24, 52
2, 14:50:00-000, 561, 247, 314, 247, 1351.61, 230, 1350.67, 66
2, 14:51:00-000, 315, 117, 198, 117, 1352.02, 154, 1351.10, 58
2, 14:52:00-000, 642, 298, 344, 298, 1352.74, 274, 1351.25, 75
2, 14:53:00-000, 298, 122, 176, 122, 1352.07, 145, 1351.28, 45
2, 14:54:00-000, 600, 269, 331, 266, 1352.03, 268, 1351.33, 39
2, 14:55:00-000, 359, 146, 213, 149, 1351.78, 167, 1351.45, 65
2, 14:56:00-000, 647, 275, 372, 275, 1352.09, 264, 1351.20, 64
2, 14:57:00-000, 237, 84, 153, 84, 1350.77, 104, 1350.55, 73
2, 14:58:00-000, 610, 289, 321, 289, 1352.42, 266, 1351.49, 59
2, 14:59:00-000, 285, 95, 190, 95, 1351.86, 138, 1350.94, 56
2, 15:00:00-000, 663, 334, 329, 334, 1351.79, 262, 1351.07, 62
2, 15:01:00-000, 355, 152, 203, 152, 1351.90, 156, 1351.60, 40
2, 15:02:00-000, 640, 339, 301, 339, 1351.70, 253, 1350.84, 70
2, 15:03:00-000, 271, 131, 140, 131, 1352.49, 119, 1351.46, 48
2, 15:04:00-000, 620, 243, 377, 243, 1351.96, 246, 1350.99, 54
2, 15:05:00-000, 306, 137, 169, 137, 1352.41, 126, 1351.09, 75
2, 15:06:00-000, 609, 234, 375, 234, 1351.94, 290, 1351.54, 82
2, 15:07:00-000, 317, 127, 190, 127, 1351.75, 131, 1351.60, 67
2, 15:08:00-000, 549, 259, 290, 259, 1353.16, 268, 1351.78, 42
2, 15:09:00-000, 325, 132, 193, 132, 1351.47, 152, 1351.09, 27
2, 15:10:00-000, 669, 264, 405, 264, 1351.94, 298, 1350.49, 69
2, 15:11:00-000, 319, 145, 174, 145, 1352.16, 137, 1351.39, 73
2, 15:12:00-000, 530, 227, 303, 227, 1352.11, 239, 1351.08, 65
2, 15:13:00-000, 325, 146, 179, 146, 1352.44, 140, 1350.99, 55
2, 15:14:00-000, 580, 273, 307, 273, 1352.59, 245, 1351.87, 63
2, 15:15:00-000, 326, 128, 198, 128, 1352.68, 129, 1351.61, 37
2, 15:16:00-000, 546, 289, 257, 289, 1352.63, 244, 1351.20, 64
2, 15:17:00-000, 300, 141, 159, 141, 1351.77, 103, 1350.78, 23
2, 15:18:00-000, 703, 260, 443, 260, 1351.64, 298, 1351.20, 80
2, 15:19:00-000, 290, 127, 163, 127, 1351.65, 130, 1351.20, 118
2, 15:20:00-000, 600, 285, 315, 285, 1351.87, 211, 1351.03, 52
2, 15:21:00-000, 322, 155, 167, 155, 1353.28, 175, 1351.22, 45
2, 15:22:00-000, 602, 219, 383, 219, 1351.07, 284, 1350.32, 44
2, 15:23:00-000, 351, 154, 197, 154, 1352.10, 147, 1350.97, 60
2, 15:24:00-000, 594, 241, 353, 241, 1352.22, 259, 1351.38, 78
2, 15:25:00-000, 262, 123, 139, 123, 1352.76, 95, 1351.58, 85
2, 15:26:00-000, 671, 297, 374, 297, 1352.18, 290, 1351.46, 55
2, 15:27:00-000, 304, 110, 194, 110, 1351.55, 137, 1350.95, 84
2, 15:28:00-000, 649, 275, 374, 275, 1352.47, 297, 1351.42, 60
2, 15:29:00-000, 270, 118, 152, 118, 1351.45, 79, 1350.63, 67
2, 15:30:00-000, 602, 265, 337, 265, 1352.60, 265, 1352.08, 106
2, 15:31:00-000, 297, 135, 162, 135, 1353.12, 126, 1352.57, 43
2, 15:32:00-000, 553, 225, 328, 225, 1352.67, 279, 1351.41, 32
2, 15:33:00-000, 308, 114, 194, 114, 1351.27, 142, 1350.82, 46
2, 15:34:00-000, 622, 268, 354, 268, 1352.07, 242, 1351.06, 82
2, 15:35:00-000, 312, 149, 163, 149, 1352.73, 133, 1351.60, 61
2, 15:36:00-000, 626, 250, 376, 250, 1352.47, 293, 1351.38, 70
2, 15:37:00-000, 335, 124, 211, 124, 1351.43, 138, 1349.94, 74
2, 15:38:00-000, 628, 306, 322, 306, 1352.53, 265, 1351.79, 59
2, 15:39:00-000, 310, 131, 179, 131, 1352.64, 161, 1351.55, 47
2, 15:40:00-000, 628, 275, 353, 275, 1352.09, 185, 1350.47, 58
2, 15:41:00-000, 338, 137, 201, 137, 1351.83, 131, 1350.38, 127
2, 15:42:00-000, 622, 242, 380, 242, 1351.76, 267, 1350.35, 116
2, 15:43:00-000, 341, 140, 201, 140, 1351.93, 130, 1350.46, 84
2, 15:44:00-000, 650, 299, 351, 299, 1352.50, 245, 1350.66, 93
2, 15:45:00-000, 324, 148, 176, 148, 1352.50, 120, 1350.88, 83
2, 15:46:00-000, 571, 223, 348, 223, 1352.33, 241, 1350.01, 91
2, 15:47:00-000, 343, 138, 205, 138, 1351.66, 161, 1350.96, 61
2, 15:48:00-000, 631, 241, 390, 241, 1352.79, 234, 1350.88, 92
2, 15:49:00-000, 272, 107, 165, 107, 1352.31, 136, 1351.68, 90
2, 15:50:00-000, 588, 227, 361, 227, 1351.67, 240, 1351.03, 70
2, 15:51:00-000, 277, 107, 170, 107, 1352.09, 130, 1350.67, 109
2, 15:52:00-000, 646, 263, 383, 263, 1352.98, 264, 1350.74, 61
2, 15:53:00-000, 291, 132, 159, 132, 1351.76, 116, 1350.93, 86
2, 15:54:00-000, 583, 250, 333, 250, 1352.07, 270, 1350.66, 55
2, 15:55:00-000, 318, 115, 203, 115, 1350.45, 125, 1350.41, 56
2, 15:56:00-000, 707, 297, 410, 297, 1351.37, 330, 1351.12, 68
2, 15:57:00-000, 301, 163, 138, 163, 1353.47, 100, 1351.70, 88
2, 15:58:00-000, 639, 258, 381, 258, 1352.31, 244, 1351.45, 71
2, 15:59:00-000, 284, 106, 178, 106, 1352.11, 150, 1351.15, 92
2, 16:00:00-000, 669, 285, 384, 285, 1352.04, 317, 1351.48, 60
2, 16:01:00-000, 263, 81, 182, 81, 1350.58, 102, 1350.05, 61
2, 16:02:00-000, 700, 306, 394, 306, 1352.19, 302, 1351.38, 78
2, 16:03:00-000, 380, 159, 221, 159, 1352.48, 162, 1351.09, 94
2, 16:04:00-000, 594, 211, 383, 211, 1352.10, 270, 1351.14, 67
2, 16:05:00-000, 290, 144, 146, 144, 1352.61, 145, 1351.77, 62
2, 16:06:00-000, 688, 262, 426, 262, 1352.51, 322, 1351.29, 61
2, 16:07:00-000, 305, 154, 151, 154, 1350.87, 115, 1351.30, 62
2, 16:08:00-000, 687, 340, 347, 340, 1352.84, 317, 1351.58, 47
2, 16:09:00-000, 269, 106, 163, 106, 1351.81, 114, 1350.76, 27
2, 16:10:00-000, 687, 308, 379, 308, 1351.91, 270, 1351.33, 100
2, 16:11:00-000, 208, 118, 90, 118, 1352.67, 72, 1351.82, 61
2, 16:12:00-000, 609, 273, 336, 273, 1353.72, 275, 1350.78, 43
2, 16:13:00-000, 328, 153, 175, 153, 1353.17, 123, 1351.54, 50
2, 16:14:00-000, 661, 325, 336, 325, 1352.75, 301, 1351.97, 58
2, 16:15:00-000, 319, 115, 204, 115, 1352.51, 127, 1351.33, 27
2, 16:16:00-000, 584, 247, 337, 247, 1352.36, 263, 1350.79, 87
2, 16:17:00-000, 300, 144, 156, 144, 1352.06, 126, 1351.03, 68
2, 16:18:00-000, 558, 242, 316, 242, 1352.59, 232, 1351.60, 45
2, 16:19:00-000, 363, 165, 198, 164, 1353.09, 182, 1351.33, 49
2, 16:20:00-000, 567, 243, 324, 244, 1351.91, 200, 1350.69, 58
2, 16:21:00-000, 353, 154, 199, 154, 1351.25, 163, 1351.28, 61
2, 16:22:00-000, 634, 276, 358, 276, 1351.86, 254, 1350.88, 75
2, 16:23:00-000, 276, 106, 170, 106, 1351.93, 136, 1351.22, 95
2, 16:24:00-000, 559, 271, 288, 271, 1352.93, 232, 1351.85, 45
2, 16:25:00-000, 323, 125, 198, 125, 1352.37, 169, 1351.04, 44
2, 16:26:00-000, 615, 194, 421, 194, 1351.30, 298, 1350.70, 38
2, 16:27:00-000, 320, 155, 165, 155, 1352.00, 136, 1350.93, 65
2, 16:28:00-000, 691, 291, 400, 291, 1351.48, 315, 1351.03, 94
2, 16:29:00-000, 295, 145, 150, 145, 1352.01, 92, 1351.18, 67
3, 09:00:00-000, 174, 173, 1, 1, 1349.00, 1, 1349.00, 164
3, 09:01:00-000, 179, 179, 0, 0, 0.00, 0, 0.00, 185
3, 09:02:00-000, 180, 180, 0, 0, 0.00, 0, 0.00, 166
3, 09:03:00-000, 176, 176, 0, 0, 0.00, 0, 0.00, 190
3, 09:04:00-000, 219, 219, 0, 0, 0.00, 0, 0.00, 208
3, 09:05:00-000, 209, 209, 0, 0, 0.00, 0, 0.00, 220
3, 09:06:00-000, 204, 204, 0, 2, 1348.50, 0, 0.00, 199
3, 09:07:00-000, 200, 200, 0, 0, 0.00, 0, 0.00, 198
3, 09:08:00-000, 202, 202, 0, 0, 0.00, 0, 0.00, 199
3, 09:09:00-000, 160, 160, 0, 0, 0.00, 0, 0.00, 168
3, 09:10:00-000, 186, 186, 0, 0, 0.00, 0, 0.00, 185
3, 09:11:00-000, 194, 194, 0, 0, 0.00, 0, 0.00, 196
3, 09:12:00-000, 196, 196, 0, 0, 0.00, 0, 0.00, 190
3, 09:13:00-000, 169, 169, 0, 1, 1525.00, 0, 0.00, 169
3, 09:14:00-000, 214, 214, 0, 2, 1356.00, 0, 0.00, 206
3, 09:15:00-000, 264, 248, 16, 12, 1354.17, 9, 1355.78, 251
3, 09:16:00-000, 201, 201, 0, 3, 1350.33, 0, 0.00, 191
3, 09:17:00-000, 178, 169, 9, 9, 1364.00, 9, 1355.44, 163
3, 09:18:00-000, 176, 174, 2, 8, 1366.37, 1, 1352.00, 170
3, 09:19:00-000, 201, 192, 9, 6, 1351.50, 5, 1355.20, 187
3, 09:20:00-000, 166, 142, 24, 9, 1353.00, 3, 1350.67, 155
3, 09:21:00-000, 201, 172, 29, 15, 1350.47, 8, 1352.75, 183
3, 09:22:00-000, 183, 145, 38, 14, 1347.36, 0, 0.00, 166
3, 09:23:00-000, 184, 118, 66, 0, 0.00, 0, 0.00, 186
3, 09:24:00-000, 219, 141, 78, 4, 1365.25, 24, 1380.41, 178
3, 09:25:00-000, 220, 202, 18, 5, 1394.80, 6, 1410.67, 219
3, 09:26:00-000, 202, 180, 22, 17, 1364.53, 17, 1356.64, 171
3, 09:27:00-000, 226, 210, 16, 3, 1352.00, 2, 1351.50, 214
3, 09:28:00-000, 169, 135, 34, 9, 1349.11, 3, 1351.67, 163
3, 09:29:00-000, 195, 177, 18, 4, 1352.00, 6, 1352.33, 177
3, 09:30:00-000, 197, 172, 25, 13, 1347.00, 6, 1351.00, 190
3, 09:31:00-000, 215, 185, 30, 5, 1350.00, 6, 1351.83, 196
3, 09:32:00-000, 199, 182, 17, 3, 1347.67, 1, 1350.00, 200
3, 09:33:00-000, 208, 192, 16, 1, 1350.00, 3, 1351.67, 198
3, 09:34:00-000, 235, 194, 41, 27, 1351.44, 10, 1352.70, 206
3, 09:35:00-000, 176, 126, 50, 6, 1348.50, 4, 1350.50, 166
3, 09:36:00-000, 204, 150, 54, 10, 1347.00, 5, 1350.80, 182
3, 09:37:00-000, 186, 124, 62, 2, 1352.00, 13, 1353.54, 173
3, 09:38:00-000, 183, 138, 45, 14, 1348.86, 2, 1350.50, 167
3, 09:39:00-000, 188, 123, 65, 6, 1348.17, 5, 1352.20, 182
3, 09:40:00-000, 217, 117, 100, 4, 1349.00, 13, 1351.69, 195
3, 09:41:00-000, 213, 110, 103, 5, 1348.60, 9, 1350.00, 205
3, 09:42:00-000, 215, 140, 75, 13, 1352.08, 15, 1351.86, 184
3, 09:43:00-000, 207, 146, 61, 1, 1351.00, 3, 1350.33, 191
3, 09:44:00-000, 188, 166, 22, 3, 1352.00, 10, 1353.30, 188
3, 09:45:00-000, 190, 163, 27, 11, 1349.82, 7, 1351.14, 164
3, 09:46:00-000, 186, 153, 33, 5, 1349.60, 15, 1351.40, 176
3, 09:47:00-000, 199, 190, 9, 2, 1347.00, 1, 1350.00, 190
3, 09:48:00-000, 184, 173, 11, 2, 1348.00, 7, 1350.86, 180
3, 09:49:00-000, 177, 170, 7, 1, 1349.00, 0, 0.00, 177
3, 09:50:00-000, 202, 189, 13, 12, 1348.75, 3, 1352.00, 183
3, 09:51:00-000, 205, 194, 11, 9, 1350.55, 5, 1351.00, 195
3, 09:52:00-000, 229, 204, 25, 8, 1351.37, 15, 1355.13, 202
3, 09:53:00-000, 216, 190, 26, 9, 1349.33, 6, 1350.33, 203
3, 09:54:00-000, 197, 159, 38, 14, 1349.00, 10, 1352.50, 171
3, 09:55:00-000, 193, 157, 36, 5, 1350.80, 17, 1351.94, 166
3, 09:56:00-000, 183, 144, 39, 22, 1350.95, 11, 1353.45, 157
3, 09:57:00-000, 218, 186, 32, 4, 1348.00, 17, 1352.70, 199
3, 09:58:00-000, 219, 207, 12, 16, 1349.81, 3, 1353.67, 197
3, 09:59:00-000, 228, 180, 48, 3, 1349.00, 7, 1351.86, 219
3, 10:00:00-000, 188, 144, 44, 4, 1347.00, 2, 1349.50, 180
3, 10:01:00-000, 208, 169, 39, 5, 1349.60, 11, 1351.36, 196
3, 10:02:00-000, 221, 205, 16, 5, 1350.40, 5, 1354.60, 207
3, 10:03:00-000, 197, 180, 17, 6, 1352.17, 8, 1352.37, 183
3, 10:04:00-000, 215, 190, 25, 5, 1348.60, 2, 1351.00, 204
3, 10:05:00-000, 187, 143, 44, 15, 1349.53, 10, 1353.80, 167
3, 10:06:00-000, 197, 178, 19, 13, 1348.77, 4, 1351.25, 181
3, 10:07:00-000, 198, 172, 26, 4, 1351.00, 12, 1352.58, 182
3, 10:08:00-000, 210, 177, 33, 4, 1350.50, 3, 1355.33, 203
3, 10:09:00-000, 213, 198, 15, 7, 1352.71, 7, 1351.00, 191
3, 10:10:00-000, 203, 183, 20, 10, 1349.30, 2, 1351.50, 194
3, 10:11:00-000, 203, 153, 50, 7, 1352.71, 6, 1351.17, 195
3, 10:12:00-000, 191, 124, 67, 6, 1347.83, 7, 1349.57, 180
3, 10:13:00-000, 198, 158, 40, 1, 1347.00, 2, 1351.00, 187
3, 10:14:00-000, 217, 165, 52, 7, 1348.57, 17, 1350.94, 193
3, 10:15:00-000, 196, 180, 16, 5, 1351.20, 8, 1351.50, 189
3, 10:16:00-000, 183, 146, 37, 15, 1348.86, 2, 1351.00, 167
3, 10:17:00-000, 198, 145, 53, 8, 1348.12, 18, 1351.44, 171
3, 10:18:00-000, 220, 202, 18, 4, 1349.00, 2, 1352.00, 216
3, 10:19:00-000, 194, 156, 38, 4, 1348.50, 5, 1351.00, 178
3, 10:20:00-000, 202, 173, 29, 16, 1348.25, 8, 1353.00, 171
3, 10:21:00-000, 198, 174, 24, 2, 1350.00, 2, 1351.50, 204
3, 10:22:00-000, 195, 137, 58, 3, 1348.00, 1, 1350.00, 194
3, 10:23:00-000, 181, 134, 47, 0, 0.00, 8, 1349.87, 161
3, 10:24:00-000, 176, 147, 29, 15, 1347.40, 7, 1353.57, 163
3, 10:25:00-000, 162, 101, 61, 8, 1350.00, 17, 1351.41, 137
3, 10:26:00-000, 196, 151, 45, 11, 1348.45, 13, 1351.23, 164
3, 10:27:00-000, 196, 167, 29, 8, 1348.25, 5, 1350.60, 189
3, 10:28:00-000, 192, 152, 40, 10, 1348.10, 1, 1350.00, 180
3, 10:29:00-000, 213, 165, 48, 9, 1349.00, 13, 1352.31, 190
3, 10:30:00-000, 225, 174, 51, 5, 1347.60, 9, 1350.22, 204
3, 10:31:00-000, 218, 181, 37, 6, 1351.50, 8, 1353.25, 216
3, 10:32:00-000, 161, 139, 22, 4, 1348.00, 9, 1351.44, 148
3, 10:33:00-000, 189, 172, 17, 14, 1348.78, 7, 1352.57, 167
3, 10:34:00-000, 166, 124, 42, 5, 1348.80, 6, 1350.50, 155
3, 10:35:00-000, 225, 176, 49, 2, 1349.00, 11, 1351.27, 214
3, 10:36:00-000, 211, 166, 45, 22, 1350.09, 2, 1354.00, 183
3, 10:37:00-000, 207, 124, 83, 12, 1348.00, 4, 1351.00, 187
3, 10:38:00-000, 201, 139, 62, 12, 1349.92, 19, 1351.10, 179
3, 10:39:00-000, 210, 147, 63, 5, 1347.00, 3, 1350.67, 199
3, 10:40:00-000, 233, 135, 98, 10, 1349.50, 19, 1351.21, 207
3, 10:41:00-000, 184, 131, 53, 0, 0.00, 7, 1350.43, 176
3, 10:42:00-000, 199, 144, 55, 6, 1349.50, 2, 1351.00, 191
3, 10:43:00-000, 181, 143, 38, 6, 1351.83, 14, 1354.14, 156
3, 10:44:00-000, 197, 169, 28, 17, 1349.47, 21, 1351.33, 157
3, 10:45:00-000, 206, 177, 29, 21, 1348.71, 7, 1351.14, 187
3, 10:46:00-000, 245, 201, 44, 18, 1348.55, 16, 1350.12, 206
3, 10:47:00-000, 202, 151, 51, 1, 1344.00, 9, 1350.11, 191
3, 10:48:00-000, 210, 160, 50, 0, 0.00, 9, 1351.67, 199
3, 10:49:00-000, 199, 192, 7, 2, 1347.00, 2, 1352.00, 202
3, 10:50:00-000, 184, 179, 5, 11, 1349.45, 2, 1355.00, 165
3, 10:51:00-000, 174, 146, 28, 5, 1348.60, 1, 1350.00, 168
3, 10:52:00-000, 205, 145, 60, 11, 1345.73, 5, 1350.60, 189
3, 10:53:00-000, 179, 145, 34, 4, 1353.00, 8, 1351.62, 172
3, 10:54:00-000, 181, 144, 37, 7, 1347.86, 5, 1351.20, 167
3, 10:55:00-000, 192, 158, 34, 1, 1351.00, 3, 1351.00, 184
3, 10:56:00-000, 209, 144, 65, 31, 1347.99, 28, 1351.71, 138
3, 10:57:00-000, 182, 135, 47, 4, 1350.25, 10, 1351.60, 188
3, 10:58:00-000, 221, 175, 46, 5, 1349.00, 12, 1350.58, 198
3, 10:59:00-000, 181, 146, 35, 12, 1347.17, 10, 1352.70, 162
3, 11:00:00-000, 175, 111, 64, 9, 1350.44, 11, 1350.82, 153
3, 11:01:00-000, 157, 147, 10, 3, 1348.67, 1, 1353.00, 153
3, 11:02:00-000, 207, 193, 14, 9, 1348.89, 4, 1350.00, 196
3, 11:03:00-000, 208, 146, 62, 1, 1346.00, 0, 0.00, 207
3, 11:04:00-000, 180, 122, 58, 16, 1348.06, 13, 1350.15, 154
3, 11:05:00-000, 191, 135, 56, 2, 1348.50, 7, 1351.29, 175
3, 11:06:00-000, 210, 157, 53, 10, 1347.60, 3, 1351.00, 201
3, 11:07:00-000, 217, 156, 61, 3, 1348.00, 3, 1351.33, 209
3, 11:08:00-000, 189, 162, 27, 2, 1346.50, 9, 1351.89, 177
3, 11:09:00-000, 212, 195, 17, 2, 1348.00, 0, 0.00, 212
3, 11:10:00-000, 184, 170, 14, 11, 1350.00, 6, 1351.67, 163
3, 11:11:00-000, 210, 168, 42, 9, 1351.44, 12, 1352.66, 197
3, 11:12:00-000, 164, 86, 78, 14, 1347.28, 9, 1351.56, 137
3, 11:13:00-000, 178, 96, 82, 3, 1349.00, 17, 1351.23, 160
3, 11:14:00-000, 191, 159, 32, 8, 1348.37, 3, 1350.33, 182
3, 11:15:00-000, 179, 140, 39, 8, 1349.50, 6, 1350.67, 159
3, 11:16:00-000, 200, 180, 20, 4, 1348.00, 2, 1354.50, 196
3, 11:17:00-000, 193, 149, 44, 13, 1349.54, 13, 1351.38, 161
3, 11:18:00-000, 212, 153, 59, 4, 1348.25, 13, 1349.38, 198
3, 11:19:00-000, 189, 154, 35, 16, 1349.69, 10, 1352.50, 158
3, 11:20:00-000, 199, 151, 48, 12, 1349.08, 8, 1350.87, 190
3, 11:21:00-000, 221, 177, 44, 12, 1351.33, 6, 1352.67, 197
3, 11:22:00-000, 192, 137, 55, 9, 1348.44, 9, 1352.00, 179
3, 11:23:00-000, 185, 140, 45, 0, 0.00, 12, 1350.50, 163
3, 11:24:00-000, 210, 182, 28, 6, 1349.00, 4, 1351.00, 205
3, 11:25:00-000, 179, 138, 41, 3, 1349.00, 2, 1350.00, 180
3, 11:26:00-000, 214, 186, 28, 12, 1348.75, 13, 1351.46, 190
3, 11:27:00-000, 192, 153, 39, 9, 1351.56, 12, 1350.92, 169
3, 11:28:00-000, 256, 229, 27, 15, 1348.13, 0, 0.00, 243
3, 11:29:00-000, 211, 168, 43, 6, 1347.33, 12, 1352.33, 187
3, 11:30:00-000, 189, 155, 34, 5, 1347.00, 5, 1351.20, 184
3, 11:31:00-000, 181, 140, 41, 15, 1348.00, 4, 1351.00, 159
3, 11:32:00-000, 212, 120, 92, 7, 1347.57, 3, 1351.33, 206
3, 11:33:00-000, 224, 134, 90, 5, 1350.00, 19, 1350.68, 197
3, 11:34:00-000, 171, 114, 57, 7, 1348.71, 23, 1351.43, 142
3, 11:35:00-000, 202, 169, 33, 9, 1348.00, 4, 1350.00, 190
3, 11:36:00-000, 246, 207, 39, 13, 1347.38, 5, 1350.80, 214
3, 11:37:00-000, 213, 145, 68, 3, 1349.33, 4, 1352.00, 204
3, 11:38:00-000, 228, 129, 99, 12, 1352.58, 15, 1351.47, 212
3, 11:39:00-000, 185, 127, 58, 3, 1347.00, 11, 1351.45, 175
3, 11:40:00-000, 217, 185, 32, 9, 1347.00, 7, 1351.57, 200
3, 11:41:00-000, 191, 156, 35, 3, 1349.00, 8, 1352.87, 181
3, 11:42:00-000, 196, 174, 22, 12, 1348.75, 1, 1353.00, 178
3, 11:43:00-000, 178, 144, 34, 8, 1349.50, 10, 1353.20, 165
3, 11:44:00-000, 179, 153, 26, 11, 1349.82, 13, 1353.46, 153
3, 11:45:00-000, 199, 180, 19, 8, 1346.75, 12, 1352.33, 175
3, 11:46:00-000, 197, 176, 21, 15, 1350.73, 2, 1351.50, 183
3, 11:47:00-000, 206, 144, 62, 10, 1348.70, 4, 1351.75, 185
3, 11:48:00-000, 190, 137, 53, 8, 1349.00, 22, 1351.59, 165
3, 11:49:00-000, 199, 167, 32, 3, 1349.00, 7, 1351.00, 189
3, 11:50:00-000, 211, 164, 47, 25, 1347.60, 5, 1351.80, 178
3, 11:51:00-000, 198, 124, 74, 2, 1349.50, 11, 1351.27, 186
3, 11:52:00-000, 202, 135, 67, 9, 1347.44, 11, 1350.73, 186
3, 11:53:00-000, 219, 151, 68, 13, 1346.31, 13, 1351.69, 197
3, 11:54:00-000, 222, 163, 59, 8, 1348.25, 14, 1351.64, 201
3, 11:55:00-000, 179, 149, 30, 10, 1350.70, 19, 1351.73, 150
3, 11:56:00-000, 214, 169, 45, 15, 1347.27, 3, 1352.00, 187
3, 11:57:00-000, 199, 141, 58, 9, 1348.33, 6, 1351.00, 185
3, 11:58:00-000, 188, 125, 63, 2, 1348.00, 4, 1350.75, 177
3, 11:59:00-000, 209, 150, 59, 15, 1347.86, 11, 1351.18, 187
3, 12:00:00-000, 190, 124, 66, 9, 1346.55, 15, 1351.33, 165
3, 12:01:00-000, 206, 161, 45, 9, 1348.89, 14, 1351.43, 189
3, 12:02:00-000, 225, 152, 73, 18, 1350.05, 14, 1350.64, 195
3, 12:03:00-000, 239, 152, 87, 13, 1349.54, 9, 1350.89, 209
3, 12:04:00-000, 190, 134, 56, 9, 1349.22, 17, 1350.58, 173
3, 12:05:00-000, 206, 161, 45, 5, 1349.40, 9, 1350.11, 191
3, 12:06:00-000, 230, 186, 44, 13, 1347.61, 8, 1350.12, 208
3, 12:07:00-000, 214, 147, 67, 8, 1350.50, 11, 1352.91, 180
3, 12:08:00-000, 180, 145, 35, 8, 1348.62, 10, 1350.90, 179
3, 12:09:00-000, 157, 131, 26, 1, 1348.00, 5, 1352.80, 135
3, 12:10:00-000, 193, 184, 9, 7, 1349.00, 6, 1350.17, 196
3, 12:11:00-000, 201, 180, 21, 12, 1348.08, 6, 1351.17, 172
3, 12:12:00-000, 236, 215, 21, 10, 1350.90, 15, 1351.67, 221
3, 12:13:00-000, 191, 162, 29, 8, 1351.12, 8, 1352.00, 174
3, 12:14:00-000, 230, 199, 31, 11, 1348.63, 6, 1351.50, 202
3, 12:15:00-000, 190, 162, 28, 9, 1349.11, 11, 1351.82, 174
3, 12:16:00-000, 202, 146, 56, 9, 1348.22, 9, 1351.55, 183
3, 12:17:00-000, 179, 130, 49, 16, 1349.19, 5, 1352.60, 161
3, 12:18:00-000, 230, 174, 56, 15, 1350.33, 23, 1352.74, 195
3, 12:19:00-000, 209, 174, 35, 0, 0.00, 11, 1352.54, 187
3, 12:20:00-000, 201, 158, 43, 5, 1345.80, 3, 1351.00, 209
3, 12:21:00-000, 183, 144, 39, 5, 1349.20, 3, 1352.00, 170
3, 12:22:00-000, 210, 181, 29, 9, 1347.89, 4, 1350.75, 192
3, 12:23:00-000, 257, 227, 30, 10, 1347.60, 6, 1350.50, 247
3, 12:24:00-000, 192, 111, 81, 13, 1348.85, 14, 1350.21, 164
3, 12:25:00-000, 225, 183, 42, 14, 1347.93, 10, 1351.70, 193
3, 12:26:00-000, 197, 164, 33, 15, 1349.33, 15, 1351.27, 173
3, 12:27:00-000, 204, 158, 46, 5, 1349.80, 13, 1352.77, 179
3, 12:28:00-000, 218, 160, 58, 13, 1347.46, 6, 1352.00, 202
3, 12:29:00-000, 192, 178, 14, 2, 1347.50, 1, 1350.00, 197
3, 12:30:00-000, 206, 180, 26, 16, 1348.69, 0, 0.00, 193
3, 12:31:00-000, 225, 162, 63, 11, 1348.36, 12, 1350.67, 192
3, 12:32:00-000, 226, 142, 84, 6, 1347.50, 21, 1350.81, 199
3, 12:33:00-000, 192, 141, 51, 4, 1347.75, 7, 1350.57, 185
3, 12:34:00-000, 200, 132, 68, 16, 1347.19, 5, 1352.60, 183
3, 12:35:00-000, 201, 122, 79, 7, 1349.00, 10, 1351.00, 182
3, 12:36:00-000, 197, 162, 35, 16, 1349.19, 15, 1352.20, 159
3, 12:37:00-000, 186, 151, 35, 7, 1348.86, 6, 1350.83, 183
3, 12:38:00-000, 185, 122, 63, 5, 1350.40, 9, 1351.78, 168
3, 12:39:00-000, 170, 131, 39, 7, 1349.14, 9, 1350.67, 157
3, 12:40:00-000, 173, 133, 40, 15, 1351.86, 9, 1353.00, 142
3, 12:41:00-000, 213, 142, 71, 15, 1350.13, 12, 1351.08, 187
3, 12:42:00-000, 194, 137, 57, 13, 1347.92, 9, 1351.11, 176
3, 12:43:00-000, 215, 136, 79, 0, 0.00, 15, 1350.20, 202
3, 12:44:00-000, 182, 124, 58, 20, 1349.25, 11, 1352.18, 142
3, 12:45:00-000, 203, 150, 53, 12, 1348.58, 12, 1351.08, 179
3, 12:46:00-000, 206, 140, 66, 20, 1347.40, 12, 1351.16, 183
3, 12:47:00-000, 176, 101, 75, 19, 1348.52, 10, 1351.20, 142
3, 12:48:00-000, 179, 117, 62, 5, 1349.20, 25, 1351.24, 155
3, 12:49:00-000, 193, 139, 54, 6, 1351.00, 7, 1352.71, 177
3, 12:50:00-000, 187, 136, 51, 7, 1348.14, 12, 1351.50, 165
3, 12:51:00-000, 212, 157, 55, 2, 1347.50, 2, 1352.00, 214
3, 12:52:00-000, 181, 171, 10, 3, 1351.00, 5, 1353.00, 164
3, 12:53:00-000, 209, 173, 36, 3, 1348.67, 0, 0.00, 213
3, 12:54:00-000, 220, 134, 86, 30, 1349.76, 13, 1351.85, 174
3, 12:55:00-000, 191, 119, 72, 2, 1348.00, 15, 1351.13, 178
3, 12:56:00-000, 175, 119, 56, 12, 1347.00, 9, 1351.78, 155
3, 12:57:00-000, 190, 135, 55, 17, 1348.12, 10, 1350.60, 155
3, 12:58:00-000, 224, 136, 88, 7, 1348.71, 8, 1350.00, 208
3, 12:59:00-000, 189, 122, 67, 2, 1350.50, 4, 1352.00, 189
3, 13:00:00-000, 241, 157, 84, 10, 1349.90, 10, 1351.50, 210
3, 13:01:00-000, 175, 132, 43, 15, 1348.27, 16, 1351.43, 149
3, 13:02:00-000, 214, 131, 83, 12, 1347.92, 11, 1350.36, 192
3, 13:03:00-000, 196, 125, 71, 7, 1346.29, 14, 1351.57, 183
3, 13:04:00-000, 181, 123, 58, 16, 1347.56, 10, 1351.20, 151
3, 13:05:00-000, 214, 142, 72, 12, 1349.17, 13, 1350.62, 191
3, 13:06:00-000, 202, 113, 89, 12, 1348.00, 14, 1352.36, 170
3, 13:07:00-000, 193, 140, 53, 5, 1347.00, 4, 1352.50, 185
3, 13:08:00-000, 195, 143, 52, 8, 1349.87, 16, 1353.50, 174
3, 13:09:00-000, 204, 172, 32, 22, 1348.91, 8, 1351.50, 174
3, 13:10:00-000, 192, 118, 74, 13, 1347.46, 18, 1352.28, 158
3, 13:11:00-000, 216, 143, 73, 13, 1350.54, 17, 1352.12, 181
3, 13:12:00-000, 162, 101, 61, 13, 1347.54, 4, 1351.00, 150
3, 13:13:00-000, 190, 90, 100, 11, 1349.45, 13, 1351.31, 171
3, 13:14:00-000, 221, 163, 58, 7, 1349.14, 17, 1350.94, 198
3, 13:15:00-000, 208, 163, 45, 5, 1350.20, 15, 1352.60, 187
3, 13:16:00-000, 177, 154, 23, 8, 1348.37, 5, 1351.80, 154
3, 13:17:00-000, 170, 116, 54, 16, 1347.69, 3, 1351.00, 162
3, 13:18:00-000, 228, 165, 63, 10, 1348.50, 16, 1350.62, 195
3, 13:19:00-000, 178, 145, 33, 6, 1349.33, 11, 1352.45, 157
3, 13:20:00-000, 175, 109, 66, 16, 1349.31, 8, 1352.50, 161
3, 13:21:00-000, 183, 135, 48, 10, 1348.20, 10, 1350.80, 162
3, 13:22:00-000, 213, 188, 25, 7, 1349.00, 6, 1351.67, 202
3, 13:23:00-000, 202, 143, 59, 12, 1349.50, 3, 1350.33, 186
3, 13:24:00-000, 194, 135, 59, 14, 1347.36, 13, 1350.61, 166
3, 13:25:00-000, 180, 93, 87, 12, 1349.00, 15, 1351.20, 151
3, 13:26:00-000, 208, 142, 66, 11, 1348.09, 15, 1351.93, 182
3, 13:27:00-000, 170, 118, 52, 0, 0.00, 6, 1351.00, 165
3, 13:28:00-000, 209, 166, 43, 10, 1348.20, 3, 1350.67, 198
3, 13:29:00-000, 224, 114, 110, 11, 1348.09, 11, 1350.54, 191
3, 13:30:00-000, 197, 144, 53, 14, 1348.71, 17, 1351.47, 177
3, 13:31:00-000, 239, 152, 87, 3, 1348.00, 9, 1350.22, 223
3, 13:32:00-000, 165, 122, 43, 7, 1344.71, 4, 1350.25, 159
3, 13:33:00-000, 216, 153, 63, 6, 1348.33, 12, 1351.08, 198
3, 13:34:00-000, 201, 160, 41, 9, 1347.22, 0, 0.00, 183
3, 13:35:00-000, 222, 153, 69, 3, 1350.00, 4, 1350.50, 222
3, 13:36:00-000, 182, 127, 55, 14, 1347.93, 6, 1351.83, 159
3, 13:37:00-000, 228, 138, 90, 8, 1347.75, 10, 1350.90, 198
3, 13:38:00-000, 194, 127, 67, 9, 1349.00, 15, 1350.53, 185
3, 13:39:00-000, 220, 174, 46, 20, 1349.20, 15, 1350.53, 187
3, 13:40:00-000, 187, 139, 48, 8, 1350.37, 20, 1352.50, 150
3, 13:41:00-000, 196, 165, 31, 5, 1350.60, 9, 1351.89, 187
3, 13:42:00-000, 204, 158, 46, 11, 1348.82, 3, 1351.33, 194
3, 13:43:00-000, 191, 135, 56, 5, 1351.80, 1, 1351.00, 184
3, 13:44:00-000, 203, 158, 45, 11, 1350.00, 26, 1351.42, 165
3, 13:45:00-000, 173, 152, 21, 8, 1348.25, 6, 1352.67, 158
3, 13:46:00-000, 184, 170, 14, 16, 1347.87, 3, 1352.33, 167
3, 13:47:00-000, 242, 198, 44, 4, 1349.25, 4, 1350.00, 228
3, 13:48:00-000, 223, 152, 71, 8, 1347.25, 15, 1350.27, 199
3, 13:49:00-000, 213, 153, 60, 15, 1349.06, 10, 1351.10, 190
3, 13:50:00-000, 196, 129, 67, 25, 1349.24, 8, 1351.00, 157
3, 13:51:00-000, 188, 124, 64, 8, 1350.87, 20, 1352.10, 171
3, 13:52:00-000, 218, 154, 64, 7, 1349.57, 22, 1351.77, 179
3, 13:53:00-000, 178, 137, 41, 8, 1347.37, 2, 1351.00, 175
3, 13:54:00-000, 186, 121, 65, 19, 1351.31, 17, 1351.70, 153
3, 13:55:00-000, 216, 160, 56, 9, 1349.78, 4, 1352.75, 200
3, 13:56:00-000, 219, 166, 53, 18, 1348.05, 25, 1350.96, 173
3, 13:57:00-000, 217, 156, 61, 18, 1348.66, 8, 1350.87, 196
3, 13:58:00-000, 195, 128, 67, 4, 1347.50, 10, 1351.20, 181
3, 13:59:00-000, 217, 163, 54, 5, 1349.20, 9, 1349.11, 204
3, 14:00:00-000, 167, 128, 39, 20, 1347.10, 8, 1350.12, 135
3, 14:01:00-000, 219, 155, 64, 2, 1345.50, 11, 1350.73, 202
3, 14:02:00-000, 212, 149, 63, 26, 1347.27, 9, 1350.44, 175
3, 14:03:00-000, 185, 101, 84, 4, 1345.00, 1, 1351.00, 190
3, 14:04:00-000, 204, 124, 80, 5, 1348.40, 16, 1350.69, 179
3, 14:05:00-000, 213, 132, 81, 8, 1347.50, 10, 1350.90, 199
3, 14:06:00-000, 214, 138, 76, 4, 1350.25, 13, 1351.00, 195
3, 14:07:00-000, 182, 153, 29, 1, 1352.00, 5, 1350.40, 178
3, 14:08:00-000, 178, 130, 48, 15, 1349.40, 8, 1350.12, 156
3, 14:09:00-000, 217, 184, 33, 2, 1348.00, 8, 1350.88, 203
3, 14:10:00-000, 238, 164, 74, 26, 1348.46, 18, 1351.22, 196
3, 14:11:00-000, 262, 161, 101, 17, 1347.06, 6, 1351.17, 230
3, 14:12:00-000, 219, 118, 101, 3, 1348.00, 9, 1348.00, 212
3, 14:13:00-000, 207, 136, 71, 8, 1349.25, 12, 1351.41, 188
3, 14:14:00-000, 208, 127, 81, 4, 1349.50, 17, 1351.64, 182
3, 14:15:00-000, 200, 157, 43, 3, 1348.00, 5, 1350.00, 202
3, 14:16:00-000, 187, 152, 35, 15, 1348.27, 10, 1352.70, 162
3, 14:17:00-000, 202, 139, 63, 17, 1348.17, 6, 1351.00, 173
3, 14:18:00-000, 232, 161, 71, 11, 1347.64, 26, 1351.08, 193
3, 14:19:00-000, 172, 124, 48, 18, 1347.50, 9, 1350.33, 154
3, 14:20:00-000, 222, 164, 58, 18, 1347.83, 10, 1351.20, 191
3, 14:21:00-000, 197, 117, 80, 6, 1346.83, 5, 1351.20, 187
3, 14:22:00-000, 183, 133, 50, 12, 1349.33, 13, 1351.08, 159
3, 14:23:00-000, 190, 163, 27, 2, 1349.50, 5, 1350.20, 181
3, 14:24:00-000, 232, 167, 65, 18, 1346.83, 6, 1350.50, 206
3, 14:25:00-000, 223, 176, 47, 13, 1346.92, 12, 1351.25, 196
3, 14:26:00-000, 221, 100, 121, 23, 1347.69, 26, 1350.73, 169
3, 14:27:00-000, 233, 141, 92, 1, 1351.00, 24, 1351.37, 202
3, 14:28:00-000, 208, 156, 52, 7, 1349.00, 8, 1351.75, 206
3, 14:29:00-000, 183, 141, 42, 2, 1347.50, 8, 1351.12, 176
3, 14:30:00-000, 205, 171, 34, 16, 1348.25, 3, 1351.33, 179
3, 14:31:00-000, 243, 163, 80, 18, 1350.66, 23, 1351.65, 200
3, 14:32:00-000, 197, 164, 33, 12, 1349.58, 6, 1351.33, 177
3, 14:33:00-000, 220, 180, 40, 7, 1347.28, 15, 1351.80, 204
3, 14:34:00-000, 181, 167, 14, 23, 1347.61, 4, 1350.50, 155
3, 14:35:00-000, 216, 128, 88, 9, 1345.78, 5, 1350.40, 201
3, 14:36:00-000, 223, 142, 81, 12, 1350.41, 32, 1350.68, 175
3, 14:37:00-000, 209, 126, 83, 6, 1349.67, 11, 1350.54, 190
3, 14:38:00-000, 210, 168, 42, 18, 1349.28, 11, 1351.63, 191
3, 14:39:00-000, 212, 177, 35, 16, 1353.25, 20, 1352.75, 175
3, 14:40:00-000, 227, 198, 29, 16, 1348.25, 4, 1351.75, 202
3, 14:41:00-000, 199, 154, 45, 18, 1348.89, 6, 1350.67, 172
3, 14:42:00-000, 188, 80, 108, 10, 1347.80, 17, 1351.00, 166
3, 14:43:00-000, 193, 116, 77, 5, 1346.80, 13, 1350.69, 179
3, 14:44:00-000, 218, 140, 78, 11, 1346.54, 7, 1349.86, 182
3, 14:45:00-000, 182, 137, 45, 4, 1348.00, 6, 1349.67, 183
3, 14:46:00-000, 192, 157, 35, 14, 1351.07, 3, 1353.33, 177
3, 14:47:00-000, 203, 128, 75, 0, 0.00, 3, 1350.67, 203
3, 14:48:00-000, 189, 125, 64, 5, 1347.00, 8, 1351.87, 178
3, 14:49:00-000, 231, 145, 86, 6, 1349.33, 11, 1350.82, 209
3, 14:50:00-000, 198, 141, 57, 8, 1347.88, 8, 1351.37, 186
3, 14:51:00-000, 204, 154, 50, 0, 0.00, 4, 1350.75, 194
3, 14:52:00-000, 190, 154, 36, 17, 1348.47, 15, 1352.00, 161
3, 14:53:00-000, 213, 146, 67, 10, 1347.50, 10, 1350.80, 195
3, 14:54:00-000, 219, 167, 52, 20, 1349.05, 19, 1353.05, 179
3, 14:55:00-000, 210, 170, 40, 13, 1349.08, 12, 1352.41, 182
3, 14:56:00-000, 201, 147, 54, 13, 1349.46, 13, 1352.07, 170
3, 14:57:00-000, 227, 169, 58, 11, 1348.63, 13, 1350.77, 214
3, 14:58:00-000, 170, 145, 25, 21, 1350.38, 9, 1352.22, 141
3, 14:59:00-000, 219, 148, 71, 11, 1346.36, 10, 1352.10, 192
3, 15:00:00-000, 192, 106, 86, 6, 1345.67, 11, 1350.45, 179
3, 15:01:00-000, 196, 135, 61, 15, 1346.20, 3, 1351.67, 174
3, 15:02:00-000, 225, 131, 94, 9, 1349.22, 18, 1349.39, 204
3, 15:03:00-000, 189, 84, 105, 2, 1349.00, 6, 1350.83, 181
3, 15:04:00-000, 212, 136, 76, 13, 1346.62, 14, 1350.43, 177
3, 15:05:00-000, 247, 183, 64, 15, 1347.13, 21, 1350.43, 205
3, 15:06:00-000, 197, 160, 37, 12, 1349.08, 17, 1351.76, 178
3, 15:07:00-000, 190, 170, 20, 3, 1349.00, 13, 1351.38, 178
3, 15:08:00-000, 210, 188, 22, 11, 1351.00, 1, 1350.00, 196
3, 15:09:00-000, 183, 160, 23, 11, 1347.45, 4, 1350.25, 167
3, 15:10:00-000, 235, 162, 73, 14, 1348.36, 12, 1351.17, 212
3, 15:11:00-000, 222, 129, 93, 10, 1345.60, 9, 1350.44, 202
3, 15:12:00-000, 213, 98, 115, 10, 1347.40, 12, 1351.42, 188
3, 15:13:00-000, 195, 167, 28, 4, 1350.25, 8, 1351.50, 180
3, 15:14:00-000, 220, 172, 48, 12, 1349.42, 5, 1352.00, 201
3, 15:15:00-000, 224, 152, 72, 3, 1347.67, 10, 1350.50, 216
3, 15:16:00-000, 226, 173, 53, 21, 1349.14, 16, 1352.12, 187
3, 15:17:00-000, 203, 143, 60, 9, 1348.78, 17, 1350.88, 181
3, 15:18:00-000, 213, 166, 47, 18, 1348.22, 17, 1351.12, 171
3, 15:19:00-000, 184, 132, 52, 8, 1348.25, 5, 1350.80, 178
3, 15:20:00-000, 240, 160, 80, 14, 1347.71, 13, 1351.08, 213
3, 15:21:00-000, 209, 158, 51, 5, 1346.80, 6, 1350.50, 192
3, 15:22:00-000, 195, 142, 53, 14, 1348.28, 7, 1351.43, 175
3, 15:23:00-000, 226, 123, 103, 2, 1347.50, 3, 1351.33, 220
3, 15:24:00-000, 217, 124, 93, 3, 1348.00, 17, 1351.17, 203
3, 15:25:00-000, 233, 213, 20, 8, 1348.00, 5, 1352.40, 210
3, 15:26:00-000, 183, 158, 25, 10, 1348.10, 5, 1350.80, 180
3, 15:27:00-000, 227, 171, 56, 8, 1349.50, 6, 1350.83, 210
3, 15:28:00-000, 211, 163, 48, 16, 1349.56, 11, 1350.45, 184
3, 15:29:00-000, 209, 160, 49, 10, 1350.20, 10, 1351.40, 187
3, 15:30:00-000, 218, 156, 62, 20, 1349.65, 41, 1351.43, 159
3, 15:31:00-000, 226, 195, 31, 10, 1350.90, 5, 1350.60, 207
3, 15:32:00-000, 196, 158, 38, 20, 1347.80, 8, 1350.75, 159
3, 15:33:00-000, 188, 137, 51, 2, 1347.50, 19, 1350.89, 176
3, 15:34:00-000, 180, 115, 65, 10, 1349.00, 15, 1349.46, 160
3, 15:35:00-000, 241, 186, 55, 5, 1347.40, 2, 1350.00, 225
3, 15:36:00-000, 219, 161, 58, 6, 1346.67, 5, 1349.80, 206
3, 15:37:00-000, 241, 197, 44, 21, 1348.62, 5, 1351.40, 224
3, 15:38:00-000, 230, 169, 61, 10, 1348.20, 12, 1350.58, 204
3, 15:39:00-000, 220, 164, 56, 12, 1349.08, 14, 1351.28, 200
3, 15:40:00-000, 210, 139, 71, 19, 1348.95, 7, 1351.43, 182
3, 15:41:00-000, 199, 122, 77, 5, 1348.60, 19, 1350.89, 174
3, 15:42:00-000, 165, 128, 37, 17, 1348.94, 8, 1351.75, 143
3, 15:43:00-000, 228, 134, 94, 5, 1348.00, 10, 1349.70, 210
3, 15:44:00-000, 198, 93, 105, 15, 1348.00, 9, 1351.22, 174
3, 15:45:00-000, 191, 132, 59, 2, 1348.50, 13, 1351.85, 175
3, 15:46:00-000, 239, 203, 36, 11, 1349.64, 5, 1350.60, 219
3, 15:47:00-000, 201, 165, 36, 2, 1347.00, 10, 1350.60, 197
3, 15:48:00-000, 220, 144, 76, 17, 1349.12, 25, 1351.44, 173
3, 15:49:00-000, 185, 147, 38, 13, 1347.77, 3, 1351.33, 169
3, 15:50:00-000, 199, 149, 50, 34, 1348.03, 16, 1350.81, 155
3, 15:51:00-000, 192, 122, 70, 4, 1348.50, 9, 1349.89, 179
3, 15:52:00-000, 187, 128, 59, 10, 1348.40, 4, 1350.75, 168
3, 15:53:00-000, 194, 123, 71, 14, 1349.21, 16, 1350.81, 170
3, 15:54:00-000, 173, 91, 82, 18, 1347.55, 13, 1351.15, 140
3, 15:55:00-000, 234, 104, 130, 2, 1348.00, 3, 1350.00, 229
3, 15:56:00-000, 216, 116, 100, 9, 1346.11, 23, 1350.56, 184
3, 15:57:00-000, 180, 119, 61, 9, 1349.67, 17, 1352.23, 154
3, 15:58:00-000, 217, 140, 77, 23, 1348.43, 13, 1350.77, 183
3, 15:59:00-000, 198, 143, 55, 6, 1348.83, 6, 1351.00, 168
3, 16:00:00-000, 205, 140, 65, 11, 1348.09, 11, 1352.45, 192
3, 16:01:00-000, 220, 144, 76, 4, 1348.50, 9, 1350.78, 210
3, 16:02:00-000, 196, 147, 49, 25, 1349.24, 11, 1351.09, 160
3, 16:03:00-000, 185, 133, 52, 3, 1348.33, 11, 1351.00, 169
3, 16:04:00-000, 195, 126, 69, 10, 1347.30, 14, 1351.71, 168
3, 16:05:00-000, 220, 114, 106, 14, 1347.86, 19, 1351.95, 183
3, 16:06:00-000, 220, 145, 75, 6, 1347.00, 13, 1352.61, 214
3, 16:07:00-000, 217, 128, 89, 12, 1348.42, 4, 1350.00, 196
3, 16:08:00-000, 189, 136, 53, 9, 1349.89, 12, 1352.25, 167
3, 16:09:00-000, 184, 162, 22, 0, 0.00, 4, 1352.75, 185
3, 16:10:00-000, 201, 157, 44, 22, 1348.77, 14, 1351.07, 167
3, 16:11:00-000, 225, 192, 33, 3, 1348.00, 5, 1350.40, 206
3, 16:12:00-000, 199, 179, 20, 9, 1351.33, 7, 1351.29, 181
3, 16:13:00-000, 195, 160, 35, 9, 1348.89, 15, 1351.26, 182
3, 16:14:00-000, 197, 152, 45, 17, 1348.82, 15, 1352.73, 168
3, 16:15:00-000, 167, 145, 22, 1, 1349.00, 8, 1349.25, 157
3, 16:16:00-000, 219, 174, 45, 25, 1348.88, 7, 1350.43, 187
3, 16:17:00-000, 193, 136, 57, 11, 1351.64, 13, 1351.61, 167
3, 16:18:00-000, 184, 144, 40, 11, 1348.45, 11, 1350.63, 165
3, 16:19:00-000, 226, 169, 57, 7, 1352.86, 7, 1351.71, 211
3, 16:20:00-000, 215, 126, 89, 18, 1348.22, 15, 1350.60, 181
3, 16:21:00-000, 207, 142, 65, 4, 1348.25, 10, 1350.90, 184
3, 16:22:00-000, 175, 123, 52, 12, 1348.08, 17, 1350.59, 149
3, 16:23:00-000, 209, 147, 62, 1, 1347.00, 4, 1351.50, 202
3, 16:24:00-000, 201, 161, 40, 11, 1349.64, 11, 1352.82, 185
3, 16:25:00-000, 195, 185, 10, 8, 1349.87, 4, 1353.75, 186
3, 16:26:00-000, 239, 201, 38, 18, 1348.22, 12, 1351.33, 210
3, 16:27:00-000, 222, 167, 55, 6, 1348.33, 9, 1349.67, 199
3, 16:28:00-000, 212, 151, 61, 12, 1346.75, 9, 1351.00, 188
3, 16:29:00-000, 230, 153, 77, 15, 1347.40, 24, 1350.41, 198
4, 09:03:00-000, 269, 269, 0, 0, 0.00, 0, 0.00, 268
4, 09:04:00-000, 0, 0, 0, 0, 0.00, 0, 0.00, 1
4, 09:06:00-000, 298, 298, 0, 296, 1351.02, 0, 0.00, 0
4, 09:07:00-000, 5, 5, 0, 1, 1352.00, 0, 0.00, 3
4, 09:08:00-000, 43, 35, 8, 8, 1354.00, 8, 1354.00, 23
4, 09:09:00-000, 95, 73, 22, 22, 1374.99, 22, 1374.99, 31
4, 09:10:00-000, 92, 81, 11, 11, 1413.36, 11, 1413.36, 82
4, 09:11:00-000, 87, 70, 17, 17, 1461.23, 17, 1461.23, 62
4, 09:12:00-000, 84, 73, 11, 11, 1484.36, 11, 1484.36, 51
4, 09:13:00-000, 66, 55, 11, 46, 1399.73, 8, 1462.50, 23
4, 09:14:00-000, 75, 61, 14, 58, 1356.97, 9, 1356.00, 13
4, 09:15:00-000, 95, 86, 9, 76, 1357.50, 3, 1354.33, 16
4, 09:16:00-000, 77, 50, 27, 29, 1365.82, 27, 1366.00, 20
4, 09:17:00-000, 74, 35, 39, 35, 1358.45, 37, 1360.91, 3
4, 09:18:00-000, 74, 43, 31, 36, 1358.88, 25, 1355.48, 4
4, 09:19:00-000, 90, 47, 43, 48, 1354.80, 45, 1354.53, 6
4, 09:20:00-000, 83, 44, 39, 42, 1350.92, 37, 1351.05, 1
4, 09:21:00-000, 101, 46, 55, 42, 1351.23, 56, 1350.42, 2
4, 09:22:00-000, 80, 30, 50, 35, 1350.37, 36, 1350.27, 3
4, 09:23:00-000, 89, 27, 62, 27, 1349.22, 41, 1349.11, 17
4, 09:24:00-000, 82, 43, 39, 34, 1374.17, 46, 1360.54, 2
4, 09:25:00-000, 109, 64, 45, 43, 1397.92, 40, 1394.87, 28
4, 09:26:00-000, 78, 43, 35, 49, 1360.09, 32, 1359.21, 4
4, 09:27:00-000, 84, 41, 43, 40, 1351.57, 40, 1351.07, 8
4, 09:28:00-000, 76, 41, 35, 38, 1351.02, 35, 1350.88, 3
4, 09:29:00-000, 87, 41, 46, 32, 1352.78, 36, 1352.69, 14
4, 09:30:00-000, 85, 32, 53, 32, 1350.84, 53, 1351.22, 3
4, 09:31:00-000, 89, 47, 42, 46, 1351.06, 35, 1350.68, 4
4, 09:32:00-000, 90, 39, 51, 39, 1350.58, 48, 1350.39, 5
4, 09:33:00-000, 94, 50, 44, 39, 1351.45, 49, 1352.01, 3
4, 09:34:00-000, 92, 50, 42, 56, 1352.90, 39, 1352.99, 5
4, 09:35:00-000, 70, 31, 39, 28, 1349.21, 25, 1349.64, 8
4, 09:36:00-000, 82, 45, 37, 45, 1350.95, 35, 1351.11, 9
4, 09:37:00-000, 68, 42, 26, 36, 1352.52, 20, 1351.90, 4
4, 09:38:00-000, 100, 32, 68, 31, 1351.09, 62, 1351.26, 5
4, 09:39:00-000, 82, 33, 49, 32, 1349.81, 44, 1349.76, 17
4, 09:40:00-000, 76, 40, 36, 40, 1351.37, 28, 1350.92, 9
4, 09:41:00-000, 97, 40, 57, 38, 1349.44, 52, 1349.49, 3
4, 09:42:00-000, 58, 27, 31, 30, 1352.39, 23, 1352.34, 2
4, 09:43:00-000, 96, 50, 46, 50, 1350.87, 44, 1350.58, 6
4, 09:44:00-000, 84, 39, 45, 38, 1353.91, 37, 1353.64, 6
4, 09:45:00-000, 69, 41, 28, 39, 1351.20, 19, 1350.63, 12
4, 09:46:00-000, 69, 32, 37, 32, 1351.90, 35, 1352.25, 3
4, 09:47:00-000, 63, 24, 39, 24, 1350.99, 36, 1351.24, 3
4, 09:48:00-000, 79, 42, 37, 42, 1353.92, 34, 1350.79, 7
4, 09:49:00-000, 69, 27, 42, 26, 1354.61, 25, 1353.12, 11
4, 09:50:00-000, 72, 34, 38, 31, 1350.67, 42, 1350.94, 1
4, 09:51:00-000, 83, 39, 44, 40, 1351.34, 40, 1351.69, 4
4, 09:52:00-000, 83, 48, 35, 49, 1354.24, 31, 1354.25, 3
4, 09:53:00-000, 83, 47, 36, 41, 1350.99, 27, 1349.99, 9
4, 09:54:00-000, 83, 35, 48, 38, 1351.47, 36, 1351.83, 10
4, 09:55:00-000, 78, 43, 35, 45, 1352.50, 34, 1352.79, 7
4, 09:56:00-000, 89, 40, 49, 40, 1350.94, 48, 1351.49, 0
4, 09:57:00-000, 82, 44, 38, 37, 1352.53, 33, 1352.51, 10
4, 09:58:00-000, 81, 31, 50, 29, 1350.20, 42, 1350.21, 6
4, 09:59:00-000, 93, 31, 62, 24, 1348.25, 37, 1348.89, 19
4, 10:00:00-000, 86, 36, 50, 36, 1349.36, 53, 1350.33, 0
4, 10:01:00-000, 95, 55, 40, 55, 1350.61, 48, 1350.85, 9
4, 10:02:00-000, 77, 36, 41, 29, 1352.75, 35, 1352.59, 9
4, 10:03:00-000, 100, 52, 48, 50, 1353.91, 37, 1353.80, 9
4, 10:04:00-000, 74, 36, 38, 30, 1350.79, 43, 1351.50, 3
4, 10:05:00-000, 87, 48, 39, 45, 1352.66, 35, 1352.02, 3
4, 10:06:00-000, 68, 37, 31, 44, 1351.29, 28, 1352.00, 2
4, 10:07:00-000, 107, 62, 45, 56, 1352.88, 42, 1353.35, 6
4, 10:08:00-000, 89, 32, 57, 35, 1351.54, 50, 1351.01, 1
4, 10:09:00-000, 61, 37, 24, 36, 1352.66, 18, 1351.33, 15
4, 10:10:00-000, 67, 25, 42, 24, 1350.08, 28, 1350.46, 8
4, 10:11:00-000, 73, 33, 40, 33, 1350.96, 40, 1350.72, 6
4, 10:12:00-000, 82, 33, 49, 33, 1347.45, 44, 1348.26, 8
4, 10:13:00-000, 63, 20, 43, 17, 1349.64, 34, 1348.82, 4
4, 10:14:00-000, 96, 49, 47, 51, 1350.38, 41, 1350.04, 5
4, 10:15:00-000, 83, 50, 33, 45, 1350.99, 40, 1351.12, 1
4, 10:16:00-000, 57, 17, 40, 23, 1349.34, 23, 1348.82, 10
4, 10:17:00-000, 82, 45, 37, 45, 1351.06, 34, 1350.93, 3
4, 10:18:00-000, 74, 23, 51, 22, 1351.40, 42, 1350.75, 10
4, 10:19:00-000, 76, 36, 40, 36, 1350.91, 39, 1351.07, 4
4, 10:20:00-000, 76, 40, 36, 40, 1352.37, 37, 1351.86, 1
4, 10:21:00-000, 92, 28, 64, 28, 1350.92, 44, 1351.56, 12
4, 10:22:00-000, 63, 28, 35, 23, 1349.91, 36, 1349.63, 2
4, 10:23:00-000, 87, 52, 35, 49, 1349.07, 38, 1348.86, 4
4, 10:24:00-000, 77, 26, 51, 31, 1348.06, 38, 1347.81, 12
4, 10:25:00-000, 88, 56, 32, 49, 1350.44, 23, 1349.65, 15
4, 10:26:00-000, 74, 37, 37, 32, 1349.12, 33, 1349.54, 5
4, 10:27:00-000, 104, 48, 56, 45, 1351.66, 44, 1351.88, 12
4, 10:28:00-000, 64, 30, 34, 32, 1350.12, 36, 1350.80, 1
4, 10:29:00-000, 112, 60, 52, 58, 1351.85, 38, 1352.49, 12
4, 10:30:00-000, 78, 33, 45, 34, 1350.11, 45, 1351.23, 6
4, 10:31:00-000, 97, 48, 49, 48, 1353.28, 43, 1352.90, 1
4, 10:32:00-000, 84, 41, 43, 38, 1350.47, 44, 1350.97, 7
4, 10:33:00-000, 99, 64, 35, 63, 1352.89, 36, 1352.41, 2
4, 10:34:00-000, 68, 26, 42, 26, 1350.15, 37, 1350.61, 3
4, 10:35:00-000, 97, 50, 47, 47, 1351.33, 48, 1350.99, 3
4, 10:36:00-000, 73, 37, 36, 34, 1351.70, 34, 1351.55, 0
4, 10:37:00-000, 94, 41, 53, 38, 1350.25, 45, 1350.34, 6
4, 10:38:00-000, 88, 37, 51, 43, 1350.02, 56, 1350.60, 2
4, 10:39:00-000, 91, 37, 54, 37, 1350.61, 46, 1350.66, 4
4, 10:40:00-000, 78, 48, 30, 38, 1350.89, 20, 1351.00, 0
4, 10:41:00-000, 83, 46, 37, 41, 1350.16, 47, 1350.01, 12
4, 10:42:00-000, 72, 34, 38, 29, 1350.58, 31, 1350.96, 0
4, 10:43:00-000, 93, 50, 43, 60, 1352.39, 43, 1351.27, 7
4, 10:44:00-000, 77, 46, 31, 39, 1351.79, 25, 1351.76, 4
4, 10:45:00-000, 74, 45, 29, 44, 1351.02, 33, 1350.99, 3
4, 10:46:00-000, 110, 52, 58, 56, 1350.47, 50, 1349.63, 4
4, 10:47:00-000, 91, 42, 49, 39, 1349.48, 36, 1348.60, 13
4, 10:48:00-000, 100, 46, 54, 37, 1350.24, 45, 1350.26, 13
4, 10:49:00-000, 74, 37, 37, 36, 1350.82, 39, 1350.84, 7
4, 10:50:00-000, 112, 46, 66, 49, 1351.54, 50, 1350.61, 11
4, 10:51:00-000, 95, 33, 62, 31, 1349.06, 54, 1349.47, 8
4, 10:52:00-000, 68, 28, 40, 23, 1350.82, 34, 1350.79, 7
4, 10:53:00-000, 90, 46, 44, 34, 1351.46, 27, 1351.96, 8
4, 10:54:00-000, 67, 29, 38, 43, 1349.43, 39, 1350.94, 14
4, 10:55:00-000, 64, 30, 34, 31, 1350.83, 30, 1350.96, 3
4, 10:56:00-000, 87, 52, 35, 50, 1352.55, 33, 1352.81, 8
4, 10:57:00-000, 78, 40, 38, 39, 1350.66, 33, 1350.60, 2
4, 10:58:00-000, 75, 25, 50, 22, 1349.36, 41, 1349.75, 8
4, 10:59:00-000, 86, 38, 48, 40, 1350.54, 41, 1349.58, 5
4, 11:00:00-000, 90, 30, 60, 30, 1352.66, 53, 1351.91, 7
4, 11:01:00-000, 101, 46, 55, 46, 1349.86, 36, 1349.83, 10
4, 11:02:00-000, 68, 38, 30, 30, 1351.19, 47, 1350.88, 2
4, 11:03:00-000, 93, 40, 53, 44, 1347.63, 46, 1348.23, 3
4, 11:04:00-000, 82, 34, 48, 34, 1350.14, 43, 1350.27, 0
4, 11:05:00-000, 70, 34, 36, 34, 1351.64, 29, 1351.96, 13
4, 11:06:00-000, 94, 51, 43, 43, 1349.95, 46, 1350.36, 6
4, 11:07:00-000, 65, 32, 33, 28, 1349.49, 28, 1348.67, 7
4, 11:08:00-000, 102, 48, 54, 48, 1350.91, 35, 1350.88, 9
4, 11:09:00-000, 112, 61, 51, 52, 1348.22, 58, 1348.39, 9
4, 11:10:00-000, 63, 39, 24, 40, 1352.77, 21, 1352.95, 3
4, 11:11:00-000, 108, 62, 46, 61, 1352.53, 38, 1352.39, 7
4, 11:12:00-000, 101, 32, 69, 31, 1349.35, 70, 1350.12, 6
4, 11:13:00-000, 71, 46, 25, 41, 1349.55, 29, 1349.41, 2
4, 11:14:00-000, 87, 42, 45, 41, 1349.65, 35, 1349.51, 6
4, 11:15:00-000, 75, 32, 43, 34, 1350.55, 40, 1350.34, 5
4, 11:16:00-000, 82, 38, 44, 38, 1351.52, 40, 1349.79, 4
4, 11:17:00-000, 80, 38, 42, 37, 1352.37, 27, 1351.70, 14
4, 11:18:00-000, 83, 33, 50, 32, 1349.96, 41, 1350.09, 15
4, 11:19:00-000, 84, 45, 39, 44, 1351.45, 40, 1351.34, 1
4, 11:20:00-000, 71, 36, 35, 27, 1350.29, 31, 1350.09, 3
4, 11:21:00-000, 94, 49, 45, 51, 1352.11, 43, 1351.62, 8
4, 11:22:00-000, 78, 35, 43, 35, 1351.93, 42, 1351.64, 0
4, 11:23:00-000, 105, 53, 52, 50, 1350.21, 49, 1350.13, 5
4, 11:24:00-000, 77, 34, 43, 33, 1350.45, 37, 1351.07, 4
4, 11:25:00-000, 82, 34, 48, 30, 1350.36, 40, 1350.37, 11
4, 11:26:00-000, 76, 41, 35, 35, 1349.59, 35, 1349.96, 10
4, 11:27:00-000, 96, 59, 37, 60, 1351.62, 36, 1351.80, 4
4, 11:28:00-000, 87, 41, 46, 25, 1351.76, 39, 1351.07, 8
4, 11:29:00-000, 65, 30, 35, 34, 1352.23, 29, 1351.58, 12
4, 11:30:00-000, 98, 41, 57, 38, 1349.33, 47, 1349.31, 4
4, 11:31:00-000, 48, 27, 21, 25, 1351.24, 20, 1351.20, 11
4, 11:32:00-000, 96, 42, 54, 37, 1349.72, 44, 1350.31, 14
4, 11:33:00-000, 107, 53, 54, 53, 1350.63, 41, 1350.26, 15
4, 11:34:00-000, 66, 34, 32, 34, 1350.70, 30, 1351.33, 2
4, 11:35:00-000, 75, 27, 48, 22, 1349.81, 41, 1350.75, 6
4, 11:36:00-000, 96, 38, 58, 42, 1349.78, 53, 1350.56, 10
4, 11:37:00-000, 79, 34, 45, 32, 1350.21, 37, 1350.02, 7
4, 11:38:00-000, 66, 25, 41, 27, 1352.66, 28, 1352.35, 13
4, 11:39:00-000, 73, 37, 36, 26, 1350.84, 27, 1351.11, 15
4, 11:40:00-000, 88, 42, 46, 38, 1352.15, 43, 1353.15, 3
4, 11:41:00-000, 87, 48, 39, 48, 1351.80, 41, 1351.33, 10
4, 11:42:00-000, 76, 40, 36, 40, 1349.69, 30, 1350.03, 5
4, 11:43:00-000, 103, 46, 57, 41, 1349.84, 59, 1349.92, 1
4, 11:44:00-000, 78, 41, 37, 42, 1352.44, 29, 1351.96, 3
4, 11:45:00-000, 89, 51, 38, 45, 1352.73, 27, 1351.81, 19
4, 11:46:00-000, 83, 44, 39, 46, 1351.77, 38, 1351.47, 0
4, 11:47:00-000, 95, 51, 44, 49, 1350.28, 39, 1350.12, 4
4, 11:48:00-000, 69, 27, 42, 29, 1350.10, 32, 1349.81, 7
4, 11:49:00-000, 90, 48, 42, 48, 1351.49, 39, 1351.40, 2
4, 11:50:00-000, 74, 35, 39, 32, 1350.56, 35, 1351.05, 3
4, 11:51:00-000, 90, 39, 51, 35, 1350.68, 56, 1350.17, 10
4, 11:52:00-000, 81, 38, 43, 38, 1350.97, 38, 1351.20, 4
4, 11:53:00-000, 71, 31, 40, 27, 1351.07, 35, 1350.76, 7
4, 11:54:00-000, 105, 50, 55, 51, 1351.72, 57, 1351.76, 2
4, 11:55:00-000, 82, 53, 29, 42, 1352.16, 27, 1352.00, 12
4, 11:56:00-000, 81, 34, 47, 33, 1349.42, 38, 1349.26, 9
4, 11:57:00-000, 89, 41, 48, 35, 1351.37, 44, 1350.47, 1
4, 11:58:00-000, 81, 22, 59, 28, 1349.32, 43, 1349.41, 12
4, 11:59:00-000, 88, 47, 41, 46, 1351.49, 39, 1351.81, 7
4, 12:00:00-000, 84, 43, 41, 35, 1351.16, 39, 1351.15, 3
4, 12:01:00-000, 97, 62, 35, 62, 1352.94, 37, 1353.10, 8
4, 12:02:00-000, 80, 39, 41, 35, 1350.51, 39, 1350.35, 3
4, 12:03:00-000, 73, 35, 38, 32, 1350.15, 27, 1350.92, 9
4, 12:04:00-000, 104, 54, 50, 53, 1351.16, 51, 1351.37, 0
4, 12:05:00-000, 77, 37, 40, 35, 1349.62, 31, 1349.99, 11
4, 12:06:00-000, 79, 33, 46, 35, 1349.79, 44, 1349.97, 2
4, 12:07:00-000, 76, 35, 41, 35, 1350.77, 36, 1349.61, 8
4, 12:08:00-000, 90, 41, 49, 37, 1350.43, 37, 1351.18, 6
4, 12:09:00-000, 63, 32, 31, 30, 1351.16, 29, 1350.96, 15
4, 12:10:00-000, 87, 41, 46, 44, 1350.42, 40, 1350.69, 0
4, 12:11:00-000, 113, 45, 68, 45, 1350.81, 61, 1350.63, 5
4, 12:12:00-000, 63, 36, 27, 36, 1349.24, 27, 1350.74, 8
4, 12:13:00-000, 82, 41, 41, 37, 1350.94, 32, 1351.56, 9
4, 12:14:00-000, 94, 37, 57, 40, 1351.04, 35, 1350.19, 10
4, 12:15:00-000, 64, 30, 34, 30, 1350.89, 33, 1351.17, 6
4, 12:16:00-000, 88, 40, 48, 41, 1351.53, 54, 1351.78, 2
4, 12:17:00-000, 89, 39, 50, 32, 1350.96, 26, 1350.80, 10
4, 12:18:00-000, 80, 51, 29, 57, 1353.32, 42, 1352.11, 2
4, 12:19:00-000, 65, 28, 37, 24, 1348.79, 26, 1350.19, 2
4, 12:20:00-000, 79, 36, 43, 36, 1350.30, 43, 1350.01, 10
4, 12:21:00-000, 87, 50, 37, 44, 1350.90, 36, 1350.63, 9
4, 12:22:00-000, 87, 33, 54, 32, 1349.84, 39, 1350.20, 7
4, 12:23:00-000, 61, 36, 25, 36, 1350.19, 33, 1350.02, 3
4, 12:24:00-000, 98, 46, 52, 44, 1350.61, 43, 1350.11, 2
4, 12:25:00-000, 85, 38, 47, 35, 1349.68, 35, 1350.13, 11
4, 12:26:00-000, 73, 43, 30, 35, 1351.22, 39, 1351.17, 1
4, 12:27:00-000, 111, 60, 51, 57, 1352.15, 45, 1351.90, 17
4, 12:28:00-000, 82, 38, 44, 41, 1351.01, 37, 1350.75, 5
4, 12:29:00-000, 76, 32, 44, 29, 1350.17, 37, 1349.78, 3
4, 12:30:00-000, 92, 40, 52, 39, 1350.35, 47, 1350.50, 2
4, 12:31:00-000, 73, 24, 49, 23, 1350.73, 37, 1350.64, 12
4, 12:32:00-000, 86, 46, 40, 49, 1350.26, 46, 1350.36, 0
4, 12:33:00-000, 65, 37, 28, 34, 1350.52, 27, 1350.40, 4
4, 12:34:00-000, 69, 22, 47, 17, 1348.58, 36, 1348.66, 7
4, 12:35:00-000, 77, 40, 37, 35, 1350.82, 43, 1350.85, 7
4, 12:36:00-000, 104, 49, 55, 55, 1351.59, 45, 1351.37, 0
4, 12:37:00-000, 92, 50, 42, 46, 1350.19, 41, 1349.62, 10
4, 12:38:00-000, 92, 36, 56, 37, 1348.96, 47, 1350.05, 3
4, 12:39:00-000, 66, 35, 31, 35, 1350.76, 29, 1351.10, 4
4, 12:40:00-000, 78, 51, 27, 29, 1353.06, 35, 1352.68, 2
4, 12:41:00-000, 84, 47, 37, 49, 1351.21, 28, 1350.74, 20
4, 12:42:00-000, 78, 34, 44, 33, 1350.45, 39, 1350.53, 1
4, 12:43:00-000, 67, 38, 29, 35, 1350.54, 32, 1350.93, 6
4, 12:44:00-000, 86, 48, 38, 44, 1351.10, 36, 1351.63, 7
4, 12:45:00-000, 81, 42, 39, 42, 1351.04, 38, 1351.18, 4
4, 12:46:00-000, 92, 33, 59, 33, 1350.21, 44, 1349.83, 8
4, 12:47:00-000, 79, 43, 36, 43, 1350.53, 35, 1350.79, 8
4, 12:48:00-000, 73, 48, 25, 48, 1351.16, 25, 1351.51, 1
4, 12:49:00-000, 104, 60, 44, 55, 1352.30, 30, 1351.59, 4
4, 12:50:00-000, 89, 36, 53, 41, 1351.77, 43, 1352.11, 16
4, 12:51:00-000, 103, 40, 63, 39, 1350.40, 60, 1350.47, 4
4, 12:52:00-000, 74, 32, 42, 29, 1351.03, 39, 1351.79, 3
4, 12:53:00-000, 91, 28, 63, 30, 1350.73, 50, 1350.33, 10
4, 12:54:00-000, 89, 41, 48, 39, 1351.17, 50, 1351.71, 3
4, 12:55:00-000, 56, 25, 31, 25, 1351.24, 18, 1352.28, 8
4, 12:56:00-000, 81, 41, 40, 40, 1350.77, 43, 1350.74, 0
4, 12:57:00-000, 87, 54, 33, 43, 1350.27, 33, 1350.63, 5
4, 12:58:00-000, 74, 34, 40, 45, 1348.26, 35, 1347.71, 1
4, 12:59:00-000, 86, 35, 51, 30, 1351.99, 47, 1350.33, 0
4, 13:00:00-000, 87, 33, 54, 34, 1349.23, 58, 1350.35, 4
4, 13:01:00-000, 71, 55, 16, 50, 1351.17, 17, 1351.29, 7
4, 13:02:00-000, 77, 30, 47, 34, 1351.26, 35, 1348.96, 7
4, 13:03:00-000, 105, 45, 60, 44, 1351.33, 48, 1351.24, 1
4, 13:04:00-000, 90, 43, 47, 42, 1350.52, 50, 1351.43, 6
4, 13:05:00-000, 90, 39, 51, 38, 1349.97, 49, 1350.26, 3
4, 13:06:00-000, 87, 43, 44, 42, 1350.66, 51, 1350.80, 1
4, 13:07:00-000, 74, 30, 44, 31, 1350.99, 43, 1351.27, 0
4, 13:08:00-000, 79, 43, 36, 42, 1351.90, 28, 1351.25, 6
4, 13:09:00-000, 100, 58, 42, 53, 1352.23, 37, 1352.48, 3
4, 13:10:00-000, 57, 28, 29, 36, 1349.58, 23, 1350.65, 0
4, 13:11:00-000, 83, 43, 40, 38, 1351.99, 43, 1351.08, 8
4, 13:12:00-000, 79, 35, 44, 35, 1349.91, 39, 1349.33, 3
4, 13:13:00-000, 87, 43, 44, 43, 1351.04, 29, 1351.62, 12
4, 13:14:00-000, 97, 40, 57, 37, 1350.02, 50, 1350.41, 5
4, 13:15:00-000, 63, 37, 26, 39, 1351.89, 26, 1349.80, 4
4, 13:16:00-000, 85, 37, 48, 35, 1351.19, 51, 1351.09, 6
4, 13:17:00-000, 92, 33, 59, 32, 1349.99, 35, 1350.31, 5
4, 13:18:00-000, 68, 34, 34, 35, 1349.99, 45, 1350.08, 2
4, 13:19:00-000, 70, 42, 28, 41, 1351.67, 28, 1351.42, 6
4, 13:20:00-000, 80, 38, 42, 36, 1352.08, 26, 1351.76, 7
4, 13:21:00-000, 94, 51, 43, 49, 1350.48, 49, 1350.32, 6
4, 13:22:00-000, 75, 32, 43, 35, 1351.11, 25, 1350.60, 5
4, 13:23:00-000, 62, 25, 37, 25, 1350.84, 38, 1351.28, 5
4, 13:24:00-000, 73, 42, 31, 37, 1350.13, 35, 1350.99, 8
4, 13:25:00-000, 90, 35, 55, 35, 1350.08, 36, 1350.41, 0
4, 13:26:00-000, 91, 61, 30, 61, 1352.25, 46, 1351.79, 0
4, 13:27:00-000, 87, 47, 40, 35, 1351.51, 39, 1352.07, 4
4, 13:28:00-000, 94, 45, 49, 50, 1350.03, 40, 1350.12, 6
4, 13:29:00-000, 74, 48, 26, 47, 1349.91, 29, 1350.10, 4
4, 13:30:00-000, 86, 40, 46, 44, 1350.76, 37, 1351.18, 2
4, 13:31:00-000, 76, 36, 40, 33, 1349.08, 36, 1349.74, 6
4, 13:32:00-000, 80, 32, 48, 35, 1347.05, 43, 1347.90, 6
4, 13:33:00-000, 86, 41, 45, 39, 1350.86, 38, 1350.57, 5
4, 13:34:00-000, 77, 32, 45, 34, 1349.58, 46, 1350.34, 1
4, 13:35:00-000, 73, 23, 50, 23, 1350.08, 35, 1350.17, 4
4, 13:36:00-000, 101, 49, 52, 41, 1350.56, 56, 1350.99, 6
4, 13:37:00-000, 80, 29, 51, 33, 1350.05, 42, 1350.18, 8
4, 13:38:00-000, 80, 39, 41, 37, 1349.80, 45, 1350.48, 2
4, 13:39:00-000, 74, 39, 35, 38, 1351.60, 26, 1352.11, 11
4, 13:40:00-000, 81, 53, 28, 43, 1351.97, 26, 1352.84, 5
4, 13:41:00-000, 70, 31, 39, 36, 1351.91, 34, 1352.61, 3
4, 13:42:00-000, 86, 33, 53, 32, 1349.37, 57, 1350.08, 1
4, 13:43:00-000, 81, 38, 43, 35, 1349.93, 42, 1349.70, 4
4, 13:44:00-000, 85, 47, 38, 49, 1351.34, 29, 1352.13, 0
4, 13:45:00-000, 66, 43, 23, 40, 1352.52, 30, 1352.73, 2
4, 13:46:00-000, 90, 51, 39, 48, 1351.72, 41, 1351.68, 8
4, 13:47:00-000, 86, 26, 60, 26, 1349.61, 47, 1350.44, 4
4, 13:48:00-000, 82, 45, 37, 38, 1349.28, 41, 1349.26, 3
4, 13:49:00-000, 63, 36, 27, 39, 1350.74, 20, 1351.10, 7
4, 13:50:00-000, 91, 51, 40, 38, 1352.07, 41, 1351.65, 7
4, 13:51:00-000, 87, 50, 37, 47, 1351.84, 37, 1351.59, 3
4, 13:52:00-000, 113, 45, 68, 49, 1350.54, 47, 1350.63, 5
4, 13:53:00-000, 59, 32, 27, 33, 1349.45, 35, 1349.73, 8
4, 13:54:00-000, 93, 36, 57, 35, 1350.65, 55, 1350.66, 4
4, 13:55:00-000, 93, 39, 54, 38, 1350.41, 43, 1349.81, 6
4, 13:56:00-000, 96, 56, 40, 51, 1351.58, 50, 1351.61, 1
4, 13:57:00-000, 77, 36, 41, 39, 1350.68, 40, 1350.62, 0
4, 13:58:00-000, 58, 16, 42, 18, 1347.55, 32, 1347.53, 4
4, 13:59:00-000, 106, 57, 49, 54, 1350.06, 43, 1349.99, 3
4, 14:00:00-000, 61, 32, 29, 28, 1350.60, 27, 1351.44, 4
4, 14:01:00-000, 81, 55, 26, 48, 1350.16, 22, 1350.49, 16
4, 14:02:00-000, 76, 27, 49, 31, 1349.25, 45, 1349.41, 1
4, 14:03:00-000, 103, 47, 56, 44, 1348.72, 48, 1349.12, 12
4, 14:04:00-000, 84, 47, 37, 49, 1349.28, 38, 1349.75, 4
4, 14:05:00-000, 97, 53, 44, 53, 1351.20, 38, 1350.70, 1
4, 14:06:00-000, 80, 36, 44, 36, 1350.47, 46, 1350.97, 0
4, 14:07:00-000, 78, 39, 39, 37, 1350.26, 39, 1349.97, 4
4, 14:08:00-000, 86, 29, 57, 30, 1350.13, 37, 1350.32, 15
4, 14:09:00-000, 108, 60, 48, 56, 1350.06, 35, 1350.19, 13
4, 14:10:00-000, 78, 39, 39, 39, 1350.74, 40, 1351.14, 3
4, 14:11:00-000, 83, 33, 50, 33, 1350.93, 36, 1351.30, 5
4, 14:12:00-000, 82, 34, 48, 32, 1348.21, 49, 1349.11, 10
4, 14:13:00-000, 90, 35, 55, 34, 1349.11, 46, 1348.86, 1
4, 14:14:00-000, 97, 45, 52, 46, 1350.56, 55, 1350.75, 7
4, 14:15:00-000, 92, 38, 54, 36, 1350.55, 37, 1350.75, 6
4, 14:16:00-000, 70, 27, 43, 27, 1351.96, 47, 1351.90, 2
4, 14:17:00-000, 90, 39, 51, 33, 1348.60, 40, 1349.04, 8
4, 14:18:00-000, 72, 48, 24, 51, 1350.91, 34, 1351.40, 2
4, 14:19:00-000, 97, 61, 36, 53, 1351.78, 31, 1351.80, 7
4, 14:20:00-000, 95, 36, 59, 41, 1349.70, 34, 1349.70, 3
4, 14:21:00-000, 83, 46, 37, 41, 1348.41, 41, 1347.77, 21
4, 14:22:00-000, 71, 37, 34, 41, 1350.51, 35, 1350.85, 2
4, 14:23:00-000, 62, 37, 25, 37, 1350.64, 23, 1350.26, 1
4, 14:24:00-000, 76, 27, 49, 25, 1350.24, 43, 1351.01, 1
4, 14:25:00-000, 82, 33, 49, 35, 1350.36, 42, 1350.68, 4
4, 14:26:00-000, 94, 53, 41, 51, 1349.81, 43, 1349.90, 9
4, 14:27:00-000, 86, 49, 37, 47, 1350.74, 31, 1350.09, 0
4, 14:28:00-000, 77, 31, 46, 34, 1350.67, 47, 1351.20, 0
4, 14:29:00-000, 92, 41, 51, 40, 1350.22, 45, 1350.21, 5
4, 14:30:00-000, 97, 37, 60, 28, 1349.35, 60, 1349.44, 2
4, 14:31:00-000, 91, 46, 45, 54, 1351.40, 45, 1351.68, 2
4, 14:32:00-000, 65, 38, 27, 33, 1351.17, 23, 1350.91, 3
4, 14:33:00-000, 88, 40, 48, 37, 1351.99, 35, 1351.99, 6
4, 14:34:00-000, 101, 41, 60, 49, 1350.09, 62, 1350.57, 5
4, 14:35:00-000, 57, 20, 37, 19, 1349.42, 35, 1350.40, 0
4, 14:36:00-000, 80, 49, 31, 50, 1351.15, 32, 1350.99, 0
4, 14:37:00-000, 69, 39, 30, 39, 1350.99, 28, 1351.17, 5
4, 14:38:00-000, 69, 33, 36, 32, 1351.43, 38, 1351.65, 0
4, 14:39:00-000, 113, 57, 56, 56, 1352.28, 32, 1352.15, 1
4, 14:40:00-000, 74, 37, 37, 25, 1350.47, 51, 1351.64, 15
4, 14:41:00-000, 87, 42, 45, 46, 1349.62, 37, 1349.24, 8
4, 14:42:00-000, 85, 47, 38, 40, 1350.34, 40, 1349.99, 3
4, 14:43:00-000, 78, 41, 37, 47, 1350.20, 36, 1350.58, 1
4, 14:44:00-000, 87, 26, 61, 26, 1346.76, 48, 1346.89, 6
4, 14:45:00-000, 94, 43, 51, 43, 1349.50, 43, 1349.27, 7
4, 14:46:00-000, 73, 39, 34, 38, 1353.18, 25, 1352.44, 6
4, 14:47:00-000, 96, 35, 61, 36, 1349.71, 49, 1350.09, 11
4, 14:48:00-000, 63, 39, 24, 32, 1352.34, 29, 1350.61, 5
4, 14:49:00-000, 76, 42, 34, 37, 1348.43, 25, 1350.15, 16
4, 14:50:00-000, 86, 42, 44, 40, 1347.79, 39, 1347.58, 8
4, 14:51:00-000, 79, 43, 36, 36, 1351.08, 33, 1351.02, 3
4, 14:52:00-000, 88, 45, 43, 46, 1352.14, 39, 1353.48, 1
4, 14:53:00-000, 65, 28, 37, 29, 1350.20, 38, 1350.05, 10
4, 14:54:00-000, 79, 45, 34, 44, 1352.81, 32, 1352.34, 2
4, 14:55:00-000, 83, 33, 50, 33, 1351.12, 45, 1350.68, 6
4, 14:56:00-000, 78, 36, 42, 36, 1353.10, 33, 1351.81, 0
4, 14:57:00-000, 76, 45, 31, 45, 1350.35, 25, 1350.55, 10
4, 14:58:00-000, 66, 38, 28, 38, 1352.68, 22, 1352.68, 10
4, 14:59:00-000, 88, 39, 49, 33, 1349.99, 33, 1351.24, 11
4, 15:00:00-000, 98, 44, 54, 45, 1349.59, 67, 1349.85, 1
4, 15:01:00-000, 78, 22, 56, 22, 1347.63, 35, 1348.82, 5
4, 15:02:00-000, 84, 38, 46, 37, 1349.89, 51, 1349.81, 1
4, 15:03:00-000, 78, 36, 42, 35, 1349.88, 41, 1350.50, 5
4, 15:04:00-000, 90, 42, 48, 37, 1349.56, 42, 1350.04, 5
4, 15:05:00-000, 91, 50, 41, 51, 1350.97, 41, 1350.92, 7
4, 15:06:00-000, 85, 49, 36, 49, 1351.38, 36, 1350.46, 2
4, 15:07:00-000, 80, 42, 38, 34, 1351.40, 40, 1351.44, 2
4, 15:08:00-000, 64, 27, 37, 31, 1350.09, 32, 1349.71, 2
4, 15:09:00-000, 82, 40, 42, 36, 1349.96, 44, 1349.88, 1
4, 15:10:00-000, 93, 44, 49, 51, 1349.64, 32, 1349.53, 5
4, 15:11:00-000, 69, 31, 38, 28, 1350.21, 38, 1349.99, 4
4, 15:12:00-000, 97, 36, 61, 38, 1350.20, 60, 1350.40, 8
4, 15:13:00-000, 84, 35, 49, 34, 1351.14, 31, 1351.28, 8
4, 15:14:00-000, 84, 45, 39, 46, 1351.75, 39, 1351.38, 2
4, 15:15:00-000, 91, 45, 46, 41, 1348.94, 41, 1349.14, 7
4, 15:16:00-000, 79, 41, 38, 42, 1351.66, 48, 1352.26, 1
4, 15:17:00-000, 77, 36, 41, 37, 1350.24, 30, 1349.53, 0
4, 15:18:00-000, 83, 47, 36, 46, 1350.95, 40, 1352.02, 4
4, 15:19:00-000, 88, 47, 41, 46, 1350.69, 36, 1350.35, 2
4, 15:20:00-000, 88, 41, 47, 37, 1349.24, 47, 1349.65, 0
4, 15:21:00-000, 96, 54, 42, 50, 1349.31, 45, 1348.97, 9
4, 15:22:00-000, 72, 44, 28, 43, 1352.04, 24, 1352.66, 4
4, 15:23:00-000, 69, 31, 38, 25, 1348.88, 22, 1349.27, 5
4, 15:24:00-000, 83, 39, 44, 41, 1350.72, 42, 1350.82, 9
4, 15:25:00-000, 78, 31, 47, 28, 1350.42, 49, 1350.28, 7
4, 15:26:00-000, 95, 49, 46, 50, 1351.09, 41, 1351.36, 2
4, 15:27:00-000, 88, 45, 43, 43, 1350.43, 42, 1350.52, 7
4, 15:28:00-000, 69, 19, 50, 19, 1350.42, 32, 1350.46, 13
4, 15:29:00-000, 89, 46, 43, 46, 1351.10, 39, 1350.74, 5
4, 15:30:00-000, 72, 48, 24, 44, 1351.76, 27, 1352.25, 6
4, 15:31:00-000, 86, 44, 42, 39, 1351.91, 32, 1352.12, 5
4, 15:32:00-000, 97, 46, 51, 48, 1350.60, 51, 1350.97, 3
4, 15:33:00-000, 84, 33, 51, 31, 1349.09, 46, 1349.36, 11
4, 15:34:00-000, 74, 37, 37, 36, 1350.05, 37, 1350.27, 1
4, 15:35:00-000, 95, 43, 52, 34, 1350.11, 33, 1350.66, 11
4, 15:36:00-000, 98, 37, 61, 46, 1349.60, 65, 1349.94, 3
4, 15:37:00-000, 79, 44, 35, 44, 1351.58, 33, 1351.18, 1
4, 15:38:00-000, 57, 34, 23, 27, 1349.29, 31, 1350.80, 1
4, 15:39:00-000, 77, 36, 41, 42, 1350.90, 33, 1351.48, 0
4, 15:40:00-000, 100, 52, 48, 50, 1351.05, 49, 1350.99, 6
4, 15:41:00-000, 89, 31, 58, 33, 1350.02, 41, 1349.97, 5
4, 15:42:00-000, 83, 41, 42, 39, 1350.51, 38, 1350.36, 4
4, 15:43:00-000, 100, 48, 52, 46, 1349.10, 44, 1349.11, 7
4, 15:44:00-000, 79, 33, 46, 31, 1349.96, 47, 1350.67, 5
4, 15:45:00-000, 57, 29, 28, 32, 1349.71, 25, 1350.04, 12
4, 15:46:00-000, 88, 47, 41, 46, 1352.25, 36, 1350.49, 5
4, 15:47:00-000, 89, 48, 41, 45, 1349.95, 33, 1350.60, 4
4, 15:48:00-000, 111, 58, 53, 58, 1350.83, 58, 1351.63, 1
4, 15:49:00-000, 83, 38, 45, 40, 1349.89, 31, 1349.48, 0
4, 15:50:00-000, 60, 26, 34, 21, 1350.57, 41, 1351.19, 3
4, 15:51:00-000, 79, 38, 41, 40, 1349.49, 39, 1349.58, 4
4, 15:52:00-000, 78, 35, 43, 33, 1349.11, 41, 1349.68, 0
4, 15:53:00-000, 90, 48, 42, 45, 1349.77, 40, 1350.14, 4
4, 15:54:00-000, 65, 31, 34, 37, 1349.10, 30, 1349.46, 2
4, 15:55:00-000, 87, 29, 58, 28, 1348.35, 45, 1348.41, 13
4, 15:56:00-000, 71, 45, 26, 34, 1351.29, 29, 1349.96, 4
4, 15:57:00-000, 88, 49, 39, 55, 1351.41, 39, 1350.89, 1
4, 15:58:00-000, 80, 36, 44, 41, 1350.41, 40, 1350.37, 2
4, 15:59:00-000, 73, 32, 41, 28, 1349.85, 38, 1349.55, 4
4, 16:00:00-000, 91, 43, 48, 44, 1351.65, 48, 1350.95, 3
4, 16:01:00-000, 53, 19, 34, 21, 1350.66, 23, 1350.73, 0
4, 16:02:00-000, 94, 46, 48, 44, 1351.61, 36, 1351.16, 1
4, 16:03:00-000, 54, 24, 30, 24, 1351.58, 26, 1351.34, 20
4, 16:04:00-000, 90, 46, 44, 44, 1349.79, 41, 1350.38, 3
4, 16:05:00-000, 88, 45, 43, 41, 1350.24, 45, 1349.70, 3
4, 16:06:00-000, 79, 33, 46, 32, 1349.24, 46, 1350.34, 2
4, 16:07:00-000, 86, 27, 59, 28, 1350.46, 41, 1350.24, 6
4, 16:08:00-000, 82, 46, 36, 40, 1351.54, 48, 1351.41, 6
4, 16:09:00-000, 73, 41, 32, 40, 1349.47, 21, 1349.66, 6
4, 16:10:00-000, 81, 38, 43, 41, 1350.99, 39, 1350.87, 3
4, 16:11:00-000, 99, 34, 65, 38, 1350.15, 52, 1349.91, 9
4, 16:12:00-000, 68, 54, 14, 43, 1353.83, 19, 1353.15, 11
4, 16:13:00-000, 100, 44, 56, 47, 1350.92, 43, 1351.34, 0
4, 16:14:00-000, 89, 52, 37, 51, 1352.85, 40, 1352.09, 8
4, 16:15:00-000, 97, 45, 52, 40, 1349.39, 47, 1349.16, 2
4, 16:16:00-000, 69, 36, 33, 36, 1350.02, 34, 1350.73, 1
4, 16:17:00-000, 97, 53, 44, 51, 1350.89, 50, 1351.21, 3
4, 16:18:00-000, 64, 33, 31, 35, 1349.65, 30, 1349.73, 2
4, 16:19:00-000, 82, 41, 41, 39, 1351.68, 38, 1351.60, 1
4, 16:20:00-000, 73, 32, 41, 31, 1350.77, 36, 1351.38, 3
4, 16:21:00-000, 72, 26, 46, 28, 1351.14, 33, 1351.27, 5
4, 16:22:00-000, 98, 44, 54, 44, 1349.01, 52, 1349.80, 6
4, 16:23:00-000, 72, 45, 27, 42, 1351.26, 29, 1350.44, 5
4, 16:24:00-000, 100, 56, 44, 54, 1351.66, 42, 1350.92, 3
4, 16:25:00-000, 85, 60, 25, 52, 1352.26, 27, 1352.33, 3
4, 16:26:00-000, 88, 28, 60, 28, 1350.32, 34, 1350.29, 5
4, 16:27:00-000, 53, 21, 32, 23, 1348.61, 40, 1349.04, 15
4, 16:28:00-000, 84, 35, 49, 35, 1349.65, 45, 1349.88, 1
4, 16:29:00-000, 100, 55, 45, 51, 1349.32, 51, 1349.24, 0
5, 09:13:00-000, 10318, 5877, 4441, 3969, 1348.40, 3754, 1349.40, 0
5, 09:14:00-000, 0, 0, 0, 0, 0.00, 32, 1357.31, 603
5, 09:15:00-000, 0, 0, 0, 0, 0.00, 87, 1358.00, 1865
5, 09:16:00-000, 0, 0, 0, 0, 0.00, 0, 0.00, 8
5, 09:26:00-000, 10038, 5429, 4609, 3528, 1348.12, 3682, 1348.38, 0
5, 09:27:00-000, 0, 0, 0, 22, 1348.00, 67, 1356.00, 0
5, 09:28:00-000, 2, 2, 0, 108, 1347.39, 63, 1356.28, 1955
5, 09:29:00-000, 35, 12, 23, 5, 1351.60, 20, 1352.55, 615
5, 09:30:00-000, 86, 49, 37, 44, 1347.36, 34, 1348.08, 0
5, 09:31:00-000, 0, 0, 0, 0, 0.00, 5, 1358.60, 1
5, 09:32:00-000, 186, 86, 100, 66, 1349.07, 98, 1351.18, 11
5, 09:33:00-000, 389, 192, 197, 139, 1349.34, 171, 1350.14, 16
5, 09:34:00-000, 610, 353, 257, 253, 1349.11, 224, 1349.40, 16
5, 09:35:00-000, 0, 0, 0, 39, 1346.43, 0, 0.00, 46
5, 09:36:00-000, 1005, 525, 480, 429, 1348.40, 407, 1349.28, 87
5, 09:37:00-000, 1093, 628, 465, 418, 1348.91, 452, 1349.79, 93
5, 09:38:00-000, 1298, 651, 647, 478, 1348.73, 526, 1349.65, 124
5, 09:39:00-000, 0, 0, 0, 36, 1346.00, 4, 1356.00, 152
5, 09:40:00-000, 1296, 697, 599, 476, 1348.78, 480, 1349.50, 222
5, 09:41:00-000, 1220, 680, 540, 454, 1348.86, 477, 1349.47, 235
5, 09:42:00-000, 1179, 657, 522, 435, 1348.84, 467, 1350.39, 209
5, 09:43:00-000, 0, 0, 0, 6, 1347.00, 15, 1357.00, 174
5, 09:44:00-000, 1063, 581, 482, 386, 1349.22, 410, 1350.28, 247
5, 09:45:00-000, 910, 459, 451, 353, 1348.68, 348, 1349.24, 198
5, 09:46:00-000, 911, 488, 423, 336, 1349.32, 313, 1350.44, 199
5, 09:47:00-000, 0, 0, 0, 27, 1345.96, 26, 1356.00, 139
5, 09:48:00-000, 920, 512, 408, 369, 1349.20, 355, 1350.17, 198
5, 09:49:00-000, 913, 539, 374, 324, 1349.54, 326, 1350.08, 127
5, 09:50:00-000, 1020, 526, 494, 396, 1348.72, 439, 1350.30, 147
5, 09:51:00-000, 0, 0, 0, 0, 0.00, 41, 1358.26, 144
5, 09:52:00-000, 950, 451, 499, 356, 1348.77, 459, 1350.20, 160
5, 09:53:00-000, 1002, 525, 477, 413, 1349.29, 375, 1349.43, 148
5, 09:54:00-000, 1147, 619, 528, 447, 1349.48, 462, 1349.58, 115
5, 09:55:00-000, 0, 0, 0, 9, 1347.00, 75, 1357.67, 123
5, 09:56:00-000, 1119, 614, 505, 454, 1348.73, 439, 1349.68, 136
5, 09:57:00-000, 1038, 525, 513, 391, 1347.93, 392, 1348.74, 172
5, 09:58:00-000, 1059, 543, 516, 368, 1349.03, 425, 1350.02, 169
5, 09:59:00-000, 0, 0, 0, 87, 1346.00, 0, 0.00, 159
5, 10:00:00-000, 1116, 578, 538, 471, 1348.35, 440, 1348.80, 172
5, 10:01:00-000, 1031, 561, 470, 399, 1348.96, 342, 1349.55, 132
5, 10:02:00-000, 1068, 608, 460, 428, 1349.30, 462, 1351.60, 159
5, 10:03:00-000, 0, 0, 0, 6, 1347.00, 27, 1358.55, 136
5, 10:04:00-000, 960, 457, 503, 368, 1349.15, 424, 1350.33, 173
5, 10:05:00-000, 993, 543, 450, 403, 1349.29, 388, 1349.53, 162
5, 10:06:00-000, 1059, 592, 467, 443, 1349.35, 415, 1350.44, 123
5, 10:07:00-000, 0, 0, 0, 0, 0.00, 0, 0.00, 134
5, 10:08:00-000, 966, 576, 390, 397, 1349.39, 349, 1350.56, 181
5, 10:09:00-000, 1054, 562, 492, 394, 1349.38, 393, 1349.93, 162
5, 10:10:00-000, 1121, 527, 594, 436, 1348.49, 444, 1349.86, 165
5, 10:11:00-000, 0, 0, 0, 10, 1345.00, 31, 1355.35, 152
5, 10:12:00-000, 939, 477, 462, 354, 1348.14, 408, 1349.55, 203
5, 10:13:00-000, 1009, 531, 478, 378, 1349.11, 398, 1349.73, 135
5, 10:14:00-000, 1072, 564, 508, 434, 1349.02, 449, 1350.23, 115
5, 10:15:00-000, 0, 0, 0, 30, 1346.43, 1, 1357.00, 156
5, 10:16:00-000, 1079, 576, 503, 469, 1348.97, 424, 1349.94, 148
5, 10:17:00-000, 985, 508, 477, 390, 1349.11, 357, 1349.20, 152
5, 10:18:00-000, 944, 525, 419, 389, 1348.17, 375, 1349.37, 158
5, 10:19:00-000, 0, 0, 0, 4, 1345.00, 32, 1356.62, 139
5, 10:20:00-000, 1026, 554, 472, 410, 1349.62, 389, 1349.88, 148
5, 10:21:00-000, 1072, 588, 484, 413, 1349.96, 401, 1350.53, 146
5, 10:22:00-000, 1119, 643, 476, 454, 1349.12, 442, 1349.81, 180
5, 10:23:00-000, 0, 0, 0, 45, 1346.91, 6, 1358.00, 139
5, 10:24:00-000, 1064, 534, 530, 441, 1348.71, 516, 1350.58, 134
5, 10:25:00-000, 965, 503, 462, 389, 1349.56, 367, 1350.03, 139
5, 10:26:00-000, 986, 506, 480, 375, 1348.41, 367, 1349.30, 125
5, 10:27:00-000, 0, 0, 0, 0, 0.00, 48, 1355.16, 121
5, 10:28:00-000, 1178, 616, 562, 440, 1349.23, 458, 1350.12, 158
5, 10:29:00-000, 933, 466, 467, 338, 1349.10, 385, 1349.82, 195
5, 10:30:00-000, 1080, 575, 505, 394, 1348.98, 426, 1349.64, 225
5, 10:31:00-000, 0, 0, 0, 28, 1346.00, 29, 1357.00, 105
5, 10:32:00-000, 1052, 549, 503, 425, 1348.54, 447, 1349.63, 175
5, 10:33:00-000, 989, 551, 438, 369, 1349.88, 318, 1350.51, 150
5, 10:34:00-000, 909, 494, 415, 375, 1349.17, 384, 1350.59, 167
5, 10:35:00-000, 0, 0, 0, 3, 1346.00, 0, 0.00, 169
5, 10:36:00-000, 1034, 565, 469, 408, 1349.37, 364, 1349.71, 149
5, 10:37:00-000, 1001, 460, 541, 376, 1348.20, 358, 1348.62, 165
5, 10:38:00-000, 1064, 554, 510, 419, 1348.66, 412, 1349.76, 187
5, 10:39:00-000, 0, 0, 0, 12, 1347.00, 17, 1355.00, 166
5, 10:40:00-000, 990, 470, 520, 333, 1348.55, 379, 1349.69, 194
5, 10:41:00-000, 993, 538, 455, 384, 1348.66, 392, 1349.75, 189
5, 10:42:00-000, 1059, 565, 494, 415, 1348.90, 433, 1350.30, 174
5, 10:43:00-000, 0, 0, 0, 27, 1346.00, 25, 1357.00, 159
5, 10:44:00-000, 910, 464, 446, 346, 1348.61, 376, 1349.12, 159
5, 10:45:00-000, 960, 499, 461, 382, 1349.31, 344, 1349.32, 129
5, 10:46:00-000, 1004, 494, 510, 381, 1348.27, 382, 1348.52, 169
5, 10:47:00-000, 0, 0, 0, 46, 1345.12, 24, 1354.00, 122
5, 10:48:00-000, 1021, 502, 519, 369, 1348.55, 408, 1349.89, 159
5, 10:49:00-000, 1015, 508, 507, 371, 1348.45, 396, 1349.09, 160
5, 10:50:00-000, 919, 458, 461, 347, 1348.81, 372, 1350.24, 175
5, 10:51:00-000, 0, 0, 0, 35, 1345.86, 48, 1356.78, 149
5, 10:52:00-000, 1078, 498, 580, 410, 1348.12, 479, 1349.11, 136
5, 10:53:00-000, 1096, 596, 500, 433, 1348.03, 425, 1349.09, 166
5, 10:54:00-000, 1051, 549, 502, 409, 1348.69, 408, 1349.54, 145
5, 10:55:00-000, 1, 1, 0, 1, 1354.00, 4, 1356.00, 152
5, 10:56:00-000, 931, 478, 453, 393, 1348.48, 418, 1350.22, 178
5, 10:57:00-000, 1044, 583, 461, 390, 1349.50, 367, 1350.02, 100
5, 10:58:00-000, 933, 458, 475, 456, 1348.03, 375, 1348.86, 148
5, 10:59:00-000, 0, 0, 0, 17, 1344.00, 0, 0.00, 158
5, 11:00:00-000, 1025, 475, 550, 394, 1347.82, 440, 1349.22, 127
5, 11:01:00-000, 1016, 482, 534, 373, 1348.47, 435, 1349.26, 152
5, 11:02:00-000, 1019, 531, 488, 458, 1348.53, 394, 1349.27, 104
5, 11:03:00-000, 0, 0, 0, 19, 1344.00, 3, 1356.00, 138
5, 11:04:00-000, 1162, 616, 546, 485, 1348.80, 452, 1349.82, 134
5, 11:05:00-000, 1021, 518, 503, 343, 1348.78, 361, 1349.11, 151
5, 11:06:00-000, 987, 516, 471, 481, 1348.68, 411, 1350.10, 146
5, 11:07:00-000, 1, 1, 0, 32, 1345.00, 0, 0.00, 159
5, 11:08:00-000, 1027, 524, 503, 413, 1348.63, 426, 1349.94, 126
5, 11:09:00-000, 1059, 546, 513, 404, 1348.41, 396, 1348.19, 133
5, 11:10:00-000, 1018, 540, 478, 405, 1348.55, 425, 1349.86, 179
5, 11:11:00-000, 0, 0, 0, 38, 1345.00, 36, 1356.58, 146
5, 11:12:00-000, 1048, 583, 465, 432, 1349.46, 389, 1350.00, 137
5, 11:13:00-000, 1095, 566, 529, 401, 1348.46, 422, 1349.32, 160
5, 11:14:00-000, 1022, 508, 514, 385, 1348.69, 443, 1349.42, 164
5, 11:15:00-000, 0, 0, 0, 14, 1345.64, 16, 1355.75, 187
5, 11:16:00-000, 1008, 523, 485, 393, 1348.71, 401, 1349.93, 157
5, 11:17:00-000, 1085, 574, 511, 454, 1349.59, 413, 1349.62, 155
5, 11:18:00-000, 938, 498, 440, 399, 1348.30, 403, 1349.52, 132
5, 11:19:00-000, 0, 0, 0, 0, 0.00, 14, 1357.00, 118
5, 11:20:00-000, 1061, 571, 490, 475, 1348.86, 413, 1350.36, 140
5, 11:21:00-000, 1040, 554, 486, 408, 1349.20, 369, 1349.70, 145
5, 11:22:00-000, 983, 517, 466, 356, 1348.99, 383, 1349.59, 125
5, 11:23:00-000, 3, 0, 3, 0, 0.00, 46, 1355.69, 178
5, 11:24:00-000, 1000, 523, 477, 393, 1348.85, 429, 1349.97, 164
5, 11:25:00-000, 1053, 515, 538, 424, 1348.65, 431, 1349.79, 120
5, 11:26:00-000, 960, 505, 455, 415, 1348.45, 407, 1349.89, 130
5, 11:27:00-000, 0, 0, 0, 2, 1345.00, 20, 1356.65, 156
5, 11:28:00-000, 1028, 588, 440, 451, 1349.86, 400, 1350.86, 113
5, 11:29:00-000, 1069, 548, 521, 429, 1349.40, 449, 1350.14, 105
5, 11:30:00-000, 1003, 521, 482, 434, 1348.47, 373, 1349.05, 143
5, 11:31:00-000, 0, 0, 0, 18, 1345.00, 16, 1354.31, 119
5, 11:32:00-000, 1062, 522, 540, 406, 1348.25, 433, 1349.06, 162
5, 11:33:00-000, 1043, 553, 490, 373, 1348.93, 369, 1349.24, 128
5, 11:34:00-000, 1082, 552, 530, 435, 1348.42, 481, 1349.68, 184
5, 11:35:00-000, 0, 0, 0, 0, 0.00, 18, 1356.06, 185
5, 11:36:00-000, 1053, 533, 520, 406, 1348.66, 404, 1349.61, 146
5, 11:37:00-000, 982, 479, 503, 377, 1348.34, 396, 1348.95, 206
5, 11:38:00-000, 957, 501, 456, 379, 1348.87, 400, 1350.47, 134
5, 11:39:00-000, 0, 0, 0, 16, 1346.00, 0, 0.00, 147
5, 11:40:00-000, 974, 500, 474, 385, 1348.70, 413, 1349.92, 132
5, 11:41:00-000, 1058, 522, 536, 429, 1348.24, 392, 1349.03, 122
5, 11:42:00-000, 1099, 605, 494, 464, 1348.57, 406, 1349.38, 133
5, 11:43:00-000, 3, 3, 0, 3, 1349.00, 17, 1355.00, 165
5, 11:44:00-000, 947, 490, 457, 391, 1348.84, 387, 1350.19, 185
5, 11:45:00-000, 1075, 553, 522, 410, 1349.05, 454, 1349.55, 137
5, 11:46:00-000, 1100, 584, 516, 427, 1348.78, 456, 1350.44, 132
5, 11:47:00-000, 0, 0, 0, 21, 1346.00, 14, 1355.93, 129
5, 11:48:00-000, 1034, 547, 487, 399, 1349.16, 437, 1350.10, 164
5, 11:49:00-000, 1090, 554, 536, 405, 1348.75, 411, 1349.23, 168
5, 11:50:00-000, 1073, 563, 510, 470, 1348.73, 461, 1349.93, 149
5, 11:51:00-000, 0, 0, 0, 18, 1345.00, 18, 1356.61, 146
5, 11:52:00-000, 1002, 497, 505, 379, 1348.54, 395, 1349.72, 138
5, 11:53:00-000, 977, 472, 505, 412, 1347.96, 387, 1348.56, 149
5, 11:54:00-000, 980, 507, 473, 415, 1348.77, 411, 1349.69, 136
5, 11:55:00-000, 0, 0, 0, 0, 0.00, 18, 1355.83, 118
5, 11:56:00-000, 1084, 542, 542, 394, 1349.30, 463, 1350.50, 145
5, 11:57:00-000, 1117, 525, 592, 471, 1347.87, 433, 1348.34, 137
5, 11:58:00-000, 980, 528, 452, 396, 1348.90, 371, 1349.77, 148
5, 11:59:00-000, 0, 0, 0, 21, 1345.00, 16, 1355.50, 167
5, 12:00:00-000, 997, 504, 493, 383, 1348.82, 411, 1350.08, 154
5, 12:01:00-000, 1024, 575, 449, 422, 1349.04, 378, 1349.84, 167
5, 12:02:00-000, 921, 460, 461, 351, 1349.01, 362, 1349.63, 163
5, 12:03:00-000, 0, 0, 0, 9, 1345.55, 14, 1355.57, 150
5, 12:04:00-000, 1070, 576, 494, 436, 1349.02, 385, 1349.62, 124
5, 12:05:00-000, 1065, 536, 529, 432, 1348.47, 412, 1348.94, 176
5, 12:06:00-000, 1067, 544, 523, 464, 1347.80, 447, 1349.33, 141
5, 12:07:00-000, 0, 0, 0, 3, 1345.00, 27, 1355.81, 140
5, 12:08:00-000, 1118, 592, 526, 465, 1348.24, 435, 1349.18, 147
5, 12:09:00-000, 993, 558, 435, 393, 1349.05, 361, 1349.49, 175
5, 12:10:00-000, 1034, 512, 522, 428, 1348.52, 407, 1349.14, 136
5, 12:11:00-000, 0, 0, 0, 16, 1345.00, 0, 0.00, 158
5, 12:12:00-000, 972, 474, 498, 410, 1347.78, 455, 1349.61, 135
5, 12:13:00-000, 986, 498, 488, 357, 1349.23, 401, 1349.96, 141
5, 12:14:00-000, 1069, 494, 575, 438, 1347.13, 432, 1348.06, 106
5, 12:15:00-000, 1, 0, 1, 25, 1343.04, 35, 1354.11, 134
5, 12:16:00-000, 1046, 513, 533, 408, 1348.42, 437, 1349.80, 148
5, 12:17:00-000, 978, 500, 478, 356, 1348.58, 381, 1349.00, 156
5, 12:18:00-000, 1031, 534, 497, 399, 1349.37, 413, 1350.51, 105
5, 12:19:00-000, 0, 0, 0, 80, 1344.61, 5, 1356.00, 171
5, 12:20:00-000, 1019, 505, 514, 331, 1349.55, 337, 1348.87, 161
5, 12:21:00-000, 1009, 534, 475, 338, 1348.53, 327, 1348.51, 179
5, 12:22:00-000, 1032, 534, 498, 414, 1349.49, 313, 1348.52, 297
5, 12:23:00-000, 0, 0, 0, 0, 0.00, 0, 0.00, 226
5, 12:24:00-000, 917, 453, 464, 289, 1348.75, 386, 1348.97, 233
5, 12:25:00-000, 978, 520, 458, 376, 1349.50, 348, 1348.68, 205
5, 12:26:00-000, 1085, 577, 508, 474, 1348.75, 379, 1349.23, 160
5, 12:27:00-000, 1, 0, 1, 0, 0.00, 1, 1352.00, 180
5, 12:28:00-000, 1040, 514, 526, 363, 1349.53, 454, 1349.33, 191
5, 12:29:00-000, 1030, 510, 520, 394, 1348.47, 363, 1348.58, 216
5, 12:30:00-000, 1080, 540, 540, 376, 1348.79, 409, 1348.69, 153
5, 12:31:00-000, 0, 0, 0, 2, 1346.00, 37, 1354.56, 182
5, 12:32:00-000, 1106, 531, 575, 408, 1349.03, 449, 1349.16, 195
5, 12:33:00-000, 1031, 507, 524, 400, 1349.43, 414, 1348.94, 206
5, 12:34:00-000, 1011, 544, 467, 415, 1349.53, 375, 1349.93, 200
5, 12:35:00-000, 0, 0, 0, 0, 0.00, 0, 0.00, 156
5, 12:36:00-000, 960, 473, 487, 370, 1348.82, 368, 1349.27, 129
5, 12:37:00-000, 1016, 508, 508, 371, 1348.55, 398, 1349.13, 207
5, 12:38:00-000, 972, 442, 530, 377, 1348.02, 401, 1349.42, 170
5, 12:39:00-000, 0, 0, 0, 17, 1345.00, 16, 1355.00, 129
5, 12:40:00-000, 1199, 664, 535, 521, 1349.13, 381, 1349.10, 161
5, 12:41:00-000, 982, 476, 506, 402, 1348.66, 367, 1349.69, 197
5, 12:42:00-000, 983, 483, 500, 379, 1348.77, 422, 1349.34, 159
5, 12:43:00-000, 0, 0, 0, 0, 0.00, 8, 1355.00, 182
5, 12:44:00-000, 997, 544, 453, 426, 1349.60, 373, 1350.17, 140
5, 12:45:00-000, 1019, 552, 467, 442, 1348.74, 371, 1349.32, 147
5, 12:46:00-000, 1024, 558, 466, 458, 1349.12, 388, 1349.95, 124
5, 12:47:00-000, 1, 0, 1, 4, 1345.50, 10, 1356.00, 141
5, 12:48:00-000, 965, 495, 470, 380, 1348.85, 342, 1349.65, 163
5, 12:49:00-000, 1006, 508, 498, 390, 1348.75, 441, 1349.86, 176
5, 12:50:00-000, 866, 415, 451, 369, 1347.78, 390, 1348.83, 142
5, 12:51:00-000, 0, 0, 0, 0, 0.00, 0, 0.00, 123
5, 12:52:00-000, 1031, 539, 492, 394, 1349.66, 417, 1350.02, 112
5, 12:53:00-000, 1087, 546, 541, 397, 1349.31, 443, 1349.61, 122
5, 12:54:00-000, 1040, 540, 500, 399, 1349.07, 451, 1350.27, 129
5, 12:55:00-000, 1, 1, 0, 29, 1346.27, 0, 0.00, 155
5, 12:56:00-000, 1006, 522, 484, 399, 1349.02, 390, 1350.02, 184
5, 12:57:00-000, 1157, 564, 593, 380, 1348.58, 462, 1348.95, 163
5, 12:58:00-000, 997, 482, 515, 365, 1348.51, 441, 1349.90, 203
5, 12:59:00-000, 0, 0, 0, 24, 1346.00, 31, 1355.83, 171
5, 13:00:00-000, 947, 480, 467, 413, 1348.79, 417, 1349.87, 117
5, 13:01:00-000, 1017, 511, 506, 398, 1349.00, 372, 1349.56, 123
5, 13:02:00-000, 973, 503, 470, 453, 1348.09, 374, 1349.60, 105
5, 13:03:00-000, 6, 6, 0, 6, 1350.83, 7, 1355.00, 154
5, 13:04:00-000, 1026, 486, 540, 391, 1348.33, 358, 1348.65, 133
5, 13:05:00-000, 917, 493, 424, 403, 1348.47, 372, 1349.61, 134
5, 13:06:00-000, 1000, 512, 488, 447, 1348.86, 416, 1349.63, 175
5, 13:07:00-000, 2, 0, 2, 21, 1344.09, 28, 1355.49, 123
5, 13:08:00-000, 1084, 551, 533, 385, 1349.63, 425, 1350.14, 99
5, 13:09:00-000, 973, 494, 479, 429, 1349.41, 385, 1349.46, 170
5, 13:10:00-000, 1045, 491, 554, 452, 1347.86, 426, 1349.05, 142
5, 13:11:00-000, 0, 0, 0, 14, 1344.43, 19, 1354.89, 101
5, 13:12:00-000, 1022, 518, 504, 420, 1348.37, 402, 1349.52, 148
5, 13:13:00-000, 951, 519, 432, 346, 1349.68, 367, 1350.74, 120
5, 13:14:00-000, 986, 534, 452, 413, 1349.42, 384, 1350.23, 178
5, 13:15:00-000, 7, 0, 7, 28, 1346.00, 32, 1355.78, 144
5, 13:16:00-000, 1112, 579, 533, 414, 1349.65, 482, 1350.39, 125
5, 13:17:00-000, 1050, 531, 519, 359, 1348.68, 415, 1349.47, 158
5, 13:18:00-000, 996, 489, 507, 401, 1348.71, 424, 1350.13, 164
5, 13:19:00-000, 0, 0, 0, 11, 1346.00, 3, 1356.00, 179
5, 13:20:00-000, 903, 448, 455, 344, 1348.98, 396, 1349.96, 146
5, 13:21:00-000, 1025, 541, 484, 413, 1349.45, 407, 1350.02, 129
5, 13:22:00-000, 1108, 561, 547, 440, 1348.10, 423, 1348.99, 117
5, 13:23:00-000, 3, 3, 0, 3, 1350.00, 38, 1355.73, 148
5, 13:24:00-000, 971, 440, 531, 397, 1347.32, 399, 1349.09, 117
5, 13:25:00-000, 1046, 562, 484, 412, 1348.98, 398, 1349.63, 171
5, 13:26:00-000, 898, 451, 447, 348, 1348.76, 378, 1349.81, 154
5, 13:27:00-000, 2, 1, 1, 22, 1346.04, 15, 1356.00, 158
5, 13:28:00-000, 1045, 557, 488, 458, 1349.16, 352, 1350.00, 141
5, 13:29:00-000, 1066, 565, 501, 432, 1349.13, 347, 1349.00, 124
5, 13:30:00-000, 1038, 500, 538, 366, 1348.47, 407, 1349.62, 202
5, 13:31:00-000, 1, 0, 1, 57, 1345.47, 47, 1355.67, 182
5, 13:32:00-000, 1096, 542, 554, 449, 1348.08, 422, 1348.70, 158
5, 13:33:00-000, 975, 508, 467, 384, 1349.45, 355, 1349.74, 135
5, 13:34:00-000, 1028, 517, 511, 391, 1348.52, 398, 1349.13, 191
5, 13:35:00-000, 1, 1, 0, 16, 1345.81, 29, 1355.21, 162
5, 13:36:00-000, 957, 460, 497, 371, 1348.09, 403, 1349.12, 164
5, 13:37:00-000, 1069, 575, 494, 389, 1349.14, 364, 1349.27, 137
5, 13:38:00-000, 957, 571, 386, 375, 1350.01, 358, 1350.90, 160
5, 13:39:00-000, 0, 0, 0, 12, 1348.00, 35, 1357.00, 190
5, 13:40:00-000, 1004, 469, 535, 374, 1348.58, 433, 1349.59, 162
5, 13:41:00-000, 1051, 533, 518, 363, 1349.00, 381, 1349.10, 177
5, 13:42:00-000, 1025, 538, 487, 414, 1348.55, 355, 1348.93, 176
5, 13:43:00-000, 1, 0, 1, 11, 1346.00, 23, 1353.60, 207
5, 13:44:00-000, 1040, 543, 497, 385, 1349.87, 414, 1350.71, 175
5, 13:45:00-000, 996, 535, 461, 360, 1349.40, 406, 1350.05, 194
5, 13:46:00-000, 1035, 553, 482, 423, 1349.03, 403, 1349.97, 151
5, 13:47:00-000, 0, 0, 0, 24, 1347.00, 3, 1356.00, 179
5, 13:48:00-000, 1030, 495, 535, 379, 1348.53, 386, 1348.82, 143
5, 13:49:00-000, 1057, 565, 492, 453, 1349.34, 398, 1349.66, 177
5, 13:50:00-000, 1037, 528, 509, 364, 1349.19, 379, 1350.12, 159
5, 13:51:00-000, 4, 0, 4, 0, 0.00, 58, 1355.58, 157
5, 13:52:00-000, 965, 514, 451, 409, 1349.37, 388, 1350.68, 184
5, 13:53:00-000, 1026, 498, 528, 392, 1348.59, 433, 1349.49, 158
5, 13:54:00-000, 1075, 577, 498, 416, 1348.99, 386, 1348.96, 138
5, 13:55:00-000, 4, 4, 0, 34, 1346.91, 30, 1356.76, 148
5, 13:56:00-000, 1034, 457, 577, 388, 1347.65, 473, 1348.94, 141
5, 13:57:00-000, 982, 507, 475, 362, 1349.15, 372, 1349.43, 174
5, 13:58:00-000, 1094, 549, 545, 446, 1348.04, 478, 1349.47, 114
5, 13:59:00-000, 0, 0, 0, 11, 1346.00, 14, 1356.00, 145
5, 14:00:00-000, 1034, 488, 546, 415, 1348.09, 417, 1349.00, 153
5, 14:01:00-000, 973, 500, 473, 353, 1348.50, 353, 1349.36, 194
5, 14:02:00-000, 1007, 480, 527, 387, 1348.85, 397, 1349.36, 158
5, 14:03:00-000, 0, 0, 0, 22, 1344.73, 0, 0.00, 175
5, 14:04:00-000, 1042, 507, 535, 402, 1347.96, 431, 1348.97, 151
5, 14:05:00-000, 1065, 562, 503, 428, 1349.00, 381, 1348.99, 181
5, 14:06:00-000, 1114, 570, 544, 411, 1348.69, 394, 1349.42, 154
5, 14:07:00-000, 5, 0, 5, 42, 1346.66, 26, 1354.77, 161
5, 14:08:00-000, 1011, 546, 465, 400, 1349.92, 421, 1350.85, 190
5, 14:09:00-000, 1082, 518, 564, 416, 1348.67, 430, 1349.18, 168
5, 14:10:00-000, 1043, 522, 521, 433, 1348.73, 367, 1349.46, 155
5, 14:11:00-000, 0, 0, 0, 5, 1345.00, 0, 0.00, 191
5, 14:12:00-000, 1010, 533, 477, 418, 1348.70, 418, 1349.58, 176
5, 14:13:00-000, 1002, 472, 530, 405, 1348.16, 364, 1348.65, 156
5, 14:14:00-000, 1007, 473, 534, 434, 1347.86, 385, 1348.56, 125
5, 14:15:00-000, 0, 0, 0, 0, 0.00, 44, 1354.45, 153
5, 14:16:00-000, 941, 460, 481, 331, 1348.17, 415, 1349.86, 156
5, 14:17:00-000, 980, 458, 522, 372, 1348.73, 402, 1349.80, 112
5, 14:18:00-000, 1104, 552, 552, 423, 1348.68, 450, 1350.19, 144
5, 14:19:00-000, 1, 0, 1, 26, 1345.00, 9, 1354.22, 143
5, 14:20:00-000, 1030, 547, 483, 451, 1348.94, 371, 1349.28, 177
5, 14:21:00-000, 987, 487, 500, 388, 1348.21, 382, 1348.60, 163
5, 14:22:00-000, 1097, 541, 556, 438, 1348.82, 434, 1349.41, 153
5, 14:23:00-000, 3, 0, 3, 39, 1346.23, 2, 1349.00, 143
5, 14:24:00-000, 979, 470, 509, 400, 1348.54, 433, 1349.36, 119
5, 14:25:00-000, 1060, 573, 487, 431, 1349.06, 408, 1349.54, 143
5, 14:26:00-000, 1023, 504, 519, 404, 1348.96, 381, 1349.57, 121
5, 14:27:00-000, 1, 1, 0, 31, 1344.96, 1, 1355.00, 170
5, 14:28:00-000, 967, 525, 442, 428, 1349.11, 394, 1350.19, 144
5, 14:29:00-000, 993, 548, 445, 370, 1349.55, 361, 1350.31, 127
5, 14:30:00-000, 1016, 515, 501, 444, 1348.43, 382, 1348.63, 156
5, 14:31:00-000, 1, 0, 1, 22, 1344.00, 44, 1356.61, 131
5, 14:32:00-000, 1016, 526, 490, 402, 1348.93, 427, 1350.15, 148
5, 14:33:00-000, 984, 453, 531, 345, 1349.01, 442, 1350.02, 146
5, 14:34:00-000, 1128, 550, 578, 436, 1348.28, 439, 1349.26, 138
5, 14:35:00-000, 2, 1, 1, 25, 1344.76, 33, 1354.33, 118
5, 14:36:00-000, 1042, 569, 473, 408, 1349.20, 414, 1350.22, 154
5, 14:37:00-000, 1029, 495, 534, 379, 1349.16, 430, 1350.10, 176
5, 14:38:00-000, 1041, 502, 539, 412, 1347.85, 462, 1349.73, 113
5, 14:39:00-000, 0, 0, 0, 21, 1345.00, 26, 1356.00, 147
5, 14:40:00-000, 1037, 530, 507, 464, 1348.53, 414, 1349.71, 147
5, 14:41:00-000, 931, 478, 453, 308, 1348.82, 357, 1349.53, 133
5, 14:42:00-000, 955, 492, 463, 393, 1348.91, 342, 1350.05, 130
5, 14:43:00-000, 0, 0, 0, 28, 1345.43, 24, 1354.71, 152
5, 14:44:00-000, 935, 493, 442, 420, 1348.40, 378, 1349.57, 154
5, 14:45:00-000, 1070, 565, 505, 419, 1349.10, 411, 1349.38, 140
5, 14:46:00-000, 1045, 553, 492, 389, 1349.01, 449, 1350.58, 141
5, 14:47:00-000, 0, 0, 0, 41, 1345.46, 12, 1357.00, 120
5, 14:48:00-000, 1024, 501, 523, 452, 1348.29, 412, 1349.10, 136
5, 14:49:00-000, 1056, 496, 560, 392, 1347.48, 419, 1348.70, 134
5, 14:50:00-000, 1012, 510, 502, 391, 1348.39, 380, 1349.61, 139
5, 14:51:00-000, 3, 3, 0, 9, 1346.00, 7, 1355.00, 174
5, 14:52:00-000, 1056, 534, 522, 422, 1348.29, 445, 1349.97, 133
5, 14:53:00-000, 991, 509, 482, 393, 1349.19, 364, 1349.70, 207
5, 14:54:00-000, 952, 510, 442, 423, 1348.70, 406, 1349.34, 158
5, 14:55:00-000, 0, 0, 0, 16, 1345.00, 1, 1356.00, 125
5, 14:56:00-000, 1027, 481, 546, 382, 1348.88, 422, 1349.73, 124
5, 14:57:00-000, 969, 487, 482, 393, 1349.41, 386, 1349.41, 148
5, 14:58:00-000, 1127, 518, 609, 456, 1347.90, 483, 1349.38, 141
5, 14:59:00-000, 0, 0, 0, 0, 0.00, 6, 1354.00, 97
5, 15:00:00-000, 1028, 471, 557, 404, 1347.97, 438, 1349.32, 150
5, 15:01:00-000, 1042, 508, 534, 379, 1349.17, 401, 1349.12, 176
5, 15:02:00-000, 1105, 527, 578, 395, 1348.60, 465, 1349.93, 171
5, 15:03:00-000, 1, 1, 0, 36, 1346.55, 12, 1356.00, 145
5, 15:04:00-000, 1044, 534, 510, 426, 1348.24, 415, 1349.46, 200
5, 15:05:00-000, 1007, 523, 484, 376, 1348.74, 365, 1349.61, 151
5, 15:06:00-000, 980, 492, 488, 390, 1348.66, 331, 1349.41, 162
5, 15:07:00-000, 1, 0, 1, 19, 1345.84, 5, 1353.80, 183
5, 15:08:00-000, 1114, 602, 512, 450, 1349.86, 449, 1350.72, 170
5, 15:09:00-000, 968, 539, 429, 386, 1349.72, 328, 1350.32, 167
5, 15:10:00-000, 1026, 510, 516, 432, 1347.86, 394, 1348.87, 182
5, 15:11:00-000, 7, 0, 7, 8, 1344.00, 39, 1354.43, 157
5, 15:12:00-000, 986, 487, 499, 370, 1348.38, 396, 1349.37, 141
5, 15:13:00-000, 1042, 580, 462, 385, 1349.48, 383, 1350.10, 179
5, 15:14:00-000, 1001, 495, 506, 365, 1349.29, 407, 1350.09, 160
5, 15:15:00-000, 2, 0, 2, 26, 1345.61, 24, 1355.50, 178
5, 15:16:00-000, 1039, 526, 513, 435, 1348.12, 457, 1349.43, 145
5, 15:17:00-000, 1074, 489, 585, 392, 1348.04, 445, 1348.85, 139
5, 15:18:00-000, 1014, 541, 473, 424, 1349.01, 365, 1349.41, 145
5, 15:19:00-000, 0, 0, 0, 28, 1345.17, 15, 1355.00, 151
5, 15:20:00-000, 1055, 491, 564, 395, 1348.50, 428, 1350.10, 152
5, 15:21:00-000, 1034, 568, 466, 430, 1349.38, 388, 1350.25, 166
5, 15:22:00-000, 1027, 505, 522, 411, 1348.99, 373, 1349.40, 152
5, 15:23:00-000, 2, 0, 2, 33, 1345.00, 27, 1354.74, 169
5, 15:24:00-000, 925, 482, 443, 362, 1349.11, 346, 1349.81, 165
5, 15:25:00-000, 1040, 548, 492, 381, 1349.41, 414, 1349.73, 154
5, 15:26:00-000, 1064, 556, 508, 418, 1348.41, 402, 1349.28, 166
5, 15:27:00-000, 2, 1, 1, 10, 1346.80, 1, 1351.00, 157
5, 15:28:00-000, 1044, 596, 448, 418, 1349.60, 394, 1350.76, 184
5, 15:29:00-000, 963, 453, 510, 356, 1348.49, 380, 1349.54, 179
5, 15:30:00-000, 992, 509, 483, 407, 1349.41, 400, 1349.93, 150
5, 15:31:00-000, 1, 0, 1, 9, 1346.00, 35, 1356.00, 164
5, 15:32:00-000, 988, 519, 469, 404, 1349.64, 353, 1350.30, 145
5, 15:33:00-000, 1033, 566, 467, 396, 1349.24, 345, 1349.34, 160
5, 15:34:00-000, 1065, 490, 575, 378, 1348.13, 466, 1349.40, 184
5, 15:35:00-000, 1, 1, 0, 1, 1347.00, 33, 1355.33, 182
5, 15:36:00-000, 1057, 539, 518, 478, 1348.10, 427, 1348.87, 163
5, 15:37:00-000, 1038, 516, 522, 375, 1349.19, 425, 1349.54, 127
5, 15:38:00-000, 1100, 571, 529, 484, 1348.16, 487, 1349.45, 112
5, 15:39:00-000, 4, 3, 1, 35, 1345.45, 16, 1355.37, 152
5, 15:40:00-000, 1129, 574, 555, 384, 1349.55, 374, 1348.73, 102
5, 15:41:00-000, 942, 474, 468, 346, 1348.94, 338, 1348.62, 210
5, 15:42:00-000, 980, 461, 519, 349, 1349.07, 363, 1348.59, 265
5, 15:43:00-000, 0, 0, 0, 0, 0.00, 0, 0.00, 178
5, 15:44:00-000, 1063, 561, 502, 439, 1348.96, 405, 1349.45, 182
5, 15:45:00-000, 1021, 509, 512, 340, 1348.92, 382, 1349.20, 154
5, 15:46:00-000, 1043, 508, 535, 369, 1348.43, 407, 1349.05, 248
5, 15:47:00-000, 0, 0, 0, 0, 0.00, 0, 0.00, 228
5, 15:48:00-000, 1070, 578, 492, 428, 1349.45, 353, 1349.64, 203
5, 15:49:00-000, 989, 537, 452, 371, 1349.52, 346, 1349.73, 182
5, 15:50:00-000, 953, 501, 452, 338, 1348.84, 338, 1349.54, 225
5, 15:51:00-000, 1, 0, 1, 8, 1346.00, 14, 1354.43, 215
5, 15:52:00-000, 1043, 575, 468, 421, 1349.19, 363, 1349.18, 200
5, 15:53:00-000, 1034, 467, 567, 377, 1348.34, 433, 1348.44, 162
5, 15:54:00-000, 1059, 561, 498, 467, 1348.46, 457, 1349.93, 180
5, 15:55:00-000, 3, 0, 3, 0, 0.00, 0, 0.00, 134
5, 15:56:00-000, 1046, 502, 544, 406, 1348.79, 426, 1349.39, 174
5, 15:57:00-000, 979, 517, 462, 364, 1349.11, 372, 1349.57, 142
5, 15:58:00-000, 1054, 562, 492, 376, 1349.84, 384, 1350.34, 145
5, 15:59:00-000, 2, 0, 2, 20, 1347.00, 0, 0.00, 191
5, 16:00:00-000, 966, 500, 466, 410, 1348.96, 349, 1349.54, 199
5, 16:01:00-000, 1071, 538, 533, 404, 1348.65, 381, 1348.96, 151
5, 16:02:00-000, 1018, 487, 531, 375, 1348.45, 442, 1349.27, 177
5, 16:03:00-000, 3, 1, 2, 0, 0.00, 33, 1355.00, 183
5, 16:04:00-000, 1110, 581, 529, 444, 1348.47, 394, 1348.84, 184
5, 16:05:00-000, 1027, 572, 455, 396, 1349.32, 357, 1348.97, 204
5, 16:06:00-000, 1007, 552, 455, 423, 1348.85, 336, 1349.16, 174
5, 16:07:00-000, 0, 0, 0, 42, 1345.16, 4, 1355.00, 203
5, 16:08:00-000, 1034, 549, 485, 402, 1349.50, 389, 1350.33, 134
5, 16:09:00-000, 1019, 503, 516, 364, 1349.14, 368, 1349.54, 207
5, 16:10:00-000, 1033, 456, 577, 394, 1347.47, 435, 1348.92, 179
5, 16:11:00-000, 0, 0, 0, 0, 0.00, 55, 1354.94, 169
5, 16:12:00-000, 1012, 498, 514, 410, 1348.41, 431, 1349.82, 161
5, 16:13:00-000, 978, 505, 473, 391, 1349.24, 408, 1350.03, 133
5, 16:14:00-000, 1006, 503, 503, 406, 1348.57, 451, 1349.59, 118
5, 16:15:00-000, 1, 0, 1, 0, 0.00, 19, 1357.00, 121
5, 16:16:00-000, 1017, 539, 478, 402, 1348.60, 413, 1349.56, 119
5, 16:17:00-000, 1033, 568, 465, 364, 1349.79, 358, 1350.40, 130
5, 16:18:00-000, 1023, 559, 464, 409, 1348.88, 389, 1350.23, 169
5, 16:19:00-000, 3, 2, 1, 48, 1346.20, 30, 1355.76, 150
5, 16:20:00-000, 1042, 522, 520, 430, 1348.95, 416, 1350.30, 182
5, 16:21:00-000, 1020, 519, 501, 427, 1348.47, 384, 1348.52, 157
5, 16:22:00-000, 1091, 518, 573, 422, 1347.89, 431, 1348.95, 148
5, 16:23:00-000, 2, 1, 1, 12, 1345.33, 20, 1354.75, 115
5, 16:24:00-000, 1028, 508, 520, 373, 1348.84, 432, 1350.02, 170
5, 16:25:00-000, 972, 508, 464, 358, 1349.59, 368, 1350.23, 190
5, 16:26:00-000, 1039, 568, 471, 422, 1349.25, 332, 1349.26, 184
5, 16:27:00-000, 1, 1, 0, 59, 1345.76, 31, 1354.83, 171
5, 16:28:00-000, 1015, 500, 515, 411, 1348.14, 361, 1349.15, 151
5, 16:29:00-000, 997, 490, 507, 383, 1348.25, 389, 1349.01, 179
6, 12:20:00-000, 6951, 3516, 3435, 1639, 1347.99, 1633, 1348.58, 0
6, 12:21:00-000, 0, 0, 0, 58, 1347.00, 4, 1354.00, 0
6, 12:22:00-000, 0, 0, 0, 71, 1346.00, 150, 1354.00, 0
6, 12:23:00-000, 0, 0, 0, 19, 1346.00, 53, 1354.00, 0
6, 12:24:00-000, 0, 0, 0, 146, 1346.00, 16, 1354.69, 0
6, 12:25:00-000, 0, 0, 0, 19, 1346.00, 114, 1355.00, 0
6, 12:26:00-000, 0, 0, 0, 0, 0.00, 28, 1355.00, 0
6, 12:27:00-000, 0, 0, 0, 0, 0.00, 89, 1355.00, 0
6, 12:28:00-000, 0, 0, 0, 66, 1345.00, 14, 1355.00, 0
6, 12:30:00-000, 0, 0, 0, 15, 1345.00, 0, 0.00, 0
6, 12:32:00-000, 0, 0, 0, 27, 1345.00, 14, 1356.00, 0
6, 12:33:00-000, 0, 0, 0, 67, 1345.00, 50, 1356.00, 0
6, 12:34:00-000, 0, 0, 0, 55, 1345.00, 19, 1356.00, 0
6, 12:35:00-000, 0, 0, 0, 6, 1345.00, 9, 1356.00, 0
6, 12:36:00-000, 0, 0, 0, 23, 1345.00, 35, 1356.00, 0
6, 12:38:00-000, 0, 0, 0, 0, 0.00, 17, 1356.00, 0
6, 12:39:00-000, 0, 0, 0, 0, 0.00, 4, 1356.00, 0
6, 12:40:00-000, 0, 0, 0, 0, 0.00, 33, 1356.00, 119
6, 12:41:00-000, 0, 0, 0, 0, 0.00, 0, 0.00, 111
6, 12:42:00-000, 0, 0, 0, 20, 1344.00, 0, 0.00, 144
6, 12:43:00-000, 0, 0, 0, 35, 1344.00, 0, 0.00, 103
6, 12:44:00-000, 0, 0, 0, 0, 0.00, 41, 1356.00, 103
6, 12:45:00-000, 0, 0, 0, 0, 0.00, 12, 1356.00, 129
6, 12:46:00-000, 0, 0, 0, 7, 1344.00, 0, 0.00, 108
6, 12:47:00-000, 0, 0, 0, 0, 0.00, 0, 0.00, 123
6, 12:48:00-000, 0, 0, 0, 0, 0.00, 0, 0.00, 111
6, 12:49:00-000, 0, 0, 0, 0, 0.00, 0, 0.00, 129
6, 12:50:00-000, 0, 0, 0, 21, 1344.00, 27, 1357.00, 122
6, 12:51:00-000, 0, 0, 0, 9, 1344.00, 12, 1357.00, 104
6, 12:52:00-000, 0, 0, 0, 0, 0.00, 0, 0.00, 94
6, 12:53:00-000, 0, 0, 0, 0, 0.00, 28, 1357.00, 97
6, 12:54:00-000, 0, 0, 0, 0, 0.00, 14, 1358.00, 134
6, 12:55:00-000, 0, 0, 0, 0, 0.00, 0, 0.00, 121
6, 12:56:00-000, 0, 0, 0, 0, 0.00, 0, 0.00, 103
6, 12:57:00-000, 0, 0, 0, 0, 0.00, 0, 0.00, 95
6, 12:58:00-000, 0, 0, 0, 0, 0.00, 0, 0.00, 88
6, 12:59:00-000, 0, 0, 0, 0, 0.00, 0, 0.00, 93
6, 13:00:00-000, 0, 0, 0, 0, 0.00, 0, 0.00, 1
6, 15:40:00-000, 6946, 3466, 3480, 1609, 1347.83, 1664, 1348.46, 0
6, 15:41:00-000, 0, 0, 0, 53, 1347.00, 55, 1354.00, 0
6, 15:42:00-000, 0, 0, 0, 183, 1346.00, 87, 1354.00, 0
6, 15:43:00-000, 0, 0, 0, 63, 1346.00, 40, 1354.00, 0
6, 15:44:00-000, 0, 0, 0, 10, 1346.00, 118, 1354.55, 0
6, 15:45:00-000, 0, 0, 0, 12, 1345.00, 20, 1355.00, 0
6, 15:46:00-000, 0, 0, 0, 56, 1345.00, 57, 1355.00, 0
6, 15:47:00-000, 0, 0, 0, 44, 1345.00, 3, 1355.00, 0
6, 15:48:00-000, 0, 0, 0, 0, 0.00, 112, 1355.00, 0
6, 15:49:00-000, 0, 0, 0, 0, 0.00, 5, 1355.00, 0
6, 15:50:00-000, 0, 0, 0, 31, 1345.00, 0, 0.00, 0
6, 15:51:00-000, 0, 0, 0, 64, 1345.00, 0, 0.00, 0
6, 15:52:00-000, 0, 0, 0, 3, 1345.00, 74, 1356.00, 0
6, 15:53:00-000, 0, 0, 0, 34, 1345.00, 0, 0.00, 0
6, 15:54:00-000, 0, 0, 0, 8, 1344.00, 8, 1356.00, 0
6, 15:55:00-000, 0, 0, 0, 45, 1344.00, 0, 0.00, 0
6, 15:56:00-000, 0, 0, 0, 74, 1344.00, 0, 0.00, 0
6, 15:57:00-000, 0, 0, 0, 0, 0.00, 41, 1356.00, 0
6, 15:58:00-000, 0, 0, 0, 0, 0.00, 18, 1356.00, 0
6, 16:00:00-000, 0, 0, 0, 0, 0.00, 17, 1356.00, 118
6, 16:01:00-000, 1, 0, 1, 0, 0.00, 0, 0.00, 123
6, 16:02:00-000, 0, 0, 0, 0, 0.00, 0, 0.00, 125
6, 16:03:00-000, 0, 0, 0, 0, 0.00, 0, 0.00, 108
6, 16:04:00-000, 0, 0, 0, 0, 0.00, 0, 0.00, 122
6, 16:05:00-000, 0, 0, 0, 0, 0.00, 23, 1356.00, 125
6, 16:06:00-000, 0, 0, 0, 0, 0.00, 11, 1356.00, 127
6, 16:07:00-000, 0, 0, 0, 0, 0.00, 0, 0.00, 114
6, 16:08:00-000, 1, 0, 1, 0, 0.00, 23, 1356.00, 108
6, 16:09:00-000, 0, 0, 0, 0, 0.00, 0, 0.00, 102
6, 16:10:00-000, 0, 0, 0, 0, 0.00, 0, 0.00, 111
6, 16:11:00-000, 0, 0, 0, 19, 1344.00, 0, 0.00, 119
6, 16:12:00-000, 0, 0, 0, 0, 0.00, 57, 1357.00, 115
6, 16:13:00-000, 0, 0, 0, 0, 0.00, 0, 0.00, 104
6, 16:14:00-000, 0, 0, 0, 0, 0.00, 9, 1357.00, 95
6, 16:15:00-000, 0, 0, 0, 0, 0.00, 0, 0.00, 93
6, 16:16:00-000, 1, 0, 1, 0, 0.00, 0, 0.00, 109
6, 16:17:00-000, 0, 0, 0, 0, 0.00, 0, 0.00, 96
6, 16:18:00-000, 0, 0, 0, 0, 0.00, 0, 0.00, 93
6, 16:19:00-000, 0, 0, 0, 0, 0.00, 0, 0.00, 90
6, 16:20:00-000, 12, 4, 8, 1, 1352.00, 6, 1351.33, 0
6, 16:21:00-000, 0, 0, 0, 1, 1344.00, 0, 0.00, 0
6, 16:29:00-000, 0, 0, 0, 0, 0.00, 0, 0.00, 1
8, 09:07:00-000, 3609, 1192, 2417, 0, 0.00, 0, 0.00, 3609
8, 09:22:00-000, 22, 21, 1, 1, 1351.00, 1, 1350.00, 20
8, 09:29:00-000, 540, 4, 536, 1, 1349.00, 1, 1353.00, 538
8, 09:30:00-000, 5672, 1184, 4488, 0, 0.00, 0, 0.00, 4210
8, 09:31:00-000, 0, 0, 0, 0, 0.00, 0, 0.00, 1462
8, 09:35:00-000, 223, 190, 33, 0, 0.00, 0, 0.00, 223
8, 09:36:00-000, 4726, 2635, 2091, 5, 1348.60, 5, 1349.00, 4716
8, 09:37:00-000, 1789, 964, 825, 3, 1352.00, 3, 1351.00, 1783
8, 09:39:00-000, 5707, 3820, 1887, 0, 0.00, 0, 0.00, 4890
8, 09:40:00-000, 7, 0, 7, 7, 1349.57, 7, 1349.00, 810
8, 09:46:00-000, 1268, 309, 959, 0, 0.00, 0, 0.00, 1174
8, 09:47:00-000, 7510, 5926, 1584, 1, 1351.00, 1, 1349.00, 7602
8, 09:48:00-000, 7410, 4062, 3348, 0, 0.00, 0, 0.00, 7410
8, 09:53:00-000, 153, 3, 150, 0, 0.00, 0, 0.00, 153
8, 09:58:00-000, 1886, 1693, 193, 65, 1347.82, 13, 1351.31, 1808
8, 09:59:00-000, 52, 0, 52, 0, 0.00, 52, 1347.34, 0
8, 10:00:00-000, 9968, 4200, 5768, 10, 1348.40, 9, 1349.56, 9949
8, 10:01:00-000, 6860, 5648, 1212, 7, 1349.29, 8, 1349.87, 6845
8, 10:02:00-000, 3832, 2719, 1113, 0, 0.00, 0, 0.00, 3832
8, 10:04:00-000, 1815, 194, 1621, 6, 1347.83, 5, 1351.00, 1804
8, 10:05:00-000, 4158, 3069, 1089, 9, 1349.00, 10, 1351.40, 4139
8, 10:11:00-000, 252, 250, 2, 0, 0.00, 0, 0.00, 252
8, 10:14:00-000, 6525, 4551, 1974, 2, 1350.50, 2, 1350.50, 6521
8, 10:15:00-000, 905, 885, 20, 0, 0.00, 0, 0.00, 905
8, 10:17:00-000, 5080, 2479, 2601, 1, 1352.00, 1, 1350.00, 5057
8, 10:18:00-000, 3240, 2577, 663, 5, 1348.00, 5, 1348.40, 3157
8, 10:19:00-000, 3064, 1801, 1263, 4, 1350.50, 4, 1350.25, 3150
8, 10:20:00-000, 1965, 1630, 335, 0, 0.00, 0, 0.00, 1965
8, 10:25:00-000, 259, 9, 250, 0, 0.00, 0, 0.00, 259
8, 10:26:00-000, 4534, 1136, 3398, 0, 0.00, 0, 0.00, 4534
8, 10:27:00-000, 6178, 4351, 1827, 1, 1350.00, 1, 1349.00, 6176
8, 10:29:00-000, 118, 80, 38, 23, 1348.00, 23, 1350.91, 72
8, 10:30:00-000, 192, 12, 180, 0, 0.00, 0, 0.00, 192
8, 10:32:00-000, 1252, 767, 485, 22, 1347.00, 16, 1351.81, 1214
8, 10:33:00-000, 11, 0, 11, 0, 0.00, 6, 1350.67, 5
8, 10:36:00-000, 1052, 735, 317, 0, 0.00, 0, 0.00, 982
8, 10:37:00-000, 6592, 5228, 1364, 4, 1351.00, 4, 1351.00, 6654
8, 10:38:00-000, 7783, 1931, 5852, 22, 1349.50, 21, 1349.57, 7740
8, 10:39:00-000, 705, 65, 640, 0, 0.00, 1, 1347.00, 704
8, 10:40:00-000, 2290, 592, 1698, 3, 1349.00, 3, 1349.67, 2284
8, 10:41:00-000, 4987, 63, 4924, 3, 1349.67, 3, 1346.33, 4981
8, 10:42:00-000, 769, 651, 118, 0, 0.00, 0, 0.00, 769
8, 10:44:00-000, 3786, 963, 2823, 0, 0.00, 0, 0.00, 3471
8, 10:45:00-000, 3026, 2011, 1015, 7, 1350.00, 7, 1349.14, 3327
8, 10:46:00-000, 806, 94, 712, 27, 1346.40, 17, 1349.12, 762
8, 10:47:00-000, 4643, 543, 4100, 13, 1350.00, 23, 1348.83, 4607
8, 10:48:00-000, 9001, 4549, 4452, 7, 1350.43, 7, 1351.00, 8274
8, 10:49:00-000, 6099, 4960, 1139, 5, 1351.20, 5, 1352.00, 6802
8, 10:50:00-000, 2259, 1312, 947, 7, 1349.00, 7, 1347.86, 2245
8, 10:51:00-000, 2461, 959, 1502, 0, 0.00, 0, 0.00, 2400
8, 10:52:00-000, 9794, 6151, 3643, 13, 1351.00, 13, 1351.38, 9726
8, 10:53:00-000, 5289, 2051, 3238, 0, 0.00, 0, 0.00, 5392
8, 10:54:00-000, 1231, 1230, 1, 0, 0.00, 0, 0.00, 1231
8, 10:55:00-000, 240, 27, 213, 7, 1349.00, 7, 1349.57, 226
8, 10:56:00-000, 340, 238, 102, 1, 1348.00, 1, 1351.00, 338
8, 10:57:00-000, 22, 1, 21, 1, 1349.00, 1, 1350.00, 20
8, 10:58:00-000, 5574, 1651, 3923, 10, 1349.00, 10, 1352.00, 5554
8, 10:59:00-000, 6039, 4195, 1844, 0, 0.00, 0, 0.00, 5652
8, 11:00:00-000, 2650, 399, 2251, 8, 1351.62, 10, 1353.70, 3019
8, 11:01:00-000, 6717, 4885, 1832, 4, 1352.50, 2, 1349.00, 6711
8, 11:02:00-000, 91, 81, 10, 1, 1350.00, 1, 1348.00, 89
8, 11:03:00-000, 1240, 104, 1136, 0, 0.00, 0, 0.00, 1064
8, 11:04:00-000, 64, 55, 9, 10, 1351.20, 10, 1349.40, 220
8, 11:05:00-000, 100, 100, 0, 0, 0.00, 0, 0.00, 100
8, 11:06:00-000, 5479, 4340, 1139, 4, 1349.50, 4, 1353.50, 5463
8, 11:07:00-000, 4331, 3948, 383, 4, 1349.25, 4, 1349.50, 4331
8, 11:08:00-000, 1633, 158, 1475, 51, 1355.11, 51, 1351.78, 1531
8, 11:09:00-000, 8144, 3474, 4670, 13, 1349.15, 13, 1353.77, 8118
8, 11:12:00-000, 4838, 1105, 3733, 29, 1348.72, 32, 1351.87, 4777
8, 11:13:00-000, 3, 3, 0, 3, 1350.00, 0, 0.00, 0
8, 11:14:00-000, 2039, 1661, 378, 0, 0.00, 0, 0.00, 1879
8, 11:15:00-000, 1966, 948, 1018, 1, 1350.00, 1, 1349.00, 2124
8, 11:16:00-000, 1292, 1139, 153, 1, 1349.00, 1, 1353.00, 1290
8, 11:19:00-000, 170, 10, 160, 0, 0.00, 0, 0.00, 170
8, 11:20:00-000, 66, 6, 60, 0, 0.00, 0, 0.00, 66
8, 11:21:00-000, 6114, 4026, 2088, 0, 0.00, 0, 0.00, 6114
8, 11:22:00-000, 1870, 1538, 332, 2, 1350.00, 2, 1351.00, 1866
8, 11:23:00-000, 3925, 2699, 1226, 4, 1350.00, 4, 1350.00, 3917
8, 11:25:00-000, 5636, 2362, 3274, 3, 1351.00, 3, 1351.00, 4898
8, 11:26:00-000, 2592, 2255, 337, 2, 1349.00, 2, 1351.00, 3320
8, 11:27:00-000, 1989, 23, 1966, 7, 1348.29, 7, 1350.28, 1975
8, 11:30:00-000, 1257, 1136, 121, 0, 0.00, 0, 0.00, 1257
8, 11:31:00-000, 4388, 4085, 303, 0, 0.00, 0, 0.00, 4291
8, 11:32:00-000, 7479, 5822, 1657, 10, 1348.30, 7, 1349.86, 7559
8, 11:33:00-000, 1566, 1513, 53, 0, 0.00, 3, 1348.00, 53
8, 11:34:00-000, 5584, 3738, 1846, 2, 1349.50, 2, 1349.50, 7083
8, 11:35:00-000, 3053, 1681, 1372, 9, 1351.78, 9, 1352.00, 3042
8, 11:36:00-000, 4192, 666, 3526, 7, 1348.43, 7, 1349.57, 4178
8, 11:37:00-000, 6789, 4625, 2164, 2, 1350.50, 2, 1350.50, 6785
8, 11:38:00-000, 5884, 2553, 3331, 4, 1357.00, 4, 1351.00, 5876
8, 11:39:00-000, 1084, 871, 213, 21, 1350.76, 27, 1353.00, 1036
8, 11:40:00-000, 8, 8, 0, 6, 1352.67, 0, 0.00, 2
8, 11:41:00-000, 1129, 838, 291, 6, 1349.50, 6, 1349.00, 1117
8, 11:42:00-000, 7397, 2880, 4517, 11, 1349.91, 11, 1349.00, 7375
8, 11:43:00-000, 165, 65, 100, 38, 1353.55, 38, 1353.00, 89
8, 11:45:00-000, 895, 29, 866, 0, 0.00, 0, 0.00, 895
8, 11:49:00-000, 1404, 4, 1400, 0, 0.00, 0, 0.00, 1404
8, 11:50:00-000, 1645, 245, 1400, 0, 0.00, 0, 0.00, 1645
8, 11:51:00-000, 1073, 1062, 11, 2, 1355.00, 2, 1351.00, 1069
8, 11:52:00-000, 4155, 1467, 2688, 2, 1351.00, 0, 0.00, 4153
8, 11:53:00-000, 1648, 891, 757, 0, 0.00, 2, 1349.00, 1646
8, 11:54:00-000, 6266, 5055, 1211, 5, 1353.00, 5, 1350.00, 6236
8, 11:55:00-000, 0, 0, 0, 0, 0.00, 0, 0.00, 20
8, 11:56:00-000, 8473, 5089, 3384, 1, 1351.00, 1, 1350.00, 8392
8, 11:57:00-000, 7401, 3886, 3515, 4, 1351.00, 4, 1351.00, 7472
8, 11:58:00-000, 5674, 1385, 4289, 1, 1349.00, 1, 1348.00, 5672
8, 11:59:00-000, 6777, 2446, 4331, 1, 1351.00, 1, 1351.00, 5735
8, 12:00:00-000, 3640, 486, 3154, 5, 1350.00, 5, 1349.20, 4670
8, 12:01:00-000, 286, 271, 15, 1, 1354.00, 1, 1351.00, 208
8, 12:02:00-000, 91, 8, 83, 3, 1349.00, 2, 1350.00, 162
8, 12:03:00-000, 2712, 999, 1713, 0, 0.00, 1, 1349.00, 2711
8, 12:04:00-000, 6092, 5072, 1020, 9, 1349.67, 9, 1350.78, 6074
8, 12:05:00-000, 3063, 1179, 1884, 12, 1345.75, 12, 1349.08, 3039
8, 12:06:00-000, 4805, 3760, 1045, 9, 1349.00, 9, 1347.55, 4787
8, 12:08:00-000, 10731, 2020, 8711, 2, 1352.00, 2, 1351.00, 10727
8, 12:09:00-000, 1722, 118, 1604, 0, 0.00, 0, 0.00, 1722
8, 12:10:00-000, 3517, 862, 2655, 4, 1353.00, 4, 1351.00, 3509
8, 12:11:00-000, 2959, 1312, 1647, 0, 0.00, 0, 0.00, 2938
8, 12:12:00-000, 6181, 3781, 2400, 64, 1348.01, 64, 1346.41, 6074
8, 12:13:00-000, 344, 14, 330, 8, 1349.63, 8, 1348.75, 328
8, 12:14:00-000, 2923, 96, 2827, 3, 1351.00, 3, 1352.00, 2917
8, 12:15:00-000, 3294, 1850, 1444, 3, 1352.00, 3, 1351.00, 3288
8, 12:16:00-000, 2548, 1022, 1526, 0, 0.00, 0, 0.00, 2548
8, 12:17:00-000, 4986, 227, 4759, 23, 1347.65, 23, 1348.61, 4940
8, 12:18:00-000, 132, 12, 120, 0, 0.00, 0, 0.00, 132
8, 12:22:00-000, 1725, 65, 1660, 0, 0.00, 0, 0.00, 1725
8, 12:24:00-000, 4135, 2141, 1994, 0, 0.00, 0, 0.00, 4135
8, 12:25:00-000, 3368, 1688, 1680, 0, 0.00, 0, 0.00, 2518
8, 12:26:00-000, 196, 92, 104, 4, 1351.00, 4, 1350.75, 1038
8, 12:28:00-000, 3360, 1585, 1775, 0, 0.00, 0, 0.00, 1915
8, 12:29:00-000, 3268, 189, 3079, 9, 1348.89, 9, 1349.11, 4695
8, 12:30:00-000, 1770, 1600, 170, 0, 0.00, 0, 0.00, 1770
8, 12:31:00-000, 1058, 303, 755, 0, 0.00, 0, 0.00, 954
8, 12:32:00-000, 1371, 1106, 265, 2, 1350.00, 2, 1350.00, 1471
8, 12:33:00-000, 787, 7, 780, 0, 0.00, 0, 0.00, 787
8, 12:34:00-000, 1859, 159, 1700, 0, 0.00, 0, 0.00, 1859
8, 12:37:00-000, 1480, 260, 1220, 0, 0.00, 0, 0.00, 1480
8, 12:38:00-000, 2093, 1492, 601, 1, 1349.00, 1, 1349.00, 2091
8, 12:40:00-000, 267, 192, 75, 0, 0.00, 0, 0.00, 267
8, 12:42:00-000, 82, 81, 1, 1, 1350.00, 1, 1351.00, 80
8, 12:44:00-000, 1122, 15, 1107, 2, 1349.00, 2, 1349.50, 1118
8, 12:45:00-000, 1557, 1540, 17, 0, 0.00, 0, 0.00, 1557
8, 12:47:00-000, 21, 1, 20, 0, 0.00, 0, 0.00, 21
8, 12:48:00-000, 50, 50, 0, 0, 0.00, 0, 0.00, 50
8, 12:49:00-000, 241, 153, 88, 9, 1356.00, 9, 1352.00, 223
8, 12:51:00-000, 235, 25, 210, 14, 1351.28, 14, 1354.00, 207
8, 12:52:00-000, 3377, 1562, 1815, 0, 0.00, 0, 0.00, 3377
8, 12:53:00-000, 1887, 857, 1030, 0, 0.00, 0, 0.00, 1887
8, 12:55:00-000, 1347, 1288, 59, 0, 0.00, 0, 0.00, 1347
8, 12:57:00-000, 2647, 1542, 1105, 13, 1347.92, 13, 1350.08, 2621
8, 12:58:00-000, 4049, 914, 3135, 0, 0.00, 0, 0.00, 4049
8, 13:00:00-000, 6749, 3763, 2986, 19, 1351.26, 19, 1350.21, 6711
8, 13:01:00-000, 9588, 7204, 2384, 4, 1352.25, 7, 1351.57, 8757
8, 13:02:00-000, 2877, 1639, 1238, 7, 1350.86, 20, 1352.00, 3670
8, 13:03:00-000, 4642, 2940, 1702, 16, 1354.44, 0, 0.00, 4626
8, 13:04:00-000, 3463, 1381, 2082, 2, 1349.00, 2, 1349.50, 3459
8, 13:05:00-000, 1738, 1710, 28, 0, 0.00, 0, 0.00, 1738
8, 13:06:00-000, 9796, 7591, 2205, 2, 1349.00, 1, 1350.00, 8215
8, 13:07:00-000, 3328, 801, 2527, 1, 1351.00, 2, 1351.00, 4903
8, 13:08:00-000, 1578, 1437, 141, 49, 1347.50, 17, 1350.47, 1512
8, 13:09:00-000, 68, 0, 68, 0, 0.00, 32, 1349.50, 36
8, 13:10:00-000, 10834, 5241, 5593, 3, 1350.33, 3, 1350.33, 10828
8, 13:12:00-000, 2702, 1552, 1150, 5, 1349.40, 5, 1347.80, 2692
8, 13:13:00-000, 3359, 1023, 2336, 2, 1350.00, 2, 1350.00, 3355
8, 13:14:00-000, 6688, 2475, 4213, 1, 1350.00, 1, 1350.00, 6686
8, 13:16:00-000, 63, 13, 50, 3, 1350.33, 3, 1353.00, 57
8, 13:18:00-000, 213, 40, 173, 6, 1348.83, 11, 1350.64, 196
8, 13:19:00-000, 4204, 1871, 2333, 6, 1351.83, 1, 1347.00, 4197
8, 13:20:00-000, 2058, 1895, 163, 14, 1349.78, 14, 1353.64, 2030
8, 13:21:00-000, 6717, 1218, 5499, 11, 1350.82, 11, 1352.27, 6672
8, 13:22:00-000, 2127, 733, 1394, 22, 1349.18, 22, 1347.82, 2106
8, 13:23:00-000, 6578, 4516, 2062, 1, 1350.00, 1, 1349.00, 5549
8, 13:24:00-000, 2232, 1925, 307, 8, 1349.75, 10, 1347.70, 3239
8, 13:25:00-000, 2314, 1282, 1032, 2, 1351.00, 0, 0.00, 2314
8, 13:26:00-000, 3823, 1196, 2627, 4, 1352.75, 4, 1350.50, 3815
8, 13:27:00-000, 1584, 972, 612, 0, 0.00, 0, 0.00, 1584
8, 13:28:00-000, 3760, 2303, 1457, 8, 1345.87, 8, 1347.62, 3691
8, 13:29:00-000, 4342, 2318, 2024, 8, 1349.50, 8, 1349.75, 4379
8, 13:30:00-000, 1178, 26, 1152, 7, 1346.71, 5, 1349.20, 1166
8, 13:31:00-000, 3153, 476, 2677, 4, 1349.00, 6, 1347.50, 3143
8, 13:32:00-000, 2173, 1175, 998, 10, 1349.20, 10, 1346.40, 2153
8, 13:33:00-000, 3502, 831, 2671, 1, 1352.00, 1, 1351.00, 3424
8, 13:34:00-000, 9014, 7011, 2003, 1, 1348.00, 1, 1350.00, 9088
8, 13:35:00-000, 11244, 5433, 5811, 1, 1351.00, 1, 1351.00, 11242
8, 13:36:00-000, 753, 678, 75, 3, 1353.67, 3, 1351.00, 747
8, 13:37:00-000, 4316, 3188, 1128, 3, 1353.00, 3, 1351.67, 4310
8, 13:38:00-000, 6835, 4827, 2008, 2, 1351.00, 2, 1351.00, 6831
8, 13:41:00-000, 561, 208, 353, 6, 1353.00, 6, 1352.00, 549
8, 13:42:00-000, 8001, 4747, 3254, 16, 1348.19, 16, 1350.87, 7868
8, 13:43:00-000, 8177, 1886, 6291, 2, 1350.50, 2, 1350.00, 8274
8, 13:44:00-000, 1708, 13, 1695, 0, 0.00, 0, 0.00, 1708
8, 13:46:00-000, 171, 11, 160, 0, 0.00, 0, 0.00, 171
8, 13:47:00-000, 88, 80, 8, 0, 0.00, 0, 0.00, 88
8, 13:48:00-000, 5273, 3290, 1983, 4, 1351.75, 4, 1351.75, 5055
8, 13:49:00-000, 7197, 1982, 5215, 3, 1350.00, 3, 1351.33, 7380
8, 13:50:00-000, 2987, 1238, 1749, 12, 1350.17, 16, 1351.25, 2921
8, 13:51:00-000, 649, 634, 15, 4, 1351.75, 0, 0.00, 704
8, 13:53:00-000, 578, 291, 287, 1, 1351.00, 1, 1349.00, 482
8, 13:54:00-000, 7288, 3594, 3694, 34, 1349.88, 34, 1352.85, 7314
8, 13:55:00-000, 733, 18, 715, 0, 0.00, 0, 0.00, 733
8, 13:56:00-000, 1931, 159, 1772, 2, 1348.00, 2, 1353.00, 1927
8, 13:57:00-000, 6302, 1994, 4308, 8, 1348.63, 8, 1350.50, 6286
8, 14:00:00-000, 1546, 1530, 16, 5, 1347.00, 5, 1350.20, 1536
8, 14:01:00-000, 3992, 912, 3080, 0, 0.00, 8, 1350.87, 3984
8, 14:02:00-000, 4865, 1909, 2956, 16, 1350.94, 8, 1349.62, 4841
8, 14:03:00-000, 8046, 5081, 2965, 0, 0.00, 1, 1349.00, 7980
8, 14:04:00-000, 4716, 1861, 2855, 6, 1348.50, 5, 1349.00, 4770
8, 14:05:00-000, 1844, 1732, 112, 5, 1351.80, 5, 1351.00, 1834
8, 14:06:00-000, 1759, 113, 1646, 2, 1348.00, 2, 1349.50, 1755
8, 14:07:00-000, 8165, 2980, 5185, 0, 0.00, 0, 0.00, 8060
8, 14:08:00-000, 2395, 2245, 150, 5, 1349.20, 5, 1348.00, 2490
8, 14:09:00-000, 3382, 858, 2524, 0, 0.00, 0, 0.00, 3374
8, 14:10:00-000, 3275, 1308, 1967, 6, 1354.67, 6, 1351.00, 3271
8, 14:11:00-000, 1061, 663, 398, 2, 1350.00, 2, 1350.00, 894
8, 14:12:00-000, 1754, 1706, 48, 23, 1345.17, 23, 1347.09, 1871
8, 14:13:00-000, 4387, 1122, 3265, 1, 1351.00, 1, 1351.00, 4226
8, 14:14:00-000, 467, 192, 275, 10, 1348.60, 10, 1351.30, 606
8, 14:15:00-000, 3336, 243, 3093, 2, 1349.50, 1, 1349.00, 3333
8, 14:16:00-000, 1600, 1533, 67, 3, 1353.33, 4, 1352.25, 1593
8, 14:17:00-000, 3225, 1507, 1718, 7, 1349.14, 7, 1346.14, 3211
8, 14:18:00-000, 3035, 1496, 1539, 2, 1354.50, 2, 1351.00, 3021
8, 14:19:00-000, 4573, 2186, 2387, 4, 1350.00, 0, 0.00, 4579
8, 14:20:00-000, 2034, 1242, 792, 0, 0.00, 4, 1348.00, 2030
8, 14:21:00-000, 2716, 1989, 727, 0, 0.00, 0, 0.00, 2716
8, 14:22:00-000, 5820, 2692, 3128, 11, 1350.09, 11, 1348.91, 5798
8, 14:23:00-000, 2390, 1135, 1255, 6, 1348.33, 6, 1349.67, 2378
8, 14:24:00-000, 3860, 2792, 1068, 26, 1351.34, 26, 1351.38, 3808
8, 14:25:00-000, 8628, 3890, 4738, 7, 1351.86, 3, 1351.33, 8618
8, 14:26:00-000, 6979, 4834, 2145, 3, 1351.00, 9, 1349.22, 6967
8, 14:27:00-000, 311, 306, 5, 6, 1352.17, 4, 1350.00, 301
8, 14:28:00-000, 2687, 1780, 907, 20, 1355.05, 24, 1351.42, 2643
8, 14:29:00-000, 7182, 3080, 4102, 5, 1349.20, 1, 1347.00, 7176
8, 14:30:00-000, 210, 10, 200, 10, 1349.60, 10, 1352.00, 190
8, 14:31:00-000, 1740, 741, 999, 4, 1356.50, 4, 1351.00, 1732
8, 14:32:00-000, 2066, 741, 1325, 5, 1348.00, 5, 1351.60, 2056
8, 14:33:00-000, 2527, 110, 2417, 2, 1346.50, 2, 1348.00, 2499
8, 14:34:00-000, 1543, 1306, 237, 5, 1349.80, 5, 1349.80, 1557
8, 14:35:00-000, 8020, 2879, 5141, 8, 1349.50, 8, 1349.00, 8004
8, 14:36:00-000, 3067, 22, 3045, 5, 1349.00, 5, 1349.40, 3057
8, 14:37:00-000, 3947, 998, 2949, 2, 1350.00, 2, 1355.00, 3943
8, 14:38:00-000, 2634, 997, 1637, 3, 1352.33, 3, 1351.00, 2628
8, 14:39:00-000, 104, 97, 7, 5, 1353.80, 5, 1353.00, 94
8, 14:40:00-000, 1037, 144, 893, 28, 1351.89, 28, 1352.35, 981
8, 14:41:00-000, 1651, 709, 942, 21, 1350.19, 21, 1350.48, 1609
8, 14:42:00-000, 1686, 1580, 106, 1, 1350.00, 1, 1352.00, 1684
8, 14:43:00-000, 7409, 4024, 3385, 0, 0.00, 0, 0.00, 7391
8, 14:44:00-000, 0, 0, 0, 0, 0.00, 0, 0.00, 18
8, 14:45:00-000, 5524, 2035, 3489, 5, 1350.20, 4, 1352.00, 5515
8, 14:46:00-000, 1041, 921, 120, 26, 1350.65, 27, 1349.00, 988
8, 14:48:00-000, 2518, 749, 1769, 7, 1346.71, 7, 1344.00, 2504
8, 14:49:00-000, 947, 98, 849, 8, 1350.75, 8, 1347.00, 910
8, 14:50:00-000, 2495, 41, 2454, 3, 1348.00, 3, 1349.33, 2510
8, 14:51:00-000, 3032, 2715, 317, 0, 0.00, 0, 0.00, 3032
8, 14:52:00-000, 6051, 2818, 3233, 1, 1354.00, 1, 1350.00, 6049
8, 14:53:00-000, 6312, 3992, 2320, 11, 1351.91, 11, 1350.82, 6287
8, 14:54:00-000, 5016, 2482, 2534, 12, 1348.83, 12, 1351.08, 4995
8, 14:55:00-000, 3555, 2605, 950, 3, 1351.00, 3, 1351.00, 3549
8, 14:56:00-000, 1024, 214, 810, 21, 1348.57, 21, 1351.67, 982
8, 14:57:00-000, 2588, 1903, 685, 7, 1352.43, 12, 1350.42, 2566
8, 14:58:00-000, 1661, 1473, 188, 15, 1348.80, 10, 1351.50, 1355
8, 14:59:00-000, 7931, 1930, 6001, 0, 0.00, 0, 0.00, 8215
8, 15:00:00-000, 3542, 2795, 747, 7, 1350.43, 8, 1349.37, 3527
8, 15:01:00-000, 1424, 905, 519, 32, 1346.93, 31, 1345.22, 1361
8, 15:02:00-000, 9769, 2569, 7200, 7, 1348.71, 7, 1350.14, 9655
8, 15:03:00-000, 12699, 3368, 9331, 5, 1348.60, 3, 1348.00, 12791
8, 15:04:00-000, 1506, 1500, 6, 0, 0.00, 2, 1346.00, 1504
8, 15:05:00-000, 3914, 1437, 2477, 16, 1352.25, 16, 1352.00, 3882
8, 15:06:00-000, 3629, 1693, 1936, 14, 1352.57, 14, 1351.36, 3601
8, 15:07:00-000, 1537, 1172, 365, 14, 1352.64, 14, 1352.36, 1509
8, 15:08:00-000, 1125, 195, 930, 0, 0.00, 0, 0.00, 1108
8, 15:09:00-000, 3759, 2185, 1574, 0, 0.00, 0, 0.00, 3776
8, 15:10:00-000, 3292, 716, 2576, 9, 1347.78, 9, 1349.44, 3274
8, 15:11:00-000, 3837, 2527, 1310, 6, 1351.00, 6, 1350.00, 3825
8, 15:12:00-000, 1546, 142, 1404, 0, 0.00, 0, 0.00, 1546
8, 15:13:00-000, 3689, 243, 3446, 4, 1350.75, 4, 1348.00, 3681
8, 15:14:00-000, 1479, 1474, 5, 3, 1352.67, 3, 1351.00, 1473
8, 15:15:00-000, 4144, 1542, 2602, 1, 1349.00, 0, 0.00, 4143
8, 15:16:00-000, 1819, 862, 957, 20, 1350.60, 11, 1350.09, 1788
8, 15:17:00-000, 749, 730, 19, 0, 0.00, 10, 1347.10, 730
8, 15:18:00-000, 2982, 1743, 1239, 1, 1351.00, 1, 1350.00, 2989
8, 15:19:00-000, 5995, 982, 5013, 0, 0.00, 0, 0.00, 5995
8, 15:20:00-000, 4520, 2792, 1728, 10, 1346.90, 10, 1348.80, 4500
8, 15:21:00-000, 2342, 1541, 801, 0, 0.00, 3, 1351.00, 2339
8, 15:22:00-000, 3626, 2763, 863, 3, 1350.00, 0, 0.00, 2255
8, 15:23:00-000, 3557, 951, 2606, 5, 1349.40, 5, 1349.40, 4915
8, 15:24:00-000, 4680, 2646, 2034, 9, 1352.89, 9, 1350.11, 4656
8, 15:25:00-000, 3353, 2038, 1315, 1, 1351.00, 1, 1352.00, 3357
8, 15:26:00-000, 4519, 1321, 3198, 14, 1351.86, 14, 1351.43, 4491
8, 15:27:00-000, 9395, 5034, 4361, 7, 1349.86, 7, 1349.14, 9381
8, 15:28:00-000, 255, 202, 53, 0, 0.00, 0, 0.00, 255
8, 15:29:00-000, 836, 76, 760, 0, 0.00, 0, 0.00, 836
8, 15:30:00-000, 2033, 234, 1799, 11, 1352.36, 21, 1352.38, 2001
8, 15:31:00-000, 18, 18, 0, 10, 1355.80, 0, 0.00, 8
8, 15:32:00-000, 3919, 703, 3216, 4, 1349.75, 4, 1351.00, 3911
8, 15:33:00-000, 4485, 4167, 318, 0, 0.00, 0, 0.00, 4485
8, 15:34:00-000, 2502, 2402, 100, 9, 1351.55, 9, 1350.00, 2484
8, 15:35:00-000, 3569, 202, 3367, 1, 1350.00, 1, 1349.00, 3567
8, 15:36:00-000, 4168, 3158, 1010, 7, 1349.71, 7, 1350.86, 4090
8, 15:37:00-000, 9554, 4035, 5519, 5, 1351.80, 2, 1350.00, 9607
8, 15:38:00-000, 2703, 1772, 931, 1, 1348.00, 4, 1346.75, 2702
8, 15:39:00-000, 2645, 978, 1667, 5, 1352.20, 5, 1351.00, 2577
8, 15:40:00-000, 15, 0, 15, 23, 1347.00, 23, 1350.08, 27
8, 15:41:00-000, 818, 800, 18, 0, 0.00, 0, 0.00, 818
8, 15:42:00-000, 2302, 2212, 90, 6, 1351.83, 6, 1351.00, 2290
8, 15:43:00-000, 109, 9, 100, 0, 0.00, 0, 0.00, 109
8, 15:44:00-000, 1771, 302, 1469, 0, 0.00, 0, 0.00, 1771
8, 15:45:00-000, 1910, 822, 1088, 0, 0.00, 0, 0.00, 1910
8, 15:46:00-000, 76, 70, 6, 0, 0.00, 0, 0.00, 76
8, 15:51:00-000, 2610, 94, 2516, 0, 0.00, 0, 0.00, 2501
8, 15:52:00-000, 0, 0, 0, 0, 0.00, 0, 0.00, 109
8, 15:55:00-000, 2162, 1619, 543, 3, 1349.00, 2, 1348.50, 2096
8, 15:56:00-000, 93, 80, 13, 12, 1349.00, 13, 1344.38, 129
8, 16:01:00-000, 5066, 1187, 3879, 0, 0.00, 0, 0.00, 5066
8, 16:03:00-000, 1081, 966, 115, 0, 0.00, 0, 0.00, 1081
8, 16:05:00-000, 1750, 767, 983, 0, 0.00, 0, 0.00, 1750
8, 16:07:00-000, 163, 98, 65, 0, 0.00, 0, 0.00, 163
8, 16:08:00-000, 906, 30, 876, 16, 1347.00, 5, 1351.80, 885
8, 16:09:00-000, 2948, 1490, 1458, 0, 0.00, 11, 1349.91, 2937
8, 16:10:00-000, 1107, 943, 164, 1, 1354.00, 1, 1351.00, 1105
8, 16:11:00-000, 1929, 1610, 319, 0, 0.00, 0, 0.00, 1929
8, 16:13:00-000, 2276, 2218, 58, 0, 0.00, 0, 0.00, 2276
8, 16:15:00-000, 23, 20, 3, 2, 1348.00, 2, 1346.00, 19
8, 16:16:00-000, 2538, 1619, 919, 0, 0.00, 0, 0.00, 2538
8, 16:17:00-000, 1613, 1532, 81, 25, 1349.00, 25, 1350.48, 1563
8, 16:18:00-000, 2569, 1640, 929, 0, 0.00, 0, 0.00, 2569
8, 16:19:00-000, 96, 6, 90, 0, 0.00, 0, 0.00, 96
8, 16:20:00-000, 4528, 3296, 1232, 10, 1351.10, 10, 1351.40, 4508
8, 16:21:00-000, 7814, 2239, 5575, 0, 0.00, 0, 0.00, 7814
8, 16:22:00-000, 11921, 6329, 5592, 1, 1353.00, 1, 1350.00, 11919
8, 16:23:00-000, 4559, 2040, 2519, 0, 0.00, 1, 1352.00, 4558
8, 16:24:00-000, 218, 188, 30, 2, 1351.50, 1, 1352.00, 215
8, 16:25:00-000, 440, 245, 195, 11, 1351.09, 11, 1350.27, 418
8, 16:26:00-000, 7497, 3030, 4467, 15, 1350.33, 15, 1350.60, 7467
8, 16:27:00-000, 911, 799, 112, 2, 1348.00, 2, 1347.00, 907
8, 16:28:00-000, 3311, 2494, 817, 11, 1350.18, 11, 1348.36, 3284
8, 16:29:00-000, 3378, 977, 2401, 0, 0.00, 0, 0.00, 3383
