TraderType,Time,EnterQty,BuyEnterQty,SellEnterQty,BuyExecutedQty,BuyExecutedPx,SellExecutedQty,SellExecutedPx,CanceledQty
1, 09:06:00-000, 3209, 3209, 0, 869, 1348.09, 0, 0.00, 0
1, 09:07:00-000, 0, 0, 0, 0, 0.00, 0, 0.00, 2317
1, 09:08:00-000, 0, 0, 0, 0, 0.00, 0, 0.00, 23
1, 09:13:00-000, 3133, 2264, 869, 1148, 1347.68, 869, 1347.38, 0
1, 09:14:00-000, 9, 2, 7, 1, 1348.00, 7, 1348.00, 1116
1, 09:15:00-000, 32, 22, 10, 4, 1346.50, 10, 1351.00, 0
1, 09:16:00-000, 192, 138, 54, 69, 1348.48, 54, 1349.94, 29
1, 09:17:00-000, 206, 119, 87, 97, 1346.89, 87, 1347.66, 37
1, 09:18:00-000, 600, 389, 211, 163, 1349.25, 211, 1355.52, 105
1, 09:19:00-000, 386, 250, 136, 98, 1349.17, 136, 1357.99, 157
1, 09:20:00-000, 814, 499, 315, 347, 1348.10, 310, 1348.24, 151
1, 09:21:00-000, 303, 168, 135, 178, 1346.38, 135, 1346.70, 117
1, 09:22:00-000, 591, 378, 213, 237, 1347.78, 209, 1347.83, 66
1, 09:23:00-000, 267, 174, 93, 115, 1348.83, 97, 1349.01, 91
1, 09:24:00-000, 570, 372, 198, 199, 1348.29, 198, 1349.92, 85
1, 09:25:00-000, 305, 184, 121, 93, 1348.44, 121, 1353.66, 153
1, 09:26:00-000, 639, 369, 270, 189, 1348.63, 270, 1349.91, 150
1, 09:27:00-000, 281, 188, 93, 112, 1348.19, 93, 1347.86, 123
1, 09:28:00-000, 599, 373, 226, 187, 1347.91, 226, 1348.14, 128
1, 09:29:00-000, 342, 236, 106, 109, 1348.82, 106, 1349.07, 138
1, 09:30:00-000, 600, 375, 225, 296, 1347.98, 225, 1347.63, 129
1, 09:31:00-000, 307, 179, 128, 121, 1347.42, 128, 1347.84, 74
1, 09:32:00-000, 652, 383, 269, 266, 1347.60, 269, 1348.14, 91
1, 09:33:00-000, 320, 198, 122, 93, 1349.47, 122, 1350.06, 96
1, 09:34:00-000, 633, 415, 218, 270, 1347.96, 218, 1348.55, 112
1, 09:35:00-000, 310, 184, 126, 124, 1347.62, 126, 1347.62, 119
1, 09:36:00-000, 577, 362, 215, 223, 1348.29, 215, 1347.88, 123
1, 09:37:00-000, 268, 137, 131, 87, 1346.92, 131, 1346.87, 78
1, 09:38:00-000, 567, 352, 215, 202, 1347.56, 215, 1347.54, 102
1, 09:39:00-000, 376, 254, 122, 123, 1348.70, 122, 1349.42, 112
1, 09:40:00-000, 576, 335, 241, 216, 1348.39, 241, 1348.28, 141
1, 09:41:00-000, 293, 172, 121, 100, 1348.83, 121, 1347.47, 101
1, 09:42:00-000, 606, 355, 251, 244, 1347.58, 251, 1347.37, 101
1, 09:43:00-000, 261, 169, 92, 98, 1348.13, 92, 1347.36, 84
1, 09:44:00-000, 558, 352, 206, 212, 1348.94, 206, 1348.62, 126
1, 09:45:00-000, 284, 158, 126, 119, 1347.13, 126, 1347.15, 85
1, 09:46:00-000, 538, 335, 203, 197, 1348.77, 203, 1347.91, 106
1, 09:47:00-000, 333, 212, 121, 147, 1348.27, 121, 1346.93, 67
1, 09:48:00-000, 618, 400, 218, 300, 1347.81, 215, 1347.18, 78
1, 09:49:00-000, 286, 162, 124, 111, 1348.90, 127, 1348.01, 84
1, 09:50:00-000, 537, 350, 187, 219, 1348.03, 187, 1348.77, 91
1, 09:51:00-000, 300, 204, 96, 94, 1348.45, 96, 1348.89, 95
1, 09:52:00-000, 571, 327, 244, 226, 1347.86, 244, 1347.69, 132
1, 09:53:00-000, 330, 216, 114, 124, 1349.12, 114, 1349.11, 87
1, 09:54:00-000, 638, 365, 273, 274, 1347.65, 273, 1347.07, 84
1, 09:55:00-000, 270, 156, 114, 137, 1346.59, 114, 1346.31, 89
1, 09:56:00-000, 609, 337, 272, 269, 1347.71, 272, 1346.94, 61
1, 09:57:00-000, 358, 222, 136, 141, 1348.80, 136, 1347.00, 40
1, 09:58:00-000, 570, 365, 205, 241, 1348.26, 205, 1348.08, 96
1, 09:59:00-000, 349, 229, 120, 147, 1348.49, 119, 1348.35, 98
1, 10:00:00-000, 517, 300, 217, 201, 1348.25, 218, 1347.68, 115
1, 10:01:00-000, 334, 206, 128, 134, 1347.67, 128, 1347.53, 66
1, 10:02:00-000, 674, 369, 305, 240, 1347.35, 305, 1347.42, 125
1, 10:03:00-000, 298, 161, 137, 101, 1346.74, 137, 1346.71, 74
1, 10:04:00-000, 590, 392, 198, 222, 1348.49, 198, 1348.04, 119
1, 10:05:00-000, 282, 165, 117, 136, 1347.42, 117, 1346.99, 97
1, 10:06:00-000, 621, 330, 291, 257, 1347.99, 291, 1347.11, 60
1, 10:07:00-000, 300, 207, 93, 121, 1348.95, 93, 1348.01, 66
1, 10:08:00-000, 612, 348, 264, 288, 1348.44, 264, 1347.18, 101
1, 10:09:00-000, 309, 203, 106, 115, 1349.57, 106, 1348.19, 50
1, 10:10:00-000, 678, 441, 237, 267, 1348.41, 237, 1348.75, 107
1, 10:11:00-000, 321, 181, 140, 128, 1347.36, 140, 1348.07, 124
1, 10:12:00-000, 571, 364, 207, 263, 1348.17, 207, 1347.28, 83
1, 10:13:00-000, 319, 171, 148, 138, 1347.88, 148, 1346.79, 65
1, 10:14:00-000, 644, 378, 266, 267, 1348.16, 266, 1348.21, 90
1, 10:15:00-000, 299, 178, 121, 132, 1347.76, 121, 1347.42, 80
1, 10:16:00-000, 538, 312, 226, 247, 1347.28, 226, 1346.48, 47
1, 10:17:00-000, 283, 152, 131, 136, 1347.97, 131, 1347.16, 57
1, 10:18:00-000, 649, 366, 283, 241, 1347.46, 283, 1346.36, 48
1, 10:19:00-000, 288, 164, 124, 131, 1347.07, 124, 1346.86, 86
1, 10:20:00-000, 708, 400, 308, 278, 1347.63, 308, 1347.46, 84
1, 10:21:00-000, 248, 140, 108, 77, 1348.00, 108, 1347.96, 95
1, 10:22:00-000, 639, 385, 254, 267, 1347.69, 254, 1347.49, 88
1, 10:23:00-000, 309, 189, 120, 140, 1347.37, 120, 1346.70, 93
1, 10:24:00-000, 560, 313, 247, 208, 1347.93, 247, 1347.59, 65
1, 10:25:00-000, 328, 177, 151, 121, 1348.96, 151, 1348.38, 73
1, 10:26:00-000, 617, 350, 267, 258, 1348.42, 267, 1347.72, 75
1, 10:27:00-000, 263, 159, 104, 129, 1348.57, 104, 1347.94, 72
1, 10:28:00-000, 604, 377, 227, 256, 1348.16, 227, 1347.48, 60
1, 10:29:00-000, 269, 188, 81, 96, 1347.61, 81, 1348.32, 95
1, 10:30:00-000, 700, 413, 287, 314, 1348.34, 287, 1347.80, 106
1, 10:31:00-000, 289, 209, 80, 114, 1349.08, 80, 1348.86, 81
1, 10:32:00-000, 689, 387, 302, 260, 1348.11, 302, 1347.58, 106
1, 10:33:00-000, 304, 182, 122, 121, 1348.44, 122, 1348.20, 105
1, 10:34:00-000, 650, 386, 264, 234, 1347.90, 264, 1347.41, 124
1, 10:35:00-000, 243, 120, 123, 101, 1347.69, 123, 1346.71, 110
1, 10:36:00-000, 668, 396, 272, 242, 1347.85, 272, 1347.87, 63
1, 10:37:00-000, 336, 203, 133, 145, 1348.76, 133, 1348.00, 99
1, 10:38:00-000, 642, 374, 268, 242, 1347.82, 268, 1347.21, 88
1, 10:39:00-000, 341, 215, 126, 148, 1347.90, 126, 1348.18, 103
1, 10:40:00-000, 623, 433, 190, 207, 1349.32, 190, 1349.11, 142
1, 10:41:00-000, 285, 189, 96, 139, 1348.48, 96, 1348.35, 117
1, 10:42:00-000, 672, 388, 284, 279, 1348.09, 284, 1347.53, 127
1, 10:43:00-000, 257, 157, 100, 108, 1347.92, 100, 1347.00, 61
1, 10:44:00-000, 596, 401, 195, 252, 1348.34, 195, 1348.01, 77
1, 10:45:00-000, 320, 166, 154, 136, 1348.02, 154, 1346.85, 123
1, 10:46:00-000, 579, 356, 223, 240, 1347.45, 223, 1347.10, 64
1, 10:47:00-000, 354, 209, 145, 141, 1348.22, 145, 1348.56, 83
1, 10:48:00-000, 672, 383, 289, 312, 1347.67, 289, 1347.53, 78
1, 10:49:00-000, 336, 223, 113, 123, 1348.57, 113, 1347.89, 79
1, 10:50:00-000, 572, 341, 231, 195, 1348.81, 231, 1348.04, 119
1, 10:51:00-000, 325, 179, 146, 137, 1348.40, 146, 1348.28, 112
1, 10:52:00-000, 622, 340, 282, 270, 1347.11, 282, 1346.92, 51
1, 10:53:00-000, 354, 172, 182, 155, 1345.84, 182, 1345.17, 44
1, 10:54:00-000, 606, 365, 241, 250, 1347.63, 241, 1346.87, 59
1, 10:55:00-000, 321, 199, 122, 146, 1347.15, 122, 1347.01, 88
1, 10:56:00-000, 700, 392, 308, 280, 1347.98, 308, 1347.91, 73
1, 10:57:00-000, 284, 169, 115, 101, 1348.85, 113, 1349.32, 99
1, 10:58:00-000, 635, 371, 264, 251, 1348.28, 266, 1347.54, 86
1, 10:59:00-000, 304, 158, 146, 99, 1347.89, 146, 1347.89, 103
1, 11:00:00-000, 630, 395, 235, 275, 1347.96, 235, 1347.56, 77
1, 11:01:00-000, 276, 161, 115, 120, 1347.88, 115, 1346.88, 107
1, 11:02:00-000, 666, 367, 299, 247, 1348.04, 299, 1347.98, 55
1, 11:03:00-000, 307, 200, 107, 139, 1348.01, 107, 1347.23, 102
1, 11:04:00-000, 637, 392, 245, 281, 1347.69, 245, 1347.77, 92
1, 11:05:00-000, 295, 185, 110, 95, 1348.10, 110, 1347.61, 83
1, 11:06:00-000, 621, 385, 236, 235, 1348.47, 236, 1347.74, 105
1, 11:07:00-000, 284, 159, 125, 138, 1347.71, 125, 1347.36, 102
1, 11:08:00-000, 657, 462, 195, 243, 1349.77, 195, 1349.51, 106
1, 11:09:00-000, 275, 166, 109, 111, 1348.15, 109, 1348.69, 138
1, 11:10:00-000, 598, 325, 273, 229, 1347.67, 273, 1347.78, 88
1, 11:11:00-000, 337, 194, 143, 137, 1347.64, 143, 1347.43, 85
1, 11:12:00-000, 628, 379, 249, 249, 1348.23, 249, 1347.37, 86
1, 11:13:00-000, 299, 171, 128, 92, 1348.86, 128, 1348.23, 107
1, 11:14:00-000, 642, 331, 311, 238, 1347.64, 311, 1346.90, 92
1, 11:15:00-000, 252, 148, 104, 136, 1346.92, 102, 1345.82, 73
1, 11:16:00-000, 545, 318, 227, 200, 1347.43, 229, 1347.25, 71
1, 11:17:00-000, 334, 203, 131, 124, 1349.46, 131, 1348.51, 67
1, 11:18:00-000, 632, 440, 192, 304, 1348.39, 192, 1347.87, 96
1, 11:19:00-000, 274, 187, 87, 113, 1348.99, 87, 1348.62, 112
1, 11:20:00-000, 752, 438, 314, 310, 1347.98, 314, 1347.25, 103
1, 11:21:00-000, 326, 188, 138, 135, 1347.93, 138, 1347.74, 108
1, 11:22:00-000, 670, 442, 228, 260, 1348.68, 228, 1348.08, 76
1, 11:23:00-000, 218, 117, 101, 114, 1348.18, 101, 1348.39, 125
1, 11:24:00-000, 551, 282, 269, 216, 1347.40, 269, 1347.50, 39
1, 11:25:00-000, 353, 194, 159, 119, 1348.24, 159, 1348.14, 69
1, 11:26:00-000, 582, 334, 248, 203, 1347.97, 248, 1347.85, 76
1, 11:27:00-000, 380, 210, 170, 155, 1346.96, 170, 1346.46, 107
1, 11:28:00-000, 616, 368, 248, 257, 1348.42, 248, 1347.83, 76
1, 11:29:00-000, 301, 167, 134, 146, 1347.65, 134, 1346.77, 63
1, 11:30:00-000, 613, 366, 247, 237, 1347.49, 247, 1347.17, 84
1, 11:31:00-000, 339, 200, 139, 163, 1347.52, 139, 1346.99, 88
1, 11:32:00-000, 547, 344, 203, 216, 1347.67, 203, 1346.98, 80
1, 11:33:00-000, 345, 211, 134, 139, 1347.83, 134, 1348.10, 88
1, 11:34:00-000, 597, 369, 228, 258, 1347.86, 228, 1347.15, 99
1, 11:35:00-000, 300, 194, 106, 144, 1348.55, 106, 1346.80, 87
1, 11:36:00-000, 601, 352, 249, 237, 1347.76, 249, 1347.26, 82
1, 11:37:00-000, 345, 201, 144, 160, 1347.03, 144, 1347.11, 81
1, 11:38:00-000, 584, 341, 243, 200, 1347.34, 243, 1346.31, 80
1, 11:39:00-000, 286, 186, 100, 135, 1347.40, 100, 1347.26, 99
1, 11:40:00-000, 647, 392, 255, 253, 1348.23, 255, 1347.34, 105
1, 11:41:00-000, 345, 208, 137, 183, 1347.90, 137, 1347.58, 59
1, 11:42:00-000, 613, 344, 269, 257, 1347.68, 269, 1347.36, 88
1, 11:43:00-000, 341, 174, 167, 174, 1346.94, 167, 1346.17, 49
1, 11:44:00-000, 597, 333, 264, 268, 1347.64, 264, 1347.51, 26
1, 11:45:00-000, 310, 158, 152, 125, 1347.64, 152, 1346.81, 55
1, 11:46:00-000, 551, 302, 249, 235, 1347.04, 249, 1346.01, 34
1, 11:47:00-000, 319, 203, 116, 136, 1348.16, 116, 1347.60, 59
1, 11:48:00-000, 647, 384, 263, 311, 1347.86, 263, 1346.54, 70
1, 11:49:00-000, 326, 171, 155, 134, 1347.35, 155, 1346.91, 79
1, 11:50:00-000, 548, 346, 202, 236, 1348.47, 202, 1348.01, 64
1, 11:51:00-000, 295, 174, 121, 116, 1347.92, 121, 1347.97, 89
1, 11:52:00-000, 589, 275, 314, 228, 1347.11, 314, 1346.23, 38
1, 11:53:00-000, 342, 185, 157, 130, 1347.33, 157, 1346.27, 50
1, 11:54:00-000, 597, 335, 262, 227, 1346.45, 262, 1345.81, 63
1, 11:55:00-000, 309, 165, 144, 140, 1347.61, 144, 1347.28, 99
1, 11:56:00-000, 621, 380, 241, 265, 1348.40, 241, 1347.22, 69
1, 11:57:00-000, 326, 201, 125, 135, 1347.52, 125, 1348.42, 56
1, 11:58:00-000, 607, 324, 283, 272, 1348.00, 283, 1347.19, 92
1, 11:59:00-000, 302, 195, 107, 126, 1348.22, 107, 1347.22, 54
1, 12:00:00-000, 574, 318, 256, 294, 1346.87, 256, 1345.78, 36
1, 12:01:00-000, 317, 179, 138, 127, 1347.13, 138, 1347.07, 65
1, 12:02:00-000, 565, 376, 189, 259, 1348.96, 185, 1348.43, 75
1, 12:03:00-000, 310, 167, 143, 137, 1348.43, 147, 1347.39, 68
1, 12:04:00-000, 570, 352, 218, 221, 1348.64, 218, 1348.14, 66
1, 12:05:00-000, 347, 180, 167, 129, 1348.85, 167, 1347.52, 94
1, 12:06:00-000, 656, 368, 288, 298, 1347.82, 288, 1346.83, 78
1, 12:07:00-000, 320, 188, 132, 136, 1347.52, 132, 1347.21, 52
1, 12:08:00-000, 553, 284, 269, 209, 1347.80, 269, 1346.50, 88
1, 12:09:00-000, 229, 132, 97, 80, 1347.77, 97, 1347.08, 49
1, 12:10:00-000, 670, 354, 316, 246, 1347.47, 316, 1346.75, 60
1, 12:11:00-000, 322, 218, 104, 139, 1348.86, 104, 1348.80, 108
1, 12:12:00-000, 640, 345, 295, 275, 1347.01, 295, 1346.14, 66
1, 12:13:00-000, 306, 191, 115, 142, 1348.28, 115, 1347.24, 75
1, 12:14:00-000, 552, 321, 231, 266, 1347.61, 231, 1346.96, 69
1, 12:15:00-000, 293, 178, 115, 139, 1347.70, 115, 1347.66, 36
1, 12:16:00-000, 577, 359, 218, 220, 1348.39, 218, 1347.79, 65
1, 12:17:00-000, 356, 232, 124, 147, 1348.53, 124, 1348.45, 102
1, 12:18:00-000, 503, 298, 205, 220, 1347.79, 205, 1346.84, 87
1, 12:19:00-000, 324, 187, 137, 143, 1347.66, 137, 1347.95, 61
1, 12:20:00-000, 686, 353, 333, 213, 1347.72, 333, 1347.14, 96
1, 12:21:00-000, 272, 142, 130, 88, 1348.10, 130, 1346.90, 116
1, 12:22:00-000, 650, 384, 266, 231, 1348.17, 266, 1346.74, 94
1, 12:23:00-000, 317, 214, 103, 124, 1348.45, 103, 1347.04, 114
1, 12:24:00-000, 647, 414, 233, 297, 1348.82, 233, 1347.95, 87
1, 12:25:00-000, 250, 147, 103, 118, 1347.42, 103, 1346.49, 92
1, 12:26:00-000, 683, 416, 267, 265, 1348.09, 267, 1347.09, 89
1, 12:27:00-000, 312, 192, 120, 156, 1348.23, 120, 1347.67, 93
1, 12:28:00-000, 647, 420, 227, 200, 1348.41, 227, 1348.12, 121
1, 12:29:00-000, 358, 221, 137, 156, 1348.52, 137, 1347.63, 140
1, 12:30:00-000, 557, 350, 207, 264, 1348.25, 207, 1346.28, 103
1, 12:31:00-000, 291, 190, 101, 109, 1348.00, 101, 1347.22, 67
1, 12:32:00-000, 672, 404, 268, 258, 1347.69, 268, 1346.98, 105
1, 12:33:00-000, 318, 187, 131, 88, 1348.89, 131, 1348.87, 109
1, 12:34:00-000, 620, 362, 258, 262, 1347.76, 258, 1347.58, 115
1, 12:35:00-000, 334, 179, 155, 143, 1347.81, 154, 1348.08, 82
1, 12:36:00-000, 639, 385, 254, 255, 1348.57, 255, 1347.37, 83
1, 12:37:00-000, 325, 208, 117, 143, 1348.11, 117, 1347.57, 96
1, 12:38:00-000, 538, 356, 182, 208, 1347.77, 182, 1347.11, 120
1, 12:39:00-000, 284, 131, 153, 124, 1346.88, 153, 1345.86, 60
1, 12:40:00-000, 662, 349, 313, 261, 1347.54, 313, 1346.74, 52
1, 12:41:00-000, 348, 213, 135, 128, 1348.23, 135, 1346.84, 82
1, 12:42:00-000, 682, 432, 250, 294, 1348.01, 250, 1347.22, 82
1, 12:43:00-000, 319, 210, 109, 150, 1348.09, 109, 1346.57, 128
1, 12:44:00-000, 608, 373, 235, 217, 1348.51, 235, 1348.15, 90
1, 12:45:00-000, 280, 185, 95, 150, 1348.63, 95, 1347.30, 126
1, 12:46:00-000, 634, 344, 290, 250, 1348.19, 290, 1347.24, 58
1, 12:47:00-000, 301, 190, 111, 112, 1347.91, 111, 1346.92, 77
1, 12:48:00-000, 621, 345, 276, 258, 1348.02, 276, 1347.69, 94
1, 12:49:00-000, 276, 174, 102, 101, 1348.75, 102, 1347.38, 63
1, 12:50:00-000, 645, 393, 252, 219, 1348.27, 252, 1348.00, 100
1, 12:51:00-000, 373, 179, 194, 155, 1348.01, 194, 1346.98, 145
1, 12:52:00-000, 549, 324, 225, 207, 1347.97, 225, 1347.34, 56
1, 12:53:00-000, 263, 154, 109, 143, 1346.92, 109, 1346.81, 44
1, 12:54:00-000, 601, 318, 283, 233, 1347.29, 283, 1346.31, 59
1, 12:55:00-000, 337, 185, 152, 171, 1347.83, 152, 1347.12, 57
1, 12:56:00-000, 583, 390, 193, 257, 1348.78, 193, 1348.03, 73
1, 12:57:00-000, 271, 144, 127, 117, 1347.84, 127, 1347.43, 74
1, 12:58:00-000, 525, 312, 213, 189, 1348.13, 213, 1347.31, 84
1, 12:59:00-000, 257, 158, 99, 118, 1348.15, 99, 1347.54, 83
1, 13:00:00-000, 619, 360, 259, 271, 1347.29, 259, 1346.63, 71
1, 13:01:00-000, 284, 182, 102, 108, 1348.28, 102, 1347.43, 75
1, 13:02:00-000, 577, 340, 237, 257, 1348.11, 237, 1347.50, 90
1, 13:03:00-000, 352, 202, 150, 168, 1347.35, 150, 1346.58, 60
1, 13:04:00-000, 516, 282, 234, 207, 1347.88, 234, 1346.81, 56
1, 13:05:00-000, 345, 194, 151, 129, 1347.58, 151, 1347.05, 44
1, 13:06:00-000, 594, 345, 249, 241, 1347.90, 249, 1347.19, 92
1, 13:07:00-000, 286, 187, 99, 116, 1348.39, 99, 1348.61, 78
1, 13:08:00-000, 623, 380, 243, 289, 1348.62, 243, 1347.75, 98
1, 13:09:00-000, 318, 179, 139, 143, 1348.29, 135, 1347.52, 62
1, 13:10:00-000, 577, 336, 241, 192, 1347.22, 245, 1347.14, 56
1, 13:11:00-000, 323, 199, 124, 139, 1348.16, 124, 1347.93, 125
1, 13:12:00-000, 645, 370, 275, 245, 1347.33, 274, 1346.74, 70
1, 13:13:00-000, 283, 175, 108, 140, 1348.58, 109, 1347.53, 104
1, 13:14:00-000, 551, 318, 233, 203, 1347.91, 233, 1348.00, 53
1, 13:15:00-000, 395, 219, 176, 172, 1347.41, 176, 1346.77, 107
1, 13:16:00-000, 591, 331, 260, 231, 1348.41, 258, 1347.33, 96
1, 13:17:00-000, 327, 180, 147, 114, 1349.08, 149, 1349.11, 67
1, 13:18:00-000, 563, 329, 234, 207, 1347.76, 234, 1348.12, 84
1, 13:19:00-000, 281, 167, 114, 146, 1348.61, 114, 1347.67, 89
1, 13:20:00-000, 640, 412, 228, 224, 1348.31, 228, 1347.98, 71
1, 13:21:00-000, 264, 144, 120, 115, 1347.23, 120, 1346.87, 108
1, 13:22:00-000, 658, 407, 251, 269, 1347.72, 251, 1347.25, 83
1, 13:23:00-000, 310, 197, 113, 146, 1347.81, 113, 1346.97, 108
1, 13:24:00-000, 578, 339, 239, 269, 1348.18, 239, 1347.91, 74
1, 13:25:00-000, 341, 160, 181, 127, 1347.71, 181, 1345.80, 66
1, 13:26:00-000, 625, 408, 217, 281, 1348.38, 217, 1347.52, 65
1, 13:27:00-000, 277, 161, 116, 145, 1347.22, 116, 1346.32, 91
1, 13:28:00-000, 663, 374, 289, 269, 1347.53, 284, 1346.87, 44
1, 13:29:00-000, 259, 156, 103, 88, 1348.00, 108, 1346.98, 91
1, 13:30:00-000, 689, 376, 313, 305, 1347.39, 313, 1346.66, 59
1, 13:31:00-000, 320, 184, 136, 156, 1347.23, 135, 1346.88, 59
1, 13:32:00-000, 597, 351, 246, 269, 1347.68, 247, 1346.56, 55
1, 13:33:00-000, 307, 191, 116, 111, 1347.38, 116, 1346.89, 71
1, 13:34:00-000, 479, 263, 216, 187, 1347.63, 216, 1346.70, 74
1, 13:35:00-000, 330, 180, 150, 164, 1346.64, 150, 1345.92, 59
1, 13:36:00-000, 667, 361, 306, 257, 1347.25, 306, 1346.49, 52
1, 13:37:00-000, 279, 184, 95, 88, 1349.47, 95, 1349.57, 88
1, 13:38:00-000, 582, 337, 245, 261, 1347.85, 241, 1347.88, 70
1, 13:39:00-000, 372, 219, 153, 133, 1347.42, 157, 1347.57, 90
1, 13:40:00-000, 560, 310, 250, 208, 1347.95, 250, 1347.41, 130
1, 13:41:00-000, 272, 176, 96, 138, 1348.58, 96, 1347.85, 57
1, 13:42:00-000, 538, 284, 254, 201, 1347.66, 254, 1347.01, 58
1, 13:43:00-000, 324, 208, 116, 155, 1348.77, 116, 1346.97, 69
1, 13:44:00-000, 691, 451, 240, 309, 1348.34, 240, 1347.83, 77
1, 13:45:00-000, 260, 146, 114, 72, 1348.46, 114, 1348.37, 116
1, 13:46:00-000, 678, 428, 250, 258, 1348.00, 250, 1348.15, 99
1, 13:47:00-000, 264, 127, 137, 119, 1347.52, 137, 1346.70, 128
1, 13:48:00-000, 588, 338, 250, 234, 1349.05, 250, 1348.29, 52
1, 13:49:00-000, 327, 207, 120, 108, 1348.76, 117, 1348.04, 80
1, 13:50:00-000, 635, 407, 228, 287, 1348.26, 231, 1347.36, 111
1, 13:51:00-000, 300, 183, 117, 137, 1347.79, 117, 1347.56, 83
1, 13:52:00-000, 694, 402, 292, 267, 1348.20, 292, 1348.31, 105
1, 13:53:00-000, 318, 188, 130, 133, 1347.76, 130, 1347.24, 92
1, 13:54:00-000, 567, 338, 229, 225, 1348.28, 229, 1347.82, 80
1, 13:55:00-000, 332, 185, 147, 135, 1347.31, 147, 1346.16, 98
1, 13:56:00-000, 673, 423, 250, 216, 1348.18, 250, 1347.89, 91
1, 13:57:00-000, 341, 228, 113, 185, 1347.76, 113, 1347.88, 132
1, 13:58:00-000, 639, 393, 246, 211, 1348.88, 246, 1348.47, 132
1, 13:59:00-000, 265, 167, 98, 119, 1349.51, 96, 1350.05, 98
1, 14:00:00-000, 636, 384, 252, 267, 1347.86, 254, 1347.77, 68
1, 14:01:00-000, 283, 165, 118, 119, 1347.04, 115, 1347.13, 121
1, 14:02:00-000, 667, 392, 275, 267, 1348.05, 278, 1346.90, 67
1, 14:03:00-000, 294, 167, 127, 141, 1347.23, 127, 1346.74, 92
1, 14:04:00-000, 618, 348, 270, 264, 1347.67, 270, 1346.89, 65
1, 14:05:00-000, 270, 154, 116, 125, 1348.16, 116, 1347.86, 52
1, 14:06:00-000, 648, 383, 265, 316, 1347.32, 265, 1346.54, 55
1, 14:07:00-000, 278, 156, 122, 115, 1347.78, 122, 1345.48, 52
1, 14:08:00-000, 640, 400, 240, 272, 1348.50, 240, 1347.55, 62
1, 14:09:00-000, 311, 177, 134, 145, 1346.89, 134, 1346.70, 87
1, 14:10:00-000, 624, 395, 229, 292, 1347.65, 229, 1347.40, 77
1, 14:11:00-000, 347, 204, 143, 138, 1347.52, 143, 1346.92, 65
1, 14:12:00-000, 626, 322, 304, 300, 1347.08, 304, 1345.84, 63
1, 14:13:00-000, 289, 161, 128, 99, 1347.16, 128, 1346.32, 47
1, 14:14:00-000, 638, 354, 284, 278, 1347.69, 284, 1347.33, 62
1, 14:15:00-000, 319, 168, 151, 154, 1347.08, 151, 1347.47, 60
1, 14:16:00-000, 669, 370, 299, 268, 1348.25, 299, 1347.48, 34
1, 14:17:00-000, 270, 133, 137, 99, 1346.81, 137, 1346.51, 72
1, 14:18:00-000, 521, 249, 272, 190, 1347.38, 272, 1346.50, 60
1, 14:19:00-000, 294, 146, 148, 117, 1347.40, 148, 1346.41, 38
1, 14:20:00-000, 490, 281, 209, 190, 1348.15, 209, 1347.04, 68
1, 14:21:00-000, 355, 225, 130, 158, 1348.08, 130, 1347.11, 57
1, 14:22:00-000, 595, 313, 282, 249, 1347.78, 281, 1347.22, 73
1, 14:23:00-000, 309, 204, 105, 136, 1349.34, 106, 1348.39, 56
1, 14:24:00-000, 612, 356, 256, 252, 1347.81, 256, 1347.36, 79
1, 14:25:00-000, 265, 153, 112, 134, 1347.71, 112, 1347.57, 85
1, 14:26:00-000, 540, 330, 210, 257, 1347.95, 210, 1346.36, 46
1, 14:27:00-000, 305, 186, 119, 126, 1348.56, 119, 1347.57, 58
1, 14:28:00-000, 574, 328, 246, 248, 1348.11, 246, 1347.27, 85
1, 14:29:00-000, 253, 144, 109, 103, 1347.13, 109, 1346.98, 67
1, 14:30:00-000, 650, 366, 284, 259, 1348.96, 284, 1348.00, 57
1, 14:31:00-000, 263, 130, 133, 124, 1347.88, 133, 1347.12, 61
1, 14:32:00-000, 655, 376, 279, 307, 1347.85, 279, 1346.79, 47
1, 14:33:00-000, 262, 164, 98, 110, 1348.86, 98, 1348.39, 53
1, 14:34:00-000, 680, 414, 266, 315, 1348.29, 266, 1347.44, 44
1, 14:35:00-000, 343, 216, 127, 147, 1348.36, 127, 1348.09, 107
1, 14:36:00-000, 580, 339, 241, 215, 1348.05, 241, 1347.49, 81
1, 14:37:00-000, 259, 149, 110, 155, 1348.16, 110, 1347.49, 85
1, 14:38:00-000, 646, 316, 330, 244, 1347.69, 330, 1346.74, 38
1, 14:39:00-000, 313, 184, 129, 144, 1348.36, 129, 1347.03, 61
1, 14:40:00-000, 608, 360, 248, 176, 1349.23, 248, 1349.66, 66
1, 14:41:00-000, 338, 214, 124, 137, 1348.81, 124, 1347.99, 131
1, 14:42:00-000, 577, 347, 230, 220, 1348.07, 230, 1347.44, 90
1, 14:43:00-000, 299, 139, 160, 148, 1346.78, 160, 1346.14, 88
1, 14:44:00-000, 655, 361, 294, 238, 1347.54, 294, 1347.25, 68
1, 14:45:00-000, 291, 202, 89, 125, 1348.24, 89, 1347.34, 67
1, 14:46:00-000, 591, 340, 251, 264, 1348.19, 251, 1348.07, 100
1, 14:47:00-000, 293, 208, 85, 112, 1349.37, 84, 1348.83, 90
1, 14:48:00-000, 636, 376, 260, 309, 1347.51, 261, 1346.73, 65
1, 14:49:00-000, 304, 180, 124, 126, 1347.57, 124, 1347.12, 86
1, 14:50:00-000, 603, 358, 245, 232, 1347.90, 245, 1347.20, 70
1, 14:51:00-000, 294, 169, 125, 137, 1347.65, 125, 1347.55, 109
1, 14:52:00-000, 576, 331, 245, 230, 1347.62, 245, 1347.25, 73
1, 14:53:00-000, 324, 143, 181, 108, 1347.74, 181, 1347.12, 72
1, 14:54:00-000, 667, 381, 286, 302, 1347.95, 285, 1347.03, 37
1, 14:55:00-000, 285, 213, 72, 91, 1349.17, 73, 1348.70, 53
1, 14:56:00-000, 589, 338, 251, 277, 1348.10, 251, 1347.23, 109
1, 14:57:00-000, 332, 158, 174, 128, 1346.76, 171, 1346.65, 70
1, 14:58:00-000, 630, 426, 204, 294, 1348.10, 207, 1347.58, 85
1, 14:59:00-000, 309, 183, 126, 114, 1347.08, 126, 1346.59, 98
1, 15:00:00-000, 658, 422, 236, 247, 1348.11, 236, 1347.39, 118
1, 15:01:00-000, 342, 186, 156, 95, 1348.33, 154, 1347.90, 131
1, 15:02:00-000, 619, 342, 277, 271, 1348.39, 279, 1346.83, 83
1, 15:03:00-000, 315, 197, 118, 141, 1348.47, 117, 1347.95, 72
1, 15:04:00-000, 599, 339, 260, 254, 1347.56, 261, 1347.83, 71
1, 15:05:00-000, 373, 198, 175, 129, 1347.48, 175, 1347.39, 56
1, 15:06:00-000, 559, 348, 211, 235, 1348.54, 211, 1348.08, 85
1, 15:07:00-000, 338, 187, 151, 132, 1348.75, 151, 1348.62, 87
1, 15:08:00-000, 583, 343, 240, 264, 1347.87, 240, 1347.17, 76
1, 15:09:00-000, 335, 205, 130, 147, 1347.17, 130, 1347.17, 69
1, 15:10:00-000, 597, 339, 258, 246, 1347.44, 258, 1347.18, 81
1, 15:11:00-000, 375, 208, 167, 170, 1347.26, 167, 1346.31, 75
1, 15:12:00-000, 627, 360, 267, 270, 1347.92, 267, 1346.76, 65
1, 15:13:00-000, 256, 143, 113, 79, 1347.84, 113, 1348.88, 66
1, 15:14:00-000, 677, 460, 217, 239, 1348.83, 217, 1348.61, 101
1, 15:15:00-000, 294, 173, 121, 103, 1348.66, 118, 1348.68, 164
1, 15:16:00-000, 556, 319, 237, 251, 1347.84, 240, 1346.95, 95
1, 15:17:00-000, 266, 154, 112, 117, 1348.54, 112, 1348.18, 54
1, 15:18:00-000, 739, 426, 313, 298, 1348.54, 313, 1348.63, 68
1, 15:19:00-000, 341, 202, 139, 160, 1348.16, 139, 1346.91, 103
1, 15:20:00-000, 656, 412, 244, 285, 1348.61, 244, 1347.40, 70
1, 15:21:00-000, 343, 192, 151, 162, 1347.85, 151, 1346.98, 75
1, 15:22:00-000, 595, 352, 243, 261, 1347.71, 243, 1347.20, 75
1, 15:23:00-000, 293, 186, 107, 109, 1349.18, 107, 1348.23, 80
1, 15:24:00-000, 567, 334, 233, 218, 1349.22, 233, 1348.69, 96
1, 15:25:00-000, 352, 197, 155, 140, 1347.92, 155, 1347.14, 81
1, 15:26:00-000, 613, 364, 249, 201, 1348.03, 249, 1347.78, 114
1, 15:27:00-000, 346, 193, 153, 145, 1348.29, 153, 1348.03, 85
1, 15:28:00-000, 638, 351, 287, 285, 1348.41, 285, 1347.66, 74
1, 15:29:00-000, 339, 189, 150, 138, 1348.45, 152, 1347.96, 63
1, 15:30:00-000, 656, 431, 225, 294, 1348.75, 225, 1348.01, 84
1, 15:31:00-000, 352, 213, 139, 155, 1348.14, 139, 1347.48, 89
1, 15:32:00-000, 533, 334, 199, 200, 1348.26, 198, 1347.83, 109
1, 15:33:00-000, 301, 154, 147, 138, 1346.97, 148, 1346.16, 77
1, 15:34:00-000, 630, 359, 271, 252, 1347.68, 271, 1347.08, 58
1, 15:35:00-000, 335, 196, 139, 195, 1348.22, 139, 1347.07, 60
1, 15:36:00-000, 625, 327, 298, 230, 1347.81, 298, 1346.54, 69
1, 15:37:00-000, 283, 186, 97, 109, 1349.25, 97, 1347.43, 55
1, 15:38:00-000, 593, 348, 245, 279, 1347.48, 245, 1347.23, 100
1, 15:39:00-000, 317, 182, 135, 138, 1347.44, 135, 1347.38, 48
1, 15:40:00-000, 613, 367, 246, 207, 1348.28, 246, 1347.44, 76
1, 15:41:00-000, 280, 152, 128, 91, 1348.30, 128, 1347.62, 115
1, 15:42:00-000, 564, 329, 235, 200, 1348.55, 235, 1347.59, 109
1, 15:43:00-000, 309, 188, 121, 90, 1349.43, 121, 1346.79, 102
1, 15:44:00-000, 764, 447, 317, 277, 1348.58, 317, 1346.74, 143
1, 15:45:00-000, 339, 213, 126, 162, 1347.94, 126, 1347.12, 95
1, 15:46:00-000, 631, 386, 245, 226, 1348.17, 245, 1346.60, 115
1, 15:47:00-000, 300, 186, 114, 121, 1348.71, 114, 1346.96, 113
1, 15:48:00-000, 609, 419, 190, 227, 1348.73, 190, 1348.25, 120
1, 15:49:00-000, 374, 248, 126, 189, 1349.44, 126, 1347.72, 121
1, 15:50:00-000, 604, 395, 209, 271, 1348.13, 209, 1347.72, 106
1, 15:51:00-000, 295, 180, 115, 114, 1347.73, 115, 1348.04, 106
1, 15:52:00-000, 701, 416, 285, 294, 1348.16, 285, 1346.46, 98
1, 15:53:00-000, 321, 207, 114, 114, 1349.27, 114, 1347.94, 85
1, 15:54:00-000, 653, 365, 288, 247, 1348.22, 288, 1347.21, 91
1, 15:55:00-000, 291, 159, 132, 100, 1347.92, 132, 1348.00, 80
1, 15:56:00-000, 662, 399, 263, 281, 1348.28, 263, 1347.47, 122
1, 15:57:00-000, 269, 178, 91, 139, 1347.99, 91, 1347.25, 95
1, 15:58:00-000, 641, 381, 260, 273, 1348.28, 260, 1347.27, 50
1, 15:59:00-000, 352, 220, 132, 133, 1348.61, 132, 1349.52, 103
1, 16:00:00-000, 622, 358, 264, 258, 1347.38, 264, 1347.06, 83
1, 16:01:00-000, 312, 148, 164, 108, 1347.96, 163, 1347.94, 98
1, 16:02:00-000, 540, 324, 216, 234, 1347.24, 217, 1346.41, 58
1, 16:03:00-000, 239, 113, 126, 79, 1347.05, 126, 1346.17, 60
1, 16:04:00-000, 674, 407, 267, 247, 1347.91, 267, 1347.45, 84
1, 16:05:00-000, 344, 176, 168, 162, 1347.29, 168, 1346.46, 59
1, 16:06:00-000, 585, 333, 252, 253, 1347.54, 252, 1346.88, 100
1, 16:07:00-000, 315, 179, 136, 157, 1347.74, 136, 1347.63, 47
1, 16:08:00-000, 574, 383, 191, 245, 1348.09, 191, 1347.90, 51
1, 16:09:00-000, 342, 192, 150, 125, 1348.90, 149, 1348.16, 117
1, 16:10:00-000, 617, 361, 256, 246, 1348.33, 257, 1347.97, 91
1, 16:11:00-000, 326, 209, 117, 114, 1348.15, 117, 1347.70, 84
1, 16:12:00-000, 562, 294, 268, 210, 1347.43, 268, 1346.64, 108
1, 16:13:00-000, 296, 170, 126, 143, 1347.26, 126, 1346.67, 64
1, 16:14:00-000, 703, 419, 284, 317, 1348.96, 284, 1348.03, 65
1, 16:15:00-000, 279, 202, 77, 112, 1349.31, 77, 1348.78, 86
1, 16:16:00-000, 633, 346, 287, 290, 1348.23, 287, 1347.32, 87
1, 16:17:00-000, 264, 171, 93, 102, 1347.77, 93, 1348.22, 47
1, 16:18:00-000, 575, 365, 210, 253, 1348.25, 210, 1347.45, 98
1, 16:19:00-000, 340, 186, 154, 145, 1349.22, 153, 1347.30, 75
1, 16:20:00-000, 700, 395, 305, 295, 1348.32, 306, 1347.47, 99
1, 16:21:00-000, 288, 157, 131, 141, 1347.62, 131, 1347.38, 50
1, 16:22:00-000, 607, 341, 266, 253, 1347.93, 266, 1347.27, 53
1, 16:23:00-000, 267, 155, 112, 130, 1348.28, 112, 1346.13, 53
1, 16:24:00-000, 606, 340, 266, 214, 1348.50, 266, 1347.65, 87
1, 16:25:00-000, 321, 162, 159, 142, 1347.47, 159, 1347.25, 72
1, 16:26:00-000, 633, 386, 247, 248, 1348.38, 247, 1347.39, 62
1, 16:27:00-000, 402, 243, 159, 158, 1347.85, 159, 1347.47, 98
1, 16:28:00-000, 676, 398, 278, 273, 1348.30, 278, 1347.67, 101
1, 16:29:00-000, 292, 189, 103, 151, 1348.59, 103, 1348.60, 88
2, 09:06:00-000, 3050, 0, 3050, 0, 0.00, 1148, 1348.71, 0
2, 09:07:00-000, 0, 0, 0, 0, 0.00, 2, 1351.00, 1899
2, 09:08:00-000, 0, 0, 0, 0, 0.00, 0, 0.00, 1
2, 09:13:00-000, 3066, 1150, 1916, 1150, 1352.12, 1465, 1350.89, 0
2, 09:14:00-000, 3, 2, 1, 2, 1356.50, 13, 1356.00, 438
2, 09:15:00-000, 41, 30, 11, 30, 1355.13, 11, 1352.55, 0
2, 09:16:00-000, 186, 69, 117, 69, 1353.06, 108, 1352.41, 0
2, 09:17:00-000, 175, 84, 91, 84, 1353.42, 100, 1351.73, 1
2, 09:18:00-000, 644, 329, 315, 329, 1357.20, 312, 1354.98, 0
2, 09:19:00-000, 402, 220, 182, 220, 1356.49, 184, 1351.60, 0
2, 09:20:00-000, 734, 326, 408, 326, 1352.77, 381, 1352.05, 0
2, 09:21:00-000, 411, 168, 243, 168, 1351.37, 218, 1350.33, 10
2, 09:22:00-000, 557, 268, 289, 267, 1353.50, 323, 1352.34, 3
2, 09:23:00-000, 256, 118, 138, 119, 1353.01, 121, 1352.87, 0
2, 09:24:00-000, 508, 259, 249, 259, 1354.00, 250, 1352.93, 14
2, 09:25:00-000, 339, 187, 152, 187, 1355.78, 153, 1353.17, 0
2, 09:26:00-000, 670, 393, 277, 393, 1353.71, 251, 1352.13, 1
2, 09:27:00-000, 301, 129, 172, 129, 1352.70, 134, 1351.36, 32
2, 09:28:00-000, 612, 311, 301, 311, 1353.60, 249, 1351.55, 50
2, 09:29:00-000, 333, 169, 164, 169, 1354.26, 169, 1353.76, 23
2, 09:30:00-000, 535, 207, 328, 207, 1352.28, 274, 1351.53, 33
2, 09:31:00-000, 347, 169, 178, 168, 1353.39, 174, 1352.74, 3
2, 09:32:00-000, 585, 290, 295, 288, 1352.95, 271, 1352.19, 35
2, 09:33:00-000, 355, 188, 167, 191, 1354.31, 173, 1352.70, 7
2, 09:34:00-000, 744, 296, 448, 296, 1352.73, 389, 1351.74, 11
2, 09:35:00-000, 340, 119, 221, 119, 1351.37, 130, 1350.63, 52
2, 09:36:00-000, 627, 301, 326, 301, 1352.85, 326, 1352.04, 46
2, 09:37:00-000, 310, 126, 184, 126, 1351.35, 148, 1351.06, 44
2, 09:38:00-000, 572, 266, 306, 266, 1352.78, 259, 1351.10, 55
2, 09:39:00-000, 342, 187, 155, 187, 1355.10, 140, 1353.06, 17
2, 09:40:00-000, 679, 364, 315, 364, 1353.50, 280, 1351.78, 41
2, 09:41:00-000, 274, 141, 133, 141, 1353.33, 112, 1350.86, 27
2, 09:42:00-000, 611, 274, 337, 274, 1352.49, 246, 1351.39, 30
2, 09:43:00-000, 364, 157, 207, 157, 1352.17, 180, 1351.61, 50
2, 09:44:00-000, 656, 307, 349, 307, 1352.95, 315, 1351.71, 49
2, 09:45:00-000, 370, 156, 214, 156, 1352.12, 134, 1350.57, 44
2, 09:46:00-000, 551, 225, 326, 225, 1353.23, 238, 1351.95, 76
2, 09:47:00-000, 353, 156, 197, 156, 1352.01, 189, 1351.80, 58
2, 09:48:00-000, 616, 262, 354, 262, 1352.17, 275, 1350.43, 65
2, 09:49:00-000, 315, 149, 166, 149, 1352.35, 165, 1352.48, 36
2, 09:50:00-000, 633, 314, 319, 314, 1353.57, 284, 1351.48, 10
2, 09:51:00-000, 271, 133, 138, 133, 1353.23, 112, 1351.82, 33
2, 09:52:00-000, 677, 294, 383, 294, 1352.88, 321, 1351.33, 48
2, 09:53:00-000, 323, 204, 119, 204, 1353.68, 122, 1351.84, 43
2, 09:54:00-000, 624, 251, 373, 251, 1352.51, 293, 1351.39, 20
2, 09:55:00-000, 323, 125, 198, 125, 1351.87, 143, 1350.75, 51
2, 09:56:00-000, 645, 301, 344, 301, 1352.84, 305, 1351.84, 70
2, 09:57:00-000, 344, 141, 203, 141, 1352.30, 174, 1351.62, 26
2, 09:58:00-000, 560, 263, 297, 263, 1353.46, 281, 1351.49, 38
2, 09:59:00-000, 326, 145, 181, 145, 1353.89, 146, 1351.69, 21
2, 10:00:00-000, 637, 294, 343, 294, 1352.48, 316, 1351.70, 40
2, 10:01:00-000, 292, 147, 145, 147, 1353.72, 121, 1351.20, 21
2, 10:02:00-000, 616, 318, 298, 318, 1353.55, 241, 1352.33, 24
2, 10:03:00-000, 323, 180, 143, 180, 1352.87, 146, 1351.45, 34
2, 10:04:00-000, 633, 265, 368, 265, 1352.74, 291, 1351.46, 29
2, 10:05:00-000, 333, 148, 185, 148, 1352.03, 141, 1350.79, 61
2, 10:06:00-000, 554, 252, 302, 252, 1352.95, 270, 1351.87, 39
2, 10:07:00-000, 329, 161, 168, 161, 1353.08, 148, 1351.88, 38
2, 10:08:00-000, 646, 269, 377, 269, 1353.12, 279, 1351.72, 22
2, 10:09:00-000, 299, 124, 175, 124, 1351.89, 185, 1352.22, 78
2, 10:10:00-000, 562, 276, 286, 276, 1354.04, 223, 1351.66, 13
2, 10:11:00-000, 350, 139, 211, 139, 1352.37, 160, 1351.31, 51
2, 10:12:00-000, 610, 299, 311, 299, 1353.58, 260, 1351.06, 40
2, 10:13:00-000, 325, 154, 171, 154, 1351.84, 150, 1351.11, 57
2, 10:14:00-000, 651, 303, 348, 303, 1353.45, 284, 1351.46, 28
2, 10:15:00-000, 323, 154, 169, 154, 1352.99, 143, 1352.08, 45
2, 10:16:00-000, 614, 210, 404, 210, 1351.59, 227, 1350.19, 91
2, 10:17:00-000, 355, 191, 164, 191, 1352.57, 153, 1351.09, 94
2, 10:18:00-000, 530, 212, 318, 212, 1351.87, 212, 1350.97, 70
2, 10:19:00-000, 343, 144, 199, 144, 1352.52, 161, 1351.21, 76
2, 10:20:00-000, 617, 298, 319, 298, 1352.66, 278, 1351.64, 52
2, 10:21:00-000, 326, 143, 183, 143, 1352.56, 160, 1351.55, 37
2, 10:22:00-000, 628, 241, 387, 241, 1351.99, 246, 1350.67, 48
2, 10:23:00-000, 283, 132, 151, 132, 1352.43, 142, 1351.91, 94
2, 10:24:00-000, 657, 294, 363, 294, 1352.35, 306, 1351.01, 39
2, 10:25:00-000, 367, 139, 228, 139, 1352.43, 165, 1352.01, 51
2, 10:26:00-000, 665, 302, 363, 302, 1352.71, 321, 1351.25, 87
2, 10:27:00-000, 234, 94, 140, 94, 1353.51, 113, 1351.57, 20
2, 10:28:00-000, 625, 288, 337, 288, 1353.38, 269, 1351.40, 33
2, 10:29:00-000, 317, 159, 158, 159, 1354.22, 138, 1351.49, 42
2, 10:30:00-000, 636, 291, 345, 291, 1352.74, 317, 1351.34, 36
2, 10:31:00-000, 308, 138, 170, 138, 1352.87, 164, 1351.50, 26
2, 10:32:00-000, 663, 309, 354, 309, 1352.65, 289, 1352.25, 21
2, 10:33:00-000, 295, 142, 153, 142, 1352.64, 140, 1351.45, 48
2, 10:34:00-000, 620, 259, 361, 259, 1352.20, 292, 1351.10, 38
2, 10:35:00-000, 277, 153, 124, 153, 1352.48, 124, 1351.80, 37
2, 10:36:00-000, 585, 264, 321, 264, 1353.14, 252, 1351.66, 31
2, 10:37:00-000, 354, 168, 186, 168, 1353.27, 161, 1351.89, 32
2, 10:38:00-000, 618, 266, 352, 266, 1352.30, 243, 1351.45, 68
2, 10:39:00-000, 302, 160, 142, 160, 1353.77, 153, 1352.12, 55
2, 10:40:00-000, 621, 305, 316, 305, 1353.47, 246, 1351.96, 45
2, 10:41:00-000, 334, 145, 189, 145, 1353.25, 147, 1352.24, 41
2, 10:42:00-000, 697, 316, 381, 316, 1352.82, 293, 1351.56, 48
2, 10:43:00-000, 262, 90, 172, 90, 1352.13, 112, 1351.33, 64
2, 10:44:00-000, 651, 259, 392, 259, 1352.36, 291, 1351.60, 104
2, 10:45:00-000, 280, 132, 148, 132, 1352.69, 137, 1352.17, 60
2, 10:46:00-000, 562, 243, 319, 243, 1352.69, 262, 1351.20, 34
2, 10:47:00-000, 341, 158, 183, 158, 1352.79, 135, 1351.90, 52
2, 10:48:00-000, 677, 322, 355, 322, 1353.43, 328, 1351.82, 47
2, 10:49:00-000, 300, 95, 205, 95, 1351.75, 137, 1350.93, 28
2, 10:50:00-000, 598, 266, 332, 266, 1352.74, 279, 1352.06, 73
2, 10:51:00-000, 330, 149, 181, 149, 1352.61, 170, 1351.89, 32
2, 10:52:00-000, 593, 253, 340, 253, 1352.96, 240, 1351.19, 51
2, 10:53:00-000, 335, 125, 210, 125, 1351.12, 138, 1351.13, 74
2, 10:54:00-000, 663, 282, 381, 282, 1351.89, 309, 1350.49, 83
2, 10:55:00-000, 358, 173, 185, 173, 1352.28, 160, 1349.66, 49
2, 10:56:00-000, 705, 306, 399, 306, 1352.48, 292, 1350.95, 67
2, 10:57:00-000, 328, 154, 174, 154, 1353.82, 172, 1351.40, 49
2, 10:58:00-000, 568, 251, 317, 251, 1351.75, 245, 1350.87, 46
2, 10:59:00-000, 304, 147, 157, 147, 1352.86, 125, 1352.21, 44
2, 11:00:00-000, 703, 298, 405, 298, 1352.14, 343, 1351.15, 62
2, 11:01:00-000, 304, 135, 169, 135, 1352.32, 124, 1350.46, 51
2, 11:02:00-000, 679, 322, 357, 322, 1352.49, 276, 1351.31, 53
2, 11:03:00-000, 307, 111, 196, 111, 1352.04, 142, 1350.99, 68
2, 11:04:00-000, 655, 271, 384, 271, 1351.89, 276, 1351.10, 75
2, 11:05:00-000, 307, 139, 168, 139, 1352.28, 141, 1351.78, 76
2, 11:06:00-000, 671, 293, 378, 293, 1352.62, 305, 1351.16, 43
2, 11:07:00-000, 271, 124, 147, 124, 1351.95, 130, 1351.34, 50
2, 11:08:00-000, 619, 319, 300, 319, 1353.54, 251, 1351.87, 49
2, 11:09:00-000, 345, 165, 180, 165, 1352.51, 162, 1351.59, 26
2, 11:10:00-000, 695, 342, 353, 342, 1353.12, 307, 1352.13, 32
2, 11:11:00-000, 304, 139, 165, 139, 1352.53, 137, 1351.35, 46
2, 11:12:00-000, 637, 303, 334, 303, 1352.64, 267, 1351.60, 47
2, 11:13:00-000, 328, 120, 208, 120, 1351.70, 131, 1351.32, 51
2, 11:14:00-000, 624, 262, 362, 262, 1352.17, 233, 1350.92, 83
2, 11:15:00-000, 311, 116, 195, 116, 1351.65, 166, 1350.31, 76
2, 11:16:00-000, 549, 278, 271, 278, 1352.61, 247, 1351.07, 62
2, 11:17:00-000, 329, 140, 189, 140, 1352.10, 125, 1351.73, 36
2, 11:18:00-000, 639, 268, 371, 268, 1352.67, 318, 1350.89, 78
2, 11:19:00-000, 314, 128, 186, 128, 1352.01, 154, 1351.34, 41
2, 11:20:00-000, 606, 252, 354, 252, 1352.42, 271, 1350.76, 58
2, 11:21:00-000, 296, 141, 155, 141, 1352.34, 125, 1351.23, 49
2, 11:22:00-000, 547, 240, 307, 240, 1352.92, 246, 1351.66, 31
2, 11:23:00-000, 301, 159, 142, 159, 1353.60, 150, 1351.96, 46
2, 11:24:00-000, 633, 280, 353, 280, 1352.78, 271, 1351.70, 42
2, 11:25:00-000, 347, 195, 152, 195, 1352.25, 136, 1351.80, 38
2, 11:26:00-000, 538, 240, 298, 240, 1352.74, 218, 1351.54, 46
2, 11:27:00-000, 271, 119, 152, 119, 1353.09, 143, 1351.89, 45
2, 11:28:00-000, 593, 277, 316, 277, 1352.60, 233, 1351.48, 50
2, 11:29:00-000, 292, 129, 163, 129, 1352.04, 137, 1350.90, 62
2, 11:30:00-000, 621, 287, 334, 287, 1352.23, 282, 1351.86, 19
2, 11:31:00-000, 252, 94, 158, 94, 1350.74, 120, 1350.19, 60
2, 11:32:00-000, 666, 257, 409, 257, 1351.80, 294, 1351.19, 41
2, 11:33:00-000, 261, 151, 110, 151, 1352.90, 119, 1352.22, 69
2, 11:34:00-000, 607, 268, 339, 268, 1352.17, 279, 1350.72, 43
2, 11:35:00-000, 307, 109, 198, 109, 1351.34, 150, 1351.63, 48
2, 11:36:00-000, 642, 253, 389, 253, 1352.13, 271, 1351.46, 64
2, 11:37:00-000, 319, 112, 207, 112, 1351.88, 147, 1350.79, 93
2, 11:38:00-000, 672, 324, 348, 324, 1352.10, 267, 1351.16, 58
2, 11:39:00-000, 292, 147, 145, 147, 1353.06, 153, 1351.14, 60
2, 11:40:00-000, 516, 214, 302, 214, 1352.06, 202, 1351.34, 49
2, 11:41:00-000, 329, 135, 194, 135, 1352.31, 182, 1350.85, 51
2, 11:42:00-000, 638, 320, 318, 320, 1353.01, 252, 1351.25, 41
2, 11:43:00-000, 323, 139, 184, 139, 1351.18, 135, 1351.00, 57
2, 11:44:00-000, 675, 295, 380, 295, 1353.35, 287, 1351.44, 41
2, 11:45:00-000, 276, 117, 159, 117, 1351.85, 106, 1350.58, 96
2, 11:46:00-000, 568, 227, 341, 227, 1350.98, 230, 1350.30, 78
2, 11:47:00-000, 368, 170, 198, 170, 1352.34, 139, 1351.85, 73
2, 11:48:00-000, 615, 253, 362, 253, 1352.44, 288, 1350.90, 79
2, 11:49:00-000, 401, 155, 246, 155, 1351.86, 160, 1350.57, 74
2, 11:50:00-000, 602, 283, 319, 283, 1353.25, 297, 1351.49, 69
2, 11:51:00-000, 331, 157, 174, 157, 1353.37, 145, 1352.51, 37
2, 11:52:00-000, 663, 242, 421, 242, 1351.05, 256, 1350.29, 87
2, 11:53:00-000, 271, 131, 140, 131, 1352.23, 115, 1351.71, 92
2, 11:54:00-000, 661, 264, 397, 264, 1351.14, 246, 1350.35, 62
2, 11:55:00-000, 282, 134, 148, 134, 1352.45, 135, 1351.61, 106
2, 11:56:00-000, 606, 245, 361, 245, 1352.45, 289, 1351.05, 48
2, 11:57:00-000, 219, 139, 80, 139, 1353.81, 96, 1352.55, 39
2, 11:58:00-000, 703, 293, 410, 293, 1352.20, 312, 1351.27, 34
2, 11:59:00-000, 319, 156, 163, 156, 1352.15, 150, 1351.78, 54
2, 12:00:00-000, 605, 223, 382, 223, 1351.00, 264, 1349.94, 55
2, 12:01:00-000, 307, 139, 168, 139, 1351.53, 118, 1350.28, 79
2, 12:02:00-000, 559, 254, 305, 254, 1353.18, 265, 1352.35, 53
2, 12:03:00-000, 320, 129, 191, 129, 1352.24, 151, 1351.26, 54
2, 12:04:00-000, 619, 287, 332, 287, 1352.18, 247, 1351.93, 65
2, 12:05:00-000, 354, 144, 210, 144, 1352.13, 154, 1351.42, 47
2, 12:06:00-000, 623, 278, 345, 278, 1351.94, 299, 1351.16, 47
2, 12:07:00-000, 282, 109, 173, 109, 1352.04, 113, 1351.02, 69
2, 12:08:00-000, 566, 260, 306, 260, 1351.70, 239, 1351.36, 60
2, 12:09:00-000, 292, 156, 136, 156, 1352.74, 126, 1351.90, 51
2, 12:10:00-000, 500, 215, 285, 215, 1352.46, 222, 1351.17, 44
2, 12:11:00-000, 374, 176, 198, 176, 1353.45, 165, 1352.19, 28
2, 12:12:00-000, 649, 293, 356, 289, 1351.60, 245, 1351.00, 51
2, 12:13:00-000, 280, 70, 210, 74, 1350.62, 116, 1350.50, 96
2, 12:14:00-000, 649, 276, 373, 276, 1351.93, 289, 1350.97, 112
2, 12:15:00-000, 336, 150, 186, 150, 1352.67, 155, 1351.26, 65
2, 12:16:00-000, 653, 285, 368, 285, 1352.20, 282, 1351.37, 43
2, 12:17:00-000, 345, 134, 211, 134, 1352.12, 151, 1351.21, 85
2, 12:18:00-000, 542, 229, 313, 229, 1351.58, 216, 1350.84, 85
2, 12:19:00-000, 305, 133, 172, 133, 1351.87, 140, 1350.79, 65
2, 12:20:00-000, 592, 248, 344, 248, 1351.63, 201, 1350.05, 57
2, 12:21:00-000, 371, 169, 202, 169, 1352.12, 118, 1349.84, 122
2, 12:22:00-000, 690, 305, 385, 305, 1352.00, 245, 1350.13, 104
2, 12:23:00-000, 299, 147, 152, 147, 1352.93, 86, 1350.89, 102
2, 12:24:00-000, 608, 225, 383, 225, 1352.54, 238, 1351.15, 111
2, 12:25:00-000, 319, 138, 181, 138, 1351.23, 135, 1350.78, 125
2, 12:26:00-000, 624, 261, 363, 261, 1351.07, 251, 1351.10, 58
2, 12:27:00-000, 333, 121, 212, 121, 1351.86, 168, 1350.47, 77
2, 12:28:00-000, 608, 205, 403, 205, 1351.49, 270, 1350.59, 74
2, 12:29:00-000, 354, 130, 224, 130, 1351.93, 145, 1350.80, 123
2, 12:30:00-000, 566, 177, 389, 177, 1351.57, 245, 1350.40, 110
2, 12:31:00-000, 332, 142, 190, 142, 1351.58, 117, 1350.82, 100
2, 12:32:00-000, 642, 259, 383, 259, 1351.95, 287, 1350.49, 104
2, 12:33:00-000, 307, 130, 177, 130, 1352.71, 132, 1351.22, 68
2, 12:34:00-000, 576, 245, 331, 245, 1351.99, 219, 1350.41, 76
2, 12:35:00-000, 342, 142, 200, 142, 1352.62, 135, 1351.15, 93
2, 12:36:00-000, 632, 228, 404, 228, 1352.49, 284, 1351.40, 74
2, 12:37:00-000, 418, 190, 228, 190, 1353.14, 195, 1350.84, 92
2, 12:38:00-000, 643, 226, 417, 226, 1351.75, 304, 1350.76, 60
2, 12:39:00-000, 348, 151, 197, 151, 1351.28, 139, 1350.53, 95
2, 12:40:00-000, 604, 254, 350, 254, 1351.48, 257, 1351.70, 76
2, 12:41:00-000, 289, 137, 152, 137, 1352.34, 116, 1351.57, 71
2, 12:42:00-000, 667, 241, 426, 241, 1352.04, 300, 1351.35, 56
2, 12:43:00-000, 286, 112, 174, 112, 1351.64, 156, 1351.12, 86
2, 12:44:00-000, 705, 336, 369, 336, 1352.82, 281, 1351.44, 61
2, 12:45:00-000, 298, 112, 186, 112, 1352.15, 131, 1350.47, 80
2, 12:46:00-000, 594, 310, 284, 310, 1352.68, 237, 1351.40, 56
2, 12:47:00-000, 341, 121, 220, 121, 1352.54, 171, 1350.91, 43
2, 12:48:00-000, 715, 330, 385, 330, 1352.54, 298, 1351.30, 54
2, 12:49:00-000, 265, 122, 143, 122, 1353.01, 128, 1351.93, 74
2, 12:50:00-000, 580, 267, 313, 260, 1352.22, 228, 1350.97, 33
2, 12:51:00-000, 274, 122, 152, 129, 1352.09, 107, 1350.72, 62
2, 12:52:00-000, 594, 272, 322, 272, 1353.05, 257, 1351.75, 72
2, 12:53:00-000, 305, 141, 164, 141, 1351.97, 109, 1350.68, 51
2, 12:54:00-000, 666, 330, 336, 330, 1351.52, 261, 1350.56, 69
2, 12:55:00-000, 382, 158, 224, 158, 1352.78, 152, 1351.02, 45
2, 12:56:00-000, 639, 258, 381, 258, 1352.15, 305, 1351.49, 71
2, 12:57:00-000, 302, 127, 175, 127, 1351.83, 123, 1350.59, 91
2, 12:58:00-000, 569, 211, 358, 211, 1352.05, 245, 1350.54, 87
2, 12:59:00-000, 266, 97, 169, 97, 1352.05, 108, 1350.97, 68
2, 13:00:00-000, 602, 247, 355, 247, 1350.63, 274, 1350.79, 81
2, 13:01:00-000, 369, 194, 175, 194, 1353.10, 150, 1351.94, 64
2, 13:02:00-000, 695, 251, 444, 251, 1352.23, 296, 1350.90, 64
2, 13:03:00-000, 335, 116, 219, 116, 1351.58, 147, 1350.33, 103
2, 13:04:00-000, 615, 254, 361, 254, 1351.55, 241, 1351.36, 123
2, 13:05:00-000, 233, 102, 131, 102, 1351.09, 104, 1350.56, 77
2, 13:06:00-000, 563, 242, 321, 242, 1352.03, 234, 1351.19, 44
2, 13:07:00-000, 332, 155, 177, 155, 1352.71, 149, 1351.22, 68
2, 13:08:00-000, 654, 308, 346, 308, 1353.32, 290, 1351.66, 56
2, 13:09:00-000, 272, 114, 158, 114, 1352.43, 129, 1351.55, 41
2, 13:10:00-000, 700, 314, 386, 314, 1352.43, 280, 1351.39, 44
2, 13:11:00-000, 323, 143, 180, 143, 1352.11, 153, 1351.61, 74
2, 13:12:00-000, 691, 240, 451, 238, 1350.96, 284, 1350.08, 68
2, 13:13:00-000, 319, 141, 178, 142, 1351.85, 160, 1351.43, 100
2, 13:14:00-000, 657, 289, 368, 289, 1352.71, 308, 1351.49, 74
2, 13:15:00-000, 266, 106, 160, 106, 1351.09, 131, 1350.63, 44
2, 13:16:00-000, 661, 268, 393, 268, 1352.78, 275, 1352.02, 42
2, 13:17:00-000, 322, 158, 164, 158, 1353.11, 155, 1352.07, 73
2, 13:18:00-000, 630, 313, 317, 313, 1353.47, 280, 1351.27, 42
2, 13:19:00-000, 325, 131, 194, 131, 1353.00, 149, 1351.86, 28
2, 13:20:00-000, 651, 299, 352, 299, 1352.67, 262, 1351.35, 82
2, 13:21:00-000, 266, 112, 154, 112, 1351.72, 98, 1350.91, 49
2, 13:22:00-000, 688, 313, 375, 313, 1353.04, 311, 1352.15, 54
2, 13:23:00-000, 285, 101, 184, 101, 1352.28, 152, 1351.08, 55
2, 13:24:00-000, 646, 337, 309, 337, 1353.85, 287, 1351.72, 53
2, 13:25:00-000, 319, 122, 197, 122, 1350.48, 100, 1349.82, 28
2, 13:26:00-000, 612, 279, 333, 279, 1352.95, 287, 1350.56, 77
2, 13:27:00-000, 275, 129, 146, 129, 1351.99, 138, 1351.38, 44
2, 13:28:00-000, 688, 300, 388, 300, 1352.45, 288, 1351.22, 54
2, 13:29:00-000, 312, 153, 159, 153, 1352.70, 130, 1351.38, 72
2, 13:30:00-000, 677, 299, 378, 299, 1352.85, 312, 1351.07, 33
2, 13:31:00-000, 387, 170, 217, 170, 1352.46, 174, 1351.38, 44
2, 13:32:00-000, 588, 240, 348, 240, 1351.68, 298, 1350.75, 54
2, 13:33:00-000, 283, 118, 165, 118, 1351.56, 115, 1351.17, 46
2, 13:34:00-000, 641, 262, 379, 262, 1351.76, 288, 1350.98, 55
2, 13:35:00-000, 312, 109, 203, 109, 1351.26, 136, 1350.37, 92
2, 13:36:00-000, 616, 269, 347, 269, 1351.07, 252, 1350.72, 84
2, 13:37:00-000, 310, 159, 151, 159, 1353.37, 111, 1352.06, 64
2, 13:38:00-000, 672, 341, 331, 338, 1353.46, 301, 1351.69, 57
2, 13:39:00-000, 279, 135, 144, 138, 1353.46, 106, 1351.57, 22
2, 13:40:00-000, 695, 279, 416, 279, 1351.88, 289, 1350.67, 71
2, 13:41:00-000, 263, 124, 139, 124, 1352.17, 119, 1350.90, 71
2, 13:42:00-000, 671, 276, 395, 276, 1352.47, 262, 1351.36, 45
2, 13:43:00-000, 275, 105, 170, 105, 1352.10, 158, 1351.69, 78
2, 13:44:00-000, 604, 246, 358, 246, 1351.93, 248, 1351.32, 91
2, 13:45:00-000, 317, 155, 162, 155, 1352.67, 133, 1352.17, 64
2, 13:46:00-000, 670, 322, 348, 322, 1353.38, 290, 1351.93, 61
2, 13:47:00-000, 320, 99, 221, 99, 1351.18, 111, 1350.92, 52
2, 13:48:00-000, 549, 246, 303, 246, 1352.90, 277, 1352.05, 74
2, 13:49:00-000, 279, 143, 136, 143, 1352.39, 103, 1350.79, 62
2, 13:50:00-000, 600, 227, 373, 227, 1352.89, 282, 1351.57, 30
2, 13:51:00-000, 332, 158, 174, 158, 1352.52, 151, 1351.54, 64
2, 13:52:00-000, 618, 315, 303, 315, 1352.67, 241, 1351.32, 66
2, 13:53:00-000, 390, 151, 239, 151, 1352.51, 204, 1350.51, 29
2, 13:54:00-000, 596, 253, 343, 253, 1352.47, 256, 1351.35, 64
2, 13:55:00-000, 267, 103, 164, 103, 1350.56, 102, 1350.49, 85
2, 13:56:00-000, 624, 296, 328, 296, 1351.66, 274, 1351.31, 59
2, 13:57:00-000, 297, 99, 198, 99, 1352.08, 153, 1350.90, 39
2, 13:58:00-000, 554, 276, 278, 276, 1352.50, 207, 1351.54, 68
2, 13:59:00-000, 272, 135, 137, 135, 1353.13, 115, 1351.38, 60
2, 14:00:00-000, 632, 300, 332, 300, 1352.93, 294, 1351.44, 23
2, 14:01:00-000, 278, 117, 161, 117, 1352.31, 109, 1349.95, 42
2, 14:02:00-000, 670, 287, 383, 287, 1351.74, 295, 1350.87, 69
2, 14:03:00-000, 302, 122, 180, 122, 1352.33, 152, 1349.88, 62
2, 14:04:00-000, 713, 279, 434, 279, 1352.36, 326, 1350.95, 48
2, 14:05:00-000, 300, 131, 169, 131, 1352.84, 148, 1351.16, 73
2, 14:06:00-000, 614, 221, 393, 221, 1351.65, 276, 1350.24, 55
2, 14:07:00-000, 299, 128, 171, 126, 1351.54, 124, 1351.49, 84
2, 14:08:00-000, 639, 296, 343, 298, 1352.68, 264, 1351.37, 62
2, 14:09:00-000, 280, 78, 202, 78, 1350.03, 91, 1349.17, 73
2, 14:10:00-000, 661, 357, 304, 357, 1352.94, 300, 1351.54, 74
2, 14:11:00-000, 313, 136, 177, 136, 1352.37, 132, 1352.25, 40
2, 14:12:00-000, 615, 258, 357, 254, 1351.76, 302, 1350.85, 47
2, 14:13:00-000, 366, 149, 217, 153, 1351.64, 154, 1350.27, 61
2, 14:14:00-000, 690, 314, 376, 314, 1352.25, 298, 1351.34, 73
2, 14:15:00-000, 295, 123, 172, 123, 1351.33, 126, 1350.28, 75
2, 14:16:00-000, 634, 267, 367, 267, 1351.94, 274, 1351.64, 36
2, 14:17:00-000, 331, 117, 214, 117, 1350.96, 150, 1350.99, 85
2, 14:18:00-000, 660, 317, 343, 317, 1351.64, 245, 1351.11, 70
2, 14:19:00-000, 308, 149, 159, 149, 1351.10, 129, 1350.51, 99
2, 14:20:00-000, 566, 259, 307, 259, 1352.20, 209, 1351.10, 59
2, 14:21:00-000, 375, 174, 201, 174, 1352.83, 166, 1351.13, 58
2, 14:22:00-000, 643, 262, 381, 262, 1351.87, 252, 1351.00, 74
2, 14:23:00-000, 320, 140, 180, 140, 1352.51, 154, 1352.26, 69
2, 14:24:00-000, 624, 259, 365, 259, 1352.70, 292, 1350.86, 58
2, 14:25:00-000, 303, 99, 204, 99, 1351.70, 146, 1350.35, 59
2, 14:26:00-000, 698, 284, 414, 284, 1352.15, 343, 1350.65, 88
2, 14:27:00-000, 305, 120, 185, 120, 1352.26, 141, 1350.77, 51
2, 14:28:00-000, 620, 251, 369, 251, 1352.79, 257, 1351.45, 89
2, 14:29:00-000, 302, 109, 193, 109, 1351.75, 137, 1350.97, 81
2, 14:30:00-000, 647, 304, 343, 304, 1352.81, 272, 1351.79, 65
2, 14:31:00-000, 276, 135, 141, 135, 1352.67, 121, 1352.15, 44
2, 14:32:00-000, 688, 289, 399, 289, 1351.57, 288, 1350.70, 58
2, 14:33:00-000, 347, 191, 156, 191, 1353.22, 128, 1351.43, 76
2, 14:34:00-000, 679, 306, 373, 306, 1352.65, 304, 1351.49, 45
2, 14:35:00-000, 351, 179, 172, 179, 1353.57, 166, 1352.10, 60
2, 14:36:00-000, 630, 264, 366, 264, 1352.25, 247, 1350.90, 26
2, 14:37:00-000, 258, 100, 158, 100, 1351.70, 126, 1351.00, 82
2, 14:38:00-000, 597, 276, 321, 276, 1352.22, 253, 1351.37, 68
2, 14:39:00-000, 313, 123, 190, 123, 1351.22, 152, 1350.99, 43
2, 14:40:00-000, 656, 293, 363, 293, 1353.35, 294, 1352.31, 46
2, 14:41:00-000, 350, 180, 170, 180, 1351.82, 131, 1351.12, 69
2, 14:42:00-000, 703, 321, 382, 321, 1352.08, 238, 1350.92, 69
2, 14:43:00-000, 295, 124, 171, 124, 1351.75, 149, 1351.04, 82
2, 14:44:00-000, 626, 260, 366, 260, 1352.29, 246, 1350.83, 76
2, 14:45:00-000, 289, 122, 167, 122, 1352.19, 107, 1350.43, 96
2, 14:46:00-000, 566, 193, 373, 193, 1351.77, 264, 1351.34, 71
2, 14:47:00-000, 272, 126, 146, 126, 1352.48, 126, 1351.92, 87
2, 14:48:00-000, 651, 244, 407, 244, 1351.47, 277, 1350.30, 53
2, 14:49:00-000, 360, 153, 207, 153, 1351.66, 155, 1351.11, 77
2, 14:50:00-000, 644, 289, 355, 289, 1352.23, 252, 1350.57, 95
2, 14:51:00-000, 304, 132, 172, 132, 1351.78, 115, 1351.40, 78
2, 14:52:00-000, 599, 266, 333, 266, 1351.11, 253, 1350.02, 89
2, 14:53:00-000, 258, 108, 150, 108, 1351.61, 80, 1351.17, 67
2, 14:54:00-000, 616, 247, 369, 247, 1352.08, 318, 1350.28, 68
2, 14:55:00-000, 280, 115, 165, 115, 1351.53, 108, 1351.29, 44
2, 14:56:00-000, 591, 242, 349, 242, 1351.92, 259, 1350.80, 85
2, 14:57:00-000, 325, 139, 186, 139, 1350.98, 131, 1350.94, 54
2, 14:58:00-000, 661, 254, 407, 254, 1352.34, 304, 1351.14, 92
2, 14:59:00-000, 354, 127, 227, 127, 1351.45, 156, 1350.51, 71
2, 15:00:00-000, 630, 266, 364, 266, 1351.78, 301, 1350.98, 75
2, 15:01:00-000, 301, 137, 164, 137, 1352.50, 144, 1351.47, 56
2, 15:02:00-000, 623, 231, 392, 231, 1351.96, 276, 1351.28, 49
2, 15:03:00-000, 308, 131, 177, 131, 1352.84, 134, 1351.85, 91
2, 15:04:00-000, 730, 387, 343, 387, 1352.44, 258, 1351.18, 55
2, 15:05:00-000, 344, 145, 199, 145, 1352.49, 177, 1351.44, 65
2, 15:06:00-000, 609, 274, 335, 274, 1352.76, 283, 1351.94, 61
2, 15:07:00-000, 280, 158, 122, 158, 1353.44, 96, 1352.30, 30
2, 15:08:00-000, 679, 270, 409, 270, 1352.19, 322, 1351.19, 43
2, 15:09:00-000, 354, 148, 206, 148, 1351.40, 149, 1350.40, 70
2, 15:10:00-000, 616, 239, 377, 239, 1351.09, 268, 1350.68, 74
2, 15:11:00-000, 319, 132, 187, 132, 1352.00, 136, 1350.70, 75
2, 15:12:00-000, 637, 278, 359, 278, 1352.75, 286, 1351.91, 71
2, 15:13:00-000, 322, 144, 178, 144, 1352.55, 121, 1351.71, 67
2, 15:14:00-000, 634, 274, 360, 274, 1352.63, 284, 1351.56, 69
2, 15:15:00-000, 354, 141, 213, 141, 1351.52, 150, 1351.17, 61
2, 15:16:00-000, 725, 334, 391, 334, 1352.63, 326, 1351.06, 61
2, 15:17:00-000, 328, 157, 171, 157, 1352.36, 149, 1352.16, 60
2, 15:18:00-000, 636, 268, 368, 268, 1352.66, 246, 1351.34, 58
2, 15:19:00-000, 334, 125, 209, 125, 1352.07, 166, 1351.49, 74
2, 15:20:00-000, 668, 252, 416, 252, 1351.85, 331, 1351.01, 69
2, 15:21:00-000, 344, 140, 204, 140, 1352.35, 115, 1350.33, 71
2, 15:22:00-000, 612, 285, 327, 285, 1351.69, 248, 1350.81, 77
2, 15:23:00-000, 340, 185, 155, 185, 1354.30, 146, 1352.54, 72
2, 15:24:00-000, 654, 318, 336, 318, 1352.86, 274, 1351.52, 64
2, 15:25:00-000, 266, 136, 130, 136, 1352.94, 109, 1351.33, 35
2, 15:26:00-000, 572, 257, 315, 257, 1352.51, 240, 1351.10, 44
2, 15:27:00-000, 304, 150, 154, 150, 1353.52, 129, 1351.29, 46
2, 15:28:00-000, 667, 280, 387, 280, 1352.65, 284, 1351.19, 41
2, 15:29:00-000, 341, 114, 227, 114, 1351.66, 123, 1351.00, 91
2, 15:30:00-000, 580, 278, 302, 278, 1352.82, 258, 1351.24, 101
2, 15:31:00-000, 316, 128, 188, 128, 1352.44, 151, 1350.76, 44
2, 15:32:00-000, 525, 244, 281, 244, 1353.02, 247, 1351.32, 38
2, 15:33:00-000, 338, 145, 193, 145, 1352.01, 128, 1349.76, 44
2, 15:34:00-000, 636, 268, 368, 268, 1351.50, 253, 1351.22, 76
2, 15:35:00-000, 244, 101, 143, 101, 1352.26, 133, 1351.32, 76
2, 15:36:00-000, 663, 272, 391, 272, 1351.57, 251, 1350.77, 53
2, 15:37:00-000, 314, 141, 173, 141, 1352.15, 158, 1351.91, 78
2, 15:38:00-000, 611, 272, 339, 272, 1352.87, 284, 1350.77, 72
2, 15:39:00-000, 287, 127, 160, 127, 1352.97, 146, 1351.88, 30
2, 15:40:00-000, 726, 290, 436, 290, 1351.70, 241, 1349.31, 55
2, 15:41:00-000, 319, 112, 207, 112, 1351.40, 123, 1350.14, 169
2, 15:42:00-000, 642, 288, 354, 288, 1351.99, 213, 1350.63, 128
2, 15:43:00-000, 323, 155, 168, 155, 1352.14, 89, 1350.24, 87
2, 15:44:00-000, 521, 221, 300, 221, 1352.48, 216, 1350.70, 95
2, 15:45:00-000, 340, 126, 214, 126, 1352.00, 143, 1350.89, 74
2, 15:46:00-000, 652, 257, 395, 257, 1352.14, 286, 1350.44, 96
2, 15:47:00-000, 337, 124, 213, 124, 1351.71, 130, 1350.59, 86
2, 15:48:00-000, 615, 247, 368, 247, 1352.23, 254, 1350.98, 112
2, 15:49:00-000, 294, 87, 207, 87, 1352.46, 136, 1351.22, 82
2, 15:50:00-000, 592, 192, 400, 192, 1351.59, 260, 1350.86, 87
2, 15:51:00-000, 297, 119, 178, 119, 1352.03, 126, 1350.38, 96
2, 15:52:00-000, 690, 277, 413, 277, 1351.57, 314, 1350.16, 97
2, 15:53:00-000, 295, 136, 159, 135, 1352.66, 118, 1351.54, 62
2, 15:54:00-000, 737, 317, 420, 318, 1352.03, 310, 1351.29, 77
2, 15:55:00-000, 300, 155, 145, 155, 1352.98, 122, 1351.78, 94
2, 15:56:00-000, 652, 264, 388, 264, 1352.07, 287, 1351.47, 49
2, 15:57:00-000, 337, 129, 208, 129, 1352.04, 150, 1350.87, 55
2, 15:58:00-000, 594, 242, 352, 242, 1352.29, 257, 1351.61, 92
2, 15:59:00-000, 322, 164, 158, 164, 1352.99, 143, 1351.35, 69
2, 16:00:00-000, 584, 247, 337, 247, 1352.12, 236, 1350.84, 47
2, 16:01:00-000, 320, 129, 191, 129, 1353.31, 118, 1351.09, 65
2, 16:02:00-000, 766, 337, 429, 337, 1352.42, 354, 1351.69, 76
2, 16:03:00-000, 260, 123, 137, 123, 1351.97, 116, 1351.69, 68
2, 16:04:00-000, 544, 271, 273, 271, 1352.68, 234, 1351.55, 58
2, 16:05:00-000, 328, 125, 203, 125, 1351.94, 127, 1349.57, 30
2, 16:06:00-000, 609, 271, 338, 271, 1352.47, 257, 1350.95, 65
2, 16:07:00-000, 378, 159, 219, 159, 1352.34, 177, 1351.59, 70
2, 16:08:00-000, 593, 242, 351, 242, 1352.55, 239, 1350.97, 76
2, 16:09:00-000, 335, 151, 184, 151, 1353.44, 197, 1351.35, 44
2, 16:10:00-000, 646, 263, 383, 263, 1352.74, 293, 1351.57, 59
2, 16:11:00-000, 300, 109, 191, 109, 1352.15, 145, 1351.35, 42
2, 16:12:00-000, 483, 234, 249, 234, 1352.09, 182, 1350.91, 79
2, 16:13:00-000, 339, 148, 191, 148, 1351.42, 107, 1350.01, 47
2, 16:14:00-000, 666, 328, 338, 328, 1352.98, 271, 1351.94, 76
2, 16:15:00-000, 366, 134, 232, 134, 1352.73, 165, 1351.60, 72
2, 16:16:00-000, 629, 285, 344, 285, 1352.29, 286, 1351.29, 67
2, 16:17:00-000, 329, 141, 188, 141, 1352.24, 156, 1351.72, 75
2, 16:18:00-000, 603, 246, 357, 246, 1351.98, 251, 1351.11, 46
2, 16:19:00-000, 242, 112, 130, 112, 1351.75, 111, 1351.78, 63
2, 16:20:00-000, 600, 230, 370, 230, 1351.71, 243, 1350.88, 73
2, 16:21:00-000, 291, 130, 161, 130, 1351.64, 159, 1350.78, 67
2, 16:22:00-000, 636, 283, 353, 283, 1352.13, 248, 1351.19, 41
2, 16:23:00-000, 380, 162, 218, 162, 1351.83, 183, 1351.98, 76
2, 16:24:00-000, 607, 258, 349, 258, 1351.95, 252, 1351.72, 82
2, 16:25:00-000, 284, 138, 146, 138, 1352.50, 121, 1350.88, 65
2, 16:26:00-000, 668, 255, 413, 255, 1351.77, 290, 1351.13, 58
2, 16:27:00-000, 353, 144, 209, 144, 1351.75, 156, 1350.88, 87
2, 16:28:00-000, 644, 295, 349, 295, 1352.38, 292, 1351.45, 51
2, 16:29:00-000, 296, 151, 145, 151, 1353.22, 148, 1350.72, 60
3, 09:00:00-000, 193, 191, 2, 2, 1350.00, 2, 1350.00, 184
3, 09:01:00-000, 195, 195, 0, 0, 0.00, 0, 0.00, 196
3, 09:02:00-000, 199, 199, 0, 0, 0.00, 0, 0.00, 189
3, 09:03:00-000, 201, 201, 0, 0, 0.00, 0, 0.00, 210
3, 09:04:00-000, 189, 189, 0, 0, 0.00, 0, 0.00, 191
3, 09:05:00-000, 194, 194, 0, 0, 0.00, 0, 0.00, 193
3, 09:06:00-000, 175, 175, 0, 1, 1346.50, 0, 0.00, 177
3, 09:07:00-000, 206, 206, 0, 0, 0.00, 0, 0.00, 200
3, 09:08:00-000, 185, 185, 0, 0, 0.00, 0, 0.00, 186
3, 09:09:00-000, 176, 176, 0, 0, 0.00, 0, 0.00, 181
3, 09:10:00-000, 218, 218, 0, 0, 0.00, 0, 0.00, 218
3, 09:11:00-000, 205, 205, 0, 0, 0.00, 0, 0.00, 202
3, 09:12:00-000, 215, 215, 0, 0, 0.00, 0, 0.00, 212
3, 09:13:00-000, 195, 195, 0, 0, 0.00, 0, 0.00, 194
3, 09:14:00-000, 181, 178, 3, 4, 1348.50, 1, 1354.00, 183
3, 09:15:00-000, 194, 189, 5, 3, 1354.67, 5, 1355.40, 180
3, 09:16:00-000, 202, 195, 7, 13, 1354.92, 0, 0.00, 194
3, 09:17:00-000, 226, 216, 10, 8, 1349.37, 5, 1363.20, 194
3, 09:18:00-000, 211, 198, 13, 15, 1369.13, 9, 1375.66, 207
3, 09:19:00-000, 187, 183, 4, 7, 1353.00, 0, 0.00, 179
3, 09:20:00-000, 194, 178, 16, 12, 1348.67, 5, 1351.80, 172
3, 09:21:00-000, 230, 197, 33, 5, 1347.20, 7, 1353.00, 223
3, 09:22:00-000, 191, 163, 28, 3, 1348.00, 5, 1352.20, 182
3, 09:23:00-000, 215, 186, 29, 18, 1350.39, 7, 1350.57, 189
3, 09:24:00-000, 198, 176, 22, 6, 1349.83, 11, 1352.63, 182
3, 09:25:00-000, 164, 162, 2, 1, 1350.00, 2, 1353.50, 154
3, 09:26:00-000, 188, 166, 22, 4, 1348.75, 0, 0.00, 192
3, 09:27:00-000, 193, 168, 25, 6, 1348.50, 4, 1350.50, 174
3, 09:28:00-000, 191, 171, 20, 15, 1349.40, 14, 1352.35, 168
3, 09:29:00-000, 193, 165, 28, 2, 1350.50, 11, 1350.91, 184
3, 09:30:00-000, 201, 194, 7, 1, 1346.00, 4, 1350.00, 196
3, 09:31:00-000, 202, 172, 30, 13, 1349.08, 7, 1353.00, 182
3, 09:32:00-000, 226, 198, 28, 6, 1350.67, 9, 1353.78, 203
3, 09:33:00-000, 177, 168, 9, 5, 1352.60, 1, 1356.00, 177
3, 09:34:00-000, 202, 190, 12, 6, 1350.00, 4, 1351.50, 180
3, 09:35:00-000, 198, 177, 21, 4, 1350.75, 7, 1350.71, 200
3, 09:36:00-000, 191, 169, 22, 2, 1347.50, 4, 1350.25, 171
3, 09:37:00-000, 194, 182, 12, 11, 1349.45, 4, 1352.50, 195
3, 09:38:00-000, 222, 156, 66, 6, 1348.33, 9, 1350.89, 207
3, 09:39:00-000, 191, 168, 23, 4, 1348.75, 3, 1350.67, 176
3, 09:40:00-000, 201, 187, 14, 9, 1350.22, 11, 1351.18, 188
3, 09:41:00-000, 191, 169, 22, 9, 1352.22, 6, 1352.50, 174
3, 09:42:00-000, 205, 141, 64, 6, 1347.83, 4, 1352.25, 187
3, 09:43:00-000, 205, 157, 48, 0, 0.00, 8, 1351.88, 207
3, 09:44:00-000, 222, 194, 28, 5, 1350.20, 7, 1352.00, 203
3, 09:45:00-000, 234, 227, 7, 0, 0.00, 2, 1350.50, 233
3, 09:46:00-000, 183, 179, 4, 9, 1351.78, 0, 0.00, 177
3, 09:47:00-000, 189, 159, 30, 4, 1348.25, 4, 1350.75, 181
3, 09:48:00-000, 181, 162, 19, 6, 1349.17, 10, 1352.00, 167
3, 09:49:00-000, 228, 198, 30, 6, 1351.33, 9, 1351.89, 206
3, 09:50:00-000, 207, 164, 43, 17, 1349.82, 10, 1351.40, 179
3, 09:51:00-000, 195, 162, 33, 3, 1349.33, 4, 1350.75, 195
3, 09:52:00-000, 208, 155, 53, 10, 1350.70, 13, 1352.00, 185
3, 09:53:00-000, 192, 156, 36, 4, 1350.75, 14, 1353.43, 174
3, 09:54:00-000, 205, 202, 3, 7, 1348.14, 0, 0.00, 198
3, 09:55:00-000, 193, 151, 42, 4, 1346.50, 0, 0.00, 190
3, 09:56:00-000, 230, 173, 57, 18, 1349.33, 9, 1351.11, 195
3, 09:57:00-000, 200, 142, 58, 0, 0.00, 5, 1351.00, 196
3, 09:58:00-000, 205, 140, 65, 15, 1349.13, 10, 1352.10, 172
3, 09:59:00-000, 226, 139, 87, 19, 1349.37, 11, 1351.27, 210
3, 10:00:00-000, 213, 152, 61, 5, 1349.20, 25, 1351.16, 177
3, 10:01:00-000, 211, 167, 44, 5, 1349.20, 3, 1352.67, 209
3, 10:02:00-000, 169, 145, 24, 3, 1351.67, 2, 1353.00, 167
3, 10:03:00-000, 216, 167, 49, 4, 1348.50, 16, 1352.94, 196
3, 10:04:00-000, 234, 181, 53, 8, 1346.25, 4, 1351.00, 219
3, 10:05:00-000, 179, 156, 23, 8, 1348.50, 10, 1353.90, 161
3, 10:06:00-000, 193, 170, 23, 14, 1349.14, 2, 1353.00, 179
3, 10:07:00-000, 186, 182, 4, 0, 0.00, 3, 1352.00, 178
3, 10:08:00-000, 228, 210, 18, 10, 1348.40, 1, 1350.00, 214
3, 10:09:00-000, 235, 219, 16, 6, 1348.50, 10, 1351.20, 228
3, 10:10:00-000, 209, 196, 13, 1, 1354.00, 0, 0.00, 203
3, 10:11:00-000, 196, 173, 23, 10, 1350.80, 3, 1350.00, 181
3, 10:12:00-000, 178, 144, 34, 6, 1347.00, 6, 1351.00, 162
3, 10:13:00-000, 188, 144, 44, 9, 1348.33, 15, 1351.60, 175
3, 10:14:00-000, 209, 134, 75, 17, 1347.70, 3, 1353.00, 185
3, 10:15:00-000, 189, 114, 75, 4, 1348.25, 10, 1350.90, 168
3, 10:16:00-000, 217, 143, 74, 13, 1348.77, 20, 1350.95, 189
3, 10:17:00-000, 235, 116, 119, 8, 1346.37, 3, 1350.33, 215
3, 10:18:00-000, 209, 128, 81, 1, 1346.00, 11, 1350.91, 205
3, 10:19:00-000, 225, 137, 88, 7, 1348.57, 7, 1350.00, 214
3, 10:20:00-000, 187, 120, 67, 13, 1347.54, 19, 1352.37, 141
3, 10:21:00-000, 210, 169, 41, 5, 1348.40, 2, 1351.00, 217
3, 10:22:00-000, 213, 179, 34, 16, 1347.81, 10, 1350.30, 184
3, 10:23:00-000, 193, 147, 46, 4, 1348.75, 8, 1351.87, 178
3, 10:24:00-000, 179, 107, 72, 13, 1349.61, 1, 1350.00, 173
3, 10:25:00-000, 196, 125, 71, 9, 1349.78, 14, 1351.14, 172
3, 10:26:00-000, 196, 143, 53, 2, 1346.50, 9, 1354.11, 182
3, 10:27:00-000, 199, 152, 47, 3, 1350.00, 9, 1351.44, 187
3, 10:28:00-000, 231, 200, 31, 17, 1348.06, 7, 1352.14, 197
3, 10:29:00-000, 221, 166, 55, 2, 1348.50, 3, 1352.00, 220
3, 10:30:00-000, 196, 125, 71, 13, 1346.46, 1, 1353.00, 191
3, 10:31:00-000, 168, 123, 45, 8, 1348.25, 11, 1351.54, 150
3, 10:32:00-000, 189, 124, 65, 5, 1348.60, 11, 1352.91, 173
3, 10:33:00-000, 212, 192, 20, 2, 1349.50, 5, 1352.40, 205
3, 10:34:00-000, 197, 177, 20, 10, 1349.00, 1, 1351.00, 187
3, 10:35:00-000, 211, 172, 39, 5, 1350.60, 6, 1351.67, 197
3, 10:36:00-000, 181, 122, 59, 10, 1350.10, 16, 1353.18, 154
3, 10:37:00-000, 210, 183, 27, 7, 1346.71, 9, 1351.22, 199
3, 10:38:00-000, 198, 158, 40, 4, 1347.25, 4, 1351.50, 186
3, 10:39:00-000, 175, 122, 53, 3, 1348.00, 0, 0.00, 174
3, 10:40:00-000, 210, 168, 42, 9, 1349.67, 13, 1352.15, 179
3, 10:41:00-000, 205, 163, 42, 8, 1348.25, 5, 1353.00, 200
3, 10:42:00-000, 214, 180, 34, 15, 1349.33, 13, 1351.15, 187
3, 10:43:00-000, 202, 112, 90, 4, 1349.25, 11, 1352.55, 185
3, 10:44:00-000, 211, 161, 50, 9, 1348.78, 10, 1350.50, 192
3, 10:45:00-000, 203, 147, 56, 10, 1347.60, 4, 1351.25, 186
3, 10:46:00-000, 184, 129, 55, 9, 1345.44, 8, 1350.00, 173
3, 10:47:00-000, 200, 133, 67, 5, 1348.60, 7, 1351.57, 189
3, 10:48:00-000, 244, 159, 85, 9, 1349.33, 23, 1351.13, 199
3, 10:49:00-000, 177, 141, 36, 8, 1350.25, 7, 1351.71, 170
3, 10:50:00-000, 196, 170, 26, 7, 1349.43, 6, 1352.17, 180
3, 10:51:00-000, 201, 188, 13, 0, 0.00, 6, 1352.83, 191
3, 10:52:00-000, 222, 213, 9, 13, 1349.61, 3, 1351.33, 210
3, 10:53:00-000, 212, 199, 13, 2, 1348.00, 1, 1350.00, 215
3, 10:54:00-000, 216, 178, 38, 13, 1348.54, 7, 1352.00, 196
3, 10:55:00-000, 212, 138, 74, 2, 1348.00, 10, 1350.90, 202
3, 10:56:00-000, 207, 142, 65, 13, 1347.54, 5, 1351.60, 185
3, 10:57:00-000, 213, 172, 41, 2, 1348.50, 5, 1351.40, 206
3, 10:58:00-000, 206, 180, 26, 9, 1349.44, 18, 1351.61, 175
3, 10:59:00-000, 231, 181, 50, 22, 1348.23, 3, 1350.67, 214
3, 11:00:00-000, 179, 83, 96, 5, 1348.20, 12, 1351.17, 153
3, 11:01:00-000, 201, 151, 50, 9, 1348.66, 18, 1350.50, 179
3, 11:02:00-000, 214, 177, 37, 7, 1347.14, 5, 1351.40, 197
3, 11:03:00-000, 172, 110, 62, 6, 1347.50, 7, 1351.00, 167
3, 11:04:00-000, 216, 145, 71, 30, 1348.80, 17, 1350.88, 167
3, 11:05:00-000, 197, 121, 76, 5, 1349.60, 8, 1350.75, 179
3, 11:06:00-000, 218, 141, 77, 1, 1349.00, 8, 1352.75, 212
3, 11:07:00-000, 216, 159, 57, 3, 1350.00, 11, 1352.27, 205
3, 11:08:00-000, 228, 159, 69, 22, 1349.54, 12, 1350.00, 194
3, 11:09:00-000, 210, 175, 35, 8, 1347.75, 16, 1350.50, 182
3, 11:10:00-000, 217, 186, 31, 15, 1349.13, 12, 1353.08, 194
3, 11:11:00-000, 155, 131, 24, 14, 1349.07, 11, 1351.45, 131
3, 11:12:00-000, 257, 218, 39, 7, 1348.57, 6, 1353.17, 243
3, 11:13:00-000, 190, 146, 44, 15, 1349.46, 13, 1353.46, 161
3, 11:14:00-000, 220, 152, 68, 19, 1349.36, 23, 1352.17, 181
3, 11:15:00-000, 213, 147, 66, 6, 1346.00, 3, 1350.00, 203
3, 11:16:00-000, 194, 136, 58, 3, 1348.00, 15, 1352.53, 175
3, 11:17:00-000, 216, 159, 57, 11, 1349.82, 20, 1352.45, 179
3, 11:18:00-000, 209, 181, 28, 12, 1349.33, 12, 1351.25, 190
3, 11:19:00-000, 210, 183, 27, 14, 1348.00, 7, 1351.29, 191
3, 11:20:00-000, 230, 195, 35, 12, 1346.08, 2, 1352.00, 208
3, 11:21:00-000, 186, 127, 59, 10, 1348.50, 6, 1350.17, 174
3, 11:22:00-000, 172, 113, 59, 4, 1347.25, 16, 1350.50, 155
3, 11:23:00-000, 233, 170, 63, 10, 1348.00, 4, 1354.00, 210
3, 11:24:00-000, 179, 160, 19, 15, 1350.60, 13, 1351.54, 159
3, 11:25:00-000, 180, 159, 21, 6, 1348.83, 10, 1351.40, 165
3, 11:26:00-000, 217, 195, 22, 7, 1350.14, 3, 1352.00, 199
3, 11:27:00-000, 201, 179, 22, 5, 1349.60, 12, 1352.08, 191
3, 11:28:00-000, 212, 175, 37, 17, 1351.41, 5, 1351.80, 190
3, 11:29:00-000, 205, 167, 38, 9, 1347.11, 1, 1350.00, 185
3, 11:30:00-000, 220, 144, 76, 12, 1349.50, 10, 1352.80, 207
3, 11:31:00-000, 197, 133, 64, 8, 1347.75, 15, 1352.07, 177
3, 11:32:00-000, 214, 157, 57, 15, 1347.80, 19, 1351.21, 180
3, 11:33:00-000, 184, 150, 34, 4, 1347.25, 1, 1352.00, 176
3, 11:34:00-000, 185, 136, 49, 6, 1347.17, 5, 1351.00, 170
3, 11:35:00-000, 196, 155, 41, 1, 1347.00, 5, 1351.60, 195
3, 11:36:00-000, 173, 146, 27, 10, 1349.90, 9, 1350.55, 152
3, 11:37:00-000, 187, 132, 55, 16, 1348.56, 4, 1349.75, 169
3, 11:38:00-000, 199, 163, 36, 13, 1348.92, 16, 1353.56, 171
3, 11:39:00-000, 219, 153, 66, 3, 1347.33, 2, 1350.50, 215
3, 11:40:00-000, 179, 95, 84, 8, 1349.25, 9, 1350.89, 155
3, 11:41:00-000, 215, 144, 71, 3, 1350.00, 7, 1351.00, 205
3, 11:42:00-000, 216, 163, 53, 9, 1348.55, 9, 1350.00, 196
3, 11:43:00-000, 190, 111, 79, 10, 1349.70, 20, 1352.90, 167
3, 11:44:00-000, 196, 169, 27, 13, 1351.77, 8, 1354.00, 177
3, 11:45:00-000, 208, 140, 68, 6, 1346.50, 0, 0.00, 195
3, 11:46:00-000, 214, 160, 54, 2, 1346.00, 12, 1351.00, 201
3, 11:47:00-000, 201, 132, 69, 10, 1348.90, 4, 1350.50, 193
3, 11:48:00-000, 184, 140, 44, 7, 1346.43, 12, 1351.08, 156
3, 11:49:00-000, 213, 195, 18, 4, 1347.75, 6, 1351.17, 211
3, 11:50:00-000, 184, 160, 24, 17, 1348.94, 5, 1352.00, 158
3, 11:51:00-000, 177, 124, 53, 8, 1347.75, 19, 1351.63, 150
3, 11:52:00-000, 192, 135, 57, 19, 1347.63, 7, 1351.14, 167
3, 11:53:00-000, 199, 139, 60, 1, 1345.00, 8, 1350.25, 191
3, 11:54:00-000, 236, 154, 82, 19, 1347.10, 22, 1350.82, 195
3, 11:55:00-000, 203, 151, 52, 6, 1349.00, 5, 1353.00, 182
3, 11:56:00-000, 167, 125, 42, 1, 1346.00, 9, 1351.11, 160
3, 11:57:00-000, 224, 172, 52, 20, 1350.25, 10, 1353.50, 198
3, 11:58:00-000, 193, 157, 36, 9, 1347.56, 8, 1350.62, 172
3, 11:59:00-000, 201, 155, 46, 4, 1351.50, 9, 1351.89, 195
3, 12:00:00-000, 202, 151, 51, 6, 1348.00, 6, 1350.50, 189
3, 12:01:00-000, 201, 168, 33, 5, 1349.20, 12, 1351.58, 182
3, 12:02:00-000, 230, 222, 8, 6, 1348.17, 1, 1354.00, 226
3, 12:03:00-000, 203, 166, 37, 7, 1347.57, 8, 1350.12, 182
3, 12:04:00-000, 220, 179, 41, 22, 1349.22, 12, 1351.33, 193
3, 12:05:00-000, 195, 151, 44, 16, 1347.44, 10, 1350.90, 172
3, 12:06:00-000, 223, 156, 67, 5, 1348.80, 8, 1351.00, 205
3, 12:07:00-000, 232, 174, 58, 7, 1348.00, 3, 1346.00, 226
3, 12:08:00-000, 197, 124, 73, 8, 1346.12, 10, 1350.80, 176
3, 12:09:00-000, 233, 187, 46, 2, 1347.00, 12, 1350.58, 214
3, 12:10:00-000, 210, 161, 49, 12, 1346.50, 8, 1351.88, 191
3, 12:11:00-000, 226, 165, 61, 4, 1349.50, 6, 1350.00, 218
3, 12:12:00-000, 206, 132, 74, 9, 1347.22, 10, 1350.90, 189
3, 12:13:00-000, 202, 142, 60, 10, 1346.20, 2, 1350.00, 191
3, 12:14:00-000, 203, 101, 102, 18, 1347.94, 13, 1350.54, 167
3, 12:15:00-000, 193, 112, 81, 5, 1348.60, 4, 1351.00, 191
3, 12:16:00-000, 190, 127, 63, 11, 1351.00, 14, 1350.64, 163
3, 12:17:00-000, 242, 150, 92, 14, 1348.43, 5, 1350.40, 221
3, 12:18:00-000, 222, 124, 98, 28, 1348.92, 22, 1351.41, 173
3, 12:19:00-000, 196, 116, 80, 2, 1348.00, 5, 1351.60, 191
3, 12:20:00-000, 192, 110, 82, 14, 1348.29, 11, 1350.45, 163
3, 12:21:00-000, 208, 144, 64, 1, 1345.00, 9, 1350.22, 196
3, 12:22:00-000, 211, 126, 85, 9, 1347.56, 3, 1350.67, 207
3, 12:23:00-000, 185, 95, 90, 2, 1348.00, 8, 1351.87, 161
3, 12:24:00-000, 251, 74, 177, 12, 1349.08, 5, 1352.40, 236
3, 12:25:00-000, 198, 110, 88, 2, 1347.00, 4, 1350.50, 194
3, 12:26:00-000, 191, 94, 97, 6, 1348.17, 20, 1350.45, 160
3, 12:27:00-000, 232, 181, 51, 0, 0.00, 15, 1351.40, 231
3, 12:28:00-000, 238, 202, 36, 10, 1348.00, 10, 1351.70, 212
3, 12:29:00-000, 242, 198, 44, 11, 1348.00, 5, 1353.40, 214
3, 12:30:00-000, 177, 133, 44, 10, 1347.10, 12, 1350.67, 174
3, 12:31:00-000, 196, 134, 62, 7, 1346.14, 2, 1350.50, 182
3, 12:32:00-000, 189, 129, 60, 13, 1349.15, 10, 1351.10, 168
3, 12:33:00-000, 178, 138, 40, 9, 1349.89, 17, 1352.53, 152
3, 12:34:00-000, 186, 143, 43, 12, 1349.58, 14, 1351.78, 161
3, 12:35:00-000, 200, 166, 34, 9, 1351.44, 1, 1355.00, 186
3, 12:36:00-000, 216, 186, 30, 6, 1348.17, 9, 1351.33, 205
3, 12:37:00-000, 184, 141, 43, 7, 1347.57, 4, 1351.50, 168
3, 12:38:00-000, 192, 149, 43, 20, 1347.30, 12, 1351.25, 160
3, 12:39:00-000, 185, 115, 70, 2, 1348.00, 6, 1349.33, 182
3, 12:40:00-000, 171, 105, 66, 14, 1347.21, 14, 1351.00, 142
3, 12:41:00-000, 201, 141, 60, 5, 1349.40, 12, 1350.58, 179
3, 12:42:00-000, 173, 144, 29, 9, 1349.33, 6, 1350.83, 160
3, 12:43:00-000, 221, 185, 36, 0, 0.00, 21, 1349.95, 198
3, 12:44:00-000, 206, 157, 49, 20, 1347.55, 3, 1350.33, 187
3, 12:45:00-000, 188, 142, 46, 5, 1347.40, 9, 1351.44, 169
3, 12:46:00-000, 224, 193, 31, 9, 1349.66, 13, 1352.23, 207
3, 12:47:00-000, 225, 184, 41, 19, 1349.37, 20, 1352.50, 190
3, 12:48:00-000, 256, 185, 71, 17, 1349.17, 7, 1351.28, 225
3, 12:49:00-000, 217, 152, 65, 16, 1352.00, 12, 1352.16, 188
3, 12:50:00-000, 211, 162, 49, 19, 1349.95, 14, 1351.93, 183
3, 12:51:00-000, 213, 148, 65, 9, 1349.00, 3, 1350.67, 194
3, 12:52:00-000, 217, 159, 58, 8, 1349.50, 12, 1350.75, 199
3, 12:53:00-000, 212, 175, 37, 14, 1347.50, 11, 1351.36, 195
3, 12:54:00-000, 192, 123, 69, 15, 1347.93, 31, 1351.19, 144
3, 12:55:00-000, 189, 134, 55, 14, 1349.21, 2, 1351.00, 174
3, 12:56:00-000, 250, 148, 102, 5, 1346.00, 37, 1350.65, 204
3, 12:57:00-000, 215, 208, 7, 10, 1348.70, 4, 1351.00, 197
3, 12:58:00-000, 188, 145, 43, 29, 1348.72, 9, 1351.44, 144
3, 12:59:00-000, 174, 130, 44, 5, 1347.60, 2, 1351.00, 172
3, 13:00:00-000, 176, 139, 37, 14, 1349.50, 16, 1351.12, 140
3, 13:01:00-000, 204, 146, 58, 4, 1349.50, 12, 1351.92, 197
3, 13:02:00-000, 189, 119, 70, 19, 1349.68, 4, 1350.25, 169
3, 13:03:00-000, 179, 104, 75, 1, 1347.00, 14, 1351.71, 164
3, 13:04:00-000, 217, 170, 47, 12, 1346.92, 17, 1350.76, 188
3, 13:05:00-000, 199, 170, 29, 5, 1349.60, 7, 1351.71, 187
3, 13:06:00-000, 194, 129, 65, 15, 1349.33, 2, 1350.50, 175
3, 13:07:00-000, 189, 139, 50, 5, 1351.60, 9, 1351.78, 178
3, 13:08:00-000, 190, 146, 44, 5, 1348.00, 4, 1352.00, 182
3, 13:09:00-000, 204, 109, 95, 14, 1348.50, 0, 0.00, 188
3, 13:10:00-000, 198, 102, 96, 10, 1346.30, 10, 1350.40, 180
3, 13:11:00-000, 245, 152, 93, 3, 1349.00, 16, 1352.06, 228
3, 13:12:00-000, 208, 99, 109, 18, 1348.28, 15, 1350.60, 175
3, 13:13:00-000, 217, 164, 53, 8, 1350.38, 27, 1351.81, 177
3, 13:14:00-000, 225, 188, 37, 21, 1352.14, 18, 1352.11, 184
3, 13:15:00-000, 204, 161, 43, 2, 1349.50, 5, 1350.80, 197
3, 13:16:00-000, 202, 180, 22, 8, 1347.50, 10, 1351.70, 189
3, 13:17:00-000, 213, 194, 19, 26, 1349.96, 9, 1351.89, 179
3, 13:18:00-000, 194, 149, 45, 5, 1348.60, 1, 1350.00, 187
3, 13:19:00-000, 223, 166, 57, 4, 1348.00, 5, 1349.20, 209
3, 13:20:00-000, 195, 147, 48, 12, 1349.17, 4, 1350.25, 185
3, 13:21:00-000, 168, 111, 57, 5, 1348.00, 13, 1350.69, 150
3, 13:22:00-000, 190, 118, 72, 11, 1347.82, 12, 1351.58, 166
3, 13:23:00-000, 223, 165, 58, 4, 1349.25, 6, 1351.83, 213
3, 13:24:00-000, 202, 123, 79, 17, 1349.35, 4, 1352.00, 180
3, 13:25:00-000, 205, 129, 76, 14, 1350.07, 8, 1350.62, 178
3, 13:26:00-000, 213, 134, 79, 16, 1348.31, 23, 1352.43, 172
3, 13:27:00-000, 215, 129, 86, 8, 1349.25, 11, 1352.27, 187
3, 13:28:00-000, 229, 117, 112, 13, 1347.38, 9, 1350.33, 225
3, 13:29:00-000, 197, 98, 99, 11, 1347.64, 3, 1351.00, 177
3, 13:30:00-000, 199, 132, 67, 11, 1349.91, 31, 1352.67, 162
3, 13:31:00-000, 199, 130, 69, 4, 1344.75, 7, 1350.00, 189
3, 13:32:00-000, 198, 142, 56, 13, 1347.54, 28, 1351.18, 157
3, 13:33:00-000, 211, 180, 31, 11, 1348.27, 2, 1351.00, 192
3, 13:34:00-000, 196, 119, 77, 14, 1348.57, 9, 1351.33, 175
3, 13:35:00-000, 199, 140, 59, 2, 1347.00, 1, 1350.00, 195
3, 13:36:00-000, 207, 142, 65, 4, 1347.50, 22, 1351.68, 180
3, 13:37:00-000, 226, 179, 47, 19, 1350.47, 12, 1351.67, 198
3, 13:38:00-000, 204, 162, 42, 5, 1348.20, 8, 1350.50, 186
3, 13:39:00-000, 205, 161, 44, 6, 1350.33, 9, 1351.89, 192
3, 13:40:00-000, 191, 166, 25, 12, 1348.91, 6, 1351.67, 172
3, 13:41:00-000, 185, 112, 73, 17, 1347.53, 4, 1350.25, 164
3, 13:42:00-000, 211, 142, 69, 5, 1347.40, 14, 1351.36, 198
3, 13:43:00-000, 203, 164, 39, 17, 1347.23, 13, 1351.08, 175
3, 13:44:00-000, 211, 169, 42, 4, 1347.00, 9, 1350.55, 186
3, 13:45:00-000, 211, 157, 54, 19, 1350.63, 16, 1352.50, 172
3, 13:46:00-000, 204, 172, 32, 11, 1351.82, 5, 1352.20, 202
3, 13:47:00-000, 203, 126, 77, 9, 1348.00, 3, 1351.00, 185
3, 13:48:00-000, 209, 138, 71, 13, 1345.54, 14, 1351.57, 180
3, 13:49:00-000, 213, 158, 55, 11, 1350.54, 4, 1353.75, 207
3, 13:50:00-000, 203, 153, 50, 2, 1349.50, 5, 1351.00, 196
3, 13:51:00-000, 214, 151, 63, 7, 1347.71, 17, 1352.11, 184
3, 13:52:00-000, 183, 138, 45, 14, 1348.50, 10, 1351.60, 165
3, 13:53:00-000, 188, 116, 72, 11, 1348.64, 14, 1351.36, 159
3, 13:54:00-000, 203, 133, 70, 17, 1348.82, 14, 1351.43, 167
3, 13:55:00-000, 183, 128, 55, 1, 1346.00, 12, 1350.58, 177
3, 13:56:00-000, 170, 139, 31, 16, 1349.18, 12, 1351.83, 144
3, 13:57:00-000, 188, 153, 35, 5, 1347.40, 3, 1350.00, 171
3, 13:58:00-000, 210, 168, 42, 6, 1347.83, 10, 1351.80, 203
3, 13:59:00-000, 177, 166, 11, 5, 1349.00, 0, 0.00, 173
3, 14:00:00-000, 191, 166, 25, 9, 1350.55, 12, 1352.00, 170
3, 14:01:00-000, 246, 193, 53, 12, 1348.58, 4, 1350.75, 228
3, 14:02:00-000, 202, 114, 88, 8, 1348.50, 14, 1350.93, 176
3, 14:03:00-000, 211, 150, 61, 18, 1347.44, 4, 1350.50, 194
3, 14:04:00-000, 183, 93, 90, 6, 1349.50, 10, 1351.20, 161
3, 14:05:00-000, 224, 135, 89, 4, 1348.75, 4, 1350.00, 222
3, 14:06:00-000, 219, 159, 60, 20, 1348.60, 20, 1351.25, 179
3, 14:07:00-000, 211, 134, 77, 11, 1345.73, 6, 1351.17, 192
3, 14:08:00-000, 197, 147, 50, 14, 1347.71, 11, 1351.00, 173
3, 14:09:00-000, 196, 112, 84, 16, 1349.00, 17, 1350.82, 161
3, 14:10:00-000, 212, 161, 51, 5, 1350.00, 11, 1351.82, 193
3, 14:11:00-000, 204, 156, 48, 3, 1349.67, 8, 1350.50, 196
3, 14:12:00-000, 196, 137, 59, 18, 1347.61, 16, 1350.68, 155
3, 14:13:00-000, 181, 105, 76, 16, 1347.50, 10, 1350.50, 166
3, 14:14:00-000, 186, 99, 87, 18, 1348.61, 14, 1351.57, 154
3, 14:15:00-000, 211, 124, 87, 1, 1347.00, 5, 1351.40, 201
3, 14:16:00-000, 212, 143, 69, 22, 1347.32, 34, 1351.85, 158
3, 14:17:00-000, 212, 167, 45, 11, 1346.91, 11, 1350.73, 186
3, 14:18:00-000, 211, 164, 47, 16, 1348.37, 10, 1352.30, 183
3, 14:19:00-000, 197, 128, 69, 6, 1345.00, 3, 1351.00, 189
3, 14:20:00-000, 163, 92, 71, 9, 1349.11, 16, 1351.81, 145
3, 14:21:00-000, 195, 133, 62, 5, 1347.20, 12, 1351.75, 177
3, 14:22:00-000, 231, 175, 56, 19, 1349.31, 15, 1351.93, 196
3, 14:23:00-000, 178, 151, 27, 3, 1347.67, 6, 1351.33, 171
3, 14:24:00-000, 192, 104, 88, 32, 1349.68, 4, 1352.75, 147
3, 14:25:00-000, 201, 67, 134, 3, 1347.00, 6, 1350.33, 194
3, 14:26:00-000, 197, 80, 117, 9, 1348.11, 20, 1351.10, 171
3, 14:27:00-000, 208, 123, 85, 6, 1347.50, 20, 1352.25, 171
3, 14:28:00-000, 200, 158, 42, 13, 1349.46, 15, 1349.80, 186
3, 14:29:00-000, 192, 156, 36, 4, 1346.50, 12, 1351.50, 171
3, 14:30:00-000, 205, 132, 73, 25, 1348.00, 12, 1350.91, 174
3, 14:31:00-000, 185, 121, 64, 11, 1348.91, 18, 1352.94, 155
3, 14:32:00-000, 217, 140, 77, 15, 1348.33, 14, 1351.43, 177
3, 14:33:00-000, 189, 148, 41, 2, 1348.50, 19, 1350.58, 179
3, 14:34:00-000, 217, 202, 15, 17, 1349.88, 3, 1353.33, 191
3, 14:35:00-000, 181, 143, 38, 9, 1347.89, 10, 1352.50, 163
3, 14:36:00-000, 221, 172, 49, 26, 1348.65, 11, 1351.09, 186
3, 14:37:00-000, 156, 109, 47, 8, 1349.12, 16, 1350.94, 133
3, 14:38:00-000, 194, 151, 43, 2, 1348.00, 1, 1351.00, 185
3, 14:39:00-000, 205, 179, 26, 6, 1349.00, 3, 1350.33, 191
3, 14:40:00-000, 192, 172, 20, 22, 1353.91, 7, 1353.00, 176
3, 14:41:00-000, 200, 148, 52, 5, 1348.20, 13, 1351.07, 180
3, 14:42:00-000, 204, 131, 73, 9, 1348.67, 13, 1350.46, 178
3, 14:43:00-000, 207, 162, 45, 9, 1350.00, 18, 1351.89, 187
3, 14:44:00-000, 205, 144, 61, 17, 1347.41, 7, 1351.29, 179
3, 14:45:00-000, 188, 139, 49, 8, 1347.50, 12, 1351.00, 163
3, 14:46:00-000, 231, 145, 86, 21, 1349.43, 5, 1351.20, 211
3, 14:47:00-000, 174, 79, 95, 4, 1349.50, 10, 1351.00, 152
3, 14:48:00-000, 194, 90, 104, 12, 1346.50, 16, 1351.12, 167
3, 14:49:00-000, 189, 111, 78, 9, 1346.11, 9, 1350.00, 173
3, 14:50:00-000, 200, 137, 63, 6, 1347.00, 8, 1350.12, 190
3, 14:51:00-000, 190, 132, 58, 6, 1347.17, 12, 1351.25, 174
3, 14:52:00-000, 182, 115, 67, 18, 1348.27, 5, 1351.40, 159
3, 14:53:00-000, 181, 81, 100, 11, 1347.91, 12, 1352.00, 147
3, 14:54:00-000, 207, 123, 84, 14, 1348.00, 10, 1350.30, 188
3, 14:55:00-000, 181, 108, 73, 5, 1349.00, 16, 1351.25, 165
3, 14:56:00-000, 196, 109, 87, 14, 1347.57, 13, 1350.31, 162
3, 14:57:00-000, 210, 116, 94, 9, 1347.22, 24, 1351.20, 183
3, 14:58:00-000, 205, 160, 45, 19, 1348.42, 6, 1349.00, 179
3, 14:59:00-000, 195, 121, 74, 3, 1346.33, 2, 1351.50, 189
3, 15:00:00-000, 165, 117, 48, 12, 1348.42, 11, 1350.82, 143
3, 15:01:00-000, 230, 153, 77, 13, 1349.31, 9, 1350.67, 204
3, 15:02:00-000, 197, 141, 56, 17, 1349.88, 18, 1352.50, 166
3, 15:03:00-000, 204, 136, 68, 3, 1347.00, 4, 1350.00, 197
3, 15:04:00-000, 207, 137, 70, 21, 1349.67, 10, 1351.50, 172
3, 15:05:00-000, 177, 95, 82, 10, 1347.50, 16, 1350.81, 154
3, 15:06:00-000, 171, 113, 58, 9, 1347.78, 16, 1352.31, 150
3, 15:07:00-000, 220, 114, 106, 2, 1347.00, 13, 1350.38, 196
3, 15:08:00-000, 222, 144, 78, 9, 1347.33, 12, 1353.33, 205
3, 15:09:00-000, 172, 125, 47, 10, 1349.20, 14, 1352.00, 152
3, 15:10:00-000, 225, 159, 66, 28, 1347.74, 2, 1351.50, 193
3, 15:11:00-000, 203, 113, 90, 6, 1348.00, 9, 1350.89, 189
3, 15:12:00-000, 204, 89, 115, 11, 1346.73, 9, 1351.33, 183
3, 15:13:00-000, 192, 110, 82, 1, 1348.00, 11, 1351.45, 182
3, 15:14:00-000, 201, 160, 41, 7, 1348.43, 9, 1350.89, 186
3, 15:15:00-000, 203, 167, 36, 7, 1349.00, 7, 1350.71, 181
3, 15:16:00-000, 234, 207, 27, 15, 1349.60, 8, 1351.87, 216
3, 15:17:00-000, 201, 159, 42, 11, 1348.27, 9, 1352.89, 180
3, 15:18:00-000, 212, 112, 100, 11, 1349.45, 10, 1351.20, 193
3, 15:19:00-000, 247, 146, 101, 8, 1348.37, 5, 1349.20, 227
3, 15:20:00-000, 202, 112, 90, 11, 1347.91, 15, 1351.13, 178
3, 15:21:00-000, 183, 98, 85, 13, 1348.15, 1, 1347.00, 171
3, 15:22:00-000, 183, 104, 79, 11, 1348.82, 22, 1350.63, 150
3, 15:23:00-000, 173, 122, 51, 9, 1349.00, 13, 1352.23, 155
3, 15:24:00-000, 216, 189, 27, 2, 1353.00, 3, 1350.33, 203
3, 15:25:00-000, 212, 169, 43, 12, 1349.08, 6, 1352.50, 201
3, 15:26:00-000, 176, 120, 56, 7, 1347.86, 10, 1351.30, 160
3, 15:27:00-000, 214, 179, 35, 14, 1351.28, 8, 1352.00, 192
3, 15:28:00-000, 191, 86, 105, 35, 1349.02, 12, 1351.42, 144
3, 15:29:00-000, 161, 40, 121, 5, 1348.20, 18, 1351.78, 138
3, 15:30:00-000, 196, 107, 89, 11, 1348.54, 21, 1350.76, 161
3, 15:31:00-000, 201, 128, 73, 8, 1350.13, 22, 1351.36, 167
3, 15:32:00-000, 188, 166, 22, 2, 1349.50, 9, 1351.44, 184
3, 15:33:00-000, 190, 165, 25, 7, 1348.43, 7, 1352.43, 169
3, 15:34:00-000, 215, 147, 68, 13, 1348.92, 18, 1351.61, 188
3, 15:35:00-000, 198, 184, 14, 5, 1349.60, 3, 1351.00, 188
3, 15:36:00-000, 201, 157, 44, 29, 1346.51, 8, 1351.50, 165
3, 15:37:00-000, 222, 153, 69, 12, 1348.58, 20, 1350.20, 191
3, 15:38:00-000, 216, 172, 44, 14, 1351.21, 17, 1352.23, 184
3, 15:39:00-000, 203, 169, 34, 16, 1349.19, 14, 1351.21, 163
3, 15:40:00-000, 222, 81, 141, 25, 1346.84, 10, 1351.30, 186
3, 15:41:00-000, 188, 110, 78, 5, 1349.80, 11, 1350.82, 177
3, 15:42:00-000, 200, 133, 67, 10, 1348.70, 10, 1350.50, 189
3, 15:43:00-000, 228, 154, 74, 2, 1353.00, 7, 1352.43, 220
3, 15:44:00-000, 218, 158, 60, 4, 1348.50, 20, 1352.25, 190
3, 15:45:00-000, 205, 166, 39, 10, 1347.50, 5, 1350.00, 191
3, 15:46:00-000, 223, 171, 52, 7, 1348.00, 13, 1350.61, 205
3, 15:47:00-000, 192, 172, 20, 11, 1349.82, 0, 0.00, 179
3, 15:48:00-000, 207, 161, 46, 11, 1349.64, 9, 1351.78, 190
3, 15:49:00-000, 173, 145, 28, 9, 1348.56, 8, 1351.00, 155
3, 15:50:00-000, 194, 146, 48, 18, 1348.17, 8, 1350.37, 165
3, 15:51:00-000, 188, 127, 61, 10, 1348.40, 3, 1349.33, 178
3, 15:52:00-000, 211, 126, 85, 10, 1347.50, 26, 1350.57, 175
3, 15:53:00-000, 222, 162, 60, 16, 1350.69, 17, 1351.06, 189
3, 15:54:00-000, 207, 179, 28, 9, 1347.89, 8, 1351.50, 189
3, 15:55:00-000, 200, 185, 15, 1, 1349.00, 6, 1351.33, 187
3, 15:56:00-000, 205, 144, 61, 19, 1349.47, 13, 1351.23, 162
3, 15:57:00-000, 187, 139, 48, 12, 1348.75, 6, 1350.83, 189
3, 15:58:00-000, 174, 108, 66, 22, 1347.31, 19, 1351.16, 133
3, 15:59:00-000, 203, 132, 71, 13, 1348.85, 8, 1350.37, 181
3, 16:00:00-000, 186, 119, 67, 4, 1347.75, 7, 1350.29, 174
3, 16:01:00-000, 231, 138, 93, 10, 1347.30, 23, 1350.43, 191
3, 16:02:00-000, 177, 132, 45, 5, 1348.60, 9, 1350.33, 158
3, 16:03:00-000, 182, 128, 54, 10, 1347.40, 11, 1351.09, 169
3, 16:04:00-000, 197, 121, 76, 26, 1348.84, 16, 1351.31, 161
3, 16:05:00-000, 190, 131, 59, 5, 1352.80, 6, 1354.83, 179
3, 16:06:00-000, 168, 132, 36, 9, 1347.67, 14, 1351.78, 142
3, 16:07:00-000, 180, 140, 40, 8, 1350.37, 8, 1351.12, 166
3, 16:08:00-000, 193, 150, 43, 18, 1348.78, 22, 1352.45, 152
3, 16:09:00-000, 184, 149, 35, 4, 1348.50, 8, 1351.62, 174
3, 16:10:00-000, 200, 168, 32, 12, 1347.25, 3, 1351.33, 181
3, 16:11:00-000, 183, 140, 43, 2, 1348.00, 3, 1350.67, 181
3, 16:12:00-000, 205, 149, 56, 6, 1348.17, 6, 1351.00, 192
3, 16:13:00-000, 183, 129, 54, 21, 1346.71, 7, 1350.57, 152
3, 16:14:00-000, 185, 130, 55, 18, 1350.11, 26, 1351.61, 145
3, 16:15:00-000, 192, 149, 43, 13, 1350.46, 8, 1350.25, 158
3, 16:16:00-000, 179, 100, 79, 23, 1348.86, 19, 1351.21, 141
3, 16:17:00-000, 219, 126, 93, 15, 1346.93, 13, 1350.85, 201
3, 16:18:00-000, 182, 108, 74, 19, 1348.63, 21, 1351.85, 137
3, 16:19:00-000, 163, 60, 103, 5, 1347.40, 8, 1350.50, 153
3, 16:20:00-000, 184, 124, 60, 1, 1346.00, 16, 1351.43, 168
3, 16:21:00-000, 227, 174, 53, 17, 1349.17, 19, 1351.42, 183
3, 16:22:00-000, 193, 122, 71, 16, 1347.87, 7, 1351.57, 175
3, 16:23:00-000, 223, 142, 81, 11, 1349.54, 15, 1351.73, 200
3, 16:24:00-000, 203, 175, 28, 10, 1349.10, 13, 1350.38, 173
3, 16:25:00-000, 205, 146, 59, 14, 1348.00, 15, 1352.33, 180
3, 16:26:00-000, 174, 141, 33, 12, 1349.83, 13, 1352.61, 149
3, 16:27:00-000, 168, 137, 31, 16, 1348.75, 10, 1350.90, 142
3, 16:28:00-000, 219, 158, 61, 29, 1348.55, 20, 1352.15, 169
3, 16:29:00-000, 188, 131, 57, 12, 1349.25, 19, 1352.58, 157
4, 09:03:00-000, 270, 270, 0, 0, 0.00, 0, 0.00, 268
4, 09:04:00-000, 0, 0, 0, 0, 0.00, 0, 0.00, 2
4, 09:06:00-000, 280, 280, 0, 278, 1351.00, 0, 0.00, 0
4, 09:07:00-000, 3, 3, 0, 2, 1351.00, 0, 0.00, 3
4, 09:08:00-000, 32, 28, 4, 4, 1351.50, 4, 1351.50, 10
4, 09:09:00-000, 86, 70, 16, 16, 1365.06, 16, 1365.06, 47
4, 09:10:00-000, 122, 96, 26, 25, 1410.79, 25, 1410.79, 76
4, 09:11:00-000, 90, 70, 20, 21, 1452.28, 21, 1452.28, 47
4, 09:12:00-000, 78, 66, 12, 12, 1481.25, 12, 1481.25, 39
4, 09:13:00-000, 103, 87, 16, 72, 1414.51, 16, 1459.62, 48
4, 09:14:00-000, 64, 49, 15, 39, 1355.28, 13, 1354.00, 7
4, 09:15:00-000, 95, 71, 24, 58, 1355.95, 19, 1354.47, 14
4, 09:16:00-000, 92, 53, 39, 48, 1356.72, 37, 1356.37, 5
4, 09:17:00-000, 80, 55, 25, 31, 1358.93, 28, 1357.92, 15
4, 09:18:00-000, 98, 59, 39, 56, 1371.69, 31, 1375.70, 7
4, 09:19:00-000, 69, 34, 35, 34, 1352.73, 39, 1352.07, 14
4, 09:20:00-000, 111, 65, 46, 60, 1351.60, 49, 1351.54, 0
4, 09:21:00-000, 74, 40, 34, 34, 1352.46, 25, 1351.64, 4
4, 09:22:00-000, 75, 36, 39, 43, 1350.76, 45, 1351.03, 1
4, 09:23:00-000, 78, 36, 42, 36, 1351.69, 31, 1350.74, 7
4, 09:24:00-000, 66, 34, 32, 31, 1352.32, 36, 1351.47, 0
4, 09:25:00-000, 83, 32, 51, 34, 1351.43, 39, 1351.30, 3
4, 09:26:00-000, 96, 27, 69, 28, 1352.10, 62, 1351.44, 9
4, 09:27:00-000, 85, 34, 51, 34, 1350.29, 39, 1350.15, 16
4, 09:28:00-000, 102, 54, 48, 50, 1353.03, 45, 1352.99, 3
4, 09:29:00-000, 91, 48, 43, 40, 1351.84, 36, 1353.02, 8
4, 09:30:00-000, 80, 33, 47, 42, 1350.37, 54, 1350.07, 0
4, 09:31:00-000, 74, 47, 27, 36, 1352.30, 23, 1352.86, 11
4, 09:32:00-000, 67, 35, 32, 31, 1354.00, 32, 1354.40, 1
4, 09:33:00-000, 91, 50, 41, 47, 1352.37, 43, 1351.80, 4
4, 09:34:00-000, 113, 72, 41, 68, 1351.94, 37, 1351.45, 4
4, 09:35:00-000, 82, 45, 37, 42, 1351.04, 41, 1351.45, 6
4, 09:36:00-000, 73, 30, 43, 25, 1349.71, 35, 1350.05, 6
4, 09:37:00-000, 86, 54, 32, 48, 1352.43, 31, 1352.03, 7
4, 09:38:00-000, 87, 43, 44, 42, 1351.33, 37, 1351.97, 14
4, 09:39:00-000, 57, 19, 38, 19, 1350.31, 24, 1351.74, 9
4, 09:40:00-000, 76, 43, 33, 39, 1352.79, 35, 1352.79, 1
4, 09:41:00-000, 72, 36, 36, 39, 1352.76, 35, 1353.17, 3
4, 09:42:00-000, 78, 31, 47, 31, 1350.51, 38, 1350.15, 4
4, 09:43:00-000, 84, 40, 44, 36, 1349.96, 36, 1349.77, 11
4, 09:44:00-000, 96, 37, 59, 32, 1351.59, 46, 1352.14, 18
4, 09:45:00-000, 71, 36, 35, 34, 1351.11, 26, 1351.07, 13
4, 09:46:00-000, 86, 47, 39, 40, 1351.52, 43, 1351.43, 6
4, 09:47:00-000, 101, 37, 64, 40, 1350.29, 61, 1350.02, 4
4, 09:48:00-000, 80, 52, 28, 42, 1352.44, 23, 1352.60, 7
4, 09:49:00-000, 84, 39, 45, 33, 1351.48, 38, 1352.18, 11
4, 09:50:00-000, 97, 49, 48, 56, 1351.18, 46, 1351.12, 0
4, 09:51:00-000, 92, 52, 40, 47, 1350.63, 42, 1350.73, 2
4, 09:52:00-000, 67, 38, 29, 42, 1354.23, 20, 1353.40, 6
4, 09:53:00-000, 79, 42, 37, 39, 1352.61, 34, 1351.64, 9
4, 09:54:00-000, 61, 31, 30, 24, 1349.33, 20, 1349.85, 1
4, 09:55:00-000, 83, 38, 45, 32, 1349.43, 41, 1349.48, 22
4, 09:56:00-000, 112, 40, 72, 44, 1350.24, 59, 1350.38, 7
4, 09:57:00-000, 76, 31, 45, 31, 1351.25, 35, 1350.82, 12
4, 09:58:00-000, 76, 27, 49, 27, 1352.59, 36, 1352.44, 12
4, 09:59:00-000, 87, 40, 47, 37, 1351.37, 40, 1351.57, 16
4, 10:00:00-000, 117, 65, 52, 59, 1352.14, 48, 1352.26, 3
4, 10:01:00-000, 71, 27, 44, 25, 1350.76, 25, 1349.68, 15
4, 10:02:00-000, 88, 42, 46, 41, 1352.48, 42, 1351.80, 6
4, 10:03:00-000, 83, 44, 39, 41, 1350.72, 32, 1350.09, 18
4, 10:04:00-000, 84, 30, 54, 31, 1349.96, 44, 1348.85, 8
4, 10:05:00-000, 91, 53, 38, 47, 1353.04, 33, 1351.69, 11
4, 10:06:00-000, 93, 39, 54, 37, 1352.37, 46, 1351.99, 13
4, 10:07:00-000, 50, 20, 30, 19, 1351.73, 21, 1352.52, 6
4, 10:08:00-000, 115, 53, 62, 44, 1351.61, 51, 1351.91, 5
4, 10:09:00-000, 82, 50, 32, 43, 1353.25, 32, 1352.53, 14
4, 10:10:00-000, 97, 42, 55, 51, 1350.37, 52, 1349.86, 2
4, 10:11:00-000, 105, 50, 55, 49, 1350.75, 44, 1350.67, 6
4, 10:12:00-000, 92, 37, 55, 32, 1349.84, 51, 1349.32, 13
4, 10:13:00-000, 92, 46, 46, 45, 1352.32, 42, 1352.56, 5
4, 10:14:00-000, 57, 27, 30, 24, 1350.37, 25, 1350.92, 12
4, 10:15:00-000, 98, 43, 55, 40, 1349.29, 53, 1349.59, 2
4, 10:16:00-000, 106, 65, 41, 61, 1350.12, 40, 1349.92, 12
4, 10:17:00-000, 70, 24, 46, 21, 1349.57, 35, 1350.96, 5
4, 10:18:00-000, 71, 36, 35, 36, 1349.63, 40, 1350.39, 5
4, 10:19:00-000, 81, 28, 53, 23, 1349.95, 22, 1349.77, 13
4, 10:20:00-000, 71, 41, 30, 37, 1350.18, 40, 1350.87, 9
4, 10:21:00-000, 102, 49, 53, 48, 1350.03, 43, 1350.27, 7
4, 10:22:00-000, 107, 51, 56, 52, 1349.72, 50, 1350.37, 15
4, 10:23:00-000, 79, 41, 38, 37, 1351.05, 31, 1351.22, 10
4, 10:24:00-000, 89, 47, 42, 42, 1349.30, 40, 1349.77, 9
4, 10:25:00-000, 62, 32, 30, 30, 1350.53, 30, 1350.56, 3
4, 10:26:00-000, 98, 47, 51, 38, 1348.73, 47, 1349.39, 4
4, 10:27:00-000, 69, 36, 33, 36, 1351.77, 32, 1351.87, 7
4, 10:28:00-000, 83, 46, 37, 45, 1352.10, 30, 1351.73, 0
4, 10:29:00-000, 116, 54, 62, 55, 1349.76, 56, 1349.51, 6
4, 10:30:00-000, 70, 21, 49, 21, 1350.85, 46, 1350.43, 7
4, 10:31:00-000, 89, 47, 42, 44, 1351.44, 37, 1351.78, 8
4, 10:32:00-000, 76, 26, 50, 28, 1350.21, 28, 1349.35, 14
4, 10:33:00-000, 99, 64, 35, 52, 1354.68, 34, 1352.46, 23
4, 10:34:00-000, 76, 32, 44, 24, 1348.91, 30, 1349.36, 13
4, 10:35:00-000, 81, 35, 46, 33, 1351.09, 34, 1351.35, 10
4, 10:36:00-000, 83, 47, 36, 41, 1353.36, 27, 1352.92, 26
4, 10:37:00-000, 83, 42, 41, 42, 1351.99, 36, 1350.55, 4
4, 10:38:00-000, 88, 34, 54, 30, 1348.76, 43, 1348.83, 12
4, 10:39:00-000, 85, 37, 48, 36, 1350.08, 42, 1350.33, 5
4, 10:40:00-000, 70, 37, 33, 37, 1352.59, 38, 1352.10, 3
4, 10:41:00-000, 68, 28, 40, 27, 1350.55, 24, 1350.37, 13
4, 10:42:00-000, 80, 35, 45, 35, 1350.96, 50, 1351.27, 0
4, 10:43:00-000, 91, 48, 43, 41, 1349.90, 25, 1349.88, 8
4, 10:44:00-000, 88, 32, 56, 39, 1350.22, 57, 1351.18, 4
4, 10:45:00-000, 70, 35, 35, 32, 1349.53, 31, 1350.00, 7
4, 10:46:00-000, 69, 31, 38, 34, 1349.64, 31, 1349.93, 9
4, 10:47:00-000, 93, 43, 50, 42, 1350.33, 44, 1350.10, 6
4, 10:48:00-000, 93, 51, 42, 47, 1349.82, 41, 1349.82, 6
4, 10:49:00-000, 83, 34, 49, 34, 1351.29, 35, 1351.19, 7
4, 10:50:00-000, 90, 52, 38, 49, 1351.62, 39, 1351.12, 0
4, 10:51:00-000, 74, 39, 35, 36, 1351.94, 26, 1352.38, 8
4, 10:52:00-000, 80, 39, 41, 36, 1350.66, 38, 1351.60, 11
4, 10:53:00-000, 65, 30, 35, 26, 1347.76, 30, 1348.46, 11
4, 10:54:00-000, 99, 42, 57, 42, 1351.44, 48, 1351.64, 6
4, 10:55:00-000, 84, 45, 39, 40, 1349.79, 38, 1350.05, 8
4, 10:56:00-000, 64, 35, 29, 40, 1348.64, 24, 1348.70, 3
4, 10:57:00-000, 74, 32, 42, 32, 1349.74, 30, 1349.89, 4
4, 10:58:00-000, 115, 68, 47, 61, 1351.02, 54, 1350.82, 0
4, 10:59:00-000, 70, 23, 47, 28, 1349.82, 24, 1350.16, 18
4, 11:00:00-000, 94, 45, 49, 45, 1351.03, 61, 1350.71, 0
4, 11:01:00-000, 100, 41, 59, 38, 1349.91, 57, 1350.33, 1
4, 11:02:00-000, 90, 47, 43, 47, 1349.80, 41, 1350.16, 3
4, 11:03:00-000, 68, 43, 25, 30, 1349.63, 19, 1350.15, 2
4, 11:04:00-000, 111, 66, 45, 75, 1350.96, 47, 1351.37, 5
4, 11:05:00-000, 67, 35, 32, 30, 1351.06, 21, 1350.90, 6
4, 11:06:00-000, 74, 23, 51, 23, 1348.87, 43, 1349.18, 9
4, 11:07:00-000, 94, 42, 52, 41, 1351.68, 44, 1350.60, 12
4, 11:08:00-000, 84, 34, 50, 36, 1350.33, 48, 1350.68, 4
4, 11:09:00-000, 85, 53, 32, 46, 1350.91, 39, 1350.84, 2
4, 11:10:00-000, 94, 50, 44, 55, 1352.48, 39, 1352.22, 1
4, 11:11:00-000, 75, 38, 37, 36, 1351.58, 27, 1351.07, 7
4, 11:12:00-000, 100, 48, 52, 45, 1351.12, 51, 1351.64, 6
4, 11:13:00-000, 103, 52, 51, 52, 1351.97, 41, 1350.09, 12
4, 11:14:00-000, 87, 39, 48, 39, 1352.17, 46, 1351.84, 3
4, 11:15:00-000, 57, 15, 42, 15, 1347.60, 31, 1348.03, 5
4, 11:16:00-000, 118, 44, 74, 45, 1350.04, 72, 1349.98, 11
4, 11:17:00-000, 93, 46, 47, 45, 1352.13, 44, 1351.79, 0
4, 11:18:00-000, 77, 35, 42, 34, 1351.05, 41, 1351.75, 2
4, 11:19:00-000, 66, 31, 35, 33, 1350.33, 35, 1349.79, 2
4, 11:20:00-000, 76, 34, 42, 29, 1350.37, 28, 1350.74, 6
4, 11:21:00-000, 84, 34, 50, 36, 1350.44, 39, 1350.25, 14
4, 11:22:00-000, 73, 39, 34, 34, 1349.05, 41, 1348.68, 1
4, 11:23:00-000, 91, 45, 46, 40, 1351.57, 40, 1350.64, 4
4, 11:24:00-000, 106, 63, 43, 69, 1351.64, 41, 1351.89, 0
4, 11:25:00-000, 89, 56, 33, 48, 1351.55, 32, 1352.49, 12
4, 11:26:00-000, 71, 32, 39, 36, 1351.55, 36, 1351.69, 0
4, 11:27:00-000, 106, 52, 54, 50, 1351.63, 50, 1351.79, 2
4, 11:28:00-000, 95, 35, 60, 33, 1352.66, 57, 1352.92, 6
4, 11:29:00-000, 80, 42, 38, 35, 1348.91, 37, 1349.26, 1
4, 11:30:00-000, 86, 50, 36, 55, 1350.88, 41, 1349.89, 1
4, 11:31:00-000, 75, 32, 43, 27, 1350.33, 41, 1350.09, 7
4, 11:32:00-000, 80, 38, 42, 41, 1350.72, 40, 1350.67, 0
4, 11:33:00-000, 87, 38, 49, 38, 1349.81, 37, 1349.10, 0
4, 11:34:00-000, 95, 41, 54, 39, 1349.02, 58, 1349.30, 8
4, 11:35:00-000, 62, 35, 27, 26, 1351.84, 28, 1351.42, 3
4, 11:36:00-000, 63, 31, 32, 29, 1350.17, 30, 1349.36, 10
4, 11:37:00-000, 99, 47, 52, 37, 1349.53, 41, 1349.36, 10
4, 11:38:00-000, 84, 56, 28, 63, 1352.59, 28, 1352.03, 3
4, 11:39:00-000, 79, 37, 42, 35, 1350.22, 27, 1350.11, 4
4, 11:40:00-000, 76, 30, 46, 31, 1348.77, 60, 1349.07, 0
4, 11:41:00-000, 92, 48, 44, 44, 1350.72, 35, 1350.62, 6
4, 11:42:00-000, 81, 25, 56, 25, 1350.36, 49, 1350.38, 9
4, 11:43:00-000, 100, 52, 48, 41, 1351.02, 43, 1350.16, 7
4, 11:44:00-000, 86, 55, 31, 49, 1352.80, 24, 1352.08, 10
4, 11:45:00-000, 81, 29, 52, 31, 1348.71, 31, 1348.77, 21
4, 11:46:00-000, 78, 33, 45, 28, 1347.21, 48, 1348.70, 5
4, 11:47:00-000, 119, 41, 78, 47, 1350.61, 82, 1350.14, 2
4, 11:48:00-000, 96, 41, 55, 40, 1349.84, 55, 1348.41, 2
4, 11:49:00-000, 92, 43, 49, 39, 1350.56, 39, 1350.79, 2
4, 11:50:00-000, 68, 43, 25, 46, 1350.12, 26, 1350.80, 7
4, 11:51:00-000, 85, 51, 34, 49, 1352.44, 30, 1352.49, 3
4, 11:52:00-000, 95, 51, 44, 48, 1349.16, 38, 1350.31, 9
4, 11:53:00-000, 88, 48, 40, 45, 1349.02, 37, 1348.83, 2
4, 11:54:00-000, 88, 37, 51, 37, 1348.64, 53, 1349.33, 6
4, 11:55:00-000, 72, 45, 27, 44, 1350.38, 21, 1351.33, 1
4, 11:56:00-000, 84, 35, 49, 33, 1349.54, 33, 1349.78, 15
4, 11:57:00-000, 82, 50, 32, 38, 1353.70, 31, 1353.70, 15
4, 11:58:00-000, 67, 17, 50, 17, 1349.47, 51, 1349.95, 7
4, 11:59:00-000, 74, 35, 39, 33, 1349.33, 37, 1349.88, 2
4, 12:00:00-000, 118, 59, 59, 48, 1349.91, 37, 1350.13, 13
4, 12:01:00-000, 102, 51, 51, 45, 1350.28, 61, 1350.94, 9
4, 12:02:00-000, 83, 55, 28, 55, 1352.86, 24, 1351.95, 9
4, 12:03:00-000, 65, 33, 32, 27, 1350.51, 25, 1350.88, 17
4, 12:04:00-000, 83, 44, 39, 38, 1351.18, 37, 1351.59, 1
4, 12:05:00-000, 80, 44, 36, 44, 1349.97, 31, 1350.77, 8
4, 12:06:00-000, 71, 39, 32, 35, 1350.45, 31, 1350.29, 5
4, 12:07:00-000, 71, 33, 38, 29, 1347.24, 30, 1348.93, 0
4, 12:08:00-000, 91, 51, 40, 55, 1349.59, 42, 1350.64, 0
4, 12:09:00-000, 88, 46, 42, 42, 1350.16, 26, 1349.96, 18
4, 12:10:00-000, 67, 36, 31, 31, 1349.83, 33, 1350.33, 1
4, 12:11:00-000, 102, 35, 67, 39, 1350.02, 51, 1349.99, 9
4, 12:12:00-000, 80, 37, 43, 36, 1350.71, 46, 1350.84, 4
4, 12:13:00-000, 68, 20, 48, 19, 1348.00, 43, 1348.02, 14
4, 12:14:00-000, 87, 32, 55, 33, 1349.75, 37, 1350.21, 13
4, 12:15:00-000, 85, 48, 37, 44, 1350.77, 39, 1350.66, 2
4, 12:16:00-000, 69, 39, 30, 40, 1350.59, 31, 1349.70, 1
4, 12:17:00-000, 91, 37, 54, 40, 1349.29, 40, 1349.34, 6
4, 12:18:00-000, 94, 47, 47, 46, 1351.30, 51, 1351.15, 4
4, 12:19:00-000, 93, 38, 55, 35, 1349.57, 45, 1349.48, 3
4, 12:20:00-000, 67, 36, 31, 38, 1350.49, 30, 1350.56, 1
4, 12:21:00-000, 77, 45, 32, 40, 1349.54, 28, 1350.39, 10
4, 12:22:00-000, 72, 24, 48, 27, 1349.81, 44, 1350.63, 7
4, 12:23:00-000, 75, 29, 46, 30, 1350.86, 34, 1350.38, 9
4, 12:24:00-000, 85, 38, 47, 38, 1349.99, 38, 1349.65, 1
4, 12:25:00-000, 93, 42, 51, 36, 1349.16, 51, 1349.03, 13
4, 12:26:00-000, 66, 28, 38, 28, 1350.39, 40, 1350.07, 3
4, 12:27:00-000, 94, 48, 46, 42, 1350.33, 39, 1350.30, 3
4, 12:28:00-000, 71, 51, 20, 47, 1351.73, 20, 1352.15, 3
4, 12:29:00-000, 77, 41, 36, 45, 1350.86, 27, 1348.84, 13
4, 12:30:00-000, 82, 39, 43, 33, 1349.60, 40, 1349.19, 6
4, 12:31:00-000, 108, 44, 64, 39, 1348.97, 54, 1349.56, 8
4, 12:32:00-000, 78, 47, 31, 41, 1350.67, 36, 1351.72, 11
4, 12:33:00-000, 93, 40, 53, 39, 1351.71, 32, 1351.71, 4
4, 12:34:00-000, 57, 36, 21, 35, 1350.73, 41, 1351.02, 1
4, 12:35:00-000, 96, 46, 50, 40, 1350.24, 31, 1349.03, 15
4, 12:36:00-000, 95, 42, 53, 44, 1351.04, 51, 1351.52, 1
4, 12:37:00-000, 72, 35, 37, 32, 1349.90, 27, 1350.22, 10
4, 12:38:00-000, 84, 42, 42, 42, 1351.25, 54, 1351.49, 0
4, 12:39:00-000, 75, 28, 47, 28, 1348.10, 35, 1349.16, 3
4, 12:40:00-000, 87, 44, 43, 36, 1352.24, 45, 1350.64, 1
4, 12:41:00-000, 66, 20, 46, 27, 1348.48, 30, 1348.76, 18
4, 12:42:00-000, 97, 60, 37, 50, 1350.23, 39, 1350.02, 5
4, 12:43:00-000, 76, 36, 40, 38, 1349.62, 36, 1349.44, 7
4, 12:44:00-000, 65, 29, 36, 27, 1350.18, 28, 1350.46, 12
4, 12:45:00-000, 83, 40, 43, 40, 1350.89, 37, 1351.21, 2
4, 12:46:00-000, 96, 46, 50, 40, 1352.49, 43, 1352.53, 5
4, 12:47:00-000, 90, 55, 35, 57, 1352.18, 40, 1350.92, 7
4, 12:48:00-000, 86, 32, 54, 32, 1350.74, 40, 1350.02, 6
4, 12:49:00-000, 65, 30, 35, 29, 1350.27, 27, 1349.70, 12
4, 12:50:00-000, 110, 40, 70, 40, 1351.44, 57, 1351.59, 9
4, 12:51:00-000, 81, 28, 53, 28, 1350.57, 49, 1351.05, 9
4, 12:52:00-000, 114, 57, 57, 57, 1351.73, 56, 1351.85, 0
4, 12:53:00-000, 62, 31, 31, 28, 1351.14, 28, 1351.17, 9
4, 12:54:00-000, 98, 58, 40, 58, 1350.65, 43, 1351.20, 0
4, 12:55:00-000, 87, 35, 52, 34, 1348.64, 28, 1348.67, 11
4, 12:56:00-000, 96, 49, 47, 46, 1350.10, 46, 1349.53, 6
4, 12:57:00-000, 74, 47, 27, 41, 1351.02, 29, 1351.03, 9
4, 12:58:00-000, 82, 45, 37, 47, 1351.27, 39, 1351.20, 1
4, 12:59:00-000, 97, 45, 52, 45, 1350.21, 44, 1350.74, 2
4, 13:00:00-000, 72, 36, 36, 34, 1350.49, 43, 1350.97, 1
4, 13:01:00-000, 86, 36, 50, 31, 1351.51, 45, 1351.31, 2
4, 13:02:00-000, 79, 36, 43, 41, 1349.46, 43, 1349.64, 2
4, 13:03:00-000, 89, 45, 44, 38, 1348.89, 34, 1348.94, 5
4, 13:04:00-000, 88, 38, 50, 44, 1349.49, 54, 1349.05, 3
4, 13:05:00-000, 95, 58, 37, 52, 1350.72, 35, 1350.77, 3
4, 13:06:00-000, 78, 34, 44, 39, 1350.28, 41, 1350.26, 0
4, 13:07:00-000, 79, 46, 33, 44, 1352.08, 31, 1352.28, 5
4, 13:08:00-000, 83, 30, 53, 30, 1349.59, 41, 1349.77, 6
4, 13:09:00-000, 82, 33, 49, 33, 1350.69, 34, 1350.73, 8
4, 13:10:00-000, 64, 26, 38, 24, 1348.04, 53, 1348.78, 1
4, 13:11:00-000, 88, 44, 44, 44, 1350.20, 30, 1349.76, 2
4, 13:12:00-000, 95, 55, 40, 56, 1350.04, 48, 1350.64, 5
4, 13:13:00-000, 92, 62, 30, 53, 1352.44, 30, 1351.70, 0
4, 13:14:00-000, 94, 56, 38, 60, 1352.62, 30, 1352.56, 3
4, 13:15:00-000, 64, 21, 43, 22, 1350.18, 31, 1350.00, 12
4, 13:16:00-000, 93, 49, 44, 49, 1350.62, 49, 1350.85, 1
4, 13:17:00-000, 101, 45, 56, 45, 1351.90, 55, 1352.06, 1
4, 13:18:00-000, 72, 19, 53, 19, 1350.68, 47, 1350.54, 6
4, 13:19:00-000, 71, 29, 42, 26, 1347.57, 35, 1348.02, 6
4, 13:20:00-000, 59, 24, 35, 25, 1350.44, 36, 1350.88, 3
4, 13:21:00-000, 121, 59, 62, 57, 1350.15, 64, 1350.88, 1
4, 13:22:00-000, 54, 31, 23, 29, 1350.75, 19, 1351.73, 5
4, 13:23:00-000, 67, 34, 33, 30, 1350.39, 24, 1350.20, 4
4, 13:24:00-000, 96, 50, 46, 37, 1350.45, 42, 1352.23, 3
4, 13:25:00-000, 88, 37, 51, 43, 1351.34, 51, 1352.11, 14
4, 13:26:00-000, 69, 38, 31, 38, 1352.10, 30, 1352.63, 1
4, 13:27:00-000, 79, 30, 49, 29, 1350.03, 46, 1348.14, 5
4, 13:28:00-000, 95, 51, 44, 44, 1349.81, 43, 1350.25, 5
4, 13:29:00-000, 67, 33, 34, 32, 1349.27, 29, 1349.69, 6
4, 13:30:00-000, 61, 42, 19, 44, 1351.42, 21, 1351.42, 1
4, 13:31:00-000, 78, 35, 43, 30, 1348.13, 40, 1347.89, 2
4, 13:32:00-000, 67, 38, 29, 32, 1349.65, 25, 1350.56, 9
4, 13:33:00-000, 84, 48, 36, 45, 1349.70, 33, 1349.66, 7
4, 13:34:00-000, 77, 39, 38, 40, 1350.89, 31, 1350.96, 2
4, 13:35:00-000, 86, 40, 46, 37, 1349.59, 42, 1350.35, 8
4, 13:36:00-000, 95, 56, 39, 49, 1350.93, 47, 1351.08, 0
4, 13:37:00-000, 94, 49, 45, 52, 1351.80, 44, 1351.63, 1
4, 13:38:00-000, 82, 39, 43, 45, 1350.90, 40, 1350.79, 1
4, 13:39:00-000, 80, 43, 37, 40, 1352.54, 31, 1352.93, 7
4, 13:40:00-000, 76, 36, 40, 39, 1351.35, 33, 1351.51, 4
4, 13:41:00-000, 73, 31, 42, 28, 1349.64, 38, 1349.76, 2
4, 13:42:00-000, 66, 26, 40, 23, 1351.47, 36, 1351.85, 8
4, 13:43:00-000, 110, 43, 67, 49, 1351.68, 55, 1351.34, 4
4, 13:44:00-000, 69, 34, 35, 31, 1349.51, 46, 1350.34, 1
4, 13:45:00-000, 76, 47, 29, 48, 1352.76, 26, 1352.76, 1
4, 13:46:00-000, 84, 36, 48, 33, 1350.63, 41, 1350.87, 0
4, 13:47:00-000, 87, 28, 59, 27, 1348.73, 38, 1348.94, 23
4, 13:48:00-000, 88, 54, 34, 53, 1350.59, 43, 1350.97, 1
4, 13:49:00-000, 79, 39, 40, 37, 1353.10, 32, 1351.24, 9
4, 13:50:00-000, 87, 36, 51, 38, 1350.73, 50, 1351.03, 0
4, 13:51:00-000, 98, 49, 49, 47, 1351.97, 51, 1351.58, 2
4, 13:52:00-000, 77, 47, 30, 45, 1351.28, 26, 1351.38, 2
4, 13:53:00-000, 88, 53, 35, 51, 1351.68, 33, 1351.54, 3
4, 13:54:00-000, 77, 45, 32, 48, 1351.55, 28, 1352.25, 0
4, 13:55:00-000, 93, 41, 52, 38, 1350.18, 47, 1350.18, 9
4, 13:56:00-000, 86, 45, 41, 46, 1351.77, 28, 1352.85, 16
4, 13:57:00-000, 93, 39, 54, 36, 1349.47, 50, 1349.55, 1
4, 13:58:00-000, 83, 33, 50, 37, 1350.78, 47, 1351.08, 3
4, 13:59:00-000, 69, 26, 43, 26, 1350.88, 39, 1350.48, 3
4, 14:00:00-000, 101, 51, 50, 48, 1352.68, 49, 1352.44, 3
4, 14:01:00-000, 58, 27, 31, 27, 1349.81, 24, 1349.91, 5
4, 14:02:00-000, 82, 33, 49, 33, 1350.39, 50, 1350.27, 7
4, 14:03:00-000, 74, 34, 40, 31, 1348.99, 34, 1348.44, 1
4, 14:04:00-000, 83, 42, 41, 43, 1349.60, 39, 1349.92, 5
4, 14:05:00-000, 100, 48, 52, 49, 1348.99, 51, 1349.30, 2
4, 14:06:00-000, 74, 39, 35, 33, 1350.84, 32, 1350.37, 7
4, 14:07:00-000, 94, 57, 37, 57, 1351.15, 38, 1350.49, 2
4, 14:08:00-000, 85, 44, 41, 38, 1350.49, 34, 1350.14, 5
4, 14:09:00-000, 69, 26, 43, 32, 1349.93, 39, 1350.17, 3
4, 14:10:00-000, 85, 49, 36, 49, 1352.56, 35, 1352.34, 0
4, 14:11:00-000, 75, 39, 36, 31, 1351.58, 28, 1351.74, 7
4, 14:12:00-000, 84, 45, 39, 52, 1351.18, 40, 1350.87, 4
4, 14:13:00-000, 66, 30, 36, 31, 1350.22, 31, 1350.19, 2
4, 14:14:00-000, 90, 52, 38, 45, 1351.75, 41, 1351.77, 0
4, 14:15:00-000, 93, 40, 53, 38, 1349.94, 42, 1350.26, 9
4, 14:16:00-000, 89, 40, 49, 36, 1350.80, 55, 1350.95, 6
4, 14:17:00-000, 88, 36, 52, 34, 1348.67, 42, 1349.49, 1
4, 14:18:00-000, 75, 32, 43, 32, 1348.99, 44, 1348.42, 4
4, 14:19:00-000, 78, 36, 42, 30, 1350.39, 41, 1350.33, 11
4, 14:20:00-000, 85, 33, 52, 33, 1348.93, 40, 1349.69, 2
4, 14:21:00-000, 82, 44, 38, 39, 1350.02, 37, 1350.62, 11
4, 14:22:00-000, 73, 38, 35, 39, 1351.53, 41, 1351.72, 2
4, 14:23:00-000, 73, 39, 34, 32, 1351.74, 27, 1351.44, 5
4, 14:24:00-000, 71, 37, 34, 45, 1350.72, 36, 1351.19, 1
4, 14:25:00-000, 90, 45, 45, 44, 1349.76, 33, 1349.93, 7
4, 14:26:00-000, 82, 34, 48, 31, 1348.35, 50, 1349.37, 6
4, 14:27:00-000, 84, 51, 33, 51, 1351.52, 31, 1351.48, 0
4, 14:28:00-000, 72, 35, 37, 35, 1349.74, 39, 1351.35, 0
4, 14:29:00-000, 78, 38, 40, 29, 1348.82, 42, 1350.35, 0
4, 14:30:00-000, 85, 42, 43, 51, 1349.38, 39, 1350.84, 0
4, 14:31:00-000, 88, 46, 42, 44, 1352.63, 30, 1351.79, 5
4, 14:32:00-000, 84, 36, 48, 37, 1348.51, 47, 1350.14, 3
4, 14:33:00-000, 96, 46, 50, 46, 1349.60, 48, 1348.10, 1
4, 14:34:00-000, 60, 32, 28, 33, 1352.63, 36, 1353.55, 2
4, 14:35:00-000, 79, 26, 53, 21, 1351.47, 29, 1352.34, 7
4, 14:36:00-000, 88, 33, 55, 34, 1350.46, 55, 1350.53, 10
4, 14:37:00-000, 77, 37, 40, 37, 1350.99, 40, 1351.39, 4
4, 14:38:00-000, 90, 34, 56, 34, 1348.64, 46, 1348.84, 8
4, 14:39:00-000, 68, 42, 26, 42, 1350.18, 31, 1350.35, 2
4, 14:40:00-000, 84, 48, 36, 44, 1353.08, 20, 1352.50, 5
4, 14:41:00-000, 90, 50, 40, 49, 1351.01, 44, 1351.40, 11
4, 14:42:00-000, 89, 32, 57, 33, 1349.75, 57, 1349.80, 1
4, 14:43:00-000, 89, 45, 44, 41, 1351.21, 34, 1351.26, 0
4, 14:44:00-000, 71, 46, 25, 48, 1350.47, 36, 1351.16, 1
4, 14:45:00-000, 97, 52, 45, 52, 1351.20, 44, 1350.90, 0
4, 14:46:00-000, 88, 50, 38, 42, 1350.61, 27, 1350.25, 4
4, 14:47:00-000, 79, 38, 41, 37, 1350.40, 35, 1350.02, 10
4, 14:48:00-000, 92, 40, 52, 37, 1348.13, 53, 1349.44, 5
4, 14:49:00-000, 78, 29, 49, 28, 1349.17, 31, 1349.54, 10
4, 14:50:00-000, 86, 42, 44, 44, 1349.56, 52, 1350.93, 1
4, 14:51:00-000, 96, 37, 59, 31, 1348.32, 52, 1348.39, 9
4, 14:52:00-000, 101, 51, 50, 49, 1349.22, 50, 1349.27, 5
4, 14:53:00-000, 86, 43, 43, 38, 1349.07, 38, 1349.49, 6
4, 14:54:00-000, 70, 40, 30, 46, 1350.12, 29, 1350.79, 3
4, 14:55:00-000, 73, 38, 35, 38, 1350.07, 35, 1350.05, 1
4, 14:56:00-000, 74, 32, 42, 31, 1349.87, 41, 1349.94, 0
4, 14:57:00-000, 86, 54, 32, 54, 1351.32, 32, 1351.93, 1
4, 14:58:00-000, 72, 37, 35, 35, 1349.77, 27, 1349.66, 1
4, 14:59:00-000, 80, 33, 47, 31, 1349.38, 31, 1349.48, 17
4, 15:00:00-000, 80, 48, 32, 36, 1349.49, 45, 1349.53, 1
4, 15:01:00-000, 76, 39, 37, 45, 1350.39, 36, 1350.69, 4
4, 15:02:00-000, 74, 44, 30, 43, 1351.09, 28, 1351.42, 4
4, 15:03:00-000, 85, 44, 41, 34, 1349.79, 30, 1348.83, 4
4, 15:04:00-000, 99, 32, 67, 42, 1350.23, 63, 1350.78, 2
4, 15:05:00-000, 62, 25, 37, 24, 1349.08, 32, 1349.49, 8
4, 15:06:00-000, 92, 44, 48, 45, 1351.39, 48, 1351.11, 1
4, 15:07:00-000, 82, 32, 50, 29, 1350.20, 37, 1350.29, 11
4, 15:08:00-000, 91, 58, 33, 54, 1350.92, 43, 1350.43, 0
4, 15:09:00-000, 71, 41, 30, 36, 1350.88, 32, 1350.56, 2
4, 15:10:00-000, 84, 45, 39, 51, 1349.05, 25, 1349.83, 3
4, 15:11:00-000, 85, 44, 41, 43, 1349.92, 38, 1349.86, 7
4, 15:12:00-000, 101, 32, 69, 34, 1348.99, 48, 1349.33, 4
4, 15:13:00-000, 73, 36, 37, 36, 1349.05, 33, 1348.39, 15
4, 15:14:00-000, 74, 41, 33, 37, 1350.72, 46, 1350.58, 0
4, 15:15:00-000, 78, 36, 42, 38, 1350.23, 30, 1350.13, 4
4, 15:16:00-000, 89, 54, 35, 49, 1351.30, 43, 1350.97, 5
4, 15:17:00-000, 79, 43, 36, 34, 1352.61, 34, 1351.91, 6
4, 15:18:00-000, 73, 36, 37, 39, 1350.58, 36, 1350.96, 2
4, 15:19:00-000, 78, 38, 40, 35, 1349.11, 34, 1349.29, 4
4, 15:20:00-000, 101, 46, 55, 49, 1350.70, 53, 1351.37, 1
4, 15:21:00-000, 78, 31, 47, 29, 1347.51, 48, 1348.60, 0
4, 15:22:00-000, 78, 36, 42, 26, 1349.88, 47, 1350.93, 9
4, 15:23:00-000, 92, 38, 54, 40, 1352.02, 42, 1353.23, 6
4, 15:24:00-000, 91, 39, 52, 37, 1349.99, 49, 1349.87, 4
4, 15:25:00-000, 62, 27, 35, 28, 1351.35, 28, 1351.49, 10
4, 15:26:00-000, 81, 37, 44, 35, 1350.19, 40, 1350.34, 5
4, 15:27:00-000, 96, 59, 37, 51, 1350.93, 40, 1350.79, 2
4, 15:28:00-000, 74, 30, 44, 38, 1350.18, 40, 1350.54, 6
4, 15:29:00-000, 74, 41, 33, 38, 1350.07, 27, 1350.18, 0
4, 15:30:00-000, 78, 33, 45, 36, 1350.27, 37, 1351.32, 2
4, 15:31:00-000, 69, 43, 26, 38, 1350.18, 23, 1350.47, 7
4, 15:32:00-000, 99, 47, 52, 46, 1350.36, 52, 1351.20, 1
4, 15:33:00-000, 93, 55, 38, 55, 1352.34, 43, 1351.76, 2
4, 15:34:00-000, 57, 35, 22, 32, 1350.71, 20, 1351.05, 9
4, 15:35:00-000, 82, 31, 51, 31, 1350.67, 41, 1350.82, 2
4, 15:36:00-000, 96, 41, 55, 37, 1349.59, 55, 1349.99, 4
4, 15:37:00-000, 95, 49, 46, 48, 1350.12, 30, 1349.56, 2
4, 15:38:00-000, 106, 65, 41, 65, 1351.54, 50, 1351.67, 10
4, 15:39:00-000, 92, 48, 44, 47, 1351.59, 27, 1351.18, 3
4, 15:40:00-000, 87, 38, 49, 37, 1348.94, 61, 1349.40, 3
4, 15:41:00-000, 66, 23, 43, 27, 1350.33, 28, 1350.78, 7
4, 15:42:00-000, 83, 37, 46, 34, 1349.73, 43, 1350.06, 11
4, 15:43:00-000, 79, 40, 39, 36, 1350.82, 19, 1349.89, 12
4, 15:44:00-000, 82, 38, 44, 40, 1349.12, 50, 1350.01, 3
4, 15:45:00-000, 64, 27, 37, 22, 1349.41, 29, 1350.20, 8
4, 15:46:00-000, 70, 30, 40, 36, 1349.99, 38, 1350.36, 3
4, 15:47:00-000, 112, 56, 56, 48, 1351.78, 56, 1351.97, 1
4, 15:48:00-000, 73, 41, 32, 48, 1351.12, 25, 1351.56, 3
4, 15:49:00-000, 76, 41, 35, 30, 1350.99, 32, 1350.84, 10
4, 15:50:00-000, 94, 39, 55, 44, 1350.17, 54, 1349.51, 6
4, 15:51:00-000, 83, 32, 51, 33, 1348.66, 41, 1348.14, 1
4, 15:52:00-000, 81, 48, 33, 44, 1350.00, 42, 1350.25, 6
4, 15:53:00-000, 73, 37, 36, 35, 1350.99, 25, 1351.35, 3
4, 15:54:00-000, 70, 31, 39, 30, 1351.93, 37, 1352.34, 6
4, 15:55:00-000, 79, 38, 41, 29, 1351.58, 28, 1351.96, 6
4, 15:56:00-000, 90, 39, 51, 47, 1350.35, 52, 1351.01, 10
4, 15:57:00-000, 73, 28, 45, 25, 1351.79, 36, 1350.77, 6
4, 15:58:00-000, 75, 38, 37, 41, 1350.75, 37, 1350.91, 5
4, 15:59:00-000, 102, 41, 61, 42, 1350.95, 46, 1351.06, 7
4, 16:00:00-000, 99, 46, 53, 45, 1349.70, 55, 1350.26, 0
4, 16:01:00-000, 89, 42, 47, 38, 1350.57, 37, 1351.05, 8
4, 16:02:00-000, 86, 42, 44, 42, 1350.80, 46, 1351.18, 0
4, 16:03:00-000, 77, 38, 39, 33, 1350.87, 36, 1351.11, 6
4, 16:04:00-000, 77, 49, 28, 51, 1350.97, 30, 1351.36, 2
4, 16:05:00-000, 92, 50, 42, 44, 1351.81, 34, 1347.79, 6
4, 16:06:00-000, 54, 33, 21, 39, 1352.07, 22, 1352.81, 6
4, 16:07:00-000, 86, 48, 38, 48, 1352.14, 31, 1350.74, 1
4, 16:08:00-000, 98, 59, 39, 48, 1351.74, 36, 1351.38, 7
4, 16:09:00-000, 74, 33, 41, 34, 1350.14, 35, 1350.14, 9
4, 16:10:00-000, 86, 43, 43, 44, 1350.56, 46, 1350.86, 4
4, 16:11:00-000, 69, 30, 39, 30, 1349.86, 28, 1349.71, 6
4, 16:12:00-000, 95, 29, 66, 29, 1349.10, 57, 1349.01, 6
4, 16:13:00-000, 71, 26, 45, 22, 1351.32, 30, 1351.20, 11
4, 16:14:00-000, 89, 46, 43, 45, 1351.55, 45, 1352.24, 5
4, 16:15:00-000, 78, 38, 40, 39, 1350.33, 37, 1350.16, 9
4, 16:16:00-000, 97, 47, 50, 47, 1351.50, 43, 1351.06, 3
4, 16:17:00-000, 92, 27, 65, 27, 1347.77, 43, 1347.25, 10
4, 16:18:00-000, 62, 30, 32, 30, 1350.83, 45, 1350.46, 2
4, 16:19:00-000, 79, 41, 38, 37, 1349.94, 36, 1349.49, 1
4, 16:20:00-000, 98, 35, 63, 38, 1350.39, 62, 1350.54, 10
4, 16:21:00-000, 65, 26, 39, 19, 1351.63, 30, 1351.99, 3
4, 16:22:00-000, 79, 44, 35, 47, 1349.41, 38, 1350.52, 1
4, 16:23:00-000, 64, 32, 32, 35, 1349.91, 23, 1349.56, 0
4, 16:24:00-000, 99, 41, 58, 42, 1350.52, 56, 1351.01, 1
4, 16:25:00-000, 76, 43, 33, 37, 1351.99, 40, 1350.74, 5
4, 16:26:00-000, 97, 56, 41, 50, 1352.29, 40, 1352.39, 3
4, 16:27:00-000, 83, 41, 42, 45, 1351.79, 36, 1351.80, 2
4, 16:28:00-000, 93, 52, 41, 53, 1349.71, 45, 1350.48, 2
4, 16:29:00-000, 90, 53, 37, 52, 1354.03, 37, 1353.86, 3
5, 09:13:00-000, 10392, 5646, 4746, 3861, 1348.04, 3881, 1348.89, 0
5, 09:14:00-000, 0, 0, 0, 2, 1347.00, 14, 1356.07, 662
5, 09:15:00-000, 0, 0, 0, 0, 0.00, 50, 1357.00, 1919
5, 09:16:00-000, 0, 0, 0, 0, 0.00, 0, 0.00, 3
5, 09:26:00-000, 10487, 5645, 4842, 3871, 1348.14, 3902, 1348.33, 0
5, 09:27:00-000, 0, 0, 0, 10, 1347.00, 21, 1356.00, 0
5, 09:28:00-000, 3, 1, 2, 60, 1347.00, 89, 1356.28, 1887
5, 09:29:00-000, 30, 18, 12, 14, 1349.00, 12, 1349.75, 649
5, 09:30:00-000, 67, 36, 31, 34, 1348.64, 23, 1349.91, 1
5, 09:31:00-000, 0, 0, 0, 1, 1345.00, 7, 1355.29, 0
5, 09:32:00-000, 210, 102, 108, 91, 1348.37, 101, 1349.28, 3
5, 09:33:00-000, 345, 207, 138, 148, 1350.11, 145, 1352.46, 9
5, 09:34:00-000, 649, 343, 306, 247, 1349.20, 239, 1349.02, 25
5, 09:35:00-000, 0, 0, 0, 15, 1346.00, 1, 1357.00, 34
5, 09:36:00-000, 907, 517, 390, 367, 1349.46, 337, 1350.21, 118
5, 09:37:00-000, 1207, 655, 552, 487, 1348.75, 445, 1349.08, 116
5, 09:38:00-000, 1352, 716, 636, 584, 1348.88, 496, 1349.09, 175
5, 09:39:00-000, 2, 0, 2, 0, 0.00, 128, 1357.15, 152
5, 09:40:00-000, 1354, 692, 662, 532, 1348.50, 593, 1350.06, 149
5, 09:41:00-000, 1337, 709, 628, 522, 1348.52, 537, 1349.60, 139
5, 09:42:00-000, 1170, 610, 560, 484, 1348.65, 500, 1349.49, 202
5, 09:43:00-000, 0, 0, 0, 25, 1346.00, 0, 0.00, 176
5, 09:44:00-000, 1000, 569, 431, 385, 1349.21, 367, 1350.18, 149
5, 09:45:00-000, 883, 438, 445, 345, 1348.09, 366, 1348.96, 163
5, 09:46:00-000, 873, 493, 380, 374, 1349.19, 361, 1350.44, 160
5, 09:47:00-000, 6, 6, 0, 30, 1347.13, 0, 0.00, 104
5, 09:48:00-000, 914, 446, 468, 318, 1347.80, 407, 1349.26, 130
5, 09:49:00-000, 949, 532, 417, 397, 1348.98, 357, 1348.95, 149
5, 09:50:00-000, 946, 485, 461, 321, 1348.69, 400, 1350.19, 97
5, 09:51:00-000, 0, 0, 0, 4, 1347.00, 27, 1356.30, 130
5, 09:52:00-000, 1034, 559, 475, 435, 1349.21, 409, 1350.63, 171
5, 09:53:00-000, 1117, 553, 564, 386, 1348.48, 473, 1349.88, 159
5, 09:54:00-000, 1048, 504, 544, 462, 1348.50, 432, 1349.19, 141
5, 09:55:00-000, 0, 0, 0, 6, 1344.33, 6, 1356.00, 151
5, 09:56:00-000, 1104, 579, 525, 457, 1348.63, 444, 1349.90, 141
5, 09:57:00-000, 1074, 574, 500, 449, 1348.46, 412, 1349.02, 158
5, 09:58:00-000, 952, 519, 433, 390, 1349.09, 404, 1350.14, 167
5, 09:59:00-000, 0, 0, 0, 0, 0.00, 32, 1358.00, 121
5, 10:00:00-000, 983, 534, 449, 387, 1349.17, 339, 1350.03, 121
5, 10:01:00-000, 1047, 572, 475, 394, 1348.79, 428, 1349.87, 165
5, 10:02:00-000, 995, 518, 477, 404, 1349.11, 416, 1350.91, 125
5, 10:03:00-000, 0, 0, 0, 35, 1345.00, 30, 1357.59, 157
5, 10:04:00-000, 1044, 536, 508, 435, 1349.07, 424, 1349.88, 147
5, 10:05:00-000, 1051, 496, 555, 368, 1349.18, 406, 1349.76, 135
5, 10:06:00-000, 1065, 586, 479, 489, 1348.45, 440, 1349.64, 131
5, 10:07:00-000, 0, 0, 0, 0, 0.00, 36, 1357.00, 148
5, 10:08:00-000, 1012, 536, 476, 400, 1348.59, 416, 1350.12, 133
5, 10:09:00-000, 987, 570, 417, 398, 1348.99, 353, 1349.24, 126
5, 10:10:00-000, 1049, 548, 501, 408, 1349.00, 491, 1350.48, 152
5, 10:11:00-000, 0, 0, 0, 21, 1346.86, 0, 0.00, 128
5, 10:12:00-000, 1109, 518, 591, 444, 1348.07, 520, 1350.03, 109
5, 10:13:00-000, 928, 459, 469, 373, 1348.53, 364, 1349.14, 149
5, 10:14:00-000, 1098, 605, 493, 417, 1348.94, 450, 1350.25, 148
5, 10:15:00-000, 0, 0, 0, 13, 1346.00, 16, 1356.00, 107
5, 10:16:00-000, 1135, 506, 629, 430, 1347.52, 448, 1348.47, 161
5, 10:17:00-000, 1009, 499, 510, 371, 1348.49, 405, 1349.46, 166
5, 10:18:00-000, 1047, 539, 508, 488, 1348.61, 427, 1349.75, 166
5, 10:19:00-000, 0, 0, 0, 18, 1345.00, 14, 1356.00, 163
5, 10:20:00-000, 1016, 511, 505, 400, 1349.07, 384, 1349.91, 114
5, 10:21:00-000, 1008, 527, 481, 405, 1348.99, 362, 1349.32, 180
5, 10:22:00-000, 1048, 515, 533, 411, 1348.03, 427, 1348.66, 179
5, 10:23:00-000, 1, 1, 0, 1, 1349.00, 13, 1355.00, 148
5, 10:24:00-000, 1104, 581, 523, 479, 1348.95, 442, 1350.06, 153
5, 10:25:00-000, 991, 553, 438, 389, 1348.85, 328, 1349.03, 123
5, 10:26:00-000, 1165, 575, 590, 512, 1348.25, 468, 1349.28, 161
5, 10:27:00-000, 1, 0, 1, 12, 1345.00, 16, 1357.00, 151
5, 10:28:00-000, 936, 455, 481, 343, 1348.64, 416, 1350.48, 189
5, 10:29:00-000, 1067, 571, 496, 410, 1349.31, 444, 1350.20, 151
5, 10:30:00-000, 1038, 538, 500, 464, 1349.17, 452, 1350.06, 126
5, 10:31:00-000, 1, 1, 0, 1, 1351.00, 13, 1358.00, 126
5, 10:32:00-000, 1048, 541, 507, 434, 1348.97, 406, 1349.86, 96
5, 10:33:00-000, 1054, 584, 470, 402, 1349.28, 418, 1350.14, 148
5, 10:34:00-000, 1126, 570, 556, 463, 1348.46, 403, 1349.30, 149
5, 10:35:00-000, 0, 0, 0, 26, 1345.00, 31, 1355.83, 147
5, 10:36:00-000, 970, 532, 438, 416, 1348.99, 406, 1350.14, 175
5, 10:37:00-000, 1047, 559, 488, 371, 1348.99, 394, 1349.89, 145
5, 10:38:00-000, 968, 493, 475, 410, 1348.48, 394, 1349.64, 130
5, 10:39:00-000, 1, 0, 1, 2, 1345.00, 28, 1356.10, 186
5, 10:40:00-000, 1014, 540, 474, 356, 1349.04, 427, 1350.57, 153
5, 10:41:00-000, 989, 508, 481, 354, 1349.28, 401, 1349.51, 135
5, 10:42:00-000, 1025, 544, 481, 404, 1348.81, 410, 1350.08, 160
5, 10:43:00-000, 1, 0, 1, 14, 1345.78, 8, 1354.00, 108
5, 10:44:00-000, 1099, 544, 555, 427, 1348.63, 433, 1348.82, 190
5, 10:45:00-000, 1024, 514, 510, 417, 1349.07, 401, 1349.56, 176
5, 10:46:00-000, 1058, 557, 501, 439, 1348.54, 441, 1349.22, 170
5, 10:47:00-000, 2, 2, 0, 5, 1348.20, 20, 1356.40, 153
5, 10:48:00-000, 1028, 547, 481, 431, 1348.86, 440, 1349.93, 118
5, 10:49:00-000, 996, 553, 443, 374, 1349.59, 342, 1349.83, 146
5, 10:50:00-000, 1042, 565, 477, 415, 1349.73, 377, 1350.76, 157
5, 10:51:00-000, 1, 1, 0, 26, 1346.46, 0, 0.00, 181
5, 10:52:00-000, 913, 461, 452, 399, 1348.69, 409, 1350.06, 174
5, 10:53:00-000, 1032, 523, 509, 424, 1348.49, 380, 1348.87, 127
5, 10:54:00-000, 1057, 534, 523, 403, 1348.52, 385, 1349.65, 114
5, 10:55:00-000, 2, 0, 2, 28, 1345.00, 59, 1354.91, 143
5, 10:56:00-000, 1073, 565, 508, 438, 1349.28, 448, 1350.42, 154
5, 10:57:00-000, 1108, 626, 482, 444, 1349.36, 413, 1350.03, 120
5, 10:58:00-000, 993, 501, 492, 406, 1349.21, 395, 1350.28, 190
5, 10:59:00-000, 5, 0, 5, 15, 1346.00, 13, 1356.00, 157
5, 11:00:00-000, 1059, 565, 494, 434, 1348.59, 407, 1349.05, 127
5, 11:01:00-000, 981, 514, 467, 364, 1348.44, 351, 1349.21, 142
5, 11:02:00-000, 1045, 528, 517, 389, 1349.25, 453, 1349.95, 193
5, 11:03:00-000, 3, 1, 2, 59, 1345.73, 8, 1355.00, 166
5, 11:04:00-000, 1016, 460, 556, 353, 1348.90, 425, 1349.11, 116
5, 11:05:00-000, 1065, 574, 491, 403, 1348.90, 392, 1348.95, 172
5, 11:06:00-000, 1074, 581, 493, 465, 1348.41, 425, 1349.62, 161
5, 11:07:00-000, 2, 2, 0, 13, 1346.61, 9, 1356.00, 163
5, 11:08:00-000, 1028, 516, 512, 338, 1349.10, 452, 1350.78, 171
5, 11:09:00-000, 1087, 557, 530, 427, 1349.63, 431, 1349.81, 207
5, 11:10:00-000, 1081, 533, 548, 429, 1348.98, 439, 1350.11, 151
5, 11:11:00-000, 0, 0, 0, 16, 1346.00, 24, 1356.00, 137
5, 11:12:00-000, 1053, 495, 558, 406, 1348.57, 437, 1349.90, 183
5, 11:13:00-000, 1080, 600, 480, 425, 1349.81, 391, 1350.31, 138
5, 11:14:00-000, 987, 522, 465, 434, 1348.42, 379, 1349.98, 138
5, 11:15:00-000, 1, 1, 0, 29, 1344.93, 0, 0.00, 139
5, 11:16:00-000, 1017, 545, 472, 419, 1347.92, 382, 1349.14, 164
5, 11:17:00-000, 1004, 522, 482, 362, 1349.40, 362, 1349.68, 203
5, 11:18:00-000, 1025, 487, 538, 378, 1348.77, 433, 1349.65, 160
5, 11:19:00-000, 0, 0, 0, 0, 0.00, 5, 1356.00, 156
5, 11:20:00-000, 1047, 531, 516, 430, 1348.54, 418, 1349.89, 175
5, 11:21:00-000, 979, 505, 474, 387, 1348.46, 401, 1349.00, 173
5, 11:22:00-000, 979, 539, 440, 360, 1349.49, 367, 1350.58, 156
5, 11:23:00-000, 4, 4, 0, 4, 1347.00, 32, 1357.00, 126
5, 11:24:00-000, 974, 510, 464, 396, 1348.78, 382, 1349.92, 182
5, 11:25:00-000, 1044, 548, 496, 362, 1348.23, 393, 1349.01, 173
5, 11:26:00-000, 1056, 580, 476, 424, 1349.02, 388, 1349.94, 177
5, 11:27:00-000, 1, 1, 0, 42, 1345.82, 13, 1356.00, 161
5, 11:28:00-000, 1061, 504, 557, 396, 1348.36, 437, 1349.49, 168
5, 11:29:00-000, 1004, 472, 532, 374, 1348.69, 384, 1349.22, 158
5, 11:30:00-000, 976, 491, 485, 376, 1348.64, 387, 1349.29, 179
5, 11:31:00-000, 1, 0, 1, 29, 1345.00, 6, 1356.00, 168
5, 11:32:00-000, 1025, 539, 486, 418, 1349.06, 391, 1349.31, 158
5, 11:33:00-000, 1023, 514, 509, 376, 1348.38, 417, 1348.99, 163
5, 11:34:00-000, 1030, 519, 511, 415, 1348.26, 416, 1349.35, 127
5, 11:35:00-000, 0, 0, 0, 19, 1346.00, 10, 1356.00, 149
5, 11:36:00-000, 1028, 540, 488, 446, 1349.05, 416, 1349.71, 178
5, 11:37:00-000, 1019, 531, 488, 383, 1349.67, 372, 1349.72, 134
5, 11:38:00-000, 1146, 551, 595, 437, 1347.79, 483, 1349.40, 143
5, 11:39:00-000, 2, 0, 2, 0, 0.00, 38, 1355.18, 145
5, 11:40:00-000, 982, 500, 482, 394, 1348.25, 374, 1349.24, 181
5, 11:41:00-000, 998, 498, 500, 377, 1349.59, 381, 1349.89, 189
5, 11:42:00-000, 995, 490, 505, 402, 1348.11, 456, 1349.78, 141
5, 11:43:00-000, 1, 0, 1, 42, 1344.42, 19, 1355.79, 121
5, 11:44:00-000, 1054, 543, 511, 418, 1349.04, 460, 1350.60, 112
5, 11:45:00-000, 1000, 490, 510, 376, 1348.77, 366, 1349.63, 105
5, 11:46:00-000, 1103, 554, 549, 456, 1347.37, 409, 1347.99, 170
5, 11:47:00-000, 2, 2, 0, 2, 1350.00, 24, 1354.00, 164
5, 11:48:00-000, 1009, 531, 478, 431, 1348.28, 424, 1349.75, 159
5, 11:49:00-000, 1030, 537, 493, 396, 1348.94, 368, 1349.67, 140
5, 11:50:00-000, 1013, 521, 492, 399, 1348.90, 448, 1349.77, 157
5, 11:51:00-000, 1, 0, 1, 6, 1345.00, 24, 1356.96, 175
5, 11:52:00-000, 1063, 516, 547, 473, 1347.44, 395, 1348.59, 90
5, 11:53:00-000, 1011, 504, 507, 420, 1347.70, 410, 1348.45, 166
5, 11:54:00-000, 1001, 479, 522, 427, 1348.16, 391, 1349.09, 161
5, 11:55:00-000, 1, 1, 0, 4, 1346.50, 25, 1355.16, 100
5, 11:56:00-000, 1104, 588, 516, 472, 1348.42, 442, 1349.46, 138
5, 11:57:00-000, 1161, 591, 570, 390, 1349.27, 460, 1349.90, 138
5, 11:58:00-000, 924, 465, 459, 401, 1348.40, 337, 1349.46, 173
5, 11:59:00-000, 0, 0, 0, 6, 1345.00, 23, 1355.78, 212
5, 12:00:00-000, 1039, 491, 548, 418, 1347.80, 426, 1348.73, 117
5, 12:01:00-000, 1072, 549, 523, 418, 1348.56, 405, 1348.90, 170
5, 12:02:00-000, 1005, 504, 501, 318, 1348.31, 417, 1349.39, 157
5, 12:03:00-000, 2, 2, 0, 42, 1346.52, 11, 1356.00, 171
5, 12:04:00-000, 870, 428, 442, 308, 1348.26, 362, 1349.28, 182
5, 12:05:00-000, 962, 521, 441, 394, 1348.99, 365, 1349.44, 146
5, 12:06:00-000, 1048, 524, 524, 446, 1348.13, 436, 1349.09, 133
5, 12:07:00-000, 8, 0, 8, 13, 1344.38, 16, 1350.94, 127
5, 12:08:00-000, 1055, 546, 509, 439, 1347.57, 411, 1348.65, 155
5, 12:09:00-000, 1057, 554, 503, 389, 1349.00, 408, 1349.73, 137
5, 12:10:00-000, 1004, 541, 463, 458, 1348.28, 383, 1349.51, 139
5, 12:11:00-000, 0, 0, 0, 0, 0.00, 32, 1356.65, 131
5, 12:12:00-000, 1023, 470, 553, 420, 1347.75, 437, 1348.92, 138
5, 12:13:00-000, 991, 487, 504, 369, 1348.17, 334, 1348.23, 147
5, 12:14:00-000, 1015, 494, 521, 408, 1348.20, 431, 1348.90, 173
5, 12:15:00-000, 1, 1, 0, 2, 1347.50, 27, 1355.00, 166
5, 12:16:00-000, 961, 475, 486, 356, 1348.78, 364, 1349.64, 161
5, 12:17:00-000, 987, 501, 486, 362, 1349.34, 380, 1349.63, 186
5, 12:18:00-000, 1057, 518, 539, 424, 1348.09, 407, 1348.61, 180
5, 12:19:00-000, 0, 0, 0, 13, 1345.00, 45, 1355.42, 110
5, 12:20:00-000, 1009, 501, 508, 357, 1348.84, 321, 1348.47, 161
5, 12:21:00-000, 1096, 519, 577, 369, 1348.62, 405, 1348.03, 235
5, 12:22:00-000, 1108, 587, 521, 402, 1348.56, 401, 1348.75, 220
5, 12:23:00-000, 0, 0, 0, 12, 1346.00, 0, 0.00, 218
5, 12:24:00-000, 1007, 567, 440, 427, 1349.58, 352, 1348.93, 233
5, 12:25:00-000, 1020, 494, 526, 376, 1348.50, 406, 1348.47, 199
5, 12:26:00-000, 1075, 579, 496, 372, 1348.98, 376, 1349.33, 190
5, 12:27:00-000, 2, 2, 0, 28, 1346.36, 5, 1354.00, 180
5, 12:28:00-000, 1119, 580, 539, 446, 1349.07, 359, 1349.31, 233
5, 12:29:00-000, 992, 534, 458, 376, 1349.00, 354, 1348.98, 186
5, 12:30:00-000, 1012, 472, 540, 382, 1348.02, 430, 1348.27, 245
5, 12:31:00-000, 3, 2, 1, 2, 1351.00, 5, 1352.60, 181
5, 12:32:00-000, 1028, 521, 507, 371, 1349.38, 359, 1349.24, 163
5, 12:33:00-000, 1042, 611, 431, 426, 1350.33, 366, 1350.75, 202
5, 12:34:00-000, 1020, 496, 524, 406, 1348.97, 411, 1349.68, 167
5, 12:35:00-000, 1, 0, 1, 17, 1346.00, 0, 0.00, 211
5, 12:36:00-000, 1060, 598, 462, 446, 1349.17, 377, 1350.08, 159
5, 12:37:00-000, 965, 490, 475, 343, 1348.48, 359, 1349.27, 174
5, 12:38:00-000, 986, 481, 505, 383, 1348.90, 352, 1348.81, 192
5, 12:39:00-000, 2, 1, 1, 25, 1345.04, 20, 1354.00, 181
5, 12:40:00-000, 1083, 575, 508, 453, 1348.85, 394, 1349.33, 126
5, 12:41:00-000, 1046, 534, 512, 390, 1348.16, 394, 1349.01, 183
5, 12:42:00-000, 1062, 552, 510, 411, 1348.23, 410, 1348.71, 226
5, 12:43:00-000, 1, 0, 1, 23, 1345.43, 1, 1348.00, 157
5, 12:44:00-000, 1050, 554, 496, 397, 1349.32, 364, 1349.52, 177
5, 12:45:00-000, 1078, 495, 583, 383, 1349.43, 412, 1349.90, 202
5, 12:46:00-000, 1008, 547, 461, 401, 1349.28, 402, 1350.88, 195
5, 12:47:00-000, 5, 0, 5, 51, 1346.05, 18, 1354.55, 138
5, 12:48:00-000, 1026, 544, 482, 386, 1348.40, 402, 1349.88, 189
5, 12:49:00-000, 988, 533, 455, 373, 1349.15, 372, 1349.81, 150
5, 12:50:00-000, 1015, 527, 488, 401, 1349.02, 371, 1349.77, 212
5, 12:51:00-000, 0, 0, 0, 58, 1345.34, 26, 1355.80, 133
5, 12:52:00-000, 946, 498, 448, 381, 1348.67, 353, 1349.71, 154
5, 12:53:00-000, 1125, 511, 614, 399, 1348.33, 468, 1348.71, 143
5, 12:54:00-000, 901, 399, 502, 318, 1348.11, 381, 1349.32, 158
5, 12:55:00-000, 3, 3, 0, 5, 1347.00, 52, 1355.44, 177
5, 12:56:00-000, 1021, 556, 465, 393, 1348.69, 378, 1349.02, 143
5, 12:57:00-000, 1051, 513, 538, 401, 1348.30, 413, 1348.89, 179
5, 12:58:00-000, 1015, 515, 500, 387, 1348.82, 357, 1349.57, 164
5, 12:59:00-000, 9, 8, 1, 1, 1346.00, 13, 1353.84, 165
5, 13:00:00-000, 998, 467, 531, 428, 1348.17, 388, 1348.86, 205
5, 13:01:00-000, 994, 533, 461, 412, 1348.37, 454, 1349.90, 127
5, 13:02:00-000, 1056, 516, 540, 403, 1348.58, 391, 1349.51, 112
5, 13:03:00-000, 0, 0, 0, 20, 1344.60, 0, 0.00, 128
5, 13:04:00-000, 1086, 565, 521, 457, 1348.11, 425, 1348.94, 169
5, 13:05:00-000, 992, 480, 512, 382, 1348.92, 374, 1349.37, 183
5, 13:06:00-000, 938, 511, 427, 343, 1348.94, 356, 1350.04, 145
5, 13:07:00-000, 5, 2, 3, 5, 1347.00, 35, 1355.48, 147
5, 13:08:00-000, 1058, 556, 502, 403, 1348.85, 457, 1350.22, 181
5, 13:09:00-000, 1119, 555, 564, 422, 1349.19, 428, 1349.53, 178
5, 13:10:00-000, 1106, 631, 475, 466, 1348.68, 418, 1349.77, 134
5, 13:11:00-000, 4, 0, 4, 0, 0.00, 6, 1356.00, 180
5, 13:12:00-000, 979, 488, 491, 449, 1348.56, 382, 1349.30, 158
5, 13:13:00-000, 996, 513, 483, 373, 1349.13, 393, 1349.64, 165
5, 13:14:00-000, 1095, 597, 498, 455, 1349.61, 439, 1350.63, 157
5, 13:15:00-000, 1, 1, 0, 41, 1346.26, 0, 0.00, 129
5, 13:16:00-000, 1068, 561, 507, 460, 1348.68, 423, 1349.69, 158
5, 13:17:00-000, 1039, 559, 480, 409, 1349.18, 385, 1349.53, 147
5, 13:18:00-000, 946, 529, 417, 420, 1349.06, 402, 1350.74, 136
5, 13:19:00-000, 1, 1, 0, 13, 1345.31, 17, 1357.00, 144
5, 13:20:00-000, 1074, 531, 543, 390, 1349.13, 423, 1350.33, 109
5, 13:21:00-000, 994, 496, 498, 419, 1348.45, 410, 1348.67, 130
5, 13:22:00-000, 1032, 522, 510, 416, 1349.10, 445, 1349.81, 184
5, 13:23:00-000, 6, 2, 4, 19, 1346.00, 5, 1351.60, 118
5, 13:24:00-000, 1040, 534, 506, 394, 1348.93, 482, 1350.65, 96
5, 13:25:00-000, 979, 442, 537, 420, 1348.19, 386, 1349.31, 115
5, 13:26:00-000, 1057, 556, 501, 412, 1349.26, 479, 1350.56, 134
5, 13:27:00-000, 3, 0, 3, 23, 1344.91, 13, 1355.54, 128
5, 13:28:00-000, 1044, 554, 490, 431, 1348.98, 433, 1350.24, 136
5, 13:29:00-000, 1067, 535, 532, 388, 1348.97, 402, 1349.86, 139
5, 13:30:00-000, 1000, 524, 476, 441, 1348.40, 429, 1350.02, 133
5, 13:31:00-000, 3, 0, 3, 14, 1343.93, 18, 1356.94, 141
5, 13:32:00-000, 984, 511, 473, 415, 1348.80, 365, 1349.46, 150
5, 13:33:00-000, 1016, 498, 518, 370, 1348.70, 389, 1348.95, 162
5, 13:34:00-000, 1158, 548, 610, 481, 1347.84, 440, 1348.58, 142
5, 13:35:00-000, 3, 1, 2, 18, 1344.00, 1, 1354.00, 151
5, 13:36:00-000, 946, 472, 474, 423, 1348.48, 375, 1349.43, 179
5, 13:37:00-000, 884, 463, 421, 305, 1349.44, 361, 1350.37, 142
5, 13:38:00-000, 1091, 552, 539, 436, 1348.30, 495, 1349.72, 95
5, 13:39:00-000, 6, 4, 2, 22, 1345.45, 36, 1356.78, 127
5, 13:40:00-000, 960, 510, 450, 389, 1348.53, 349, 1349.89, 156
5, 13:41:00-000, 1015, 474, 541, 338, 1348.42, 388, 1348.95, 161
5, 13:42:00-000, 1088, 602, 486, 452, 1348.69, 391, 1349.89, 136
5, 13:43:00-000, 2, 2, 0, 18, 1346.56, 2, 1353.00, 188
5, 13:44:00-000, 1104, 557, 547, 416, 1348.62, 462, 1348.99, 210
5, 13:45:00-000, 988, 528, 460, 375, 1349.93, 381, 1350.55, 185
5, 13:46:00-000, 1001, 536, 465, 377, 1348.73, 415, 1349.99, 154
5, 13:47:00-000, 2, 2, 0, 36, 1345.66, 0, 0.00, 148
5, 13:48:00-000, 1046, 588, 458, 426, 1349.45, 389, 1350.13, 185
5, 13:49:00-000, 983, 523, 460, 360, 1349.32, 403, 1350.44, 149
5, 13:50:00-000, 1054, 534, 520, 424, 1348.96, 410, 1349.64, 163
5, 13:51:00-000, 3, 1, 2, 3, 1346.33, 16, 1355.88, 143
5, 13:52:00-000, 976, 485, 491, 375, 1348.80, 447, 1350.27, 161
5, 13:53:00-000, 1036, 571, 465, 416, 1348.49, 381, 1349.23, 167
5, 13:54:00-000, 1062, 508, 554, 414, 1348.47, 446, 1349.26, 118
5, 13:55:00-000, 1, 0, 1, 48, 1344.01, 1, 1346.00, 132
5, 13:56:00-000, 1047, 516, 531, 384, 1348.50, 394, 1349.11, 179
5, 13:57:00-000, 1105, 573, 532, 430, 1349.49, 436, 1349.28, 153
5, 13:58:00-000, 957, 496, 461, 365, 1348.83, 385, 1350.13, 203
5, 13:59:00-000, 2, 0, 2, 0, 0.00, 35, 1355.77, 131
5, 14:00:00-000, 994, 492, 502, 407, 1348.54, 422, 1349.64, 128
5, 14:01:00-000, 1058, 517, 541, 375, 1348.70, 398, 1349.35, 174
5, 14:02:00-000, 1015, 519, 496, 446, 1349.02, 404, 1350.32, 143
5, 14:03:00-000, 4, 4, 0, 28, 1345.14, 23, 1356.00, 150
5, 14:04:00-000, 1035, 532, 503, 434, 1348.74, 381, 1350.04, 179
5, 14:05:00-000, 929, 491, 438, 376, 1349.24, 367, 1349.77, 143
5, 14:06:00-000, 1127, 506, 621, 460, 1347.74, 454, 1348.26, 140
5, 14:07:00-000, 2, 1, 1, 26, 1344.15, 47, 1353.57, 101
5, 14:08:00-000, 1060, 513, 547, 388, 1348.44, 461, 1349.90, 125
5, 14:09:00-000, 1049, 493, 556, 396, 1348.29, 386, 1348.30, 163
5, 14:10:00-000, 997, 500, 497, 354, 1349.14, 482, 1350.47, 170
5, 14:11:00-000, 0, 0, 0, 12, 1345.66, 9, 1356.89, 148
5, 14:12:00-000, 1020, 522, 498, 444, 1348.05, 407, 1349.21, 128
5, 14:13:00-000, 939, 469, 470, 377, 1348.42, 352, 1349.33, 138
5, 14:14:00-000, 1084, 559, 525, 412, 1348.58, 430, 1349.53, 146
5, 14:15:00-000, 2, 1, 1, 10, 1346.70, 2, 1352.00, 130
5, 14:16:00-000, 1029, 543, 486, 454, 1348.59, 384, 1348.68, 183
5, 14:17:00-000, 1126, 599, 527, 448, 1348.78, 370, 1348.64, 210
5, 14:18:00-000, 1046, 520, 526, 434, 1347.58, 418, 1349.09, 120
5, 14:19:00-000, 3, 1, 2, 38, 1344.73, 18, 1353.89, 181
5, 14:20:00-000, 1004, 495, 509, 396, 1348.21, 414, 1349.59, 158
5, 14:21:00-000, 1020, 488, 532, 373, 1348.92, 404, 1349.77, 132
5, 14:22:00-000, 1001, 515, 486, 425, 1348.71, 405, 1349.67, 162
5, 14:23:00-000, 2, 2, 0, 0, 0.00, 18, 1355.00, 155
5, 14:24:00-000, 1027, 521, 506, 406, 1349.34, 406, 1350.58, 154
5, 14:25:00-000, 960, 497, 463, 365, 1349.36, 348, 1349.46, 166
5, 14:26:00-000, 1182, 608, 574, 472, 1348.28, 420, 1349.20, 147
5, 14:27:00-000, 0, 0, 0, 31, 1346.00, 33, 1354.42, 147
5, 14:28:00-000, 996, 518, 478, 405, 1349.25, 395, 1350.41, 187
5, 14:29:00-000, 997, 524, 473, 418, 1348.66, 363, 1348.66, 161
5, 14:30:00-000, 1039, 551, 488, 424, 1348.80, 456, 1350.04, 154
5, 14:31:00-000, 4, 1, 3, 13, 1345.00, 25, 1356.08, 130
5, 14:32:00-000, 999, 434, 565, 413, 1348.42, 433, 1349.38, 118
5, 14:33:00-000, 914, 439, 475, 329, 1348.17, 385, 1349.77, 118
5, 14:34:00-000, 1113, 542, 571, 427, 1348.77, 481, 1350.32, 111
5, 14:35:00-000, 0, 0, 0, 0, 0.00, 32, 1357.06, 121
5, 14:36:00-000, 1054, 546, 508, 426, 1349.17, 411, 1350.36, 198
5, 14:37:00-000, 927, 492, 435, 324, 1348.89, 332, 1348.87, 168
5, 14:38:00-000, 961, 476, 485, 462, 1347.84, 388, 1349.43, 136
5, 14:39:00-000, 16, 5, 11, 17, 1344.29, 17, 1353.00, 118
5, 14:40:00-000, 1001, 584, 417, 423, 1350.23, 389, 1351.41, 117
5, 14:41:00-000, 1110, 524, 586, 383, 1348.08, 442, 1348.87, 151
5, 14:42:00-000, 1079, 539, 540, 421, 1348.03, 446, 1349.26, 154
5, 14:43:00-000, 2, 0, 2, 34, 1345.00, 15, 1354.60, 180
5, 14:44:00-000, 998, 495, 503, 421, 1348.58, 401, 1349.81, 177
5, 14:45:00-000, 1103, 558, 545, 396, 1348.47, 451, 1349.12, 136
5, 14:46:00-000, 1009, 507, 502, 405, 1349.27, 378, 1349.40, 153
5, 14:47:00-000, 4, 0, 4, 0, 0.00, 25, 1354.15, 175
5, 14:48:00-000, 1054, 520, 534, 412, 1348.36, 406, 1349.07, 177
5, 14:49:00-000, 1044, 529, 515, 386, 1348.90, 383, 1349.17, 163
5, 14:50:00-000, 1009, 501, 508, 396, 1348.53, 410, 1350.01, 151
5, 14:51:00-000, 2, 1, 1, 5, 1345.40, 7, 1355.00, 188
5, 14:52:00-000, 964, 470, 494, 350, 1348.79, 360, 1349.87, 194
5, 14:53:00-000, 1009, 528, 481, 406, 1348.59, 360, 1349.28, 182
5, 14:54:00-000, 1084, 606, 478, 477, 1349.16, 444, 1350.42, 150
5, 14:55:00-000, 6, 0, 6, 0, 0.00, 17, 1355.23, 123
5, 14:56:00-000, 1016, 536, 480, 390, 1348.95, 389, 1349.75, 200
5, 14:57:00-000, 1014, 514, 500, 389, 1348.89, 362, 1348.91, 187
5, 14:58:00-000, 1068, 547, 521, 402, 1349.47, 460, 1349.89, 152
5, 14:59:00-000, 2, 0, 2, 42, 1345.64, 2, 1350.00, 170
5, 15:00:00-000, 1088, 557, 531, 429, 1348.56, 397, 1349.22, 147
5, 15:01:00-000, 1015, 575, 440, 396, 1348.89, 343, 1349.54, 174
5, 15:02:00-000, 1058, 544, 514, 465, 1348.81, 426, 1349.90, 195
5, 15:03:00-000, 4, 0, 4, 0, 0.00, 24, 1355.83, 163
5, 15:04:00-000, 955, 424, 531, 338, 1348.13, 451, 1349.68, 149
5, 15:05:00-000, 934, 526, 408, 394, 1349.38, 301, 1349.86, 151
5, 15:06:00-000, 945, 520, 425, 356, 1349.93, 361, 1350.40, 156
5, 15:07:00-000, 2, 2, 0, 20, 1347.10, 44, 1356.65, 130
5, 15:08:00-000, 1008, 494, 514, 415, 1348.38, 395, 1348.93, 106
5, 15:09:00-000, 1007, 478, 529, 378, 1348.38, 394, 1348.64, 156
5, 15:10:00-000, 1066, 507, 559, 398, 1348.76, 413, 1348.95, 183
5, 15:11:00-000, 1, 0, 1, 37, 1345.24, 34, 1353.91, 190
5, 15:12:00-000, 1084, 516, 568, 452, 1348.33, 435, 1349.35, 130
5, 15:13:00-000, 972, 537, 435, 367, 1349.63, 351, 1349.95, 134
5, 15:14:00-000, 1091, 575, 516, 460, 1350.02, 459, 1350.84, 157
5, 15:15:00-000, 0, 0, 0, 16, 1347.00, 0, 0.00, 168
5, 15:16:00-000, 1040, 506, 534, 411, 1348.32, 443, 1350.05, 138
5, 15:17:00-000, 1057, 540, 517, 378, 1349.23, 393, 1349.50, 143
5, 15:18:00-000, 994, 532, 462, 391, 1349.50, 402, 1350.43, 161
5, 15:19:00-000, 5, 0, 5, 25, 1346.00, 9, 1353.33, 188
5, 15:20:00-000, 1081, 565, 516, 419, 1349.02, 373, 1349.56, 148
5, 15:21:00-000, 1065, 504, 561, 400, 1348.11, 429, 1349.24, 213
5, 15:22:00-000, 1099, 567, 532, 419, 1349.44, 386, 1350.11, 161
5, 15:23:00-000, 11, 4, 7, 20, 1347.00, 111, 1355.78, 162
5, 15:24:00-000, 972, 497, 475, 387, 1349.25, 403, 1350.86, 167
5, 15:25:00-000, 979, 493, 486, 372, 1349.30, 390, 1350.29, 135
5, 15:26:00-000, 1053, 572, 481, 450, 1348.83, 411, 1349.95, 132
5, 15:27:00-000, 2, 0, 2, 20, 1345.00, 50, 1356.69, 142
5, 15:28:00-000, 1011, 508, 503, 383, 1348.45, 400, 1350.13, 138
5, 15:29:00-000, 1040, 545, 495, 408, 1349.63, 383, 1349.92, 159
5, 15:30:00-000, 1017, 492, 525, 382, 1348.42, 456, 1349.70, 167
5, 15:31:00-000, 3, 1, 2, 23, 1346.00, 21, 1355.57, 131
5, 15:32:00-000, 1044, 551, 493, 432, 1349.34, 418, 1349.97, 154
5, 15:33:00-000, 1120, 526, 594, 450, 1348.35, 469, 1349.48, 122
5, 15:34:00-000, 967, 467, 500, 380, 1348.95, 383, 1349.40, 129
5, 15:35:00-000, 0, 0, 0, 2, 1344.00, 18, 1354.55, 169
5, 15:36:00-000, 943, 482, 461, 406, 1348.10, 362, 1349.35, 132
5, 15:37:00-000, 955, 488, 467, 352, 1349.23, 357, 1349.46, 145
5, 15:38:00-000, 1061, 536, 525, 423, 1348.64, 457, 1349.90, 152
5, 15:39:00-000, 3, 0, 3, 9, 1345.00, 15, 1356.00, 139
5, 15:40:00-000, 1023, 568, 455, 342, 1349.26, 281, 1348.73, 170
5, 15:41:00-000, 1098, 584, 514, 417, 1349.19, 338, 1348.38, 215
5, 15:42:00-000, 1008, 495, 513, 382, 1349.33, 351, 1349.40, 306
5, 15:43:00-000, 1, 1, 0, 1, 1352.00, 0, 0.00, 217
5, 15:44:00-000, 1104, 538, 566, 410, 1348.13, 427, 1348.57, 243
5, 15:45:00-000, 1050, 525, 525, 397, 1348.92, 408, 1349.07, 223
5, 15:46:00-000, 1042, 518, 524, 397, 1349.00, 388, 1349.42, 190
5, 15:47:00-000, 2, 1, 1, 0, 0.00, 1, 1353.00, 187
5, 15:48:00-000, 1046, 539, 507, 384, 1349.15, 392, 1349.45, 189
5, 15:49:00-000, 987, 492, 495, 362, 1348.83, 354, 1349.12, 219
5, 15:50:00-000, 1052, 517, 535, 404, 1349.81, 379, 1349.67, 163
5, 15:51:00-000, 2, 0, 2, 23, 1346.00, 0, 0.00, 229
5, 15:52:00-000, 950, 467, 483, 334, 1348.59, 373, 1349.06, 172
5, 15:53:00-000, 1031, 548, 483, 361, 1349.47, 377, 1350.18, 199
5, 15:54:00-000, 955, 493, 462, 395, 1348.60, 356, 1350.02, 136
5, 15:55:00-000, 1, 1, 0, 34, 1347.14, 0, 0.00, 193
5, 15:56:00-000, 1028, 550, 478, 392, 1349.24, 383, 1349.77, 176
5, 15:57:00-000, 1050, 515, 535, 404, 1348.65, 426, 1348.97, 172
5, 15:58:00-000, 1110, 580, 530, 438, 1348.99, 420, 1349.34, 185
5, 15:59:00-000, 1, 0, 1, 2, 1349.00, 1, 1354.00, 177
5, 16:00:00-000, 1164, 594, 570, 466, 1348.61, 449, 1349.32, 185
5, 16:01:00-000, 1047, 579, 468, 421, 1349.35, 333, 1349.71, 187
5, 16:02:00-000, 1021, 543, 478, 412, 1349.19, 375, 1349.51, 187
5, 16:03:00-000, 5, 3, 2, 23, 1345.78, 2, 1349.00, 211
5, 16:04:00-000, 1023, 515, 508, 403, 1348.82, 427, 1349.63, 179
5, 16:05:00-000, 1002, 508, 494, 377, 1348.78, 362, 1350.10, 162
5, 16:06:00-000, 1079, 520, 559, 423, 1348.62, 456, 1349.64, 158
5, 16:07:00-000, 0, 0, 0, 0, 0.00, 21, 1356.00, 168
5, 16:08:00-000, 1050, 515, 535, 380, 1348.95, 445, 1349.76, 151
5, 16:09:00-000, 1011, 550, 461, 458, 1349.22, 383, 1349.98, 149
5, 16:10:00-000, 948, 515, 433, 386, 1349.92, 352, 1350.82, 165
5, 16:11:00-000, 3, 1, 2, 40, 1347.57, 2, 1348.00, 116
5, 16:12:00-000, 1108, 573, 535, 464, 1348.09, 452, 1349.22, 161
5, 16:13:00-000, 1050, 465, 585, 348, 1347.89, 412, 1348.59, 134
5, 16:14:00-000, 1067, 553, 514, 379, 1349.49, 464, 1350.82, 147
5, 16:15:00-000, 7, 0, 7, 8, 1347.00, 19, 1355.68, 159
5, 16:16:00-000, 933, 433, 500, 369, 1348.48, 379, 1350.05, 225
5, 16:17:00-000, 1042, 544, 498, 381, 1348.61, 361, 1348.50, 139
5, 16:18:00-000, 939, 493, 446, 337, 1349.41, 358, 1350.14, 157
5, 16:19:00-000, 3, 1, 2, 34, 1345.64, 25, 1355.96, 197
5, 16:20:00-000, 1060, 544, 516, 457, 1349.27, 384, 1350.14, 170
5, 16:21:00-000, 1072, 556, 516, 429, 1348.81, 406, 1348.90, 143
5, 16:22:00-000, 1004, 490, 514, 383, 1348.61, 435, 1349.63, 181
5, 16:23:00-000, 1, 0, 1, 24, 1344.58, 16, 1354.12, 140
5, 16:24:00-000, 1083, 587, 496, 467, 1349.12, 404, 1350.41, 145
5, 16:25:00-000, 1012, 499, 513, 412, 1348.75, 408, 1349.55, 173
5, 16:26:00-000, 944, 499, 445, 369, 1348.75, 344, 1349.78, 146
5, 16:27:00-000, 1, 0, 1, 18, 1346.00, 20, 1355.00, 106
5, 16:28:00-000, 1092, 516, 576, 420, 1349.06, 434, 1349.89, 173
5, 16:29:00-000, 1079, 540, 539, 414, 1349.19, 474, 1350.00, 139
6, 12:20:00-000, 6948, 3391, 3557, 1606, 1347.70, 1580, 1348.26, 0
6, 12:21:00-000, 0, 0, 0, 129, 1346.00, 113, 1353.00, 0
6, 12:22:00-000, 0, 0, 0, 112, 1346.00, 117, 1353.80, 0
6, 12:23:00-000, 0, 0, 0, 9, 1346.00, 96, 1354.00, 0
6, 12:24:00-000, 0, 0, 0, 0, 0.00, 133, 1354.63, 0
6, 12:25:00-000, 0, 0, 0, 33, 1345.00, 4, 1355.00, 0
6, 12:26:00-000, 0, 0, 0, 22, 1345.00, 0, 0.00, 0
6, 12:28:00-000, 0, 0, 0, 0, 0.00, 22, 1355.00, 0
6, 12:29:00-000, 0, 0, 0, 0, 0.00, 50, 1355.00, 0
6, 12:30:00-000, 0, 0, 0, 49, 1345.00, 15, 1355.00, 0
6, 12:31:00-000, 0, 0, 0, 36, 1345.00, 22, 1355.00, 0
6, 12:32:00-000, 0, 0, 0, 65, 1345.00, 47, 1355.00, 0
6, 12:33:00-000, 0, 0, 0, 0, 0.00, 14, 1356.00, 0
6, 12:34:00-000, 0, 0, 0, 0, 0.00, 17, 1356.00, 0
6, 12:35:00-000, 0, 0, 0, 0, 0.00, 30, 1356.00, 0
6, 12:36:00-000, 0, 0, 0, 3, 1345.00, 6, 1356.00, 0
6, 12:37:00-000, 0, 0, 0, 7, 1345.00, 20, 1356.00, 0
6, 12:38:00-000, 0, 0, 0, 25, 1345.00, 0, 0.00, 0
6, 12:39:00-000, 0, 0, 0, 23, 1344.00, 0, 0.00, 0
6, 12:40:00-000, 0, 0, 0, 9, 1344.00, 4, 1356.00, 124
6, 12:41:00-000, 0, 0, 0, 0, 0.00, 0, 0.00, 129
6, 12:42:00-000, 0, 0, 0, 0, 0.00, 0, 0.00, 111
6, 12:43:00-000, 0, 0, 0, 0, 0.00, 0, 0.00, 126
6, 12:44:00-000, 0, 0, 0, 0, 0.00, 86, 1356.00, 122
6, 12:45:00-000, 0, 0, 0, 0, 0.00, 6, 1356.00, 120
6, 12:46:00-000, 0, 0, 0, 0, 0.00, 25, 1356.00, 107
6, 12:47:00-000, 0, 0, 0, 0, 0.00, 0, 0.00, 121
6, 12:48:00-000, 0, 0, 0, 0, 0.00, 0, 0.00, 120
6, 12:49:00-000, 0, 0, 0, 0, 0.00, 0, 0.00, 112
6, 12:50:00-000, 0, 0, 0, 0, 0.00, 17, 1357.00, 122
6, 12:51:00-000, 0, 0, 0, 0, 0.00, 0, 0.00, 109
6, 12:52:00-000, 0, 0, 0, 0, 0.00, 22, 1357.00, 116
6, 12:53:00-000, 0, 0, 0, 0, 0.00, 0, 0.00, 106
6, 12:54:00-000, 0, 0, 0, 42, 1344.00, 0, 0.00, 127
6, 12:55:00-000, 0, 0, 0, 7, 1344.00, 0, 0.00, 112
6, 12:56:00-000, 0, 0, 0, 0, 0.00, 0, 0.00, 132
6, 12:57:00-000, 0, 0, 0, 0, 0.00, 0, 0.00, 104
6, 12:58:00-000, 0, 0, 0, 0, 0.00, 0, 0.00, 89
6, 12:59:00-000, 0, 0, 0, 0, 0.00, 0, 0.00, 116
6, 15:40:00-000, 6953, 3444, 3509, 1548, 1347.60, 1603, 1348.25, 0
6, 15:41:00-000, 0, 0, 0, 62, 1347.00, 93, 1353.00, 0
6, 15:42:00-000, 0, 0, 0, 40, 1346.00, 118, 1353.62, 0
6, 15:43:00-000, 0, 0, 0, 76, 1346.00, 108, 1354.00, 0
6, 15:44:00-000, 0, 0, 0, 137, 1346.00, 59, 1354.00, 0
6, 15:45:00-000, 0, 0, 0, 0, 0.00, 6, 1355.00, 0
6, 15:46:00-000, 0, 0, 0, 87, 1345.00, 40, 1355.00, 0
6, 15:47:00-000, 0, 0, 0, 28, 1345.00, 31, 1355.00, 0
6, 15:48:00-000, 0, 0, 0, 0, 0.00, 47, 1355.00, 0
6, 15:49:00-000, 0, 0, 0, 0, 0.00, 21, 1355.00, 0
6, 15:50:00-000, 0, 0, 0, 0, 0.00, 19, 1355.00, 0
6, 15:51:00-000, 0, 0, 0, 0, 0.00, 14, 1355.00, 0
6, 15:52:00-000, 0, 0, 0, 113, 1345.00, 14, 1355.00, 0
6, 15:53:00-000, 0, 0, 0, 0, 0.00, 28, 1355.04, 0
6, 15:55:00-000, 0, 0, 0, 0, 0.00, 31, 1356.00, 0
6, 15:56:00-000, 0, 0, 0, 0, 0.00, 5, 1356.00, 0
6, 15:58:00-000, 0, 0, 0, 0, 0.00, 23, 1356.00, 0
6, 15:59:00-000, 0, 0, 0, 0, 0.00, 24, 1356.00, 0
6, 16:00:00-000, 1, 0, 1, 0, 0.00, 9, 1355.44, 106
6, 16:01:00-000, 0, 0, 0, 0, 0.00, 32, 1356.00, 150
6, 16:02:00-000, 0, 0, 0, 0, 0.00, 29, 1356.00, 122
6, 16:03:00-000, 0, 0, 0, 24, 1344.00, 1, 1356.00, 129
6, 16:04:00-000, 0, 0, 0, 2, 1344.00, 26, 1356.00, 124
6, 16:05:00-000, 0, 0, 0, 0, 0.00, 16, 1356.00, 115
6, 16:06:00-000, 1, 0, 1, 15, 1344.00, 9, 1355.44, 119
6, 16:07:00-000, 0, 0, 0, 1, 1344.00, 0, 0.00, 127
6, 16:08:00-000, 0, 0, 0, 0, 0.00, 0, 0.00, 135
6, 16:09:00-000, 0, 0, 0, 0, 0.00, 0, 0.00, 111
6, 16:10:00-000, 0, 0, 0, 0, 0.00, 0, 0.00, 107
6, 16:11:00-000, 0, 0, 0, 0, 0.00, 0, 0.00, 127
6, 16:12:00-000, 0, 0, 0, 22, 1344.00, 0, 0.00, 103
6, 16:13:00-000, 0, 0, 0, 0, 0.00, 0, 0.00, 108
6, 16:14:00-000, 0, 0, 0, 3, 1344.00, 0, 0.00, 142
6, 16:15:00-000, 0, 0, 0, 0, 0.00, 0, 0.00, 100
6, 16:16:00-000, 0, 0, 0, 0, 0.00, 0, 0.00, 95
6, 16:17:00-000, 0, 0, 0, 0, 0.00, 0, 0.00, 117
6, 16:18:00-000, 0, 0, 0, 0, 0.00, 0, 0.00, 131
6, 16:19:00-000, 0, 0, 0, 0, 0.00, 0, 0.00, 123
6, 16:20:00-000, 14, 8, 6, 4, 1348.00, 5, 1350.40, 0
6, 16:22:00-000, 0, 0, 0, 0, 0.00, 1, 1356.00, 0
7, 09:06:00-000, 1308, 8, 1300, 0, 0.00, 0, 0.00, 1308
7, 09:07:00-000, 10410, 7280, 3130, 0, 0.00, 0, 0.00, 9670
7, 09:08:00-000, 50, 50, 0, 0, 0.00, 0, 0.00, 790
7, 09:21:00-000, 6353, 2671, 3682, 6, 1352.00, 6, 1346.50, 6341
7, 09:22:00-000, 7738, 3552, 4186, 0, 0.00, 0, 0.00, 7738
7, 09:23:00-000, 1495, 1480, 15, 0, 0.00, 0, 0.00, 0
7, 09:24:00-000, 19, 19, 0, 15, 1352.20, 15, 1350.07, 1484
7, 09:30:00-000, 12618, 1794, 10824, 49, 1351.77, 49, 1350.93, 12520
7, 09:31:00-000, 742, 12, 730, 0, 0.00, 0, 0.00, 742
7, 09:35:00-000, 19972, 14067, 5905, 1, 1350.00, 0, 0.00, 19011
7, 09:36:00-000, 19, 0, 19, 18, 1348.00, 19, 1347.68, 942
7, 09:38:00-000, 5602, 3648, 1954, 0, 0.00, 0, 0.00, 5602
7, 09:45:00-000, 8926, 4425, 4501, 0, 0.00, 0, 0.00, 8926
7, 09:47:00-000, 4672, 3790, 882, 0, 0.00, 2, 1352.00, 4670
7, 09:48:00-000, 2443, 20, 2423, 12, 1350.67, 10, 1352.00, 2421
7, 09:53:00-000, 2865, 2149, 716, 6, 1355.00, 6, 1352.00, 2853
7, 09:54:00-000, 18227, 7321, 10906, 2, 1348.00, 2, 1349.00, 18051
7, 09:55:00-000, 12854, 6300, 6554, 3, 1350.67, 3, 1350.33, 13020
7, 09:56:00-000, 15313, 8407, 6906, 64, 1348.33, 64, 1346.76, 14341
7, 09:57:00-000, 15609, 8014, 7595, 0, 0.00, 0, 0.00, 16453
7, 10:05:00-000, 1990, 544, 1446, 0, 0.00, 0, 0.00, 1990
7, 10:06:00-000, 10662, 6904, 3758, 7, 1348.29, 7, 1352.29, 10648
7, 10:09:00-000, 5059, 2944, 2115, 0, 0.00, 0, 0.00, 5059
7, 10:12:00-000, 5351, 3149, 2202, 2, 1347.00, 2, 1346.00, 5347
7, 10:13:00-000, 6446, 2792, 3654, 25, 1351.96, 25, 1353.00, 6396
7, 10:14:00-000, 15938, 10123, 5815, 1, 1349.00, 1, 1348.00, 15936
7, 10:15:00-000, 8128, 5924, 2204, 7, 1347.29, 7, 1348.71, 8114
7, 10:16:00-000, 62, 12, 50, 0, 0.00, 0, 0.00, 62
7, 10:17:00-000, 14832, 5227, 9605, 0, 0.00, 0, 0.00, 14832
7, 10:18:00-000, 24458, 14726, 9732, 5, 1350.60, 10, 1351.10, 24443
7, 10:19:00-000, 14395, 9565, 4830, 9, 1351.11, 4, 1351.00, 14382
7, 10:20:00-000, 4185, 3754, 431, 9, 1346.89, 6, 1348.83, 4170
7, 10:21:00-000, 18544, 6709, 11835, 2, 1348.00, 5, 1350.20, 18537
7, 10:22:00-000, 12645, 6801, 5844, 10, 1346.90, 10, 1349.30, 12625
7, 10:23:00-000, 13669, 7725, 5944, 1, 1355.00, 1, 1349.00, 13581
7, 10:24:00-000, 8936, 923, 8013, 12, 1349.50, 12, 1347.83, 8998
7, 10:25:00-000, 23149, 13081, 10068, 6, 1354.50, 6, 1351.00, 23137
7, 10:26:00-000, 8858, 6225, 2633, 2, 1348.00, 2, 1347.00, 8854
7, 10:27:00-000, 14800, 8442, 6358, 0, 0.00, 0, 0.00, 14788
7, 10:28:00-000, 3857, 2696, 1161, 0, 0.00, 0, 0.00, 2733
7, 10:29:00-000, 5492, 3831, 1661, 15, 1349.47, 15, 1349.13, 6598
7, 10:30:00-000, 2520, 200, 2320, 10, 1348.20, 10, 1349.20, 2500
7, 10:32:00-000, 3256, 3154, 102, 0, 0.00, 0, 0.00, 3256
7, 10:35:00-000, 9005, 5780, 3225, 0, 0.00, 0, 0.00, 9005
7, 10:36:00-000, 1786, 727, 1059, 0, 0.00, 0, 0.00, 1786
7, 10:37:00-000, 12424, 8564, 3860, 6, 1349.00, 6, 1353.33, 12412
7, 10:38:00-000, 1470, 0, 1470, 0, 0.00, 0, 0.00, 1470
7, 10:39:00-000, 3777, 1876, 1901, 0, 0.00, 0, 0.00, 3777
7, 10:42:00-000, 5491, 3048, 2443, 43, 1349.56, 42, 1350.31, 5406
7, 10:43:00-000, 9099, 5875, 3224, 2, 1353.00, 3, 1349.00, 8308
7, 10:44:00-000, 9587, 4044, 5543, 27, 1352.81, 27, 1350.92, 10319
7, 10:45:00-000, 3225, 1148, 2077, 16, 1348.44, 16, 1350.00, 3193
7, 10:46:00-000, 14194, 6108, 8086, 9, 1347.78, 9, 1350.89, 14175
7, 10:47:00-000, 6264, 1795, 4469, 0, 0.00, 0, 0.00, 6265
7, 10:48:00-000, 8361, 3121, 5240, 0, 0.00, 0, 0.00, 8361
7, 10:49:00-000, 2867, 2853, 14, 3, 1350.67, 3, 1352.00, 1307
7, 10:50:00-000, 3163, 1333, 1830, 0, 0.00, 0, 0.00, 4717
7, 10:51:00-000, 3428, 1217, 2211, 5, 1352.80, 5, 1352.00, 3418
7, 10:52:00-000, 7856, 2916, 4940, 17, 1353.35, 16, 1351.25, 7823
7, 10:53:00-000, 1, 0, 1, 0, 0.00, 1, 1348.00, 0
7, 10:54:00-000, 15525, 8392, 7133, 83, 1346.80, 83, 1347.59, 15359
7, 10:55:00-000, 13356, 4480, 8876, 46, 1352.39, 46, 1351.21, 13264
7, 10:56:00-000, 13169, 6751, 6418, 4, 1349.00, 4, 1348.25, 13161
7, 10:57:00-000, 660, 10, 650, 0, 0.00, 0, 0.00, 660
7, 10:59:00-000, 19868, 8908, 10960, 41, 1348.98, 41, 1350.29, 19786
7, 11:00:00-000, 13721, 7490, 6231, 36, 1352.00, 35, 1351.97, 13650
7, 11:01:00-000, 8029, 2955, 5074, 0, 0.00, 1, 1348.00, 8028
7, 11:02:00-000, 10829, 8186, 2643, 0, 0.00, 0, 0.00, 10829
7, 11:03:00-000, 7948, 6084, 1864, 0, 0.00, 0, 0.00, 7948
7, 11:04:00-000, 7600, 2986, 4614, 20, 1349.85, 20, 1352.00, 6861
7, 11:05:00-000, 14733, 12799, 1934, 27, 1346.89, 27, 1351.37, 15378
7, 11:06:00-000, 11157, 6942, 4215, 0, 0.00, 0, 0.00, 11157
7, 11:07:00-000, 6596, 3750, 2846, 0, 0.00, 0, 0.00, 5009
7, 11:08:00-000, 0, 0, 0, 0, 0.00, 0, 0.00, 1587
7, 11:11:00-000, 4181, 3360, 821, 0, 0.00, 0, 0.00, 3391
7, 11:12:00-000, 9884, 5323, 4561, 18, 1350.83, 18, 1350.00, 10638
7, 11:13:00-000, 715, 5, 710, 0, 0.00, 0, 0.00, 715
7, 11:14:00-000, 9002, 3859, 5143, 12, 1349.08, 12, 1350.83, 8978
7, 11:15:00-000, 1216, 1210, 6, 0, 0.00, 0, 0.00, 1216
7, 11:16:00-000, 1973, 1049, 924, 0, 0.00, 0, 0.00, 1973
7, 11:17:00-000, 9825, 3559, 6266, 41, 1350.36, 41, 1352.12, 9743
7, 11:18:00-000, 1282, 42, 1240, 35, 1352.62, 35, 1352.00, 1212
7, 11:19:00-000, 18027, 9110, 8917, 7, 1349.00, 7, 1350.00, 18013
7, 11:20:00-000, 6509, 4143, 2366, 0, 0.00, 0, 0.00, 6000
7, 11:21:00-000, 10615, 3294, 7321, 1, 1348.00, 1, 1349.00, 10746
7, 11:22:00-000, 9680, 5471, 4209, 1, 1354.00, 1, 1349.00, 10054
7, 11:24:00-000, 2120, 1088, 1032, 0, 0.00, 0, 0.00, 2120
7, 11:25:00-000, 3574, 34, 3540, 1, 1355.00, 1, 1352.00, 3572
7, 11:26:00-000, 2380, 2370, 10, 0, 0.00, 0, 0.00, 2380
7, 11:27:00-000, 507, 500, 7, 0, 0.00, 0, 0.00, 507
7, 11:28:00-000, 4872, 2467, 2405, 11, 1351.00, 11, 1352.00, 4850
7, 11:29:00-000, 10692, 8524, 2168, 7, 1351.00, 7, 1352.00, 10678
7, 11:30:00-000, 932, 2, 930, 0, 0.00, 0, 0.00, 932
7, 11:32:00-000, 5191, 1426, 3765, 23, 1350.08, 23, 1352.22, 5145
7, 11:33:00-000, 2627, 1074, 1553, 0, 0.00, 0, 0.00, 2627
7, 11:34:00-000, 5163, 3269, 1894, 0, 0.00, 0, 0.00, 5163
7, 11:36:00-000, 10341, 6145, 4196, 60, 1351.10, 60, 1351.33, 10221
7, 11:37:00-000, 6181, 2650, 3531, 0, 0.00, 0, 0.00, 6181
7, 11:38:00-000, 5148, 4201, 947, 37, 1348.35, 37, 1350.72, 5074
7, 11:39:00-000, 10357, 8705, 1652, 5, 1350.00, 5, 1350.00, 8986
7, 11:40:00-000, 13355, 6800, 6555, 6, 1349.00, 6, 1348.00, 14704
7, 11:41:00-000, 7167, 3686, 3481, 1, 1352.00, 1, 1351.00, 7165
7, 11:42:00-000, 24487, 9860, 14627, 40, 1348.25, 42, 1348.45, 24405
7, 11:43:00-000, 1161, 91, 1070, 59, 1354.01, 57, 1352.00, 1045
7, 11:44:00-000, 4801, 1595, 3206, 1, 1348.00, 1, 1349.00, 4799
7, 11:45:00-000, 15335, 7449, 7886, 10, 1349.20, 10, 1348.90, 15315
7, 11:46:00-000, 832, 813, 19, 18, 1347.83, 18, 1350.50, 796
7, 11:47:00-000, 8057, 2376, 5681, 30, 1349.10, 30, 1352.00, 7997
7, 11:48:00-000, 75, 5, 70, 4, 1349.00, 4, 1353.00, 67
7, 11:49:00-000, 6681, 773, 5908, 1, 1351.00, 1, 1352.00, 6673
7, 11:50:00-000, 7744, 4533, 3211, 65, 1347.09, 68, 1349.18, 7617
7, 11:51:00-000, 10548, 6692, 3856, 19, 1353.94, 16, 1352.75, 10513
7, 11:52:00-000, 9011, 3765, 5246, 1, 1352.00, 1, 1351.00, 9009
7, 11:53:00-000, 880, 10, 870, 0, 0.00, 0, 0.00, 880
7, 11:54:00-000, 7048, 5089, 1959, 29, 1348.55, 29, 1348.21, 6990
7, 11:55:00-000, 7868, 6207, 1661, 43, 1350.67, 41, 1350.53, 7784
7, 11:56:00-000, 2603, 1094, 1509, 2, 1354.00, 4, 1350.00, 2597
7, 11:57:00-000, 1138, 48, 1090, 45, 1354.28, 45, 1352.00, 1048
7, 11:58:00-000, 2471, 8, 2463, 3, 1348.00, 1, 1349.00, 2467
7, 11:59:00-000, 7450, 7369, 81, 8, 1352.12, 10, 1348.40, 7432
7, 12:00:00-000, 10867, 5031, 5836, 4, 1350.50, 4, 1349.00, 10856
7, 12:01:00-000, 3466, 720, 2746, 13, 1349.00, 13, 1348.08, 3443
7, 12:03:00-000, 12854, 2395, 10459, 4, 1345.00, 4, 1352.00, 12846
7, 12:04:00-000, 9062, 4248, 4814, 70, 1353.22, 70, 1352.17, 8922
7, 12:05:00-000, 6212, 3441, 2771, 27, 1346.14, 27, 1349.44, 6158
7, 12:06:00-000, 6111, 3524, 2587, 2, 1349.50, 2, 1352.00, 5041
7, 12:07:00-000, 16722, 8669, 8053, 0, 0.00, 0, 0.00, 17766
7, 12:08:00-000, 14349, 6832, 7517, 32, 1348.50, 32, 1348.59, 14307
7, 12:09:00-000, 14662, 5434, 9228, 0, 0.00, 0, 0.00, 13594
7, 12:10:00-000, 19031, 9747, 9284, 10, 1349.70, 10, 1351.00, 20079
7, 12:11:00-000, 7473, 1679, 5794, 1, 1351.00, 1, 1350.00, 7471
7, 12:12:00-000, 9785, 5114, 4671, 7, 1349.29, 3, 1350.67, 9775
7, 12:13:00-000, 11558, 4968, 6590, 0, 0.00, 4, 1346.75, 11552
7, 12:14:00-000, 5668, 55, 5613, 8, 1348.00, 8, 1347.37, 5654
7, 12:15:00-000, 14151, 4062, 10089, 3, 1349.67, 3, 1349.00, 14145
7, 12:16:00-000, 11197, 5434, 5763, 46, 1351.12, 49, 1352.36, 11102
7, 12:17:00-000, 3542, 2429, 1113, 39, 1348.84, 36, 1347.36, 3467
7, 12:18:00-000, 7364, 4515, 2849, 15, 1351.73, 61, 1351.00, 7288
7, 12:19:00-000, 14020, 6843, 7177, 50, 1354.53, 4, 1349.75, 12717
7, 12:20:00-000, 1192, 19, 1173, 19, 1348.16, 19, 1348.58, 2403
7, 12:21:00-000, 10006, 2260, 7746, 30, 1349.77, 23, 1350.95, 9953
7, 12:22:00-000, 1543, 1528, 15, 5, 1350.00, 15, 1350.07, 1523
7, 12:23:00-000, 8507, 7111, 1396, 3, 1351.00, 0, 0.00, 8504
7, 12:24:00-000, 875, 21, 854, 4, 1349.00, 4, 1351.00, 867
7, 12:25:00-000, 5055, 3966, 1089, 0, 0.00, 0, 0.00, 5055
7, 12:26:00-000, 2630, 40, 2590, 30, 1351.80, 30, 1352.00, 2570
7, 12:27:00-000, 1859, 918, 941, 12, 1348.42, 12, 1349.08, 1835
7, 12:28:00-000, 1249, 1245, 4, 4, 1353.25, 4, 1351.00, 1241
7, 12:30:00-000, 4014, 2671, 1343, 42, 1347.00, 8, 1350.50, 3964
7, 12:31:00-000, 34, 0, 34, 0, 0.00, 34, 1345.49, 0
7, 12:32:00-000, 6556, 1867, 4689, 1, 1353.00, 1, 1352.00, 6554
7, 12:33:00-000, 1174, 1167, 7, 7, 1351.86, 7, 1352.00, 1160
7, 12:36:00-000, 783, 773, 10, 10, 1353.60, 10, 1352.00, 763
7, 12:38:00-000, 1222, 1213, 9, 3, 1352.00, 3, 1352.00, 1216
7, 12:39:00-000, 1026, 1020, 6, 0, 0.00, 0, 0.00, 1026
7, 12:40:00-000, 12628, 7834, 4794, 0, 0.00, 0, 0.00, 12606
7, 12:41:00-000, 4451, 2365, 2086, 0, 0.00, 0, 0.00, 4473
7, 12:44:00-000, 1809, 811, 998, 0, 0.00, 0, 0.00, 818
7, 12:45:00-000, 617, 47, 570, 15, 1351.40, 15, 1352.00, 1578
7, 12:49:00-000, 1300, 10, 1290, 3, 1356.00, 3, 1351.00, 1294
7, 12:51:00-000, 5021, 2490, 2531, 0, 0.00, 0, 0.00, 5021
7, 12:52:00-000, 3598, 1438, 2160, 0, 0.00, 0, 0.00, 3598
7, 12:53:00-000, 2841, 2825, 16, 10, 1352.60, 10, 1351.00, 2821
7, 12:54:00-000, 10529, 6915, 3614, 32, 1347.62, 29, 1351.13, 10468
7, 12:55:00-000, 3, 0, 3, 0, 0.00, 3, 1346.00, 0
7, 12:56:00-000, 8959, 4513, 4446, 15, 1350.87, 15, 1350.33, 8929
7, 12:57:00-000, 5107, 3056, 2051, 0, 0.00, 0, 0.00, 4437
7, 12:58:00-000, 15423, 7700, 7723, 39, 1346.69, 39, 1351.40, 16015
7, 12:59:00-000, 11063, 2888, 8175, 19, 1348.21, 19, 1349.68, 11025
7, 13:00:00-000, 4364, 2788, 1576, 0, 0.00, 0, 0.00, 4364
7, 13:01:00-000, 4763, 4220, 543, 0, 0.00, 0, 0.00, 4763
7, 13:02:00-000, 6148, 2263, 3885, 0, 0.00, 0, 0.00, 6148
7, 13:03:00-000, 12347, 7064, 5283, 34, 1349.00, 32, 1350.81, 12278
7, 13:04:00-000, 10560, 6326, 4234, 26, 1349.57, 29, 1348.27, 10508
7, 13:05:00-000, 4027, 22, 4005, 6, 1349.00, 5, 1350.00, 4016
7, 13:06:00-000, 18295, 12396, 5899, 7, 1350.29, 7, 1351.14, 18266
7, 13:07:00-000, 9948, 5494, 4454, 0, 0.00, 0, 0.00, 9963
7, 13:08:00-000, 2407, 1619, 788, 39, 1347.02, 39, 1349.64, 2329
7, 13:09:00-000, 5476, 4021, 1455, 2, 1349.00, 2, 1348.50, 5472
7, 13:10:00-000, 3881, 1327, 2554, 2, 1350.00, 2, 1351.00, 3877
7, 13:11:00-000, 984, 4, 980, 0, 0.00, 0, 0.00, 984
7, 13:12:00-000, 10547, 5991, 4556, 5, 1349.20, 8, 1349.75, 10531
7, 13:13:00-000, 2265, 75, 2190, 14, 1354.29, 11, 1351.09, 2243
7, 13:15:00-000, 10175, 3505, 6670, 0, 0.00, 0, 0.00, 10175
7, 13:16:00-000, 9776, 5183, 4593, 13, 1350.38, 14, 1349.71, 9741
7, 13:17:00-000, 4415, 2863, 1552, 1, 1351.00, 0, 0.00, 4422
7, 13:20:00-000, 4201, 3278, 923, 10, 1349.00, 7, 1350.00, 4184
7, 13:21:00-000, 6225, 4715, 1510, 5, 1352.20, 8, 1350.25, 6212
7, 13:22:00-000, 8648, 3761, 4887, 1, 1350.00, 1, 1348.00, 8646
7, 13:23:00-000, 4088, 2599, 1489, 1, 1353.00, 1, 1350.00, 4086
7, 13:24:00-000, 4778, 3029, 1749, 12, 1353.83, 12, 1351.83, 4754
7, 13:25:00-000, 11759, 5673, 6086, 0, 0.00, 0, 0.00, 11749
7, 13:26:00-000, 6082, 2401, 3681, 40, 1347.47, 30, 1349.67, 6022
7, 13:27:00-000, 5739, 2660, 3079, 7, 1351.29, 17, 1347.94, 5715
7, 13:28:00-000, 16117, 9512, 6605, 10, 1348.60, 10, 1348.40, 16088
7, 13:29:00-000, 16283, 8358, 7925, 4, 1348.00, 4, 1348.50, 15467
7, 13:30:00-000, 9075, 3460, 5615, 10, 1347.60, 6, 1345.67, 9876
7, 13:31:00-000, 5227, 3735, 1492, 6, 1350.00, 4, 1344.00, 5217
7, 13:32:00-000, 4999, 2568, 2431, 29, 1351.38, 35, 1351.51, 4935
7, 13:33:00-000, 12753, 6926, 5827, 7, 1352.14, 7, 1349.57, 12739
7, 13:34:00-000, 5884, 3561, 2323, 1, 1351.00, 1, 1349.00, 5882
7, 13:35:00-000, 5505, 25, 5480, 0, 0.00, 0, 0.00, 5505
7, 13:36:00-000, 3074, 14, 3060, 0, 0.00, 0, 0.00, 3074
7, 13:37:00-000, 2527, 2506, 21, 5, 1350.40, 5, 1352.00, 2517
7, 13:40:00-000, 12648, 7507, 5141, 0, 0.00, 0, 0.00, 11455
7, 13:41:00-000, 17017, 7712, 9305, 1, 1349.00, 1, 1350.00, 17703
7, 13:42:00-000, 8218, 2372, 5846, 0, 0.00, 0, 0.00, 8713
7, 13:43:00-000, 6265, 3433, 2832, 2, 1350.00, 2, 1347.00, 6271
7, 13:44:00-000, 12260, 5810, 6450, 6, 1350.67, 7, 1349.86, 12247
7, 13:45:00-000, 1, 1, 0, 1, 1355.00, 0, 0.00, 0
7, 13:46:00-000, 2025, 1155, 870, 0, 0.00, 0, 0.00, 2025
7, 13:47:00-000, 7291, 2028, 5263, 0, 0.00, 1, 1350.00, 5832
7, 13:48:00-000, 2263, 912, 1351, 15, 1353.53, 14, 1351.93, 3692
7, 13:50:00-000, 4913, 633, 4280, 0, 0.00, 0, 0.00, 3733
7, 13:51:00-000, 7028, 2100, 4928, 1, 1349.00, 1, 1354.00, 8142
7, 13:52:00-000, 4593, 1587, 3006, 14, 1352.00, 14, 1351.64, 4629
7, 13:53:00-000, 16487, 9166, 7321, 1, 1348.00, 1, 1350.00, 15016
7, 13:54:00-000, 15650, 12001, 3649, 48, 1348.08, 32, 1348.97, 17039
7, 13:55:00-000, 10637, 5147, 5490, 2, 1352.00, 18, 1345.33, 10617
7, 13:56:00-000, 6729, 4057, 2672, 40, 1350.04, 40, 1349.94, 6649
7, 13:57:00-000, 5095, 5040, 55, 27, 1347.78, 27, 1346.92, 5041
7, 13:58:00-000, 7901, 3620, 4281, 8, 1351.12, 8, 1349.00, 7885
7, 13:59:00-000, 1540, 20, 1520, 0, 0.00, 0, 0.00, 1540
7, 14:00:00-000, 4988, 2381, 2607, 0, 0.00, 0, 0.00, 4988
7, 14:01:00-000, 8724, 2163, 6561, 8, 1349.00, 8, 1349.00, 8708
7, 14:02:00-000, 16757, 6221, 10536, 0, 0.00, 0, 0.00, 16757
7, 14:03:00-000, 6900, 4668, 2232, 8, 1347.00, 8, 1349.38, 6884
7, 14:04:00-000, 12094, 5936, 6158, 1, 1350.00, 1, 1348.00, 12092
7, 14:05:00-000, 22648, 10757, 11891, 11, 1348.00, 10, 1349.60, 22627
7, 14:06:00-000, 14442, 6602, 7840, 2, 1351.00, 3, 1351.67, 14437
7, 14:07:00-000, 1119, 1100, 19, 0, 0.00, 0, 0.00, 1119
7, 14:08:00-000, 10071, 5286, 4785, 8, 1349.50, 8, 1353.00, 10055
7, 14:09:00-000, 8369, 4377, 3992, 6, 1352.17, 6, 1350.50, 8352
7, 14:10:00-000, 2614, 1457, 1157, 5, 1355.20, 5, 1352.00, 2609
7, 14:11:00-000, 4347, 694, 3653, 8, 1348.50, 8, 1349.12, 4331
7, 14:12:00-000, 11726, 4120, 7606, 6, 1351.17, 5, 1351.80, 11715
7, 14:13:00-000, 11841, 5681, 6160, 4, 1351.50, 5, 1350.80, 11832
7, 14:14:00-000, 5922, 3535, 2387, 4, 1352.00, 4, 1353.00, 5914
7, 14:15:00-000, 9117, 3090, 6027, 0, 0.00, 0, 0.00, 7828
7, 14:16:00-000, 6350, 3612, 2738, 42, 1350.35, 43, 1352.04, 7554
7, 14:17:00-000, 8945, 7492, 1453, 20, 1350.55, 19, 1351.47, 8906
7, 14:18:00-000, 1917, 17, 1900, 0, 0.00, 0, 0.00, 1917
7, 14:19:00-000, 7546, 1278, 6268, 34, 1350.50, 35, 1351.06, 7477
7, 14:20:00-000, 13720, 5168, 8552, 11, 1348.82, 10, 1349.40, 13699
7, 14:21:00-000, 12110, 6729, 5381, 35, 1351.48, 35, 1351.76, 12040
7, 14:22:00-000, 15314, 6267, 9047, 12, 1351.58, 12, 1351.67, 13824
7, 14:23:00-000, 8860, 5617, 3243, 13, 1350.38, 13, 1350.00, 10300
7, 14:24:00-000, 12752, 5700, 7052, 14, 1347.50, 14, 1349.50, 12724
7, 14:25:00-000, 9967, 7787, 2180, 10, 1348.00, 10, 1349.80, 9932
7, 14:26:00-000, 15781, 7574, 8207, 24, 1348.41, 34, 1350.00, 15738
7, 14:27:00-000, 9487, 5244, 4243, 10, 1352.00, 0, 0.00, 8203
7, 14:28:00-000, 10567, 4852, 5715, 2, 1351.50, 2, 1352.00, 11818
7, 14:29:00-000, 8343, 5930, 2413, 0, 0.00, 0, 0.00, 8362
7, 14:30:00-000, 2153, 1105, 1048, 15, 1349.33, 15, 1349.73, 2123
7, 14:31:00-000, 7773, 2143, 5630, 0, 0.00, 0, 0.00, 7773
7, 14:32:00-000, 9793, 4116, 5677, 25, 1350.68, 25, 1351.64, 9743
7, 14:33:00-000, 8977, 2949, 6028, 14, 1350.71, 14, 1351.29, 8949
7, 14:34:00-000, 7240, 3262, 3978, 65, 1353.96, 73, 1350.31, 7102
7, 14:35:00-000, 17, 17, 0, 8, 1351.75, 0, 0.00, 9
7, 14:36:00-000, 6374, 1805, 4569, 2, 1351.50, 2, 1350.00, 6370
7, 14:37:00-000, 11588, 5297, 6291, 4, 1348.50, 4, 1350.25, 11580
7, 14:38:00-000, 5851, 1169, 4682, 0, 0.00, 0, 0.00, 5851
7, 14:39:00-000, 12623, 7525, 5098, 9, 1348.33, 9, 1346.78, 12605
7, 14:40:00-000, 1701, 61, 1640, 26, 1353.92, 26, 1352.00, 1649
7, 14:41:00-000, 1361, 1342, 19, 7, 1352.71, 7, 1351.14, 1347
7, 14:42:00-000, 6814, 4704, 2110, 25, 1349.76, 25, 1351.12, 6764
7, 14:43:00-000, 3409, 1652, 1757, 4, 1352.75, 4, 1351.00, 2645
7, 14:44:00-000, 11487, 3363, 8124, 5, 1350.00, 5, 1353.00, 12233
7, 14:45:00-000, 20886, 7973, 12913, 13, 1348.61, 13, 1349.84, 20860
7, 14:46:00-000, 19704, 9290, 10414, 92, 1348.22, 92, 1347.17, 19519
7, 14:47:00-000, 18768, 6158, 12610, 5, 1351.60, 4, 1351.50, 18001
7, 14:48:00-000, 5400, 3476, 1924, 15, 1348.13, 16, 1346.06, 6128
7, 14:49:00-000, 7601, 5579, 2022, 20, 1348.05, 20, 1347.40, 7561
7, 14:50:00-000, 17236, 11385, 5851, 24, 1350.08, 24, 1351.37, 17188
7, 14:51:00-000, 10405, 4835, 5570, 0, 0.00, 0, 0.00, 9345
7, 14:52:00-000, 13543, 9134, 4409, 24, 1347.21, 24, 1347.33, 14555
7, 14:53:00-000, 11214, 7006, 4208, 10, 1349.60, 10, 1348.10, 11088
7, 14:54:00-000, 15206, 7550, 7656, 4, 1345.50, 4, 1349.25, 13951
7, 14:55:00-000, 9058, 1067, 7991, 23, 1354.30, 23, 1351.87, 10365
7, 14:56:00-000, 14670, 8626, 6044, 19, 1347.73, 20, 1350.90, 13524
7, 14:57:00-000, 6097, 2289, 3808, 18, 1346.50, 17, 1351.12, 7169
7, 14:58:00-000, 5734, 2888, 2846, 15, 1348.80, 15, 1348.00, 5704
7, 14:59:00-000, 15029, 7970, 7059, 0, 0.00, 0, 0.00, 15029
7, 15:00:00-000, 11517, 5101, 6416, 5, 1349.40, 5, 1349.00, 10087
7, 15:01:00-000, 6367, 3671, 2696, 8, 1352.50, 8, 1351.75, 7771
7, 15:02:00-000, 6749, 563, 6186, 0, 0.00, 0, 0.00, 6749
7, 15:03:00-000, 9896, 4441, 5455, 0, 0.00, 0, 0.00, 9896
7, 15:04:00-000, 11421, 9635, 1786, 13, 1348.61, 13, 1348.54, 11395
7, 15:05:00-000, 13214, 4817, 8397, 5, 1350.40, 5, 1349.80, 13204
7, 15:06:00-000, 14888, 7453, 7435, 20, 1350.50, 20, 1352.80, 14848
7, 15:07:00-000, 938, 920, 18, 0, 0.00, 0, 0.00, 938
7, 15:08:00-000, 15628, 7135, 8493, 11, 1346.91, 11, 1350.64, 15606
7, 15:09:00-000, 12836, 4967, 7869, 48, 1351.47, 48, 1351.48, 12740
7, 15:10:00-000, 14127, 5625, 8502, 41, 1348.29, 37, 1348.29, 14049
7, 15:11:00-000, 10883, 5802, 5081, 8, 1347.12, 12, 1347.33, 10863
7, 15:12:00-000, 4123, 1671, 2452, 0, 0.00, 0, 0.00, 4123
7, 15:13:00-000, 6900, 3395, 3505, 2, 1349.00, 0, 0.00, 6898
7, 15:14:00-000, 2642, 2622, 20, 2, 1353.00, 4, 1349.50, 2636
7, 15:15:00-000, 8669, 7290, 1379, 0, 0.00, 0, 0.00, 8669
7, 15:16:00-000, 9974, 4769, 5205, 16, 1352.56, 16, 1353.00, 9223
7, 15:17:00-000, 13358, 4519, 8839, 30, 1349.80, 30, 1349.40, 14017
7, 15:18:00-000, 5445, 4136, 1309, 3, 1352.00, 3, 1351.00, 5439
7, 15:19:00-000, 9847, 3994, 5853, 0, 0.00, 0, 0.00, 9102
7, 15:20:00-000, 10391, 3585, 6806, 42, 1350.62, 42, 1351.71, 11052
7, 15:21:00-000, 8681, 4335, 4346, 0, 0.00, 0, 0.00, 8681
7, 15:22:00-000, 3637, 555, 3082, 50, 1351.95, 50, 1348.80, 3537
7, 15:23:00-000, 503, 500, 3, 0, 0.00, 0, 0.00, 503
7, 15:25:00-000, 3468, 2552, 916, 0, 0.00, 0, 0.00, 3468
7, 15:26:00-000, 7441, 3239, 4202, 2, 1348.00, 2, 1349.00, 6208
7, 15:27:00-000, 12666, 6038, 6628, 4, 1352.00, 4, 1351.75, 13887
7, 15:28:00-000, 19236, 10632, 8604, 10, 1351.40, 10, 1351.70, 19216
7, 15:29:00-000, 15752, 8002, 7750, 57, 1347.98, 57, 1348.01, 14185
7, 15:30:00-000, 9206, 2511, 6695, 11, 1351.54, 15, 1351.06, 10633
7, 15:31:00-000, 6571, 3447, 3124, 16, 1348.50, 12, 1349.50, 6543
7, 15:32:00-000, 792, 27, 765, 27, 1347.33, 27, 1353.00, 738
7, 15:33:00-000, 4711, 2400, 2311, 1, 1349.00, 1, 1352.00, 4709
7, 15:34:00-000, 22117, 14033, 8084, 48, 1350.10, 48, 1351.87, 22021
7, 15:35:00-000, 13324, 8292, 5032, 0, 0.00, 0, 0.00, 13324
7, 15:36:00-000, 7384, 5664, 1720, 38, 1347.89, 38, 1350.36, 7308
7, 15:37:00-000, 11720, 5657, 6063, 16, 1345.19, 16, 1350.50, 11688
7, 15:38:00-000, 3903, 2104, 1799, 0, 0.00, 0, 0.00, 3903
7, 15:39:00-000, 5990, 2464, 3526, 12, 1351.50, 12, 1350.25, 5955
7, 15:40:00-000, 1580, 1325, 255, 16, 1348.37, 16, 1348.06, 1559
7, 15:41:00-000, 11838, 6145, 5693, 42, 1350.30, 42, 1351.21, 11754
7, 15:42:00-000, 8849, 6088, 2761, 26, 1347.50, 10, 1349.10, 8813
7, 15:43:00-000, 16, 0, 16, 0, 0.00, 16, 1346.00, 0
7, 15:44:00-000, 3530, 1570, 1960, 0, 0.00, 0, 0.00, 1960
7, 15:45:00-000, 5759, 1658, 4101, 12, 1345.00, 12, 1347.92, 7305
7, 15:46:00-000, 12976, 7874, 5102, 0, 0.00, 0, 0.00, 12976
7, 15:50:00-000, 568, 560, 8, 0, 0.00, 0, 0.00, 568
7, 15:51:00-000, 4084, 4070, 14, 0, 0.00, 0, 0.00, 4084
7, 15:52:00-000, 2607, 1710, 897, 3, 1350.00, 5, 1350.00, 2599
7, 15:53:00-000, 810, 806, 4, 6, 1351.33, 4, 1349.50, 800
7, 15:54:00-000, 1082, 1076, 6, 6, 1353.00, 6, 1351.00, 1070
7, 15:56:00-000, 1988, 38, 1950, 0, 0.00, 0, 0.00, 1988
7, 15:57:00-000, 1442, 1441, 1, 1, 1353.00, 1, 1351.00, 1440
7, 16:03:00-000, 5447, 4316, 1131, 0, 0.00, 0, 0.00, 5447
7, 16:04:00-000, 5049, 1111, 3938, 0, 0.00, 0, 0.00, 5049
7, 16:06:00-000, 1100, 285, 815, 0, 0.00, 0, 0.00, 1100
7, 16:07:00-000, 10581, 1443, 9138, 0, 0.00, 0, 0.00, 9141
7, 16:08:00-000, 4086, 3172, 914, 8, 1354.50, 8, 1352.00, 5510
7, 16:09:00-000, 7181, 2844, 4337, 12, 1349.67, 12, 1352.00, 7157
7, 16:11:00-000, 2359, 1147, 1212, 0, 0.00, 0, 0.00, 2359
7, 16:12:00-000, 2145, 2124, 21, 14, 1349.50, 14, 1352.00, 2117
7, 16:13:00-000, 3733, 2396, 1337, 0, 0.00, 0, 0.00, 3733
7, 16:14:00-000, 5019, 1588, 3431, 13, 1348.38, 13, 1349.46, 4264
7, 16:15:00-000, 19429, 11684, 7745, 3, 1351.00, 3, 1350.00, 19361
7, 16:16:00-000, 1950, 1670, 280, 23, 1345.91, 23, 1346.43, 2695
7, 16:17:00-000, 5210, 1425, 3785, 0, 0.00, 0, 0.00, 5210
7, 16:18:00-000, 7221, 3947, 3274, 2, 1351.00, 2, 1351.00, 7217
7, 16:19:00-000, 4456, 3128, 1328, 0, 0.00, 0, 0.00, 4456
7, 16:20:00-000, 18780, 8184, 10596, 20, 1349.75, 23, 1350.74, 18737
7, 16:21:00-000, 9628, 5126, 4502, 20, 1348.30, 17, 1345.59, 8555
7, 16:22:00-000, 10148, 5689, 4459, 52, 1350.65, 39, 1351.74, 11093
7, 16:23:00-000, 5542, 44, 5498, 26, 1354.42, 39, 1350.59, 5477
7, 16:24:00-000, 11770, 3563, 8207, 87, 1353.98, 87, 1351.14, 11596
7, 16:25:00-000, 8603, 5016, 3587, 7, 1355.43, 7, 1351.86, 8589
7, 16:26:00-000, 7517, 1060, 6457, 17, 1354.41, 17, 1352.35, 7483
7, 16:27:00-000, 8641, 6147, 2494, 17, 1348.23, 17, 1347.65, 8607
7, 16:28:00-000, 11914, 4238, 7676, 5, 1347.40, 5, 1349.20, 11904
7, 16:29:00-000, 3132, 1270, 1862, 3, 1356.00, 3, 1350.67, 3126
9, 09:07:00-000, 2470, 1580, 890, 0, 0.00, 0, 0.00, 2470
9, 09:21:00-000, 6400, 910, 5490, 0, 0.00, 0, 0.00, 5890
9, 09:22:00-000, 7215, 2601, 4614, 35, 1348.08, 3, 1352.00, 7687
9, 09:23:00-000, 1149, 0, 1149, 0, 0.00, 32, 1350.40, 1117
9, 09:30:00-000, 1000, 980, 20, 20, 1346.25, 20, 1346.05, 960
9, 09:35:00-000, 7110, 3590, 3520, 0, 0.00, 0, 0.00, 7110
9, 09:36:00-000, 1547, 1540, 7, 7, 1348.00, 7, 1347.00, 1533
9, 09:37:00-000, 2510, 0, 2510, 0, 0.00, 0, 0.00, 2510
9, 09:38:00-000, 984, 94, 890, 10, 1352.00, 94, 1353.00, 880
9, 09:39:00-000, 84, 84, 0, 84, 1356.21, 0, 0.00, 0
9, 09:45:00-000, 4470, 3120, 1350, 0, 0.00, 0, 0.00, 4470
9, 09:47:00-000, 3760, 1490, 2270, 0, 0.00, 0, 0.00, 3760
9, 09:52:00-000, 1270, 1270, 0, 0, 0.00, 0, 0.00, 1270
9, 09:53:00-000, 2320, 2320, 0, 0, 0.00, 0, 0.00, 2320
9, 09:54:00-000, 8340, 4400, 3940, 0, 0.00, 0, 0.00, 8340
9, 09:55:00-000, 6420, 5330, 1090, 0, 0.00, 0, 0.00, 6420
9, 09:56:00-000, 8580, 1750, 6830, 60, 1349.00, 60, 1348.93, 8460
9, 09:57:00-000, 5590, 3020, 2570, 0, 0.00, 0, 0.00, 5590
9, 10:04:00-000, 1299, 9, 1290, 9, 1350.11, 9, 1352.00, 1281
9, 10:05:00-000, 4976, 3720, 1256, 5, 1349.00, 5, 1353.00, 4966
9, 10:06:00-000, 5517, 1957, 3560, 17, 1357.00, 17, 1352.00, 5483
9, 10:09:00-000, 3597, 2387, 1210, 37, 1356.48, 37, 1353.00, 3523
9, 10:12:00-000, 2190, 0, 2190, 0, 0.00, 0, 0.00, 2190
9, 10:13:00-000, 2530, 2530, 0, 0, 0.00, 0, 0.00, 1780
9, 10:14:00-000, 7220, 2670, 4550, 0, 0.00, 0, 0.00, 7970
9, 10:15:00-000, 2180, 1310, 870, 0, 0.00, 0, 0.00, 2180
9, 10:16:00-000, 1440, 1440, 0, 0, 0.00, 0, 0.00, 1440
9, 10:17:00-000, 8370, 3750, 4620, 0, 0.00, 0, 0.00, 8370
9, 10:18:00-000, 10510, 2450, 8060, 0, 0.00, 0, 0.00, 10510
9, 10:19:00-000, 6291, 4371, 1920, 1, 1351.00, 1, 1351.00, 6289
9, 10:21:00-000, 9660, 2730, 6930, 0, 0.00, 0, 0.00, 9660
9, 10:22:00-000, 6257, 4070, 2187, 7, 1348.00, 7, 1348.00, 6243
9, 10:23:00-000, 2220, 2220, 0, 0, 0.00, 0, 0.00, 2220
9, 10:24:00-000, 9766, 4730, 5036, 6, 1346.00, 6, 1348.00, 9754
9, 10:25:00-000, 7109, 1859, 5250, 9, 1351.44, 9, 1352.00, 7091
9, 10:26:00-000, 8880, 4270, 4610, 0, 0.00, 0, 0.00, 8880
9, 10:27:00-000, 5820, 1090, 4730, 0, 0.00, 0, 0.00, 5820
9, 10:28:00-000, 779, 760, 19, 10, 1347.00, 10, 1349.70, 759
9, 10:29:00-000, 2220, 0, 2220, 0, 0.00, 0, 0.00, 2220
9, 10:32:00-000, 4063, 880, 3183, 3, 1348.00, 3, 1351.33, 4057
9, 10:35:00-000, 3320, 0, 3320, 0, 0.00, 0, 0.00, 3320
9, 10:36:00-000, 1470, 0, 1470, 0, 0.00, 0, 0.00, 1470
9, 10:37:00-000, 2010, 920, 1090, 0, 0.00, 0, 0.00, 2010
9, 10:38:00-000, 910, 0, 910, 0, 0.00, 0, 0.00, 910
9, 10:39:00-000, 1390, 0, 1390, 0, 0.00, 0, 0.00, 1390
9, 10:42:00-000, 3990, 2690, 1300, 0, 0.00, 0, 0.00, 3990
9, 10:43:00-000, 11243, 1823, 9420, 3, 1350.00, 3, 1351.00, 11237
9, 10:44:00-000, 4221, 2521, 1700, 11, 1351.00, 11, 1352.00, 4199
9, 10:45:00-000, 1480, 0, 1480, 0, 0.00, 0, 0.00, 1480
9, 10:46:00-000, 4560, 3500, 1060, 0, 0.00, 0, 0.00, 4560
9, 10:47:00-000, 4820, 1200, 3620, 0, 0.00, 0, 0.00, 3690
9, 10:48:00-000, 1835, 805, 1030, 5, 1351.80, 5, 1353.00, 2955
9, 10:50:00-000, 4551, 3151, 1400, 1, 1355.00, 1, 1354.00, 4549
9, 10:51:00-000, 1380, 0, 1380, 0, 0.00, 0, 0.00, 1380
9, 10:54:00-000, 7815, 7780, 35, 35, 1350.00, 35, 1349.06, 7745
9, 10:55:00-000, 2340, 1240, 1100, 0, 0.00, 0, 0.00, 2340
9, 10:56:00-000, 9360, 5010, 4350, 0, 0.00, 0, 0.00, 9360
9, 10:59:00-000, 8680, 6690, 1990, 0, 0.00, 0, 0.00, 8680
9, 11:00:00-000, 9858, 6111, 3747, 8, 1347.25, 8, 1349.50, 9842
9, 11:01:00-000, 7156, 4540, 2616, 34, 1351.17, 34, 1352.11, 6268
9, 11:02:00-000, 4710, 4630, 80, 80, 1346.51, 18, 1347.78, 5432
9, 11:03:00-000, 4719, 850, 3869, 0, 0.00, 62, 1346.39, 4657
9, 11:04:00-000, 740, 740, 0, 0, 0.00, 0, 0.00, 740
9, 11:05:00-000, 1180, 0, 1180, 0, 0.00, 0, 0.00, 1180
9, 11:06:00-000, 5990, 4090, 1900, 0, 0.00, 0, 0.00, 5990
9, 11:07:00-000, 4040, 1280, 2760, 0, 0.00, 0, 0.00, 4040
9, 11:08:00-000, 1314, 4, 1310, 4, 1351.00, 4, 1353.00, 1306
9, 11:11:00-000, 8610, 6510, 2100, 0, 0.00, 0, 0.00, 8610
9, 11:12:00-000, 4880, 0, 4880, 0, 0.00, 0, 0.00, 4880
9, 11:14:00-000, 4460, 2510, 1950, 0, 0.00, 0, 0.00, 4460
9, 11:16:00-000, 1670, 1670, 0, 0, 0.00, 0, 0.00, 1670
9, 11:17:00-000, 6202, 1180, 5022, 2, 1350.00, 2, 1349.00, 6198
9, 11:19:00-000, 7450, 3230, 4220, 0, 0.00, 0, 0.00, 7450
9, 11:20:00-000, 7667, 3417, 4250, 4, 1353.00, 4, 1353.00, 7659
9, 11:21:00-000, 12330, 5240, 7090, 0, 0.00, 0, 0.00, 12330
9, 11:22:00-000, 8630, 6570, 2060, 0, 0.00, 0, 0.00, 8630
9, 11:26:00-000, 2934, 1769, 1165, 7, 1348.57, 24, 1351.37, 2903
9, 11:27:00-000, 2357, 957, 1400, 17, 1353.65, 0, 0.00, 2340
9, 11:28:00-000, 8540, 7360, 1180, 0, 0.00, 0, 0.00, 7840
9, 11:29:00-000, 10574, 7010, 3564, 4, 1348.00, 4, 1346.00, 11266
9, 11:30:00-000, 900, 900, 0, 0, 0.00, 0, 0.00, 900
9, 11:31:00-000, 1265, 65, 1200, 58, 1351.82, 58, 1349.00, 1149
9, 11:32:00-000, 2310, 10, 2300, 10, 1352.10, 10, 1352.00, 2290
9, 11:33:00-000, 4733, 3480, 1253, 27, 1348.89, 27, 1346.77, 4679
9, 11:34:00-000, 5689, 3160, 2529, 7, 1347.00, 7, 1348.57, 5675
9, 11:35:00-000, 2334, 1224, 1110, 35, 1355.11, 35, 1352.00, 2264
9, 11:36:00-000, 5510, 0, 5510, 0, 0.00, 0, 0.00, 5510
9, 11:37:00-000, 5940, 2070, 3870, 0, 0.00, 0, 0.00, 4620
9, 11:38:00-000, 0, 0, 0, 0, 0.00, 0, 0.00, 1320
9, 11:39:00-000, 6750, 4680, 2070, 0, 0.00, 0, 0.00, 6750
9, 11:40:00-000, 3835, 1865, 1970, 5, 1352.00, 5, 1352.00, 3165
9, 11:41:00-000, 15050, 5560, 9490, 0, 0.00, 0, 0.00, 15710
9, 11:42:00-000, 11570, 7880, 3690, 24, 1347.00, 0, 0.00, 11546
9, 11:43:00-000, 24, 0, 24, 0, 0.00, 24, 1345.37, 0
9, 11:44:00-000, 4200, 0, 4200, 0, 0.00, 0, 0.00, 4200
9, 11:45:00-000, 5271, 1441, 3830, 1, 1351.00, 1, 1352.00, 5269
9, 11:47:00-000, 8443, 3860, 4583, 3, 1349.00, 3, 1346.00, 8437
9, 11:48:00-000, 1090, 1090, 0, 0, 0.00, 0, 0.00, 1090
9, 11:49:00-000, 8300, 3280, 5020, 0, 0.00, 0, 0.00, 7300
9, 11:50:00-000, 981, 170, 811, 1, 1348.00, 1, 1346.00, 1979
9, 11:51:00-000, 2600, 0, 2600, 0, 0.00, 0, 0.00, 2600
9, 11:52:00-000, 2163, 625, 1538, 26, 1349.38, 26, 1347.19, 2111
9, 11:53:00-000, 1030, 1030, 0, 0, 0.00, 0, 0.00, 1030
9, 11:54:00-000, 4070, 2700, 1370, 0, 0.00, 0, 0.00, 4070
9, 11:55:00-000, 5650, 2050, 3600, 0, 0.00, 0, 0.00, 5650
9, 11:56:00-000, 1865, 5, 1860, 5, 1347.40, 5, 1352.00, 1855
9, 11:58:00-000, 4416, 81, 4335, 20, 1350.75, 23, 1351.17, 4373
9, 11:59:00-000, 3133, 1833, 1300, 3, 1355.00, 0, 0.00, 3130
9, 12:00:00-000, 5520, 1740, 3780, 0, 0.00, 0, 0.00, 5520
9, 12:01:00-000, 3260, 1450, 1810, 10, 1352.00, 10, 1353.00, 3240
9, 12:03:00-000, 3640, 3640, 0, 0, 0.00, 0, 0.00, 3640
9, 12:04:00-000, 2830, 1530, 1300, 0, 0.00, 0, 0.00, 2830
9, 12:05:00-000, 2920, 1880, 1040, 0, 0.00, 0, 0.00, 2920
9, 12:06:00-000, 4980, 3830, 1150, 0, 0.00, 0, 0.00, 4980
9, 12:07:00-000, 9960, 5680, 4280, 0, 0.00, 0, 0.00, 9960
9, 12:08:00-000, 2210, 0, 2210, 0, 0.00, 0, 0.00, 2210
9, 12:09:00-000, 8055, 5480, 2575, 4, 1348.00, 4, 1349.50, 8047
9, 12:10:00-000, 10530, 6960, 3570, 0, 0.00, 0, 0.00, 10530
9, 12:11:00-000, 6940, 6940, 0, 0, 0.00, 0, 0.00, 6940
9, 12:12:00-000, 5670, 1390, 4280, 0, 0.00, 0, 0.00, 5670
9, 12:13:00-000, 5575, 1005, 4570, 4, 1350.50, 4, 1352.00, 5567
9, 12:14:00-000, 2510, 2510, 0, 0, 0.00, 0, 0.00, 1840
9, 12:15:00-000, 10000, 4790, 5210, 9, 1348.00, 9, 1349.44, 10132
9, 12:16:00-000, 11693, 7150, 4543, 11, 1349.00, 11, 1352.18, 12191
9, 12:18:00-000, 7112, 5910, 1202, 2, 1347.00, 2, 1349.00, 7108
9, 12:19:00-000, 6970, 5450, 1520, 0, 0.00, 0, 0.00, 6970
9, 12:21:00-000, 8069, 5640, 2429, 24, 1348.00, 24, 1347.12, 8021
9, 12:23:00-000, 2550, 1470, 1080, 0, 0.00, 0, 0.00, 2550
9, 12:25:00-000, 770, 770, 0, 0, 0.00, 0, 0.00, 770
9, 12:26:00-000, 2643, 13, 2630, 12, 1350.17, 12, 1352.00, 2619
9, 12:30:00-000, 1430, 0, 1430, 0, 0.00, 0, 0.00, 1430
9, 12:31:00-000, 2110, 2110, 0, 0, 0.00, 0, 0.00, 2110
9, 12:32:00-000, 1530, 1530, 0, 0, 0.00, 0, 0.00, 1530
9, 12:33:00-000, 1410, 0, 1410, 0, 0.00, 0, 0.00, 1410
9, 12:38:00-000, 2513, 3, 2510, 3, 1352.00, 3, 1352.00, 2507
9, 12:40:00-000, 4385, 2545, 1840, 15, 1351.80, 15, 1351.53, 4355
9, 12:44:00-000, 3190, 1910, 1280, 0, 0.00, 0, 0.00, 3190
9, 12:45:00-000, 3045, 1960, 1085, 45, 1347.84, 45, 1347.13, 2955
9, 12:46:00-000, 733, 730, 3, 3, 1345.33, 3, 1351.00, 727
9, 12:49:00-000, 1447, 1430, 17, 15, 1348.00, 15, 1351.60, 1417
9, 12:51:00-000, 3980, 910, 3070, 0, 0.00, 0, 0.00, 3070
9, 12:52:00-000, 1195, 65, 1130, 20, 1351.60, 20, 1351.00, 2065
9, 12:53:00-000, 710, 0, 710, 0, 0.00, 0, 0.00, 710
9, 12:54:00-000, 6230, 1230, 5000, 10, 1354.60, 10, 1352.50, 6210
9, 12:56:00-000, 10879, 5759, 5120, 9, 1350.33, 9, 1352.00, 10861
9, 12:57:00-000, 5100, 4070, 1030, 0, 0.00, 0, 0.00, 5100
9, 12:58:00-000, 8582, 5230, 3352, 12, 1349.00, 12, 1348.42, 7748
9, 12:59:00-000, 8760, 5180, 3580, 0, 0.00, 0, 0.00, 9570
9, 13:00:00-000, 6253, 3191, 3062, 77, 1353.25, 91, 1349.38, 6085
9, 13:01:00-000, 6560, 3500, 3060, 70, 1355.59, 56, 1352.00, 6434
9, 13:02:00-000, 1570, 1550, 20, 20, 1346.00, 20, 1346.20, 1530
9, 13:03:00-000, 5420, 5420, 0, 0, 0.00, 0, 0.00, 4420
9, 13:04:00-000, 2656, 766, 1890, 13, 1353.31, 13, 1352.00, 3630
9, 13:05:00-000, 3100, 1280, 1820, 0, 0.00, 0, 0.00, 3100
9, 13:06:00-000, 13091, 9170, 3921, 7, 1349.00, 5, 1350.80, 13079
9, 13:07:00-000, 9124, 2766, 6358, 10, 1352.80, 12, 1352.00, 9102
9, 13:09:00-000, 4390, 1250, 3140, 0, 0.00, 0, 0.00, 4390
9, 13:10:00-000, 2064, 4, 2060, 4, 1350.50, 4, 1352.00, 2056
9, 13:12:00-000, 1410, 1410, 0, 0, 0.00, 0, 0.00, 0
9, 13:13:00-000, 601, 1, 600, 1, 1354.00, 1, 1353.00, 2009
9, 13:15:00-000, 15340, 6590, 8750, 0, 0.00, 0, 0.00, 14680
9, 13:16:00-000, 1010, 0, 1010, 0, 0.00, 0, 0.00, 1670
9, 13:17:00-000, 3205, 2355, 850, 5, 1352.00, 5, 1352.00, 3195
9, 13:20:00-000, 1530, 1530, 0, 0, 0.00, 0, 0.00, 1530
9, 13:21:00-000, 2391, 1, 2390, 1, 1351.00, 1, 1352.00, 2389
9, 13:22:00-000, 5733, 4270, 1463, 13, 1347.31, 13, 1348.15, 5707
9, 13:23:00-000, 940, 940, 0, 0, 0.00, 0, 0.00, 940
9, 13:24:00-000, 1990, 1040, 950, 0, 0.00, 0, 0.00, 1990
9, 13:25:00-000, 5600, 3610, 1990, 0, 0.00, 0, 0.00, 4700
9, 13:26:00-000, 2390, 780, 1610, 0, 0.00, 0, 0.00, 3290
9, 13:27:00-000, 2671, 1910, 761, 1, 1347.00, 1, 1348.00, 2669
9, 13:28:00-000, 12734, 6400, 6334, 4, 1347.00, 4, 1349.25, 11846
9, 13:29:00-000, 6398, 3168, 3230, 6, 1353.17, 6, 1352.00, 7266
9, 13:30:00-000, 5629, 2942, 2687, 11, 1348.73, 9, 1348.55, 5609
9, 13:31:00-000, 1272, 1270, 2, 0, 0.00, 2, 1344.00, 1270
9, 13:32:00-000, 2010, 0, 2010, 0, 0.00, 0, 0.00, 2010
9, 13:33:00-000, 12218, 5220, 6998, 18, 1347.00, 18, 1349.05, 12182
9, 13:34:00-000, 11785, 4435, 7350, 15, 1350.80, 15, 1352.00, 11755
9, 13:35:00-000, 2180, 2180, 0, 0, 0.00, 0, 0.00, 2180
9, 13:36:00-000, 2452, 922, 1530, 2, 1354.00, 2, 1352.00, 2448
9, 13:37:00-000, 2440, 2440, 0, 0, 0.00, 0, 0.00, 2440
9, 13:40:00-000, 1650, 750, 900, 0, 0.00, 0, 0.00, 1650
9, 13:41:00-000, 8090, 5730, 2360, 0, 0.00, 0, 0.00, 8090
9, 13:42:00-000, 10059, 7680, 2379, 9, 1348.00, 9, 1349.00, 10041
9, 13:43:00-000, 5540, 3400, 2140, 0, 0.00, 0, 0.00, 4360
9, 13:44:00-000, 6548, 4390, 2158, 8, 1347.75, 8, 1348.25, 7712
9, 13:46:00-000, 2110, 2110, 0, 0, 0.00, 0, 0.00, 2110
9, 13:47:00-000, 2430, 1400, 1030, 0, 0.00, 0, 0.00, 2430
9, 13:48:00-000, 4534, 4530, 4, 4, 1348.00, 4, 1349.25, 4526
9, 13:50:00-000, 1190, 1190, 0, 0, 0.00, 0, 0.00, 1190
9, 13:51:00-000, 14890, 9670, 5220, 0, 0.00, 0, 0.00, 14890
9, 13:52:00-000, 1924, 1064, 860, 14, 1356.00, 14, 1352.00, 1896
9, 13:53:00-000, 8300, 1720, 6580, 0, 0.00, 0, 0.00, 8300
9, 13:54:00-000, 6430, 3520, 2910, 0, 0.00, 0, 0.00, 6430
9, 13:55:00-000, 5510, 3580, 1930, 0, 0.00, 0, 0.00, 5510
9, 13:56:00-000, 1205, 1190, 15, 10, 1347.00, 10, 1347.90, 1185
9, 13:57:00-000, 1250, 1250, 0, 0, 0.00, 0, 0.00, 1250
9, 13:58:00-000, 6320, 6320, 0, 0, 0.00, 0, 0.00, 6320
9, 13:59:00-000, 970, 0, 970, 0, 0.00, 0, 0.00, 970
9, 14:01:00-000, 2660, 2660, 0, 0, 0.00, 0, 0.00, 2660
9, 14:02:00-000, 9171, 3450, 5721, 21, 1348.00, 21, 1347.66, 7919
9, 14:03:00-000, 3485, 1080, 2405, 18, 1347.17, 18, 1347.55, 4659
9, 14:04:00-000, 11893, 7310, 4583, 26, 1348.00, 26, 1347.57, 11841
9, 14:05:00-000, 9555, 4810, 4745, 5, 1348.00, 5, 1345.00, 9545
9, 14:06:00-000, 10027, 740, 9287, 17, 1345.53, 19, 1350.26, 9991
9, 14:07:00-000, 3348, 2398, 950, 8, 1350.75, 6, 1347.50, 3334
9, 14:08:00-000, 5770, 4680, 1090, 0, 0.00, 0, 0.00, 5770
9, 14:09:00-000, 9520, 4630, 4890, 10, 1351.00, 10, 1353.00, 9500
9, 14:10:00-000, 890, 0, 890, 0, 0.00, 0, 0.00, 890
9, 14:11:00-000, 2150, 2150, 0, 0, 0.00, 0, 0.00, 2150
9, 14:12:00-000, 1320, 1320, 0, 0, 0.00, 0, 0.00, 1320
9, 14:13:00-000, 7190, 3730, 3460, 0, 0.00, 0, 0.00, 7190
9, 14:14:00-000, 6912, 2252, 4660, 2, 1353.00, 2, 1352.00, 6908
9, 14:16:00-000, 7268, 2628, 4640, 17, 1351.17, 17, 1352.00, 7234
9, 14:17:00-000, 6536, 2124, 4412, 6, 1349.33, 6, 1350.33, 6524
9, 14:18:00-000, 1436, 1430, 6, 6, 1348.00, 6, 1350.33, 1424
9, 14:19:00-000, 4741, 750, 3991, 1, 1348.00, 1, 1348.00, 4739
9, 14:20:00-000, 3320, 2050, 1270, 0, 0.00, 0, 0.00, 3320
9, 14:21:00-000, 6090, 2050, 4040, 0, 0.00, 0, 0.00, 5910
9, 14:22:00-000, 3900, 0, 3900, 0, 0.00, 0, 0.00, 4080
9, 14:23:00-000, 6253, 2840, 3413, 3, 1348.00, 3, 1349.00, 6247
9, 14:24:00-000, 7000, 5010, 1990, 0, 0.00, 0, 0.00, 7000
9, 14:25:00-000, 6814, 2200, 4614, 4, 1348.00, 4, 1347.00, 6806
9, 14:26:00-000, 8349, 4079, 4270, 29, 1350.55, 29, 1352.55, 8291
9, 14:27:00-000, 4732, 1282, 3450, 2, 1355.00, 2, 1351.00, 4728
9, 14:28:00-000, 6330, 2560, 3770, 0, 0.00, 0, 0.00, 6330
9, 14:29:00-000, 7117, 4003, 3114, 46, 1352.58, 46, 1351.41, 7025
9, 14:30:00-000, 3670, 2560, 1110, 0, 0.00, 0, 0.00, 3670
9, 14:31:00-000, 4440, 0, 4440, 0, 0.00, 0, 0.00, 4440
9, 14:32:00-000, 4940, 3730, 1210, 10, 1348.00, 10, 1345.30, 4920
9, 14:33:00-000, 3350, 2000, 1350, 0, 0.00, 0, 0.00, 3350
9, 14:36:00-000, 3251, 1491, 1760, 1, 1352.00, 1, 1352.00, 3249
9, 14:37:00-000, 5390, 820, 4570, 0, 0.00, 0, 0.00, 4180
9, 14:38:00-000, 2832, 1600, 1232, 2, 1346.00, 2, 1350.00, 2808
9, 14:39:00-000, 7764, 4770, 2994, 4, 1345.00, 4, 1345.00, 8986
9, 14:40:00-000, 1390, 1390, 0, 0, 0.00, 0, 0.00, 1390
9, 14:41:00-000, 3380, 3380, 0, 0, 0.00, 0, 0.00, 3380
9, 14:42:00-000, 7503, 3013, 4490, 23, 1350.78, 43, 1352.00, 7437
9, 14:43:00-000, 3752, 1412, 2340, 20, 1353.00, 0, 0.00, 3732
9, 14:44:00-000, 8050, 4030, 4020, 0, 0.00, 0, 0.00, 8050
9, 14:45:00-000, 9820, 5080, 4740, 0, 0.00, 0, 0.00, 8870
9, 14:46:00-000, 8670, 5480, 3190, 10, 1351.00, 10, 1353.00, 9600
9, 14:47:00-000, 6700, 2190, 4510, 0, 0.00, 0, 0.00, 6700
9, 14:48:00-000, 3872, 3230, 642, 12, 1348.00, 12, 1348.00, 3218
9, 14:49:00-000, 6450, 5230, 1220, 0, 0.00, 0, 0.00, 7080
9, 14:50:00-000, 8500, 4700, 3800, 0, 0.00, 0, 0.00, 7160
9, 14:51:00-000, 5350, 1380, 3970, 0, 0.00, 0, 0.00, 6690
9, 14:52:00-000, 4840, 4840, 0, 0, 0.00, 0, 0.00, 4840
9, 14:53:00-000, 6130, 730, 5400, 0, 0.00, 0, 0.00, 6130
9, 14:54:00-000, 4120, 820, 3300, 0, 0.00, 0, 0.00, 4120
9, 14:55:00-000, 7350, 1720, 5630, 0, 0.00, 0, 0.00, 7350
9, 14:56:00-000, 3935, 2445, 1490, 5, 1351.00, 5, 1354.00, 3925
9, 14:57:00-000, 5042, 2192, 2850, 29, 1352.37, 29, 1352.69, 4034
9, 14:58:00-000, 3155, 1150, 2005, 5, 1345.00, 5, 1347.00, 4095
9, 14:59:00-000, 5580, 4410, 1170, 0, 0.00, 0, 0.00, 5580
9, 15:00:00-000, 11671, 2321, 9350, 1, 1351.00, 1, 1350.00, 11669
9, 15:01:00-000, 7804, 3730, 4074, 4, 1348.00, 4, 1349.00, 7796
9, 15:02:00-000, 9620, 4420, 5200, 0, 0.00, 0, 0.00, 8650
9, 15:03:00-000, 4353, 1772, 2581, 11, 1347.91, 11, 1350.55, 5301
9, 15:04:00-000, 8523, 6560, 1963, 14, 1347.93, 13, 1350.61, 8496
9, 15:05:00-000, 8391, 3780, 4611, 0, 0.00, 1, 1346.00, 8390
9, 15:06:00-000, 8040, 2700, 5340, 0, 0.00, 0, 0.00, 8040
9, 15:08:00-000, 7360, 2650, 4710, 0, 0.00, 0, 0.00, 7360
9, 15:09:00-000, 5750, 2130, 3620, 0, 0.00, 0, 0.00, 5750
9, 15:10:00-000, 7470, 4290, 3180, 10, 1347.00, 10, 1346.50, 7450
9, 15:11:00-000, 6510, 2120, 4390, 0, 0.00, 0, 0.00, 6510
9, 15:13:00-000, 4750, 1580, 3170, 0, 0.00, 0, 0.00, 4750
9, 15:14:00-000, 1358, 1320, 38, 38, 1349.60, 38, 1347.52, 1282
9, 15:15:00-000, 9590, 5990, 3600, 0, 0.00, 0, 0.00, 9590
9, 15:16:00-000, 4307, 2287, 2020, 37, 1353.05, 37, 1353.00, 4233
9, 15:17:00-000, 3846, 6, 3840, 6, 1356.00, 6, 1352.00, 3834
9, 15:18:00-000, 6781, 2940, 3841, 11, 1348.00, 11, 1346.27, 6759
9, 15:19:00-000, 5271, 2120, 3151, 1, 1349.00, 1, 1349.00, 5269
9, 15:20:00-000, 7205, 4860, 2345, 5, 1349.00, 5, 1348.60, 7195
9, 15:21:00-000, 9572, 8350, 1222, 24, 1348.16, 24, 1345.50, 9524
9, 15:22:00-000, 5911, 81, 5830, 25, 1350.24, 81, 1352.20, 5805
9, 15:23:00-000, 1256, 1256, 0, 56, 1354.85, 0, 0.00, 1200
9, 15:25:00-000, 1070, 1070, 0, 0, 0.00, 0, 0.00, 0
9, 15:26:00-000, 3680, 990, 2690, 0, 0.00, 0, 0.00, 4750
9, 15:27:00-000, 3700, 1200, 2500, 0, 0.00, 0, 0.00, 3700
9, 15:28:00-000, 6651, 3940, 2711, 44, 1348.00, 44, 1345.68, 6563
9, 15:29:00-000, 7660, 3930, 3730, 0, 0.00, 0, 0.00, 7660
9, 15:30:00-000, 4991, 4150, 841, 1, 1347.00, 1, 1350.00, 4989
9, 15:31:00-000, 1510, 0, 1510, 0, 0.00, 0, 0.00, 1510
9, 15:32:00-000, 1170, 1170, 0, 0, 0.00, 0, 0.00, 1170
9, 15:33:00-000, 4713, 1263, 3450, 3, 1354.00, 3, 1351.00, 4707
9, 15:34:00-000, 8700, 2410, 6290, 0, 0.00, 0, 0.00, 8700
9, 15:35:00-000, 6080, 4400, 1680, 0, 0.00, 0, 0.00, 6080
9, 15:37:00-000, 6350, 1350, 5000, 0, 0.00, 0, 0.00, 5340
9, 15:38:00-000, 2380, 850, 1530, 0, 0.00, 0, 0.00, 3390
9, 15:39:00-000, 5383, 2113, 3270, 3, 1353.67, 3, 1352.00, 5377
9, 15:40:00-000, 2448, 1218, 1230, 1, 1352.00, 8, 1352.00, 2439
9, 15:41:00-000, 3227, 1077, 2150, 7, 1353.00, 0, 0.00, 3220
9, 15:42:00-000, 6211, 3660, 2551, 1, 1345.00, 1, 1346.00, 6209
9, 15:44:00-000, 1450, 0, 1450, 0, 0.00, 0, 0.00, 1450
9, 15:45:00-000, 2510, 2510, 0, 0, 0.00, 0, 0.00, 2510
9, 15:46:00-000, 3220, 1730, 1490, 0, 0.00, 0, 0.00, 3220
9, 15:50:00-000, 2510, 1210, 1300, 0, 0.00, 0, 0.00, 2510
9, 15:51:00-000, 2363, 1398, 965, 13, 1348.46, 13, 1349.69, 2337
9, 15:52:00-000, 2195, 1345, 850, 9, 1351.33, 25, 1352.00, 841
9, 15:53:00-000, 2277, 2277, 0, 16, 1354.43, 0, 0.00, 3581
9, 16:00:00-000, 1271, 1270, 1, 1, 1349.00, 1, 1349.00, 1269
9, 16:03:00-000, 3700, 2250, 1450, 0, 0.00, 0, 0.00, 3700
9, 16:04:00-000, 2880, 1000, 1880, 0, 0.00, 0, 0.00, 2880
9, 16:07:00-000, 3190, 1060, 2130, 0, 0.00, 0, 0.00, 3190
9, 16:08:00-000, 5313, 1343, 3970, 2, 1353.00, 2, 1352.00, 5309
9, 16:09:00-000, 2110, 1120, 990, 0, 0.00, 0, 0.00, 2110
9, 16:11:00-000, 4910, 3540, 1370, 0, 0.00, 0, 0.00, 4910
9, 16:12:00-000, 3770, 2240, 1530, 0, 0.00, 0, 0.00, 3770
9, 16:13:00-000, 4410, 2380, 2030, 0, 0.00, 0, 0.00, 4410
9, 16:14:00-000, 3200, 990, 2210, 0, 0.00, 0, 0.00, 3200
9, 16:15:00-000, 12300, 6990, 5310, 0, 0.00, 0, 0.00, 12300
9, 16:16:00-000, 4206, 2416, 1790, 26, 1355.00, 26, 1352.00, 4154
9, 16:17:00-000, 9020, 4320, 4700, 0, 0.00, 0, 0.00, 9020
9, 16:18:00-000, 5270, 1410, 3860, 0, 0.00, 0, 0.00, 4920
9, 16:19:00-000, 2510, 2510, 0, 0, 0.00, 0, 0.00, 2860
9, 16:20:00-000, 10479, 4409, 6070, 3, 1351.00, 9, 1351.00, 10467
9, 16:21:00-000, 4253, 1166, 3087, 13, 1349.38, 7, 1351.00, 4233
9, 16:22:00-000, 4906, 2640, 2266, 6, 1348.00, 6, 1348.83, 4894
9, 16:23:00-000, 6195, 3820, 2375, 10, 1347.00, 10, 1348.50, 6175
9, 16:24:00-000, 6730, 4520, 2210, 0, 0.00, 0, 0.00, 6730
9, 16:25:00-000, 4790, 0, 4790, 0, 0.00, 0, 0.00, 4790
9, 16:26:00-000, 2790, 1470, 1320, 0, 0.00, 0, 0.00, 2790
9, 16:27:00-000, 3090, 0, 3090, 0, 0.00, 0, 0.00, 3090
9, 16:28:00-000, 5106, 1980, 3126, 15, 1351.13, 16, 1349.94, 5075
9, 16:29:00-000, 1337, 17, 1320, 17, 1353.29, 16, 1353.00, 1304
