TraderType,Time,EnterQty,BuyEnterQty,SellEnterQty,BuyExecutedQty,BuyExecutedPx,SellExecutedQty,SellExecutedPx,CanceledQty
1, 09:06:00-000, 2987, 2987, 0, 860, 1347.75, 0, 0.00, 0
1, 09:07:00-000, 0, 0, 0, 0, 0.00, 0, 0.00, 2109
1, 09:08:00-000, 0, 0, 0, 0, 0.00, 0, 0.00, 18
1, 09:13:00-000, 3105, 2245, 860, 1155, 1347.78, 860, 1347.35, 0
1, 09:14:00-000, 6, 5, 1, 0, 0.00, 1, 1347.00, 1090
1, 09:15:00-000, 15, 8, 7, 7, 1348.14, 7, 1348.14, 0
1, 09:16:00-000, 182, 102, 80, 14, 1349.00, 78, 1365.76, 17
1, 09:17:00-000, 195, 128, 67, 78, 1348.86, 69, 1349.44, 48
1, 09:18:00-000, 575, 373, 202, 167, 1348.94, 197, 1352.90, 121
1, 09:19:00-000, 421, 287, 134, 162, 1348.22, 139, 1348.70, 127
1, 09:20:00-000, 878, 547, 331, 210, 1348.75, 330, 1354.36, 224
1, 09:21:00-000, 326, 238, 88, 115, 1349.90, 84, 1349.93, 222
1, 09:22:00-000, 561, 316, 245, 249, 1347.96, 250, 1348.12, 143
1, 09:23:00-000, 238, 148, 90, 67, 1348.96, 85, 1353.25, 92
1, 09:24:00-000, 527, 346, 181, 181, 1348.77, 185, 1350.96, 82
1, 09:25:00-000, 254, 167, 87, 95, 1348.92, 87, 1352.08, 135
1, 09:26:00-000, 605, 390, 215, 252, 1347.87, 215, 1347.62, 108
1, 09:27:00-000, 366, 271, 95, 130, 1349.20, 95, 1348.82, 135
1, 09:28:00-000, 609, 390, 219, 220, 1348.76, 219, 1348.43, 154
1, 09:29:00-000, 289, 199, 90, 98, 1348.64, 90, 1349.91, 148
1, 09:30:00-000, 617, 391, 226, 257, 1348.29, 220, 1348.26, 155
1, 09:31:00-000, 235, 155, 80, 94, 1350.18, 86, 1350.21, 85
1, 09:32:00-000, 572, 336, 236, 216, 1348.05, 236, 1349.62, 78
1, 09:33:00-000, 270, 143, 127, 119, 1347.72, 127, 1347.59, 89
1, 09:34:00-000, 702, 479, 223, 240, 1348.37, 223, 1348.22, 75
1, 09:35:00-000, 312, 190, 122, 130, 1348.51, 122, 1348.22, 197
1, 09:36:00-000, 611, 390, 221, 188, 1348.28, 221, 1348.43, 124
1, 09:37:00-000, 272, 142, 130, 109, 1348.85, 130, 1348.41, 123
1, 09:38:00-000, 634, 460, 174, 236, 1348.54, 174, 1348.74, 118
1, 09:39:00-000, 322, 197, 125, 125, 1348.67, 125, 1348.95, 134
1, 09:40:00-000, 593, 363, 230, 224, 1347.66, 230, 1347.85, 117
1, 09:41:00-000, 262, 165, 97, 119, 1348.05, 97, 1346.77, 115
1, 09:42:00-000, 648, 396, 252, 234, 1347.76, 252, 1347.15, 74
1, 09:43:00-000, 336, 177, 159, 137, 1347.21, 159, 1347.10, 103
1, 09:44:00-000, 553, 384, 169, 204, 1348.44, 169, 1348.31, 121
1, 09:45:00-000, 324, 206, 118, 152, 1347.78, 118, 1347.03, 113
1, 09:46:00-000, 579, 318, 261, 218, 1347.87, 259, 1347.61, 95
1, 09:47:00-000, 357, 249, 108, 134, 1348.44, 110, 1347.82, 89
1, 09:48:00-000, 631, 404, 227, 253, 1348.11, 227, 1348.34, 121
1, 09:49:00-000, 257, 160, 97, 109, 1347.36, 97, 1347.16, 123
1, 09:50:00-000, 581, 352, 229, 230, 1347.21, 226, 1347.08, 85
1, 09:51:00-000, 253, 152, 101, 107, 1346.28, 104, 1346.03, 105
1, 09:52:00-000, 604, 400, 204, 249, 1348.32, 204, 1347.93, 76
1, 09:53:00-000, 365, 221, 144, 128, 1347.66, 144, 1348.01, 103
1, 09:54:00-000, 532, 286, 246, 222, 1347.91, 246, 1347.24, 111
1, 09:55:00-000, 339, 210, 129, 127, 1348.79, 129, 1347.35, 63
1, 09:56:00-000, 591, 369, 222, 202, 1348.28, 222, 1347.45, 111
1, 09:57:00-000, 336, 192, 144, 149, 1348.68, 144, 1348.35, 105
1, 09:58:00-000, 667, 400, 267, 288, 1348.57, 267, 1347.91, 78
1, 09:59:00-000, 265, 140, 125, 101, 1347.75, 125, 1346.24, 101
1, 10:00:00-000, 559, 355, 204, 220, 1348.58, 204, 1348.42, 82
1, 10:01:00-000, 285, 203, 82, 116, 1347.81, 82, 1348.29, 85
1, 10:02:00-000, 573, 364, 209, 254, 1348.11, 209, 1347.02, 120
1, 10:03:00-000, 315, 189, 126, 116, 1347.88, 126, 1348.91, 99
1, 10:04:00-000, 703, 380, 323, 254, 1347.24, 323, 1346.83, 67
1, 10:05:00-000, 299, 181, 118, 101, 1348.53, 118, 1349.30, 119
1, 10:06:00-000, 629, 358, 271, 248, 1348.05, 271, 1348.13, 87
1, 10:07:00-000, 320, 200, 120, 108, 1349.86, 120, 1347.74, 113
1, 10:08:00-000, 666, 427, 239, 299, 1347.90, 239, 1347.03, 92
1, 10:09:00-000, 282, 189, 93, 96, 1347.58, 93, 1347.57, 123
1, 10:10:00-000, 566, 354, 212, 210, 1348.28, 212, 1347.95, 127
1, 10:11:00-000, 332, 206, 126, 124, 1347.13, 126, 1347.20, 103
1, 10:12:00-000, 586, 371, 215, 198, 1349.48, 215, 1349.57, 127
1, 10:13:00-000, 338, 199, 139, 116, 1348.43, 139, 1347.73, 106
1, 10:14:00-000, 588, 318, 270, 240, 1347.47, 270, 1347.03, 112
1, 10:15:00-000, 346, 191, 155, 166, 1348.02, 155, 1347.16, 68
1, 10:16:00-000, 655, 414, 241, 280, 1348.11, 241, 1347.51, 79
1, 10:17:00-000, 255, 164, 91, 132, 1348.05, 91, 1346.78, 76
1, 10:18:00-000, 627, 374, 253, 247, 1348.40, 253, 1347.11, 69
1, 10:19:00-000, 333, 259, 74, 137, 1349.37, 74, 1348.18, 99
1, 10:20:00-000, 609, 378, 231, 267, 1347.78, 231, 1347.42, 135
1, 10:21:00-000, 350, 209, 141, 149, 1347.87, 141, 1346.82, 102
1, 10:22:00-000, 635, 356, 279, 249, 1347.90, 279, 1347.65, 77
1, 10:23:00-000, 278, 149, 129, 115, 1348.49, 129, 1346.68, 73
1, 10:24:00-000, 650, 379, 271, 314, 1347.89, 271, 1347.35, 52
1, 10:25:00-000, 319, 211, 108, 91, 1348.23, 108, 1348.68, 64
1, 10:26:00-000, 628, 337, 291, 261, 1348.00, 291, 1347.81, 115
1, 10:27:00-000, 343, 173, 170, 149, 1348.15, 170, 1346.92, 79
1, 10:28:00-000, 641, 380, 261, 237, 1346.99, 261, 1346.79, 80
1, 10:29:00-000, 300, 204, 96, 108, 1349.84, 96, 1349.27, 83
1, 10:30:00-000, 673, 396, 277, 279, 1347.81, 277, 1347.47, 101
1, 10:31:00-000, 325, 168, 157, 124, 1347.74, 157, 1347.97, 111
1, 10:32:00-000, 650, 407, 243, 192, 1349.67, 243, 1349.02, 92
1, 10:33:00-000, 300, 193, 107, 144, 1348.23, 107, 1347.86, 143
1, 10:34:00-000, 590, 378, 212, 205, 1348.36, 212, 1347.79, 104
1, 10:35:00-000, 358, 213, 145, 133, 1347.88, 145, 1347.26, 110
1, 10:36:00-000, 685, 424, 261, 318, 1347.91, 261, 1347.10, 166
1, 10:37:00-000, 240, 149, 91, 82, 1347.76, 91, 1347.26, 68
1, 10:38:00-000, 622, 434, 188, 252, 1348.16, 188, 1348.41, 100
1, 10:39:00-000, 237, 149, 88, 84, 1348.11, 88, 1348.37, 132
1, 10:40:00-000, 700, 348, 352, 282, 1347.15, 352, 1346.77, 64
1, 10:41:00-000, 297, 140, 157, 144, 1346.58, 157, 1345.87, 44
1, 10:42:00-000, 588, 354, 234, 257, 1347.50, 234, 1346.55, 46
1, 10:43:00-000, 301, 186, 115, 114, 1349.57, 115, 1349.63, 60
1, 10:44:00-000, 598, 389, 209, 271, 1347.73, 209, 1346.92, 101
1, 10:45:00-000, 301, 171, 130, 125, 1347.44, 128, 1347.46, 88
1, 10:46:00-000, 575, 307, 268, 229, 1347.36, 270, 1346.46, 74
1, 10:47:00-000, 287, 167, 120, 119, 1346.46, 120, 1346.47, 77
1, 10:48:00-000, 655, 357, 298, 262, 1347.96, 298, 1346.95, 68
1, 10:49:00-000, 312, 176, 136, 135, 1347.36, 136, 1346.88, 64
1, 10:50:00-000, 673, 415, 258, 258, 1348.07, 258, 1347.65, 67
1, 10:51:00-000, 290, 181, 109, 128, 1347.76, 109, 1347.42, 105
1, 10:52:00-000, 521, 303, 218, 227, 1347.99, 218, 1347.25, 80
1, 10:53:00-000, 289, 172, 117, 116, 1348.27, 117, 1347.57, 76
1, 10:54:00-000, 629, 385, 244, 259, 1348.34, 244, 1347.47, 74
1, 10:55:00-000, 372, 233, 139, 163, 1347.48, 139, 1345.98, 83
1, 10:56:00-000, 610, 394, 216, 249, 1347.97, 216, 1347.81, 130
1, 10:57:00-000, 391, 234, 157, 128, 1348.87, 157, 1349.05, 109
1, 10:58:00-000, 612, 328, 284, 258, 1346.94, 284, 1347.24, 100
1, 10:59:00-000, 279, 149, 130, 123, 1346.50, 130, 1346.35, 66
1, 11:00:00-000, 566, 354, 212, 199, 1348.57, 212, 1347.88, 67
1, 11:01:00-000, 337, 211, 126, 158, 1348.32, 126, 1347.99, 117
1, 11:02:00-000, 567, 338, 229, 211, 1347.46, 229, 1347.24, 93
1, 11:03:00-000, 347, 251, 96, 129, 1349.25, 96, 1347.68, 86
1, 11:04:00-000, 703, 365, 338, 299, 1347.46, 338, 1346.84, 103
1, 11:05:00-000, 320, 195, 125, 151, 1347.19, 125, 1346.41, 86
1, 11:06:00-000, 622, 397, 225, 251, 1347.83, 225, 1347.38, 64
1, 11:07:00-000, 254, 143, 111, 135, 1348.02, 111, 1347.86, 109
1, 11:08:00-000, 562, 349, 213, 207, 1348.37, 213, 1347.72, 73
1, 11:09:00-000, 300, 190, 110, 158, 1348.42, 110, 1348.57, 93
1, 11:10:00-000, 698, 385, 313, 286, 1347.94, 313, 1346.98, 82
1, 11:11:00-000, 294, 174, 120, 116, 1347.84, 117, 1347.22, 67
1, 11:12:00-000, 636, 316, 320, 284, 1347.46, 323, 1346.95, 53
1, 11:13:00-000, 322, 205, 117, 91, 1347.73, 117, 1347.40, 36
1, 11:14:00-000, 672, 374, 298, 248, 1348.04, 298, 1347.98, 116
1, 11:15:00-000, 306, 176, 130, 134, 1347.26, 130, 1346.40, 100
1, 11:16:00-000, 592, 364, 228, 233, 1348.00, 228, 1346.27, 85
1, 11:17:00-000, 289, 163, 126, 136, 1347.67, 126, 1347.49, 83
1, 11:18:00-000, 625, 340, 285, 252, 1347.52, 285, 1346.76, 62
1, 11:19:00-000, 309, 198, 111, 113, 1347.79, 111, 1347.39, 64
1, 11:20:00-000, 533, 292, 241, 194, 1348.50, 238, 1348.11, 100
1, 11:21:00-000, 321, 211, 110, 132, 1348.85, 111, 1348.64, 90
1, 11:22:00-000, 605, 377, 228, 244, 1348.37, 230, 1348.03, 90
1, 11:23:00-000, 276, 174, 102, 133, 1349.14, 102, 1348.66, 111
1, 11:24:00-000, 685, 375, 310, 280, 1347.72, 310, 1346.58, 57
1, 11:25:00-000, 243, 150, 93, 115, 1348.36, 89, 1347.66, 97
1, 11:26:00-000, 571, 322, 249, 212, 1348.42, 253, 1347.40, 68
1, 11:27:00-000, 270, 162, 108, 96, 1348.13, 108, 1348.15, 70
1, 11:28:00-000, 594, 378, 216, 224, 1348.58, 216, 1347.51, 90
1, 11:29:00-000, 280, 154, 126, 136, 1348.62, 126, 1348.30, 81
1, 11:30:00-000, 517, 315, 202, 186, 1348.06, 202, 1347.70, 88
1, 11:31:00-000, 331, 141, 190, 166, 1346.89, 190, 1346.08, 69
1, 11:32:00-000, 561, 325, 236, 212, 1347.69, 236, 1347.66, 47
1, 11:33:00-000, 311, 188, 123, 130, 1348.22, 123, 1347.27, 88
1, 11:34:00-000, 578, 354, 224, 276, 1347.87, 224, 1347.13, 73
1, 11:35:00-000, 287, 194, 93, 114, 1347.71, 93, 1346.99, 55
1, 11:36:00-000, 600, 351, 249, 231, 1347.26, 249, 1347.17, 97
1, 11:37:00-000, 310, 212, 98, 127, 1348.86, 98, 1348.02, 97
1, 11:38:00-000, 597, 366, 231, 254, 1348.01, 231, 1347.15, 117
1, 11:39:00-000, 287, 183, 104, 117, 1348.68, 104, 1348.00, 92
1, 11:40:00-000, 566, 333, 233, 202, 1348.12, 233, 1348.06, 106
1, 11:41:00-000, 347, 191, 156, 127, 1347.83, 156, 1347.57, 83
1, 11:42:00-000, 652, 381, 271, 239, 1347.18, 271, 1346.74, 77
1, 11:43:00-000, 297, 170, 127, 133, 1347.11, 127, 1347.58, 100
1, 11:44:00-000, 594, 359, 235, 269, 1348.49, 235, 1347.11, 100
1, 11:45:00-000, 334, 193, 141, 147, 1347.41, 141, 1346.66, 60
1, 11:46:00-000, 572, 342, 230, 187, 1347.16, 230, 1346.50, 67
1, 11:47:00-000, 383, 257, 126, 140, 1348.19, 126, 1347.51, 116
1, 11:48:00-000, 560, 357, 203, 287, 1348.10, 203, 1347.91, 116
1, 11:49:00-000, 288, 201, 87, 119, 1349.06, 87, 1348.26, 81
1, 11:50:00-000, 664, 375, 289, 259, 1348.02, 289, 1347.88, 95
1, 11:51:00-000, 253, 167, 86, 100, 1347.94, 86, 1347.64, 107
1, 11:52:00-000, 688, 366, 322, 302, 1347.85, 322, 1347.07, 77
1, 11:53:00-000, 319, 197, 122, 144, 1348.36, 122, 1348.05, 57
1, 11:54:00-000, 639, 436, 203, 258, 1348.50, 203, 1348.49, 107
1, 11:55:00-000, 305, 186, 119, 147, 1348.11, 119, 1347.72, 105
1, 11:56:00-000, 622, 361, 261, 243, 1348.37, 261, 1347.65, 93
1, 11:57:00-000, 324, 188, 136, 124, 1349.29, 136, 1349.54, 67
1, 11:58:00-000, 683, 391, 292, 318, 1347.43, 292, 1347.14, 82
1, 11:59:00-000, 329, 121, 208, 107, 1346.25, 208, 1345.14, 64
1, 12:00:00-000, 573, 295, 278, 220, 1347.52, 278, 1346.43, 32
1, 12:01:00-000, 277, 166, 111, 95, 1348.64, 111, 1348.72, 70
1, 12:02:00-000, 610, 378, 232, 215, 1349.18, 232, 1348.75, 82
1, 12:03:00-000, 337, 202, 135, 144, 1348.71, 130, 1348.37, 132
1, 12:04:00-000, 588, 371, 217, 242, 1348.06, 222, 1347.59, 79
1, 12:05:00-000, 277, 167, 110, 110, 1348.41, 110, 1348.00, 102
1, 12:06:00-000, 537, 329, 208, 243, 1348.17, 208, 1347.65, 97
1, 12:07:00-000, 293, 171, 122, 120, 1347.34, 122, 1346.98, 63
1, 12:08:00-000, 614, 384, 230, 254, 1348.03, 230, 1347.30, 86
1, 12:09:00-000, 352, 207, 145, 135, 1348.49, 145, 1347.93, 84
1, 12:10:00-000, 730, 442, 288, 313, 1347.70, 288, 1347.48, 98
1, 12:11:00-000, 294, 176, 118, 110, 1348.40, 118, 1348.26, 92
1, 12:12:00-000, 575, 382, 193, 221, 1348.52, 193, 1347.79, 120
1, 12:13:00-000, 358, 213, 145, 135, 1348.65, 145, 1348.50, 125
1, 12:14:00-000, 606, 307, 299, 215, 1347.86, 299, 1347.20, 98
1, 12:15:00-000, 283, 146, 137, 129, 1348.17, 137, 1347.08, 75
1, 12:16:00-000, 631, 373, 258, 259, 1347.83, 258, 1346.85, 40
1, 12:17:00-000, 299, 182, 117, 149, 1347.93, 117, 1347.06, 73
1, 12:18:00-000, 652, 397, 255, 298, 1348.10, 255, 1347.68, 61
1, 12:19:00-000, 315, 205, 110, 136, 1347.74, 110, 1347.47, 85
1, 12:20:00-000, 598, 336, 262, 216, 1347.91, 262, 1347.33, 101
1, 12:21:00-000, 302, 202, 100, 123, 1347.91, 100, 1347.50, 108
1, 12:22:00-000, 602, 341, 261, 209, 1348.22, 261, 1347.20, 96
1, 12:23:00-000, 327, 187, 140, 121, 1348.15, 140, 1347.14, 115
1, 12:24:00-000, 540, 290, 250, 178, 1348.76, 250, 1347.40, 77
1, 12:25:00-000, 279, 202, 77, 119, 1349.20, 77, 1347.52, 72
1, 12:26:00-000, 720, 423, 297, 288, 1348.69, 297, 1347.84, 109
1, 12:27:00-000, 305, 196, 109, 98, 1348.22, 109, 1347.46, 138
1, 12:28:00-000, 727, 458, 269, 296, 1348.11, 269, 1347.47, 121
1, 12:29:00-000, 326, 210, 116, 149, 1347.62, 116, 1347.31, 115
1, 12:30:00-000, 598, 378, 220, 272, 1347.52, 220, 1347.08, 108
1, 12:31:00-000, 259, 167, 92, 122, 1348.22, 92, 1347.50, 77
1, 12:32:00-000, 611, 425, 186, 254, 1348.39, 186, 1347.33, 87
1, 12:33:00-000, 341, 215, 126, 142, 1348.26, 126, 1347.85, 97
1, 12:34:00-000, 639, 371, 268, 270, 1347.66, 268, 1347.20, 125
1, 12:35:00-000, 341, 196, 145, 138, 1347.33, 145, 1347.28, 86
1, 12:36:00-000, 614, 322, 292, 229, 1348.08, 292, 1346.60, 83
1, 12:37:00-000, 325, 171, 154, 101, 1347.41, 154, 1347.69, 46
1, 12:38:00-000, 552, 301, 251, 214, 1348.05, 247, 1347.00, 111
1, 12:39:00-000, 282, 185, 97, 115, 1348.04, 101, 1347.16, 67
1, 12:40:00-000, 678, 408, 270, 311, 1347.87, 270, 1347.57, 91
1, 12:41:00-000, 313, 170, 143, 129, 1347.90, 143, 1346.56, 63
1, 12:42:00-000, 661, 401, 260, 256, 1347.45, 260, 1347.58, 60
1, 12:43:00-000, 329, 202, 127, 164, 1347.91, 127, 1347.09, 115
1, 12:44:00-000, 588, 370, 218, 240, 1347.86, 218, 1347.83, 74
1, 12:45:00-000, 328, 222, 106, 142, 1348.21, 106, 1347.63, 74
1, 12:46:00-000, 640, 347, 293, 302, 1347.78, 293, 1347.00, 96
1, 12:47:00-000, 289, 158, 131, 122, 1347.87, 131, 1346.78, 57
1, 12:48:00-000, 663, 383, 280, 268, 1347.77, 280, 1347.63, 54
1, 12:49:00-000, 277, 159, 118, 135, 1347.87, 118, 1347.09, 76
1, 12:50:00-000, 650, 351, 299, 289, 1347.61, 299, 1346.16, 66
1, 12:51:00-000, 298, 167, 131, 124, 1347.70, 131, 1346.53, 55
1, 12:52:00-000, 626, 326, 300, 272, 1347.08, 298, 1346.29, 64
1, 12:53:00-000, 300, 151, 149, 114, 1347.89, 151, 1347.42, 33
1, 12:54:00-000, 563, 325, 238, 207, 1347.88, 238, 1347.05, 60
1, 12:55:00-000, 314, 184, 130, 139, 1348.24, 130, 1347.90, 54
1, 12:56:00-000, 557, 302, 255, 249, 1347.32, 255, 1347.04, 76
1, 12:57:00-000, 313, 195, 118, 134, 1348.85, 118, 1348.03, 60
1, 12:58:00-000, 611, 331, 280, 216, 1347.54, 280, 1346.51, 80
1, 12:59:00-000, 290, 192, 98, 148, 1348.53, 98, 1347.69, 91
1, 13:00:00-000, 585, 307, 278, 206, 1347.35, 278, 1346.56, 61
1, 13:01:00-000, 302, 177, 125, 128, 1348.18, 125, 1347.25, 81
1, 13:02:00-000, 687, 413, 274, 310, 1347.83, 274, 1347.29, 67
1, 13:03:00-000, 273, 170, 103, 118, 1348.04, 103, 1347.06, 85
1, 13:04:00-000, 602, 358, 244, 215, 1348.36, 244, 1347.61, 79
1, 13:05:00-000, 324, 206, 118, 172, 1348.26, 118, 1347.15, 96
1, 13:06:00-000, 616, 350, 266, 206, 1347.75, 266, 1347.02, 58
1, 13:07:00-000, 325, 178, 147, 158, 1348.04, 147, 1347.55, 117
1, 13:08:00-000, 531, 353, 178, 172, 1350.25, 178, 1349.49, 88
1, 13:09:00-000, 287, 182, 105, 138, 1348.18, 105, 1347.93, 116
1, 13:10:00-000, 659, 380, 279, 273, 1347.33, 279, 1346.93, 86
1, 13:11:00-000, 296, 168, 128, 140, 1348.15, 128, 1347.34, 76
1, 13:12:00-000, 603, 349, 254, 253, 1347.76, 254, 1346.67, 50
1, 13:13:00-000, 326, 186, 140, 137, 1347.30, 140, 1346.80, 54
1, 13:14:00-000, 550, 357, 193, 259, 1348.20, 193, 1348.84, 115
1, 13:15:00-000, 333, 217, 116, 151, 1348.02, 116, 1346.99, 39
1, 13:16:00-000, 656, 398, 258, 264, 1348.31, 258, 1347.93, 116
1, 13:17:00-000, 363, 212, 151, 140, 1348.01, 151, 1347.69, 107
1, 13:18:00-000, 627, 348, 279, 279, 1347.88, 279, 1346.70, 83
1, 13:19:00-000, 300, 172, 128, 137, 1347.96, 128, 1346.64, 47
1, 13:20:00-000, 583, 337, 246, 271, 1347.58, 246, 1346.85, 64
1, 13:21:00-000, 289, 150, 139, 91, 1348.31, 139, 1347.40, 59
1, 13:22:00-000, 571, 303, 268, 238, 1348.29, 268, 1347.69, 70
1, 13:23:00-000, 333, 200, 133, 134, 1347.41, 133, 1347.68, 46
1, 13:24:00-000, 664, 366, 298, 262, 1348.16, 298, 1347.41, 81
1, 13:25:00-000, 334, 200, 134, 126, 1348.30, 134, 1347.46, 66
1, 13:26:00-000, 539, 332, 207, 228, 1347.83, 207, 1346.89, 85
1, 13:27:00-000, 358, 180, 178, 145, 1347.56, 178, 1347.54, 96
1, 13:28:00-000, 575, 349, 226, 253, 1347.70, 226, 1347.01, 62
1, 13:29:00-000, 313, 178, 135, 101, 1347.67, 135, 1347.72, 99
1, 13:30:00-000, 599, 366, 233, 266, 1348.23, 233, 1347.64, 77
1, 13:31:00-000, 350, 193, 157, 144, 1347.35, 157, 1346.70, 70
1, 13:32:00-000, 615, 365, 250, 212, 1348.36, 250, 1347.19, 115
1, 13:33:00-000, 333, 185, 148, 114, 1348.45, 148, 1347.90, 108
1, 13:34:00-000, 550, 370, 180, 211, 1349.36, 180, 1348.19, 107
1, 13:35:00-000, 262, 155, 107, 148, 1348.23, 107, 1347.62, 107
1, 13:36:00-000, 633, 362, 271, 234, 1348.26, 271, 1347.59, 39
1, 13:37:00-000, 317, 218, 99, 140, 1348.53, 99, 1347.62, 87
1, 13:38:00-000, 669, 398, 271, 273, 1348.44, 270, 1348.35, 114
1, 13:39:00-000, 320, 198, 122, 159, 1348.26, 123, 1347.44, 97
1, 13:40:00-000, 555, 331, 224, 275, 1347.49, 224, 1346.93, 55
1, 13:41:00-000, 295, 189, 106, 139, 1348.41, 106, 1347.33, 56
1, 13:42:00-000, 683, 371, 312, 275, 1347.77, 312, 1346.80, 70
1, 13:43:00-000, 308, 198, 110, 137, 1347.18, 110, 1346.95, 71
1, 13:44:00-000, 625, 322, 303, 261, 1347.50, 303, 1347.00, 80
1, 13:45:00-000, 288, 165, 123, 98, 1349.40, 123, 1348.25, 56
1, 13:46:00-000, 642, 358, 284, 275, 1347.53, 279, 1346.85, 69
1, 13:47:00-000, 328, 176, 152, 119, 1347.78, 157, 1346.33, 72
1, 13:48:00-000, 566, 342, 224, 230, 1348.43, 224, 1347.21, 77
1, 13:49:00-000, 316, 172, 144, 117, 1347.04, 144, 1347.01, 91
1, 13:50:00-000, 593, 323, 270, 249, 1347.82, 270, 1346.40, 78
1, 13:51:00-000, 268, 166, 102, 101, 1347.83, 102, 1347.95, 59
1, 13:52:00-000, 700, 385, 315, 279, 1347.87, 315, 1347.77, 76
1, 13:53:00-000, 299, 190, 109, 115, 1347.73, 109, 1347.17, 92
1, 13:54:00-000, 560, 360, 200, 227, 1348.58, 200, 1347.16, 107
1, 13:55:00-000, 286, 165, 121, 122, 1347.77, 121, 1347.45, 66
1, 13:56:00-000, 659, 400, 259, 283, 1348.10, 259, 1348.21, 87
1, 13:57:00-000, 369, 221, 148, 150, 1348.33, 148, 1347.72, 84
1, 13:58:00-000, 610, 365, 245, 268, 1348.34, 245, 1347.95, 102
1, 13:59:00-000, 271, 165, 106, 125, 1347.20, 106, 1346.26, 79
1, 14:00:00-000, 624, 370, 254, 266, 1347.21, 254, 1346.93, 66
1, 14:01:00-000, 347, 203, 144, 145, 1348.11, 144, 1347.65, 92
1, 14:02:00-000, 590, 391, 199, 240, 1348.86, 199, 1348.24, 91
1, 14:03:00-000, 340, 202, 138, 124, 1348.46, 137, 1347.86, 102
1, 14:04:00-000, 647, 396, 251, 274, 1348.32, 252, 1347.76, 96
1, 14:05:00-000, 318, 204, 114, 120, 1347.58, 114, 1346.90, 108
1, 14:06:00-000, 562, 298, 264, 226, 1348.05, 264, 1347.06, 100
1, 14:07:00-000, 311, 169, 142, 114, 1347.78, 142, 1347.65, 55
1, 14:08:00-000, 657, 385, 272, 258, 1347.70, 272, 1347.23, 85
1, 14:09:00-000, 345, 199, 146, 115, 1348.27, 142, 1347.77, 97
1, 14:10:00-000, 637, 384, 253, 315, 1347.52, 257, 1346.55, 92
1, 14:11:00-000, 320, 219, 101, 117, 1348.30, 101, 1347.85, 71
1, 14:12:00-000, 582, 318, 264, 259, 1348.27, 264, 1347.65, 97
1, 14:13:00-000, 304, 172, 132, 110, 1348.51, 132, 1348.31, 62
1, 14:14:00-000, 655, 398, 257, 307, 1348.33, 257, 1347.99, 84
1, 14:15:00-000, 383, 231, 152, 155, 1348.53, 152, 1347.38, 64
1, 14:16:00-000, 601, 362, 239, 236, 1348.22, 239, 1347.61, 99
1, 14:17:00-000, 285, 131, 154, 96, 1347.95, 154, 1347.48, 107
1, 14:18:00-000, 714, 378, 336, 322, 1347.54, 336, 1346.23, 48
1, 14:19:00-000, 288, 189, 99, 114, 1348.38, 99, 1347.66, 53
1, 14:20:00-000, 628, 398, 230, 259, 1348.54, 230, 1347.61, 105
1, 14:21:00-000, 297, 184, 113, 112, 1349.04, 113, 1347.78, 108
1, 14:22:00-000, 656, 372, 284, 280, 1347.69, 284, 1347.30, 72
1, 14:23:00-000, 284, 165, 119, 134, 1348.72, 119, 1347.86, 69
1, 14:24:00-000, 702, 393, 309, 276, 1347.53, 309, 1346.83, 49
1, 14:25:00-000, 230, 104, 126, 90, 1347.11, 126, 1346.48, 86
1, 14:26:00-000, 630, 370, 260, 276, 1348.42, 260, 1347.56, 49
1, 14:27:00-000, 348, 210, 138, 163, 1348.52, 138, 1348.05, 73
1, 14:28:00-000, 660, 384, 276, 312, 1347.74, 276, 1346.88, 62
1, 14:29:00-000, 320, 181, 139, 132, 1348.27, 139, 1347.08, 71
1, 14:30:00-000, 600, 336, 264, 240, 1347.78, 264, 1347.25, 68
1, 14:31:00-000, 260, 170, 90, 113, 1348.49, 90, 1347.74, 71
1, 14:32:00-000, 610, 335, 275, 277, 1347.74, 275, 1347.15, 68
1, 14:33:00-000, 283, 154, 129, 124, 1347.13, 129, 1346.93, 28
1, 14:34:00-000, 668, 373, 295, 281, 1347.41, 295, 1347.05, 67
1, 14:35:00-000, 299, 142, 157, 123, 1347.91, 157, 1347.75, 55
1, 14:36:00-000, 530, 318, 212, 223, 1347.30, 212, 1346.76, 58
1, 14:37:00-000, 301, 168, 133, 140, 1347.84, 133, 1347.15, 72
1, 14:38:00-000, 582, 319, 263, 265, 1347.10, 263, 1346.83, 56
1, 14:39:00-000, 323, 181, 142, 149, 1347.64, 142, 1345.72, 29
1, 14:40:00-000, 677, 420, 257, 272, 1348.43, 253, 1347.30, 82
1, 14:41:00-000, 352, 224, 128, 129, 1348.94, 132, 1347.68, 100
1, 14:42:00-000, 590, 343, 247, 206, 1348.52, 247, 1347.79, 116
1, 14:43:00-000, 301, 152, 149, 138, 1347.94, 149, 1347.09, 102
1, 14:44:00-000, 623, 392, 231, 227, 1347.97, 231, 1348.51, 75
1, 14:45:00-000, 331, 187, 144, 127, 1348.99, 144, 1347.88, 117
1, 14:46:00-000, 656, 401, 255, 268, 1348.36, 255, 1347.65, 90
1, 14:47:00-000, 249, 132, 117, 101, 1347.74, 117, 1347.56, 61
1, 14:48:00-000, 643, 390, 253, 297, 1348.06, 253, 1347.13, 82
1, 14:49:00-000, 309, 148, 161, 120, 1347.42, 161, 1346.76, 85
1, 14:50:00-000, 602, 375, 227, 206, 1348.99, 227, 1348.28, 54
1, 14:51:00-000, 301, 175, 126, 139, 1348.61, 126, 1348.34, 108
1, 14:52:00-000, 636, 382, 254, 256, 1347.99, 254, 1347.26, 98
1, 14:53:00-000, 353, 225, 128, 105, 1349.47, 128, 1347.61, 92
1, 14:54:00-000, 591, 336, 255, 266, 1347.93, 255, 1347.46, 146
1, 14:55:00-000, 265, 180, 85, 118, 1348.00, 85, 1347.53, 54
1, 14:56:00-000, 619, 326, 293, 282, 1347.87, 293, 1347.02, 52
1, 14:57:00-000, 307, 208, 99, 114, 1348.71, 99, 1348.36, 65
1, 14:58:00-000, 638, 352, 286, 275, 1347.89, 286, 1347.27, 95
1, 14:59:00-000, 257, 133, 124, 139, 1347.21, 124, 1347.11, 50
1, 15:00:00-000, 556, 314, 242, 221, 1347.21, 242, 1346.25, 24
1, 15:01:00-000, 285, 122, 163, 119, 1347.85, 163, 1347.08, 59
1, 15:02:00-000, 630, 417, 213, 250, 1349.02, 213, 1348.17, 47
1, 15:03:00-000, 233, 124, 109, 97, 1347.89, 109, 1347.78, 121
1, 15:04:00-000, 606, 386, 220, 228, 1348.98, 220, 1348.20, 104
1, 15:05:00-000, 307, 212, 95, 110, 1349.90, 95, 1349.51, 103
1, 15:06:00-000, 704, 408, 296, 290, 1347.85, 296, 1347.65, 91
1, 15:07:00-000, 305, 159, 146, 116, 1348.56, 146, 1346.62, 125
1, 15:08:00-000, 555, 328, 227, 179, 1348.58, 227, 1347.16, 73
1, 15:09:00-000, 334, 192, 142, 135, 1347.55, 142, 1347.36, 111
1, 15:10:00-000, 564, 372, 192, 255, 1348.63, 192, 1347.34, 89
1, 15:11:00-000, 376, 227, 149, 152, 1348.67, 149, 1348.49, 77
1, 15:12:00-000, 664, 391, 273, 242, 1348.61, 273, 1347.57, 123
1, 15:13:00-000, 269, 181, 88, 112, 1348.38, 88, 1347.91, 118
1, 15:14:00-000, 580, 351, 229, 255, 1348.01, 229, 1347.25, 63
1, 15:15:00-000, 307, 179, 128, 141, 1348.03, 128, 1347.75, 101
1, 15:16:00-000, 616, 378, 238, 257, 1348.45, 238, 1348.07, 68
1, 15:17:00-000, 357, 191, 166, 160, 1348.04, 166, 1346.91, 78
1, 15:18:00-000, 593, 376, 217, 262, 1348.15, 217, 1347.88, 84
1, 15:19:00-000, 276, 167, 109, 105, 1348.44, 109, 1347.44, 54
1, 15:20:00-000, 644, 346, 298, 264, 1347.44, 298, 1346.38, 89
1, 15:21:00-000, 309, 199, 110, 133, 1347.82, 110, 1347.53, 69
1, 15:22:00-000, 567, 332, 235, 255, 1347.85, 235, 1347.74, 89
1, 15:23:00-000, 313, 182, 131, 121, 1348.57, 131, 1348.01, 66
1, 15:24:00-000, 659, 360, 299, 274, 1348.30, 299, 1347.39, 69
1, 15:25:00-000, 366, 238, 128, 130, 1349.28, 128, 1347.96, 83
1, 15:26:00-000, 561, 332, 229, 223, 1347.99, 229, 1347.24, 95
1, 15:27:00-000, 389, 171, 218, 172, 1346.99, 218, 1346.47, 86
1, 15:28:00-000, 577, 337, 240, 216, 1347.83, 240, 1347.30, 76
1, 15:29:00-000, 319, 176, 143, 111, 1347.41, 143, 1347.03, 65
1, 15:30:00-000, 540, 331, 209, 201, 1348.41, 209, 1347.55, 85
1, 15:31:00-000, 277, 164, 113, 140, 1348.73, 113, 1347.63, 89
1, 15:32:00-000, 674, 377, 297, 314, 1348.09, 297, 1347.44, 46
1, 15:33:00-000, 269, 162, 107, 122, 1348.22, 107, 1347.77, 62
1, 15:34:00-000, 584, 317, 267, 224, 1347.97, 267, 1347.80, 59
1, 15:35:00-000, 284, 165, 119, 115, 1347.84, 119, 1347.50, 74
1, 15:36:00-000, 589, 346, 243, 237, 1349.05, 243, 1348.28, 88
1, 15:37:00-000, 298, 201, 97, 96, 1348.58, 97, 1348.74, 80
1, 15:38:00-000, 699, 420, 279, 252, 1348.49, 279, 1347.89, 107
1, 15:39:00-000, 234, 147, 87, 95, 1348.50, 87, 1347.51, 162
1, 15:40:00-000, 677, 445, 232, 260, 1348.28, 232, 1347.77, 100
1, 15:41:00-000, 293, 177, 116, 111, 1348.50, 116, 1347.78, 121
1, 15:42:00-000, 578, 366, 212, 209, 1348.77, 212, 1347.41, 103
1, 15:43:00-000, 281, 186, 95, 98, 1349.04, 95, 1348.46, 112
1, 15:44:00-000, 632, 413, 219, 240, 1348.71, 219, 1348.33, 128
1, 15:45:00-000, 300, 175, 125, 110, 1348.34, 125, 1346.70, 142
1, 15:46:00-000, 654, 390, 264, 263, 1347.56, 264, 1346.72, 114
1, 15:47:00-000, 289, 153, 136, 103, 1348.38, 136, 1346.55, 100
1, 15:48:00-000, 585, 328, 257, 235, 1347.85, 257, 1346.53, 66
1, 15:49:00-000, 338, 213, 125, 134, 1348.55, 125, 1348.19, 67
1, 15:50:00-000, 580, 404, 176, 242, 1348.57, 176, 1347.80, 85
1, 15:51:00-000, 268, 188, 80, 116, 1348.42, 80, 1348.29, 142
1, 15:52:00-000, 667, 403, 264, 293, 1347.67, 264, 1346.88, 91
1, 15:53:00-000, 331, 194, 137, 137, 1348.05, 137, 1347.22, 82
1, 15:54:00-000, 631, 368, 263, 234, 1348.57, 263, 1348.36, 70
1, 15:55:00-000, 265, 188, 77, 104, 1348.78, 77, 1348.41, 117
1, 15:56:00-000, 678, 421, 257, 291, 1348.64, 257, 1347.72, 112
1, 15:57:00-000, 313, 190, 123, 122, 1347.79, 123, 1346.83, 117
1, 15:58:00-000, 653, 381, 272, 250, 1348.55, 272, 1347.46, 119
1, 15:59:00-000, 224, 128, 96, 85, 1349.15, 96, 1347.84, 97
1, 16:00:00-000, 712, 434, 278, 321, 1347.74, 278, 1346.92, 61
1, 16:01:00-000, 321, 193, 128, 136, 1348.56, 128, 1347.41, 86
1, 16:02:00-000, 546, 321, 225, 213, 1347.62, 225, 1346.92, 74
1, 16:03:00-000, 301, 201, 100, 115, 1349.10, 100, 1348.34, 88
1, 16:04:00-000, 732, 415, 317, 334, 1347.77, 317, 1347.22, 65
1, 16:05:00-000, 321, 204, 117, 149, 1348.47, 117, 1348.01, 91
1, 16:06:00-000, 696, 424, 272, 303, 1348.36, 272, 1347.72, 83
1, 16:07:00-000, 332, 206, 126, 120, 1347.97, 126, 1347.60, 112
1, 16:08:00-000, 604, 325, 279, 266, 1347.97, 279, 1347.05, 83
1, 16:09:00-000, 311, 182, 129, 105, 1348.49, 129, 1348.05, 69
1, 16:10:00-000, 605, 315, 290, 242, 1347.98, 290, 1346.98, 78
1, 16:11:00-000, 398, 198, 200, 176, 1347.61, 200, 1346.78, 56
1, 16:12:00-000, 515, 331, 184, 206, 1349.32, 184, 1349.14, 64
1, 16:13:00-000, 354, 200, 154, 150, 1348.00, 154, 1347.58, 95
1, 16:14:00-000, 602, 320, 282, 242, 1347.59, 282, 1347.17, 75
1, 16:15:00-000, 268, 177, 91, 96, 1348.53, 91, 1347.19, 61
1, 16:16:00-000, 617, 352, 265, 273, 1347.51, 264, 1346.92, 60
1, 16:17:00-000, 367, 232, 135, 125, 1348.91, 136, 1347.27, 102
1, 16:18:00-000, 579, 326, 253, 235, 1348.09, 253, 1347.45, 84
1, 16:19:00-000, 350, 194, 156, 123, 1348.50, 156, 1348.38, 97
1, 16:20:00-000, 583, 306, 277, 268, 1347.33, 277, 1346.57, 68
1, 16:21:00-000, 336, 193, 143, 167, 1347.66, 143, 1346.84, 51
1, 16:22:00-000, 569, 345, 224, 240, 1348.50, 224, 1348.03, 44
1, 16:23:00-000, 262, 156, 106, 101, 1348.95, 106, 1348.08, 69
1, 16:24:00-000, 622, 402, 220, 212, 1348.81, 220, 1348.48, 105
1, 16:25:00-000, 327, 193, 134, 154, 1347.90, 134, 1347.35, 105
1, 16:26:00-000, 570, 335, 235, 271, 1347.95, 235, 1347.32, 91
1, 16:27:00-000, 284, 161, 123, 135, 1347.64, 123, 1347.25, 50
1, 16:28:00-000, 651, 336, 315, 269, 1347.49, 315, 1346.53, 70
1, 16:29:00-000, 299, 164, 135, 116, 1347.36, 135, 1347.13, 47
2, 09:06:00-000, 3062, 0, 3062, 0, 0.00, 1149, 1348.48, 0
2, 09:07:00-000, 0, 0, 0, 0, 0.00, 0, 0.00, 1909
2, 09:08:00-000, 0, 0, 0, 0, 0.00, 0, 0.00, 4
2, 09:13:00-000, 3158, 1149, 2009, 1149, 1352.21, 1597, 1350.71, 0
2, 09:14:00-000, 5, 5, 0, 5, 1356.00, 44, 1356.00, 368
2, 09:15:00-000, 11, 6, 5, 6, 1357.00, 3, 1351.33, 0
2, 09:16:00-000, 127, 81, 46, 76, 1363.96, 48, 1356.41, 0
2, 09:17:00-000, 180, 68, 112, 68, 1354.56, 89, 1352.82, 5
2, 09:18:00-000, 584, 304, 280, 304, 1354.93, 300, 1352.45, 0
2, 09:19:00-000, 436, 218, 218, 218, 1353.41, 221, 1352.68, 0
2, 09:20:00-000, 900, 505, 395, 505, 1355.32, 378, 1352.50, 0
2, 09:21:00-000, 367, 169, 198, 169, 1352.70, 183, 1352.40, 5
2, 09:22:00-000, 525, 262, 263, 262, 1352.58, 266, 1352.37, 4
2, 09:23:00-000, 255, 145, 110, 143, 1355.64, 130, 1353.60, 0
2, 09:24:00-000, 595, 306, 289, 299, 1355.11, 289, 1353.49, 0
2, 09:25:00-000, 280, 116, 164, 125, 1355.01, 133, 1352.38, 0
2, 09:26:00-000, 610, 285, 325, 285, 1351.89, 293, 1351.47, 29
2, 09:27:00-000, 357, 149, 208, 149, 1353.41, 165, 1350.98, 34
2, 09:28:00-000, 629, 332, 297, 332, 1354.37, 222, 1351.24, 55
2, 09:29:00-000, 369, 181, 188, 181, 1354.76, 207, 1353.68, 30
2, 09:30:00-000, 559, 263, 296, 263, 1353.52, 293, 1352.82, 0
2, 09:31:00-000, 274, 142, 132, 142, 1354.06, 148, 1353.59, 1
2, 09:32:00-000, 720, 367, 353, 367, 1354.12, 331, 1352.77, 0
2, 09:33:00-000, 319, 160, 159, 160, 1353.49, 142, 1352.94, 0
2, 09:34:00-000, 563, 271, 292, 271, 1353.43, 259, 1352.46, 29
2, 09:35:00-000, 318, 144, 174, 144, 1353.33, 157, 1352.51, 30
2, 09:36:00-000, 678, 276, 402, 276, 1352.36, 320, 1351.68, 37
2, 09:37:00-000, 304, 157, 147, 157, 1353.31, 109, 1351.60, 61
2, 09:38:00-000, 603, 275, 328, 275, 1353.88, 249, 1351.31, 36
2, 09:39:00-000, 317, 150, 167, 150, 1353.11, 158, 1352.50, 68
2, 09:40:00-000, 679, 323, 356, 323, 1353.38, 346, 1352.07, 19
2, 09:41:00-000, 303, 120, 183, 120, 1351.32, 142, 1350.45, 20
2, 09:42:00-000, 603, 276, 327, 276, 1352.18, 273, 1351.08, 53
2, 09:43:00-000, 313, 120, 193, 120, 1351.98, 130, 1350.48, 49
2, 09:44:00-000, 639, 330, 309, 328, 1353.34, 305, 1351.97, 36
2, 09:45:00-000, 329, 174, 155, 176, 1353.64, 148, 1351.47, 27
2, 09:46:00-000, 652, 260, 392, 260, 1352.44, 299, 1351.43, 16
2, 09:47:00-000, 336, 157, 179, 157, 1353.29, 171, 1352.65, 69
2, 09:48:00-000, 607, 262, 345, 262, 1352.93, 288, 1351.09, 27
2, 09:49:00-000, 287, 119, 168, 119, 1352.31, 121, 1350.79, 57
2, 09:50:00-000, 718, 325, 393, 325, 1352.21, 274, 1351.02, 72
2, 09:51:00-000, 375, 170, 205, 170, 1352.25, 183, 1351.07, 64
2, 09:52:00-000, 529, 281, 248, 280, 1353.35, 252, 1351.82, 38
2, 09:53:00-000, 353, 190, 163, 191, 1353.05, 126, 1351.35, 9
2, 09:54:00-000, 621, 281, 340, 281, 1352.77, 260, 1351.70, 40
2, 09:55:00-000, 346, 170, 176, 170, 1353.73, 157, 1352.23, 64
2, 09:56:00-000, 704, 273, 431, 273, 1351.78, 323, 1351.33, 65
2, 09:57:00-000, 311, 137, 174, 137, 1353.23, 136, 1352.43, 44
2, 09:58:00-000, 623, 269, 354, 269, 1353.00, 297, 1351.63, 60
2, 09:59:00-000, 299, 127, 172, 127, 1350.73, 125, 1351.13, 63
2, 10:00:00-000, 605, 285, 320, 285, 1353.42, 296, 1351.97, 48
2, 10:01:00-000, 333, 145, 188, 145, 1352.95, 127, 1350.92, 25
2, 10:02:00-000, 636, 274, 362, 274, 1351.99, 316, 1351.92, 65
2, 10:03:00-000, 300, 154, 146, 154, 1354.51, 111, 1352.22, 30
2, 10:04:00-000, 582, 250, 332, 250, 1352.25, 274, 1351.17, 50
2, 10:05:00-000, 290, 165, 125, 165, 1353.68, 133, 1352.17, 31
2, 10:06:00-000, 639, 279, 360, 279, 1352.12, 271, 1350.88, 12
2, 10:07:00-000, 327, 179, 148, 179, 1352.51, 162, 1352.46, 55
2, 10:08:00-000, 594, 265, 329, 265, 1352.32, 261, 1351.03, 42
2, 10:09:00-000, 281, 130, 151, 130, 1352.06, 107, 1350.65, 48
2, 10:10:00-000, 551, 282, 269, 282, 1353.58, 224, 1351.62, 67
2, 10:11:00-000, 277, 122, 155, 122, 1353.28, 124, 1351.37, 26
2, 10:12:00-000, 588, 260, 328, 260, 1353.39, 251, 1351.62, 35
2, 10:13:00-000, 358, 175, 183, 175, 1352.38, 165, 1351.01, 43
2, 10:14:00-000, 580, 240, 340, 240, 1351.75, 254, 1350.61, 63
2, 10:15:00-000, 268, 89, 179, 89, 1352.04, 127, 1350.45, 59
2, 10:16:00-000, 665, 285, 380, 285, 1352.75, 295, 1351.32, 90
2, 10:17:00-000, 299, 109, 190, 109, 1352.05, 140, 1350.48, 51
2, 10:18:00-000, 669, 272, 397, 272, 1351.27, 306, 1351.57, 53
2, 10:19:00-000, 261, 95, 166, 95, 1352.91, 155, 1351.63, 74
2, 10:20:00-000, 631, 276, 355, 276, 1352.68, 257, 1351.82, 61
2, 10:21:00-000, 306, 95, 211, 95, 1351.82, 145, 1350.69, 56
2, 10:22:00-000, 690, 285, 405, 285, 1351.40, 269, 1351.35, 96
2, 10:23:00-000, 337, 169, 168, 169, 1352.58, 161, 1352.05, 77
2, 10:24:00-000, 690, 305, 385, 305, 1353.11, 323, 1351.65, 47
2, 10:25:00-000, 313, 159, 154, 157, 1353.98, 144, 1352.58, 52
2, 10:26:00-000, 632, 257, 375, 259, 1353.07, 298, 1351.75, 15
2, 10:27:00-000, 268, 139, 129, 139, 1351.44, 133, 1350.75, 50
2, 10:28:00-000, 718, 341, 377, 341, 1352.64, 327, 1351.44, 31
2, 10:29:00-000, 303, 175, 128, 175, 1353.88, 108, 1352.03, 37
2, 10:30:00-000, 603, 308, 295, 308, 1353.07, 241, 1351.23, 35
2, 10:31:00-000, 268, 145, 123, 145, 1353.08, 127, 1352.50, 34
2, 10:32:00-000, 510, 236, 274, 236, 1352.99, 221, 1352.09, 28
2, 10:33:00-000, 393, 151, 242, 151, 1351.83, 166, 1351.73, 33
2, 10:34:00-000, 607, 293, 314, 293, 1353.14, 256, 1351.52, 84
2, 10:35:00-000, 315, 133, 182, 133, 1352.36, 138, 1350.78, 50
2, 10:36:00-000, 532, 220, 312, 220, 1352.05, 264, 1351.27, 41
2, 10:37:00-000, 323, 123, 200, 123, 1351.97, 164, 1351.27, 53
2, 10:38:00-000, 672, 320, 352, 320, 1352.96, 270, 1350.92, 50
2, 10:39:00-000, 303, 150, 153, 150, 1353.09, 133, 1351.72, 51
2, 10:40:00-000, 578, 247, 331, 247, 1351.59, 225, 1350.77, 48
2, 10:41:00-000, 301, 111, 190, 111, 1350.90, 126, 1350.58, 89
2, 10:42:00-000, 645, 310, 335, 310, 1352.37, 289, 1351.65, 68
2, 10:43:00-000, 312, 155, 157, 155, 1353.36, 124, 1352.12, 43
2, 10:44:00-000, 583, 239, 344, 239, 1352.13, 254, 1351.07, 79
2, 10:45:00-000, 287, 144, 143, 144, 1352.61, 118, 1351.39, 47
2, 10:46:00-000, 608, 260, 348, 260, 1351.79, 265, 1350.99, 40
2, 10:47:00-000, 355, 153, 202, 153, 1351.59, 151, 1350.45, 68
2, 10:48:00-000, 511, 184, 327, 184, 1351.91, 221, 1351.31, 83
2, 10:49:00-000, 384, 157, 227, 157, 1351.64, 168, 1350.81, 71
2, 10:50:00-000, 583, 233, 350, 233, 1352.11, 229, 1351.74, 89
2, 10:51:00-000, 325, 140, 185, 140, 1351.79, 164, 1350.94, 60
2, 10:52:00-000, 647, 267, 380, 267, 1352.60, 261, 1351.18, 59
2, 10:53:00-000, 278, 103, 175, 103, 1351.41, 112, 1350.30, 116
2, 10:54:00-000, 600, 266, 334, 266, 1351.88, 231, 1350.95, 73
2, 10:55:00-000, 318, 120, 198, 120, 1352.66, 152, 1349.68, 94
2, 10:56:00-000, 620, 232, 388, 232, 1352.22, 255, 1350.84, 69
2, 10:57:00-000, 366, 178, 188, 178, 1353.38, 187, 1352.11, 77
2, 10:58:00-000, 632, 274, 358, 272, 1352.33, 306, 1350.76, 49
2, 10:59:00-000, 326, 134, 192, 136, 1351.58, 136, 1350.48, 33
2, 11:00:00-000, 601, 259, 342, 259, 1352.53, 271, 1351.74, 56
2, 11:01:00-000, 258, 122, 136, 122, 1352.54, 134, 1351.61, 55
2, 11:02:00-000, 603, 271, 332, 271, 1352.35, 235, 1351.22, 34
2, 11:03:00-000, 291, 140, 151, 140, 1352.29, 123, 1352.26, 57
2, 11:04:00-000, 736, 318, 418, 318, 1351.70, 275, 1350.83, 99
2, 11:05:00-000, 309, 140, 169, 140, 1350.82, 136, 1350.97, 77
2, 11:06:00-000, 602, 306, 296, 306, 1353.29, 265, 1351.60, 56
2, 11:07:00-000, 307, 116, 191, 116, 1352.51, 160, 1350.21, 30
2, 11:08:00-000, 532, 225, 307, 225, 1352.11, 220, 1351.62, 55
2, 11:09:00-000, 343, 148, 195, 148, 1352.93, 159, 1351.16, 46
2, 11:10:00-000, 635, 280, 355, 280, 1352.04, 248, 1351.67, 63
2, 11:11:00-000, 320, 137, 183, 137, 1352.82, 164, 1351.03, 78
2, 11:12:00-000, 582, 240, 342, 240, 1351.68, 247, 1351.08, 53
2, 11:13:00-000, 272, 113, 159, 113, 1352.68, 120, 1351.69, 62
2, 11:14:00-000, 552, 268, 284, 268, 1352.29, 243, 1351.72, 38
2, 11:15:00-000, 285, 103, 182, 103, 1350.42, 110, 1350.12, 43
2, 11:16:00-000, 597, 280, 317, 280, 1352.06, 274, 1350.85, 58
2, 11:17:00-000, 315, 149, 166, 149, 1351.84, 109, 1350.78, 68
2, 11:18:00-000, 673, 252, 421, 252, 1351.58, 248, 1350.88, 84
2, 11:19:00-000, 289, 121, 168, 121, 1352.21, 132, 1351.36, 126
2, 11:20:00-000, 605, 271, 334, 271, 1352.88, 281, 1351.59, 71
2, 11:21:00-000, 295, 142, 153, 141, 1352.76, 127, 1351.96, 45
2, 11:22:00-000, 546, 219, 327, 220, 1351.81, 270, 1351.22, 33
2, 11:23:00-000, 351, 158, 193, 158, 1354.13, 168, 1352.51, 39
2, 11:24:00-000, 637, 276, 361, 276, 1351.96, 275, 1351.41, 59
2, 11:25:00-000, 329, 133, 196, 133, 1351.61, 118, 1349.78, 59
2, 11:26:00-000, 547, 230, 317, 230, 1352.10, 232, 1351.27, 84
2, 11:27:00-000, 327, 173, 154, 173, 1352.85, 154, 1352.70, 53
2, 11:28:00-000, 578, 263, 315, 263, 1353.57, 264, 1351.02, 43
2, 11:29:00-000, 234, 100, 134, 100, 1353.09, 95, 1352.00, 35
2, 11:30:00-000, 619, 286, 333, 286, 1352.33, 302, 1351.50, 26
2, 11:31:00-000, 295, 116, 179, 116, 1351.39, 137, 1351.03, 39
2, 11:32:00-000, 633, 288, 345, 288, 1351.47, 263, 1350.80, 61
2, 11:33:00-000, 264, 150, 114, 150, 1352.25, 100, 1351.11, 62
2, 11:34:00-000, 579, 221, 358, 221, 1352.20, 269, 1351.19, 36
2, 11:35:00-000, 296, 111, 185, 111, 1351.98, 124, 1351.35, 74
2, 11:36:00-000, 627, 275, 352, 275, 1352.64, 289, 1351.00, 73
2, 11:37:00-000, 300, 135, 165, 135, 1353.37, 136, 1351.63, 37
2, 11:38:00-000, 623, 273, 350, 273, 1353.10, 292, 1351.82, 58
2, 11:39:00-000, 232, 92, 140, 92, 1352.12, 105, 1351.76, 40
2, 11:40:00-000, 690, 284, 406, 284, 1352.81, 292, 1351.52, 56
2, 11:41:00-000, 306, 132, 174, 132, 1351.60, 123, 1350.56, 87
2, 11:42:00-000, 588, 282, 306, 282, 1352.70, 258, 1351.37, 54
2, 11:43:00-000, 326, 144, 182, 141, 1352.47, 146, 1351.19, 51
2, 11:44:00-000, 603, 266, 337, 269, 1351.86, 229, 1350.96, 67
2, 11:45:00-000, 274, 111, 163, 111, 1352.68, 124, 1351.10, 68
2, 11:46:00-000, 665, 329, 336, 329, 1351.62, 247, 1350.90, 45
2, 11:47:00-000, 279, 102, 177, 102, 1352.11, 150, 1351.27, 85
2, 11:48:00-000, 690, 278, 412, 278, 1352.33, 347, 1350.84, 50
2, 11:49:00-000, 323, 154, 169, 154, 1352.82, 149, 1351.99, 45
2, 11:50:00-000, 643, 238, 405, 238, 1351.96, 253, 1350.98, 58
2, 11:51:00-000, 379, 149, 230, 149, 1351.60, 171, 1350.96, 68
2, 11:52:00-000, 614, 239, 375, 239, 1352.11, 280, 1351.35, 100
2, 11:53:00-000, 309, 156, 153, 156, 1352.10, 137, 1351.09, 99
2, 11:54:00-000, 532, 249, 283, 249, 1353.08, 221, 1351.57, 35
2, 11:55:00-000, 287, 133, 154, 133, 1352.87, 161, 1351.89, 29
2, 11:56:00-000, 726, 323, 403, 321, 1353.08, 370, 1352.21, 19
2, 11:57:00-000, 299, 161, 138, 163, 1353.27, 109, 1352.58, 31
2, 11:58:00-000, 632, 270, 362, 270, 1352.13, 301, 1351.00, 38
2, 11:59:00-000, 266, 110, 156, 110, 1349.23, 85, 1349.90, 55
2, 12:00:00-000, 623, 319, 304, 316, 1352.41, 233, 1352.05, 72
2, 12:01:00-000, 334, 151, 183, 151, 1352.63, 147, 1352.15, 55
2, 12:02:00-000, 647, 286, 361, 286, 1352.67, 294, 1351.68, 45
2, 12:03:00-000, 294, 142, 152, 142, 1353.92, 112, 1351.72, 55
2, 12:04:00-000, 607, 251, 356, 251, 1352.69, 253, 1351.51, 76
2, 12:05:00-000, 315, 118, 197, 118, 1351.90, 169, 1351.58, 56
2, 12:06:00-000, 598, 265, 333, 265, 1352.57, 282, 1351.70, 48
2, 12:07:00-000, 283, 116, 167, 116, 1352.71, 146, 1351.98, 47
2, 12:08:00-000, 573, 253, 320, 253, 1353.15, 273, 1351.17, 42
2, 12:09:00-000, 362, 143, 219, 143, 1352.04, 150, 1350.63, 43
2, 12:10:00-000, 617, 272, 345, 272, 1351.70, 214, 1350.49, 111
2, 12:11:00-000, 350, 181, 169, 181, 1354.06, 159, 1352.28, 65
2, 12:12:00-000, 565, 260, 305, 260, 1352.94, 273, 1351.29, 25
2, 12:13:00-000, 283, 159, 124, 159, 1353.73, 115, 1352.85, 25
2, 12:14:00-000, 711, 272, 439, 272, 1351.60, 300, 1351.21, 42
2, 12:15:00-000, 280, 130, 150, 130, 1352.50, 130, 1352.36, 64
2, 12:16:00-000, 653, 291, 362, 291, 1352.39, 315, 1351.25, 82
2, 12:17:00-000, 245, 108, 137, 108, 1352.97, 98, 1351.13, 38
2, 12:18:00-000, 559, 239, 320, 239, 1352.10, 243, 1350.86, 40
2, 12:19:00-000, 346, 178, 168, 178, 1353.03, 143, 1351.55, 50
2, 12:20:00-000, 700, 296, 404, 296, 1351.55, 232, 1349.81, 103
2, 12:21:00-000, 280, 97, 183, 97, 1351.23, 121, 1350.22, 123
2, 12:22:00-000, 685, 276, 409, 276, 1352.21, 249, 1350.56, 92
2, 12:23:00-000, 319, 144, 175, 144, 1352.35, 106, 1350.22, 125
2, 12:24:00-000, 606, 248, 358, 248, 1351.61, 220, 1349.48, 104
2, 12:25:00-000, 252, 124, 128, 124, 1352.65, 117, 1351.19, 84
2, 12:26:00-000, 655, 223, 432, 223, 1351.45, 262, 1350.85, 67
2, 12:27:00-000, 374, 172, 202, 172, 1352.28, 174, 1350.92, 102
2, 12:28:00-000, 642, 215, 427, 215, 1351.91, 266, 1351.30, 97
2, 12:29:00-000, 271, 93, 178, 93, 1351.47, 135, 1351.00, 91
2, 12:30:00-000, 581, 179, 402, 179, 1351.28, 240, 1350.18, 97
2, 12:31:00-000, 352, 153, 199, 153, 1352.62, 114, 1350.58, 118
2, 12:32:00-000, 696, 277, 419, 277, 1352.15, 323, 1351.17, 113
2, 12:33:00-000, 242, 132, 110, 132, 1353.90, 99, 1351.42, 66
2, 12:34:00-000, 741, 296, 445, 296, 1352.35, 308, 1350.84, 79
2, 12:35:00-000, 270, 121, 149, 121, 1351.97, 146, 1351.13, 71
2, 12:36:00-000, 565, 282, 283, 282, 1352.71, 226, 1350.81, 38
2, 12:37:00-000, 280, 145, 135, 144, 1352.63, 108, 1350.93, 42
2, 12:38:00-000, 612, 251, 361, 252, 1352.17, 268, 1351.11, 51
2, 12:39:00-000, 289, 89, 200, 89, 1352.59, 130, 1351.54, 59
2, 12:40:00-000, 710, 319, 391, 319, 1352.47, 331, 1351.40, 80
2, 12:41:00-000, 327, 116, 211, 116, 1351.77, 137, 1351.04, 65
2, 12:42:00-000, 480, 262, 218, 262, 1353.17, 177, 1351.81, 93
2, 12:43:00-000, 312, 142, 170, 142, 1352.84, 149, 1351.67, 17
2, 12:44:00-000, 673, 310, 363, 310, 1352.40, 291, 1350.71, 45
2, 12:45:00-000, 266, 119, 147, 119, 1351.78, 79, 1351.19, 44
2, 12:46:00-000, 543, 242, 301, 242, 1352.19, 256, 1351.40, 73
2, 12:47:00-000, 303, 126, 177, 126, 1352.13, 156, 1350.75, 37
2, 12:48:00-000, 632, 284, 348, 284, 1352.12, 259, 1351.11, 59
2, 12:49:00-000, 324, 141, 183, 141, 1352.98, 146, 1351.38, 52
2, 12:50:00-000, 646, 223, 423, 223, 1351.54, 286, 1350.30, 65
2, 12:51:00-000, 314, 116, 198, 116, 1351.11, 102, 1350.62, 117
2, 12:52:00-000, 647, 290, 357, 290, 1351.37, 251, 1350.58, 101
2, 12:53:00-000, 307, 154, 153, 154, 1351.99, 138, 1350.66, 83
2, 12:54:00-000, 601, 260, 341, 260, 1352.18, 233, 1350.68, 77
2, 12:55:00-000, 270, 108, 162, 108, 1351.92, 120, 1351.51, 55
2, 12:56:00-000, 606, 246, 360, 246, 1351.32, 232, 1350.21, 77
2, 12:57:00-000, 318, 132, 186, 132, 1352.11, 155, 1351.41, 72
2, 12:58:00-000, 643, 242, 401, 242, 1351.69, 253, 1351.25, 100
2, 12:59:00-000, 348, 139, 209, 139, 1352.04, 162, 1351.49, 89
2, 13:00:00-000, 649, 266, 383, 266, 1351.21, 238, 1350.72, 110
2, 13:01:00-000, 274, 93, 181, 93, 1351.45, 127, 1350.44, 88
2, 13:02:00-000, 648, 275, 373, 275, 1352.23, 280, 1350.92, 62
2, 13:03:00-000, 300, 139, 161, 139, 1352.37, 160, 1351.23, 69
2, 13:04:00-000, 646, 286, 360, 286, 1352.65, 267, 1350.91, 53
2, 13:05:00-000, 317, 128, 189, 128, 1351.75, 150, 1350.67, 55
2, 13:06:00-000, 521, 226, 295, 226, 1353.04, 254, 1351.66, 62
2, 13:07:00-000, 312, 150, 162, 150, 1352.11, 150, 1352.05, 37
2, 13:08:00-000, 639, 278, 361, 278, 1352.95, 307, 1351.91, 16
2, 13:09:00-000, 317, 111, 206, 111, 1351.79, 100, 1350.39, 54
2, 13:10:00-000, 564, 215, 349, 215, 1351.09, 258, 1350.86, 98
2, 13:11:00-000, 371, 178, 193, 178, 1351.98, 159, 1350.86, 73
2, 13:12:00-000, 581, 285, 296, 285, 1351.79, 224, 1350.98, 70
2, 13:13:00-000, 332, 143, 189, 143, 1352.55, 168, 1351.25, 32
2, 13:14:00-000, 603, 276, 327, 276, 1352.41, 279, 1351.16, 48
2, 13:15:00-000, 272, 119, 153, 119, 1353.22, 126, 1351.38, 29
2, 13:16:00-000, 602, 294, 308, 294, 1352.84, 289, 1351.70, 48
2, 13:17:00-000, 285, 143, 142, 143, 1352.58, 92, 1351.70, 17
2, 13:18:00-000, 617, 240, 377, 240, 1351.43, 259, 1351.08, 68
2, 13:19:00-000, 300, 117, 183, 117, 1351.73, 150, 1351.43, 78
2, 13:20:00-000, 649, 276, 373, 276, 1352.27, 270, 1350.99, 65
2, 13:21:00-000, 305, 144, 161, 144, 1352.96, 177, 1351.65, 50
2, 13:22:00-000, 542, 307, 235, 307, 1352.95, 214, 1351.84, 23
2, 13:23:00-000, 334, 150, 184, 150, 1352.85, 136, 1351.04, 28
2, 13:24:00-000, 583, 269, 314, 269, 1352.52, 266, 1351.27, 61
2, 13:25:00-000, 347, 116, 231, 116, 1351.52, 135, 1351.17, 34
2, 13:26:00-000, 633, 241, 392, 241, 1351.72, 305, 1350.59, 106
2, 13:27:00-000, 319, 131, 188, 131, 1351.97, 139, 1350.46, 67
2, 13:28:00-000, 644, 280, 364, 280, 1352.45, 274, 1350.86, 66
2, 13:29:00-000, 332, 149, 183, 149, 1352.11, 149, 1350.83, 65
2, 13:30:00-000, 594, 260, 334, 260, 1352.48, 266, 1351.03, 59
2, 13:31:00-000, 290, 110, 180, 110, 1351.01, 128, 1350.20, 56
2, 13:32:00-000, 608, 289, 319, 289, 1352.50, 258, 1351.35, 59
2, 13:33:00-000, 328, 153, 175, 153, 1351.71, 143, 1351.49, 45
2, 13:34:00-000, 662, 292, 370, 292, 1352.58, 265, 1352.06, 60
2, 13:35:00-000, 328, 124, 204, 124, 1353.09, 139, 1351.44, 87
2, 13:36:00-000, 614, 307, 307, 307, 1352.76, 303, 1351.83, 55
2, 13:37:00-000, 353, 134, 219, 134, 1352.34, 146, 1350.88, 18
2, 13:38:00-000, 558, 227, 331, 227, 1352.77, 259, 1351.69, 67
2, 13:39:00-000, 341, 130, 211, 130, 1351.46, 164, 1351.41, 64
2, 13:40:00-000, 639, 300, 339, 300, 1352.37, 266, 1351.10, 65
2, 13:41:00-000, 277, 93, 184, 93, 1351.23, 111, 1350.32, 65
2, 13:42:00-000, 644, 308, 336, 308, 1352.94, 270, 1351.69, 81
2, 13:43:00-000, 273, 118, 155, 118, 1351.56, 137, 1351.06, 51
2, 13:44:00-000, 620, 284, 336, 284, 1352.18, 247, 1350.88, 43
2, 13:45:00-000, 321, 132, 189, 132, 1353.23, 171, 1352.24, 35
2, 13:46:00-000, 702, 254, 448, 254, 1351.58, 290, 1350.90, 101
2, 13:47:00-000, 272, 117, 155, 117, 1351.01, 127, 1351.34, 92
2, 13:48:00-000, 671, 308, 363, 308, 1351.97, 281, 1351.18, 65
2, 13:49:00-000, 321, 137, 184, 137, 1351.35, 129, 1350.63, 50
2, 13:50:00-000, 609, 257, 352, 257, 1351.57, 260, 1350.65, 61
2, 13:51:00-000, 316, 160, 156, 160, 1352.41, 153, 1351.50, 78
2, 13:52:00-000, 588, 297, 291, 297, 1352.76, 228, 1351.61, 25
2, 13:53:00-000, 350, 111, 239, 111, 1351.39, 169, 1350.07, 60
2, 13:54:00-000, 629, 273, 356, 273, 1352.66, 261, 1351.57, 104
2, 13:55:00-000, 280, 100, 180, 100, 1351.58, 119, 1350.79, 61
2, 13:56:00-000, 611, 298, 313, 298, 1352.47, 252, 1351.13, 72
2, 13:57:00-000, 362, 172, 190, 172, 1352.74, 155, 1350.61, 49
2, 13:58:00-000, 660, 342, 318, 342, 1352.85, 275, 1351.47, 35
2, 13:59:00-000, 295, 105, 190, 105, 1350.92, 130, 1350.10, 43
2, 14:00:00-000, 596, 241, 355, 241, 1351.38, 227, 1350.75, 92
2, 14:01:00-000, 306, 107, 199, 107, 1351.83, 126, 1350.76, 86
2, 14:02:00-000, 695, 313, 382, 313, 1352.40, 295, 1351.52, 85
2, 14:03:00-000, 260, 124, 136, 124, 1352.55, 107, 1351.21, 85
2, 14:04:00-000, 620, 251, 369, 251, 1352.64, 294, 1351.01, 43
2, 14:05:00-000, 358, 114, 244, 114, 1351.64, 101, 1350.71, 51
2, 14:06:00-000, 659, 281, 378, 281, 1351.58, 312, 1350.88, 158
2, 14:07:00-000, 308, 121, 187, 121, 1351.47, 108, 1350.99, 70
2, 14:08:00-000, 611, 233, 378, 233, 1352.06, 272, 1351.19, 63
2, 14:09:00-000, 350, 157, 193, 157, 1352.30, 170, 1352.07, 79
2, 14:10:00-000, 635, 209, 426, 209, 1351.23, 268, 1350.38, 73
2, 14:11:00-000, 256, 123, 133, 123, 1351.93, 77, 1350.82, 141
2, 14:12:00-000, 633, 253, 380, 253, 1352.01, 272, 1351.10, 87
2, 14:13:00-000, 336, 164, 172, 164, 1352.52, 135, 1350.68, 59
2, 14:14:00-000, 738, 289, 449, 289, 1352.12, 309, 1350.95, 80
2, 14:15:00-000, 343, 164, 179, 164, 1352.94, 174, 1351.33, 93
2, 14:16:00-000, 550, 241, 309, 241, 1351.96, 235, 1351.43, 41
2, 14:17:00-000, 289, 122, 167, 122, 1351.45, 122, 1351.00, 51
2, 14:18:00-000, 649, 305, 344, 305, 1352.09, 266, 1351.43, 71
2, 14:19:00-000, 323, 106, 217, 106, 1351.31, 139, 1351.19, 43
2, 14:20:00-000, 656, 261, 395, 261, 1352.31, 298, 1351.64, 78
2, 14:21:00-000, 302, 154, 148, 154, 1351.82, 125, 1351.07, 108
2, 14:22:00-000, 619, 244, 375, 244, 1351.73, 270, 1351.00, 39
2, 14:23:00-000, 347, 180, 167, 180, 1353.43, 203, 1352.57, 54
2, 14:24:00-000, 600, 248, 352, 248, 1351.02, 234, 1350.53, 34
2, 14:25:00-000, 357, 153, 204, 153, 1350.99, 150, 1350.84, 80
2, 14:26:00-000, 611, 267, 344, 267, 1352.01, 243, 1350.65, 58
2, 14:27:00-000, 320, 154, 166, 154, 1352.58, 138, 1351.23, 78
2, 14:28:00-000, 627, 278, 349, 278, 1352.02, 278, 1350.81, 71
2, 14:29:00-000, 261, 92, 169, 92, 1351.77, 114, 1350.22, 65
2, 14:30:00-000, 732, 344, 388, 344, 1351.88, 309, 1351.46, 47
2, 14:31:00-000, 263, 103, 160, 103, 1351.98, 98, 1351.31, 84
2, 14:32:00-000, 682, 305, 377, 305, 1351.71, 276, 1350.83, 81
2, 14:33:00-000, 295, 114, 181, 114, 1350.98, 129, 1350.66, 87
2, 14:34:00-000, 537, 232, 305, 232, 1352.06, 207, 1350.61, 59
2, 14:35:00-000, 328, 141, 187, 141, 1352.37, 127, 1351.31, 84
2, 14:36:00-000, 705, 280, 425, 280, 1351.36, 310, 1350.55, 76
2, 14:37:00-000, 293, 99, 194, 99, 1352.20, 125, 1350.32, 88
2, 14:38:00-000, 628, 274, 354, 274, 1351.57, 247, 1350.69, 80
2, 14:39:00-000, 376, 169, 207, 167, 1351.19, 194, 1350.46, 69
2, 14:40:00-000, 566, 230, 336, 232, 1352.23, 258, 1351.18, 49
2, 14:41:00-000, 293, 122, 171, 122, 1352.05, 140, 1351.10, 65
2, 14:42:00-000, 590, 231, 359, 231, 1351.86, 290, 1351.26, 51
2, 14:43:00-000, 371, 144, 227, 144, 1352.76, 171, 1351.92, 56
2, 14:44:00-000, 657, 307, 350, 307, 1352.65, 279, 1351.13, 76
2, 14:45:00-000, 312, 158, 154, 158, 1352.61, 139, 1351.06, 55
2, 14:46:00-000, 674, 298, 376, 295, 1353.22, 276, 1351.19, 29
2, 14:47:00-000, 304, 138, 166, 141, 1352.39, 129, 1352.10, 68
2, 14:48:00-000, 697, 322, 375, 322, 1352.28, 285, 1350.77, 102
2, 14:49:00-000, 244, 110, 134, 110, 1351.77, 68, 1351.48, 47
2, 14:50:00-000, 546, 263, 283, 263, 1353.13, 246, 1351.34, 72
2, 14:51:00-000, 268, 131, 137, 131, 1353.45, 121, 1351.90, 24
2, 14:52:00-000, 633, 250, 383, 250, 1351.72, 260, 1350.95, 50
2, 14:53:00-000, 349, 166, 183, 166, 1353.00, 157, 1352.25, 64
2, 14:54:00-000, 671, 301, 370, 301, 1352.04, 296, 1351.30, 71
2, 14:55:00-000, 292, 98, 194, 98, 1351.91, 137, 1351.38, 67
2, 14:56:00-000, 519, 219, 300, 219, 1352.07, 275, 1351.14, 47
2, 14:57:00-000, 289, 142, 147, 142, 1352.99, 114, 1351.08, 35
2, 14:58:00-000, 543, 244, 299, 244, 1352.84, 261, 1350.97, 27
2, 14:59:00-000, 315, 113, 202, 113, 1351.51, 134, 1350.59, 43
2, 15:00:00-000, 566, 262, 304, 262, 1352.27, 239, 1351.38, 67
2, 15:01:00-000, 306, 139, 167, 139, 1352.72, 124, 1351.72, 45
2, 15:02:00-000, 647, 325, 322, 325, 1353.04, 273, 1352.07, 63
2, 15:03:00-000, 281, 127, 154, 126, 1352.63, 107, 1351.25, 47
2, 15:04:00-000, 618, 289, 329, 290, 1353.38, 288, 1352.35, 38
2, 15:05:00-000, 382, 194, 188, 194, 1353.54, 172, 1352.18, 35
2, 15:06:00-000, 656, 272, 384, 272, 1351.99, 270, 1350.98, 68
2, 15:07:00-000, 297, 131, 166, 131, 1352.83, 132, 1351.95, 51
2, 15:08:00-000, 551, 217, 334, 217, 1351.28, 242, 1351.35, 61
2, 15:09:00-000, 316, 125, 191, 125, 1351.27, 127, 1351.02, 60
2, 15:10:00-000, 566, 264, 302, 264, 1352.56, 253, 1351.58, 84
2, 15:11:00-000, 362, 158, 204, 158, 1351.73, 146, 1351.33, 55
2, 15:12:00-000, 625, 280, 345, 280, 1351.91, 270, 1351.84, 66
2, 15:13:00-000, 274, 125, 149, 125, 1352.28, 110, 1351.27, 65
2, 15:14:00-000, 572, 230, 342, 230, 1352.12, 241, 1350.83, 61
2, 15:15:00-000, 313, 130, 183, 130, 1352.29, 119, 1350.60, 73
2, 15:16:00-000, 663, 276, 387, 276, 1352.15, 320, 1351.52, 71
2, 15:17:00-000, 235, 117, 118, 117, 1351.74, 97, 1350.22, 64
2, 15:18:00-000, 644, 274, 370, 274, 1352.58, 295, 1351.61, 33
2, 15:19:00-000, 350, 135, 215, 135, 1351.90, 147, 1351.79, 72
2, 15:20:00-000, 547, 232, 315, 232, 1351.20, 227, 1350.70, 86
2, 15:21:00-000, 326, 134, 192, 134, 1351.73, 138, 1349.63, 62
2, 15:22:00-000, 643, 305, 338, 302, 1352.16, 274, 1351.19, 61
2, 15:23:00-000, 303, 160, 143, 163, 1353.67, 136, 1352.41, 45
2, 15:24:00-000, 634, 270, 364, 270, 1352.35, 287, 1351.53, 43
2, 15:25:00-000, 303, 110, 193, 110, 1352.23, 120, 1351.24, 61
2, 15:26:00-000, 586, 247, 339, 247, 1352.33, 261, 1351.30, 65
2, 15:27:00-000, 248, 87, 161, 87, 1351.03, 84, 1350.27, 69
2, 15:28:00-000, 694, 295, 399, 295, 1352.01, 294, 1351.14, 108
2, 15:29:00-000, 314, 127, 187, 127, 1351.19, 94, 1350.14, 86
2, 15:30:00-000, 497, 233, 264, 233, 1352.28, 244, 1351.82, 75
2, 15:31:00-000, 371, 123, 248, 123, 1351.99, 177, 1351.30, 37
2, 15:32:00-000, 594, 262, 332, 262, 1352.27, 261, 1351.23, 93
2, 15:33:00-000, 405, 168, 237, 168, 1352.27, 153, 1351.23, 60
2, 15:34:00-000, 590, 254, 336, 254, 1352.02, 264, 1350.97, 95
2, 15:35:00-000, 282, 133, 149, 133, 1351.62, 109, 1350.96, 57
2, 15:36:00-000, 612, 249, 363, 249, 1352.09, 263, 1351.64, 56
2, 15:37:00-000, 305, 146, 159, 146, 1352.62, 148, 1351.80, 63
2, 15:38:00-000, 649, 313, 336, 313, 1352.88, 284, 1352.10, 33
2, 15:39:00-000, 278, 116, 162, 116, 1353.90, 112, 1351.69, 47
2, 15:40:00-000, 623, 222, 401, 222, 1351.54, 226, 1349.33, 77
2, 15:41:00-000, 373, 155, 218, 155, 1351.91, 112, 1349.94, 140
2, 15:42:00-000, 618, 266, 352, 266, 1352.00, 216, 1350.46, 145
2, 15:43:00-000, 284, 156, 128, 155, 1352.40, 68, 1350.59, 105
2, 15:44:00-000, 590, 267, 323, 268, 1352.65, 224, 1350.96, 59
2, 15:45:00-000, 293, 111, 182, 111, 1351.77, 118, 1350.54, 86
2, 15:46:00-000, 672, 200, 472, 200, 1351.30, 304, 1349.69, 101
2, 15:47:00-000, 326, 91, 235, 91, 1350.82, 153, 1349.64, 120
2, 15:48:00-000, 553, 200, 353, 200, 1352.24, 222, 1350.29, 161
2, 15:49:00-000, 342, 155, 187, 155, 1352.77, 123, 1350.61, 77
2, 15:50:00-000, 611, 246, 365, 246, 1352.68, 270, 1350.79, 87
2, 15:51:00-000, 302, 116, 186, 116, 1352.60, 123, 1350.82, 65
2, 15:52:00-000, 537, 228, 309, 228, 1351.66, 237, 1350.60, 72
2, 15:53:00-000, 288, 107, 181, 107, 1352.21, 120, 1351.19, 67
2, 15:54:00-000, 675, 302, 373, 302, 1352.44, 296, 1351.31, 72
2, 15:55:00-000, 319, 118, 201, 118, 1352.67, 128, 1351.95, 61
2, 15:56:00-000, 600, 187, 413, 187, 1352.33, 275, 1351.57, 97
2, 15:57:00-000, 274, 99, 175, 99, 1351.47, 100, 1350.61, 126
2, 15:58:00-000, 641, 324, 317, 324, 1352.81, 268, 1351.24, 60
2, 15:59:00-000, 284, 131, 153, 131, 1352.43, 123, 1351.70, 55
2, 16:00:00-000, 548, 218, 330, 218, 1352.03, 252, 1350.71, 49
2, 16:01:00-000, 302, 118, 184, 118, 1352.64, 124, 1351.17, 52
2, 16:02:00-000, 653, 287, 366, 287, 1351.65, 308, 1351.01, 81
2, 16:03:00-000, 328, 134, 194, 134, 1352.41, 139, 1351.25, 38
2, 16:04:00-000, 619, 283, 336, 283, 1352.83, 259, 1350.89, 70
2, 16:05:00-000, 338, 125, 213, 125, 1352.18, 151, 1351.11, 52
2, 16:06:00-000, 592, 264, 328, 264, 1352.26, 262, 1351.74, 80
2, 16:07:00-000, 316, 141, 175, 141, 1352.21, 156, 1351.25, 49
2, 16:08:00-000, 581, 281, 300, 281, 1352.50, 214, 1351.55, 55
2, 16:09:00-000, 360, 160, 200, 160, 1352.46, 173, 1351.85, 53
2, 16:10:00-000, 596, 278, 318, 278, 1352.43, 223, 1351.81, 43
2, 16:11:00-000, 294, 116, 178, 116, 1351.17, 150, 1350.54, 99
2, 16:12:00-000, 615, 254, 361, 254, 1353.21, 281, 1352.07, 27
2, 16:13:00-000, 373, 148, 225, 148, 1351.55, 150, 1351.17, 64
2, 16:14:00-000, 665, 254, 411, 254, 1351.76, 277, 1350.60, 108
2, 16:15:00-000, 310, 136, 174, 136, 1352.46, 132, 1351.51, 103
2, 16:16:00-000, 594, 265, 329, 265, 1351.96, 254, 1350.77, 68
2, 16:17:00-000, 289, 102, 187, 102, 1352.06, 122, 1351.46, 64
2, 16:18:00-000, 588, 246, 342, 246, 1352.77, 276, 1351.32, 66
2, 16:19:00-000, 346, 189, 157, 189, 1353.58, 134, 1352.33, 46
2, 16:20:00-000, 689, 244, 445, 244, 1351.36, 314, 1350.29, 70
2, 16:21:00-000, 350, 159, 191, 159, 1351.52, 144, 1350.80, 68
2, 16:22:00-000, 605, 295, 310, 295, 1352.47, 256, 1351.61, 91
2, 16:23:00-000, 299, 136, 163, 130, 1352.60, 137, 1351.61, 43
2, 16:24:00-000, 608, 277, 331, 283, 1352.87, 279, 1351.86, 35
2, 16:25:00-000, 335, 150, 185, 150, 1353.52, 150, 1350.66, 48
2, 16:26:00-000, 702, 269, 433, 269, 1351.57, 289, 1351.14, 56
2, 16:27:00-000, 315, 129, 186, 129, 1351.21, 141, 1350.78, 78
2, 16:28:00-000, 640, 271, 369, 271, 1351.47, 265, 1350.32, 78
2, 16:29:00-000, 305, 132, 173, 132, 1351.58, 114, 1350.65, 88
3, 09:00:00-000, 185, 156, 29, 1, 1349.00, 1, 1349.00, 171
3, 09:01:00-000, 185, 185, 0, 0, 0.00, 0, 0.00, 195
3, 09:02:00-000, 200, 200, 0, 0, 0.00, 0, 0.00, 199
3, 09:03:00-000, 253, 253, 0, 0, 0.00, 0, 0.00, 251
3, 09:04:00-000, 192, 192, 0, 0, 0.00, 0, 0.00, 194
3, 09:05:00-000, 186, 186, 0, 0, 0.00, 0, 0.00, 184
3, 09:06:00-000, 176, 176, 0, 0, 0.00, 0, 0.00, 176
3, 09:07:00-000, 208, 208, 0, 0, 0.00, 0, 0.00, 211
3, 09:08:00-000, 186, 186, 0, 0, 0.00, 0, 0.00, 186
3, 09:09:00-000, 199, 199, 0, 7, 1377.29, 0, 0.00, 188
3, 09:10:00-000, 180, 180, 0, 0, 0.00, 0, 0.00, 177
3, 09:11:00-000, 188, 188, 0, 0, 0.00, 0, 0.00, 193
3, 09:12:00-000, 198, 198, 0, 0, 0.00, 0, 0.00, 202
3, 09:13:00-000, 192, 188, 4, 11, 1459.36, 4, 1352.00, 174
3, 09:14:00-000, 166, 165, 1, 1, 1355.00, 1, 1355.00, 163
3, 09:15:00-000, 208, 208, 0, 1, 1349.00, 0, 0.00, 202
3, 09:16:00-000, 198, 187, 11, 21, 1363.43, 8, 1365.50, 175
3, 09:17:00-000, 208, 184, 24, 8, 1353.00, 10, 1354.10, 175
3, 09:18:00-000, 175, 130, 45, 25, 1350.16, 19, 1352.68, 139
3, 09:19:00-000, 168, 147, 21, 2, 1348.00, 2, 1351.00, 168
3, 09:20:00-000, 217, 195, 22, 11, 1354.27, 13, 1357.30, 195
3, 09:21:00-000, 218, 171, 47, 10, 1350.00, 1, 1351.00, 210
3, 09:22:00-000, 208, 187, 21, 7, 1350.86, 18, 1352.50, 177
3, 09:23:00-000, 193, 182, 11, 8, 1351.50, 4, 1360.00, 185
3, 09:24:00-000, 194, 165, 29, 15, 1356.13, 5, 1353.20, 166
3, 09:25:00-000, 187, 157, 30, 5, 1359.00, 9, 1355.00, 178
3, 09:26:00-000, 240, 228, 12, 6, 1351.67, 4, 1353.50, 228
3, 09:27:00-000, 225, 209, 16, 8, 1351.00, 3, 1354.00, 214
3, 09:28:00-000, 172, 138, 34, 15, 1348.80, 13, 1351.46, 150
3, 09:29:00-000, 176, 154, 22, 5, 1352.00, 10, 1352.90, 160
3, 09:30:00-000, 217, 217, 0, 0, 0.00, 0, 0.00, 218
3, 09:31:00-000, 230, 222, 8, 9, 1351.11, 2, 1351.50, 213
3, 09:32:00-000, 203, 173, 30, 2, 1347.00, 6, 1353.00, 198
3, 09:33:00-000, 194, 176, 18, 11, 1347.00, 6, 1351.83, 180
3, 09:34:00-000, 218, 145, 73, 10, 1350.80, 20, 1352.75, 184
3, 09:35:00-000, 186, 166, 20, 2, 1350.50, 6, 1352.17, 178
3, 09:36:00-000, 192, 177, 15, 8, 1349.00, 3, 1350.33, 185
3, 09:37:00-000, 204, 179, 25, 1, 1348.00, 0, 0.00, 189
3, 09:38:00-000, 191, 160, 31, 14, 1350.64, 17, 1352.76, 176
3, 09:39:00-000, 212, 162, 50, 7, 1349.43, 0, 0.00, 193
3, 09:40:00-000, 201, 168, 33, 6, 1350.33, 13, 1352.30, 189
3, 09:41:00-000, 174, 129, 45, 5, 1348.40, 1, 1350.00, 172
3, 09:42:00-000, 210, 169, 41, 4, 1349.25, 6, 1352.50, 199
3, 09:43:00-000, 197, 135, 62, 8, 1347.75, 10, 1350.30, 171
3, 09:44:00-000, 175, 159, 16, 4, 1348.75, 7, 1352.00, 169
3, 09:45:00-000, 169, 154, 15, 2, 1350.50, 0, 0.00, 158
3, 09:46:00-000, 212, 185, 27, 16, 1349.06, 3, 1350.67, 204
3, 09:47:00-000, 191, 136, 55, 2, 1347.50, 12, 1351.33, 167
3, 09:48:00-000, 210, 155, 55, 19, 1347.68, 9, 1351.11, 189
3, 09:49:00-000, 191, 130, 61, 9, 1349.22, 7, 1350.57, 176
3, 09:50:00-000, 198, 118, 80, 10, 1348.00, 16, 1352.25, 170
3, 09:51:00-000, 192, 156, 36, 2, 1349.00, 5, 1350.60, 190
3, 09:52:00-000, 205, 185, 20, 10, 1352.30, 9, 1355.11, 188
3, 09:53:00-000, 222, 161, 61, 16, 1353.81, 4, 1354.75, 199
3, 09:54:00-000, 205, 136, 69, 13, 1350.15, 20, 1350.75, 164
3, 09:55:00-000, 210, 147, 63, 9, 1348.89, 13, 1350.84, 188
3, 09:56:00-000, 221, 161, 60, 12, 1348.91, 24, 1350.16, 190
3, 09:57:00-000, 182, 162, 20, 7, 1350.29, 6, 1350.83, 172
3, 09:58:00-000, 206, 193, 13, 9, 1346.78, 1, 1350.00, 193
3, 09:59:00-000, 203, 167, 36, 8, 1346.12, 8, 1351.75, 182
3, 10:00:00-000, 226, 135, 91, 14, 1350.28, 10, 1351.10, 204
3, 10:01:00-000, 198, 130, 68, 7, 1348.57, 4, 1351.00, 193
3, 10:02:00-000, 168, 126, 42, 2, 1348.50, 7, 1351.00, 161
3, 10:03:00-000, 223, 178, 45, 17, 1349.29, 8, 1351.50, 192
3, 10:04:00-000, 229, 161, 68, 12, 1348.33, 19, 1352.37, 205
3, 10:05:00-000, 202, 170, 32, 1, 1348.00, 14, 1351.07, 180
3, 10:06:00-000, 191, 137, 54, 20, 1350.45, 11, 1355.73, 167
3, 10:07:00-000, 182, 118, 64, 18, 1349.61, 6, 1350.33, 156
3, 10:08:00-000, 180, 91, 89, 6, 1348.00, 3, 1351.33, 168
3, 10:09:00-000, 199, 93, 106, 3, 1347.67, 7, 1350.71, 193
3, 10:10:00-000, 194, 141, 53, 13, 1348.69, 10, 1350.40, 164
3, 10:11:00-000, 189, 121, 68, 12, 1351.83, 23, 1352.08, 162
3, 10:12:00-000, 207, 148, 59, 8, 1351.63, 9, 1352.44, 189
3, 10:13:00-000, 229, 147, 82, 13, 1349.15, 20, 1351.05, 184
3, 10:14:00-000, 192, 134, 58, 17, 1348.82, 12, 1350.42, 170
3, 10:15:00-000, 224, 182, 42, 9, 1347.11, 13, 1351.92, 207
3, 10:16:00-000, 179, 152, 27, 10, 1353.00, 16, 1352.69, 145
3, 10:17:00-000, 203, 151, 52, 6, 1351.67, 0, 0.00, 197
3, 10:18:00-000, 212, 112, 100, 6, 1347.83, 11, 1350.54, 198
3, 10:19:00-000, 184, 142, 42, 2, 1350.50, 5, 1351.40, 179
3, 10:20:00-000, 187, 169, 18, 7, 1348.57, 2, 1349.00, 177
3, 10:21:00-000, 224, 193, 31, 0, 0.00, 3, 1350.00, 221
3, 10:22:00-000, 188, 177, 11, 2, 1345.50, 3, 1350.33, 187
3, 10:23:00-000, 218, 196, 22, 3, 1348.00, 3, 1353.00, 210
3, 10:24:00-000, 203, 186, 17, 10, 1347.70, 9, 1352.67, 177
3, 10:25:00-000, 192, 175, 17, 10, 1351.80, 6, 1355.33, 183
3, 10:26:00-000, 202, 169, 33, 11, 1348.45, 0, 0.00, 192
3, 10:27:00-000, 170, 142, 28, 1, 1345.00, 4, 1349.00, 165
3, 10:28:00-000, 196, 152, 44, 4, 1348.75, 4, 1350.75, 185
3, 10:29:00-000, 206, 144, 62, 8, 1350.00, 9, 1351.00, 192
3, 10:30:00-000, 232, 176, 56, 13, 1347.77, 16, 1352.37, 205
3, 10:31:00-000, 186, 159, 27, 5, 1349.60, 8, 1352.12, 168
3, 10:32:00-000, 191, 175, 16, 11, 1349.00, 9, 1351.44, 173
3, 10:33:00-000, 219, 179, 40, 9, 1350.78, 3, 1354.00, 198
3, 10:34:00-000, 177, 133, 44, 6, 1346.83, 2, 1350.50, 174
3, 10:35:00-000, 240, 158, 82, 3, 1347.00, 0, 0.00, 241
3, 10:36:00-000, 189, 126, 63, 11, 1346.45, 6, 1350.83, 161
3, 10:37:00-000, 185, 96, 89, 2, 1349.50, 9, 1350.44, 187
3, 10:38:00-000, 169, 136, 33, 5, 1349.80, 11, 1351.63, 150
3, 10:39:00-000, 203, 180, 23, 6, 1348.50, 6, 1350.50, 193
3, 10:40:00-000, 177, 129, 48, 10, 1348.60, 6, 1350.67, 158
3, 10:41:00-000, 208, 132, 76, 7, 1348.00, 3, 1350.00, 191
3, 10:42:00-000, 256, 213, 43, 5, 1347.60, 14, 1351.28, 228
3, 10:43:00-000, 205, 177, 28, 10, 1350.30, 2, 1351.50, 212
3, 10:44:00-000, 201, 146, 55, 4, 1347.25, 12, 1351.16, 185
3, 10:45:00-000, 206, 155, 51, 21, 1349.14, 16, 1351.94, 165
3, 10:46:00-000, 215, 135, 80, 15, 1347.07, 9, 1350.55, 180
3, 10:47:00-000, 192, 108, 84, 1, 1345.00, 8, 1350.37, 191
3, 10:48:00-000, 220, 160, 60, 21, 1347.95, 26, 1351.07, 172
3, 10:49:00-000, 222, 140, 82, 7, 1348.00, 8, 1350.62, 200
3, 10:50:00-000, 208, 135, 73, 0, 0.00, 8, 1352.12, 216
3, 10:51:00-000, 215, 158, 57, 9, 1346.78, 2, 1350.00, 194
3, 10:52:00-000, 205, 152, 53, 18, 1348.39, 14, 1350.71, 172
3, 10:53:00-000, 181, 133, 48, 3, 1348.00, 14, 1350.57, 168
3, 10:54:00-000, 234, 187, 47, 6, 1349.33, 11, 1352.45, 224
3, 10:55:00-000, 188, 160, 28, 17, 1350.70, 13, 1352.61, 150
3, 10:56:00-000, 206, 190, 16, 9, 1350.11, 8, 1351.88, 195
3, 10:57:00-000, 215, 188, 27, 13, 1348.54, 6, 1352.33, 186
3, 10:58:00-000, 207, 163, 44, 8, 1348.87, 6, 1352.00, 201
3, 10:59:00-000, 237, 176, 61, 8, 1350.87, 10, 1352.10, 210
3, 11:00:00-000, 221, 175, 46, 3, 1352.67, 9, 1350.78, 219
3, 11:01:00-000, 182, 178, 4, 1, 1349.00, 3, 1350.67, 177
3, 11:02:00-000, 234, 204, 30, 19, 1350.16, 6, 1351.00, 199
3, 11:03:00-000, 189, 147, 42, 3, 1350.00, 10, 1351.30, 189
3, 11:04:00-000, 202, 177, 25, 9, 1349.33, 21, 1351.28, 173
3, 11:05:00-000, 208, 169, 39, 23, 1349.87, 13, 1352.38, 171
3, 11:06:00-000, 190, 149, 41, 13, 1349.07, 12, 1351.58, 164
3, 11:07:00-000, 200, 144, 56, 5, 1348.00, 2, 1350.00, 191
3, 11:08:00-000, 193, 113, 80, 15, 1348.20, 10, 1350.60, 169
3, 11:09:00-000, 194, 143, 51, 2, 1349.50, 12, 1351.50, 179
3, 11:10:00-000, 217, 170, 47, 31, 1347.29, 19, 1351.73, 166
3, 11:11:00-000, 219, 136, 83, 2, 1347.50, 1, 1350.00, 212
3, 11:12:00-000, 181, 106, 75, 7, 1349.28, 6, 1351.67, 171
3, 11:13:00-000, 203, 145, 58, 9, 1346.67, 13, 1350.23, 186
3, 11:14:00-000, 219, 170, 49, 17, 1348.23, 22, 1351.59, 181
3, 11:15:00-000, 188, 165, 23, 0, 0.00, 10, 1351.10, 178
3, 11:16:00-000, 184, 159, 25, 17, 1346.12, 5, 1350.40, 153
3, 11:17:00-000, 185, 138, 47, 5, 1349.60, 8, 1352.12, 173
3, 11:18:00-000, 214, 166, 48, 8, 1347.12, 15, 1351.93, 197
3, 11:19:00-000, 176, 147, 29, 6, 1348.00, 5, 1352.00, 167
3, 11:20:00-000, 188, 160, 28, 5, 1350.20, 7, 1352.28, 176
3, 11:21:00-000, 204, 189, 15, 9, 1349.89, 4, 1351.00, 189
3, 11:22:00-000, 198, 149, 49, 20, 1348.75, 9, 1350.55, 170
3, 11:23:00-000, 225, 141, 84, 8, 1348.50, 16, 1352.62, 197
3, 11:24:00-000, 197, 127, 70, 2, 1349.50, 7, 1350.57, 189
3, 11:25:00-000, 209, 171, 38, 14, 1347.78, 8, 1351.37, 173
3, 11:26:00-000, 211, 172, 39, 18, 1350.33, 4, 1351.50, 199
3, 11:27:00-000, 214, 131, 83, 12, 1351.17, 16, 1352.31, 191
3, 11:28:00-000, 202, 172, 30, 22, 1347.63, 13, 1351.77, 152
3, 11:29:00-000, 199, 130, 69, 15, 1348.46, 4, 1351.50, 197
3, 11:30:00-000, 231, 114, 117, 4, 1348.00, 12, 1351.58, 208
3, 11:31:00-000, 224, 114, 110, 7, 1346.29, 9, 1350.67, 206
3, 11:32:00-000, 202, 113, 89, 5, 1347.20, 22, 1350.22, 178
3, 11:33:00-000, 219, 170, 49, 5, 1347.00, 9, 1351.00, 202
3, 11:34:00-000, 180, 139, 41, 5, 1347.80, 6, 1351.33, 179
3, 11:35:00-000, 205, 161, 44, 7, 1347.29, 1, 1350.00, 189
3, 11:36:00-000, 188, 151, 37, 13, 1346.84, 8, 1352.75, 162
3, 11:37:00-000, 215, 183, 32, 8, 1349.25, 12, 1351.50, 195
3, 11:38:00-000, 172, 150, 22, 5, 1349.00, 10, 1350.40, 169
3, 11:39:00-000, 195, 162, 33, 2, 1349.50, 2, 1350.50, 191
3, 11:40:00-000, 196, 174, 22, 7, 1349.14, 10, 1350.40, 181
3, 11:41:00-000, 182, 159, 23, 8, 1348.00, 2, 1350.50, 166
3, 11:42:00-000, 220, 198, 22, 13, 1349.69, 7, 1352.57, 205
3, 11:43:00-000, 165, 131, 34, 8, 1346.75, 7, 1351.57, 151
3, 11:44:00-000, 223, 161, 62, 12, 1347.58, 9, 1352.11, 201
3, 11:45:00-000, 211, 147, 64, 7, 1348.71, 12, 1350.25, 188
3, 11:46:00-000, 180, 111, 69, 8, 1347.87, 22, 1350.63, 155
3, 11:47:00-000, 217, 202, 15, 4, 1347.00, 7, 1350.29, 190
3, 11:48:00-000, 197, 175, 22, 20, 1349.75, 9, 1352.33, 180
3, 11:49:00-000, 187, 143, 44, 7, 1348.86, 15, 1352.86, 160
3, 11:50:00-000, 226, 179, 47, 32, 1351.31, 24, 1352.12, 179
3, 11:51:00-000, 228, 150, 78, 9, 1347.89, 6, 1350.00, 209
3, 11:52:00-000, 177, 103, 74, 19, 1347.26, 7, 1350.43, 152
3, 11:53:00-000, 216, 95, 121, 1, 1347.00, 11, 1350.64, 200
3, 11:54:00-000, 175, 128, 47, 5, 1351.00, 6, 1351.00, 167
3, 11:55:00-000, 216, 165, 51, 7, 1348.14, 9, 1350.67, 202
3, 11:56:00-000, 185, 140, 45, 24, 1350.66, 18, 1352.27, 143
3, 11:57:00-000, 191, 128, 63, 20, 1350.50, 15, 1352.26, 154
3, 11:58:00-000, 188, 139, 49, 3, 1348.00, 2, 1350.00, 176
3, 11:59:00-000, 204, 101, 103, 17, 1345.00, 15, 1350.40, 181
3, 12:00:00-000, 196, 116, 80, 4, 1345.00, 13, 1350.23, 177
3, 12:01:00-000, 204, 147, 57, 1, 1348.00, 21, 1351.86, 183
3, 12:02:00-000, 198, 175, 23, 9, 1350.89, 5, 1352.20, 181
3, 12:03:00-000, 197, 167, 30, 7, 1349.57, 3, 1352.00, 192
3, 12:04:00-000, 172, 146, 26, 13, 1350.38, 11, 1351.82, 148
3, 12:05:00-000, 201, 168, 33, 6, 1350.33, 1, 1350.00, 192
3, 12:06:00-000, 194, 144, 50, 19, 1348.58, 14, 1350.43, 158
3, 12:07:00-000, 202, 142, 60, 4, 1348.50, 17, 1350.41, 185
3, 12:08:00-000, 206, 161, 45, 24, 1348.29, 10, 1351.90, 172
3, 12:09:00-000, 230, 157, 73, 10, 1348.60, 7, 1350.14, 213
3, 12:10:00-000, 181, 119, 62, 5, 1349.80, 5, 1351.40, 166
3, 12:11:00-000, 164, 114, 50, 6, 1349.17, 11, 1350.91, 147
3, 12:12:00-000, 191, 137, 54, 12, 1348.17, 11, 1351.27, 162
3, 12:13:00-000, 197, 140, 57, 8, 1348.75, 8, 1350.37, 192
3, 12:14:00-000, 239, 158, 81, 9, 1348.00, 4, 1350.25, 219
3, 12:15:00-000, 175, 125, 50, 4, 1346.75, 4, 1350.50, 173
3, 12:16:00-000, 207, 138, 69, 15, 1349.26, 27, 1351.63, 166
3, 12:17:00-000, 213, 124, 89, 16, 1348.50, 16, 1351.25, 182
3, 12:18:00-000, 186, 136, 50, 4, 1347.50, 9, 1351.33, 168
3, 12:19:00-000, 190, 154, 36, 0, 0.00, 5, 1351.60, 189
3, 12:20:00-000, 210, 147, 63, 11, 1348.18, 9, 1351.78, 190
3, 12:21:00-000, 199, 163, 36, 4, 1348.00, 6, 1351.83, 188
3, 12:22:00-000, 202, 192, 10, 6, 1347.50, 3, 1350.00, 183
3, 12:23:00-000, 202, 201, 1, 3, 1348.67, 1, 1351.00, 202
3, 12:24:00-000, 169, 153, 16, 12, 1348.00, 3, 1350.00, 162
3, 12:25:00-000, 195, 156, 39, 9, 1352.89, 10, 1352.30, 171
3, 12:26:00-000, 240, 165, 75, 9, 1349.78, 20, 1351.25, 203
3, 12:27:00-000, 222, 200, 22, 2, 1347.00, 3, 1350.33, 228
3, 12:28:00-000, 193, 140, 53, 9, 1349.44, 1, 1351.00, 178
3, 12:29:00-000, 173, 117, 56, 10, 1347.50, 4, 1349.75, 165
3, 12:30:00-000, 191, 129, 62, 3, 1347.33, 8, 1351.75, 180
3, 12:31:00-000, 213, 161, 52, 1, 1350.00, 3, 1350.00, 209
3, 12:32:00-000, 220, 151, 69, 27, 1347.40, 12, 1351.25, 176
3, 12:33:00-000, 191, 131, 60, 10, 1348.80, 11, 1351.36, 169
3, 12:34:00-000, 213, 139, 74, 8, 1348.13, 16, 1351.00, 195
3, 12:35:00-000, 234, 168, 66, 5, 1350.80, 12, 1350.50, 215
3, 12:36:00-000, 153, 115, 38, 8, 1347.87, 8, 1352.00, 136
3, 12:37:00-000, 224, 165, 59, 7, 1349.86, 10, 1352.40, 208
3, 12:38:00-000, 215, 195, 20, 13, 1349.00, 8, 1351.87, 193
3, 12:39:00-000, 191, 164, 27, 4, 1351.25, 4, 1351.50, 182
3, 12:40:00-000, 208, 164, 44, 16, 1349.31, 14, 1351.28, 178
3, 12:41:00-000, 242, 214, 28, 3, 1348.67, 6, 1351.33, 236
3, 12:42:00-000, 229, 178, 51, 20, 1348.05, 5, 1351.80, 207
3, 12:43:00-000, 194, 140, 54, 6, 1351.67, 24, 1351.62, 157
3, 12:44:00-000, 210, 164, 46, 4, 1348.75, 9, 1352.66, 203
3, 12:45:00-000, 201, 151, 50, 15, 1349.46, 0, 0.00, 186
3, 12:46:00-000, 165, 119, 46, 2, 1348.00, 6, 1351.50, 156
3, 12:47:00-000, 185, 157, 28, 4, 1346.75, 6, 1353.50, 174
3, 12:48:00-000, 194, 128, 66, 17, 1349.47, 5, 1350.20, 170
3, 12:49:00-000, 203, 110, 93, 9, 1348.00, 21, 1351.33, 177
3, 12:50:00-000, 237, 165, 72, 27, 1347.89, 6, 1351.17, 197
3, 12:51:00-000, 215, 125, 90, 9, 1346.44, 10, 1350.50, 198
3, 12:52:00-000, 214, 83, 131, 14, 1347.43, 7, 1350.14, 193
3, 12:53:00-000, 214, 94, 120, 15, 1348.07, 37, 1351.27, 167
3, 12:54:00-000, 205, 116, 89, 7, 1348.00, 13, 1350.07, 182
3, 12:55:00-000, 204, 168, 36, 9, 1347.67, 3, 1352.67, 193
3, 12:56:00-000, 203, 136, 67, 14, 1346.71, 9, 1350.78, 181
3, 12:57:00-000, 217, 172, 45, 14, 1348.43, 2, 1350.50, 202
3, 12:58:00-000, 193, 112, 81, 21, 1346.95, 13, 1350.38, 158
3, 12:59:00-000, 191, 89, 102, 2, 1349.00, 18, 1351.55, 166
3, 13:00:00-000, 204, 108, 96, 28, 1349.18, 26, 1351.88, 148
3, 13:01:00-000, 199, 117, 82, 1, 1346.00, 10, 1350.40, 184
3, 13:02:00-000, 190, 104, 86, 6, 1348.00, 6, 1351.33, 188
3, 13:03:00-000, 172, 142, 30, 4, 1346.50, 9, 1350.33, 162
3, 13:04:00-000, 179, 109, 70, 24, 1347.87, 13, 1351.08, 138
3, 13:05:00-000, 195, 132, 63, 4, 1348.50, 11, 1350.63, 183
3, 13:06:00-000, 197, 127, 70, 20, 1348.05, 15, 1351.86, 161
3, 13:07:00-000, 216, 171, 45, 7, 1348.57, 6, 1352.00, 197
3, 13:08:00-000, 208, 122, 86, 5, 1351.80, 11, 1351.09, 197
3, 13:09:00-000, 181, 104, 77, 6, 1349.67, 5, 1350.80, 168
3, 13:10:00-000, 163, 94, 69, 11, 1348.27, 10, 1350.80, 142
3, 13:11:00-000, 186, 123, 63, 1, 1346.00, 1, 1350.00, 177
3, 13:12:00-000, 226, 111, 115, 22, 1347.00, 13, 1351.15, 203
3, 13:13:00-000, 207, 120, 87, 3, 1350.33, 13, 1352.15, 187
3, 13:14:00-000, 179, 135, 44, 12, 1349.91, 7, 1350.71, 156
3, 13:15:00-000, 188, 117, 71, 5, 1353.40, 12, 1351.42, 173
3, 13:16:00-000, 194, 125, 69, 29, 1350.10, 26, 1352.23, 139
3, 13:17:00-000, 192, 119, 73, 5, 1348.20, 12, 1351.00, 179
3, 13:18:00-000, 215, 122, 93, 7, 1347.29, 5, 1351.00, 200
3, 13:19:00-000, 209, 119, 90, 5, 1345.20, 7, 1350.14, 199
3, 13:20:00-000, 233, 158, 75, 16, 1349.00, 19, 1350.68, 199
3, 13:21:00-000, 186, 111, 75, 13, 1350.00, 14, 1351.21, 160
3, 13:22:00-000, 206, 171, 35, 24, 1348.95, 17, 1352.47, 154
3, 13:23:00-000, 194, 162, 32, 6, 1348.33, 6, 1350.17, 194
3, 13:24:00-000, 216, 177, 39, 6, 1347.50, 4, 1351.25, 204
3, 13:25:00-000, 186, 150, 36, 15, 1348.93, 14, 1350.86, 154
3, 13:26:00-000, 189, 102, 87, 16, 1347.19, 14, 1351.64, 162
3, 13:27:00-000, 190, 135, 55, 5, 1348.80, 3, 1351.67, 182
3, 13:28:00-000, 209, 144, 65, 13, 1349.15, 18, 1350.89, 179
3, 13:29:00-000, 215, 155, 60, 1, 1345.00, 4, 1350.00, 208
3, 13:30:00-000, 181, 131, 50, 15, 1347.66, 8, 1351.13, 154
3, 13:31:00-000, 169, 97, 72, 7, 1349.00, 3, 1350.67, 161
3, 13:32:00-000, 232, 144, 88, 14, 1348.00, 15, 1350.13, 203
3, 13:33:00-000, 191, 122, 69, 12, 1348.75, 10, 1352.80, 171
3, 13:34:00-000, 201, 117, 84, 17, 1349.23, 15, 1350.93, 172
3, 13:35:00-000, 198, 123, 75, 9, 1349.44, 23, 1351.87, 159
3, 13:36:00-000, 172, 111, 61, 22, 1348.41, 10, 1352.10, 143
3, 13:37:00-000, 170, 112, 58, 4, 1348.25, 14, 1350.36, 155
3, 13:38:00-000, 200, 164, 36, 10, 1348.50, 8, 1351.00, 181
3, 13:39:00-000, 177, 132, 45, 3, 1347.00, 1, 1352.00, 173
3, 13:40:00-000, 192, 120, 72, 19, 1347.63, 19, 1350.10, 152
3, 13:41:00-000, 223, 132, 91, 6, 1346.83, 4, 1348.25, 204
3, 13:42:00-000, 213, 132, 81, 3, 1347.00, 8, 1351.50, 212
3, 13:43:00-000, 215, 172, 43, 2, 1350.00, 6, 1352.67, 194
3, 13:44:00-000, 171, 113, 58, 11, 1348.18, 10, 1351.70, 158
3, 13:45:00-000, 180, 126, 54, 16, 1348.44, 5, 1351.20, 166
3, 13:46:00-000, 219, 163, 56, 9, 1347.56, 16, 1352.37, 181
3, 13:47:00-000, 184, 130, 54, 1, 1345.00, 4, 1350.25, 185
3, 13:48:00-000, 211, 150, 61, 29, 1348.82, 12, 1350.83, 176
3, 13:49:00-000, 197, 100, 97, 4, 1348.75, 3, 1350.00, 189
3, 13:50:00-000, 192, 104, 88, 12, 1348.08, 22, 1351.27, 152
3, 13:51:00-000, 182, 134, 48, 13, 1347.31, 12, 1352.17, 162
3, 13:52:00-000, 181, 104, 77, 9, 1349.33, 21, 1352.00, 148
3, 13:53:00-000, 193, 154, 39, 8, 1348.50, 10, 1351.90, 180
3, 13:54:00-000, 186, 136, 50, 17, 1347.94, 7, 1352.00, 156
3, 13:55:00-000, 214, 139, 75, 13, 1348.77, 6, 1351.17, 199
3, 13:56:00-000, 189, 111, 78, 12, 1348.50, 14, 1351.28, 156
3, 13:57:00-000, 224, 152, 72, 6, 1348.00, 7, 1351.71, 206
3, 13:58:00-000, 217, 130, 87, 34, 1346.91, 10, 1349.20, 186
3, 13:59:00-000, 211, 40, 171, 0, 0.00, 7, 1350.00, 194
3, 14:00:00-000, 181, 79, 102, 4, 1347.00, 21, 1350.19, 167
3, 14:01:00-000, 218, 112, 106, 8, 1347.25, 8, 1350.62, 197
3, 14:02:00-000, 198, 120, 78, 2, 1347.00, 5, 1350.80, 182
3, 14:03:00-000, 198, 152, 46, 4, 1351.00, 16, 1351.25, 191
3, 14:04:00-000, 205, 162, 43, 12, 1348.91, 8, 1351.50, 175
3, 14:05:00-000, 193, 147, 46, 10, 1346.00, 2, 1350.50, 192
3, 14:06:00-000, 204, 116, 88, 16, 1347.12, 20, 1351.55, 164
3, 14:07:00-000, 204, 134, 70, 10, 1349.20, 6, 1352.83, 192
3, 14:08:00-000, 182, 94, 88, 16, 1347.69, 18, 1350.61, 150
3, 14:09:00-000, 196, 108, 88, 4, 1346.75, 3, 1351.33, 185
3, 14:10:00-000, 229, 126, 103, 10, 1348.90, 10, 1350.50, 213
3, 14:11:00-000, 202, 122, 80, 3, 1349.00, 9, 1350.22, 187
3, 14:12:00-000, 263, 242, 21, 12, 1350.75, 10, 1351.10, 232
3, 14:13:00-000, 235, 169, 66, 10, 1348.90, 9, 1351.44, 218
3, 14:14:00-000, 183, 123, 60, 17, 1347.53, 11, 1350.73, 163
3, 14:15:00-000, 203, 133, 70, 11, 1346.45, 10, 1351.50, 182
3, 14:16:00-000, 184, 128, 56, 12, 1348.83, 16, 1351.31, 151
3, 14:17:00-000, 207, 134, 73, 9, 1349.67, 3, 1351.00, 195
3, 14:18:00-000, 175, 70, 105, 15, 1347.20, 19, 1351.47, 148
3, 14:19:00-000, 187, 69, 118, 2, 1347.00, 12, 1350.83, 162
3, 14:20:00-000, 203, 132, 71, 15, 1347.93, 16, 1351.12, 181
3, 14:21:00-000, 193, 138, 55, 7, 1349.14, 17, 1350.88, 167
3, 14:22:00-000, 197, 150, 47, 14, 1348.00, 8, 1351.00, 172
3, 14:23:00-000, 217, 195, 22, 6, 1354.00, 15, 1353.13, 195
3, 14:24:00-000, 203, 126, 77, 20, 1348.60, 33, 1351.24, 152
3, 14:25:00-000, 170, 142, 28, 9, 1346.89, 3, 1350.67, 160
3, 14:26:00-000, 228, 176, 52, 27, 1348.37, 7, 1351.71, 197
3, 14:27:00-000, 165, 111, 54, 3, 1347.00, 5, 1349.40, 153
3, 14:28:00-000, 188, 135, 53, 21, 1349.38, 18, 1350.72, 145
3, 14:29:00-000, 191, 140, 51, 4, 1348.50, 12, 1352.91, 180
3, 14:30:00-000, 196, 135, 61, 7, 1348.14, 10, 1350.40, 178
3, 14:31:00-000, 189, 150, 39, 4, 1348.75, 5, 1351.60, 182
3, 14:32:00-000, 190, 166, 24, 8, 1351.25, 7, 1351.00, 168
3, 14:33:00-000, 220, 156, 64, 19, 1349.68, 14, 1351.28, 193
3, 14:34:00-000, 172, 130, 42, 8, 1346.12, 20, 1350.60, 146
3, 14:35:00-000, 208, 191, 17, 8, 1349.12, 4, 1353.25, 198
3, 14:36:00-000, 207, 168, 39, 19, 1347.73, 16, 1351.31, 165
3, 14:37:00-000, 204, 176, 28, 10, 1347.40, 0, 0.00, 190
3, 14:38:00-000, 214, 177, 37, 13, 1349.15, 9, 1351.00, 190
3, 14:39:00-000, 189, 139, 50, 6, 1350.00, 8, 1350.87, 186
3, 14:40:00-000, 199, 121, 78, 22, 1348.27, 17, 1349.59, 161
3, 14:41:00-000, 204, 157, 47, 4, 1348.00, 12, 1350.67, 171
3, 14:42:00-000, 202, 151, 51, 10, 1350.60, 16, 1351.69, 191
3, 14:43:00-000, 210, 200, 10, 4, 1350.00, 6, 1352.50, 196
3, 14:44:00-000, 206, 182, 24, 28, 1350.21, 8, 1351.62, 171
3, 14:45:00-000, 242, 157, 85, 23, 1348.65, 21, 1352.04, 193
3, 14:46:00-000, 192, 120, 72, 10, 1350.30, 18, 1350.61, 172
3, 14:47:00-000, 226, 170, 56, 9, 1347.78, 6, 1350.17, 210
3, 14:48:00-000, 200, 124, 76, 16, 1347.62, 10, 1351.50, 173
3, 14:49:00-000, 194, 120, 74, 8, 1347.12, 9, 1351.00, 167
3, 14:50:00-000, 172, 137, 35, 10, 1347.80, 12, 1351.58, 160
3, 14:51:00-000, 190, 127, 63, 3, 1351.33, 22, 1351.41, 164
3, 14:52:00-000, 220, 154, 66, 23, 1348.91, 3, 1352.67, 198
3, 14:53:00-000, 231, 159, 72, 7, 1349.00, 18, 1351.11, 192
3, 14:54:00-000, 225, 187, 38, 11, 1348.09, 9, 1351.66, 213
3, 14:55:00-000, 193, 163, 30, 5, 1348.40, 7, 1351.57, 187
3, 14:56:00-000, 210, 142, 68, 19, 1347.21, 14, 1350.28, 169
3, 14:57:00-000, 196, 145, 51, 9, 1348.56, 14, 1350.86, 179
3, 14:58:00-000, 207, 156, 51, 22, 1347.50, 9, 1350.33, 178
3, 14:59:00-000, 206, 134, 72, 5, 1347.00, 17, 1350.35, 175
3, 15:00:00-000, 175, 101, 74, 17, 1346.70, 12, 1350.58, 155
3, 15:01:00-000, 185, 121, 64, 9, 1348.55, 9, 1351.11, 165
3, 15:02:00-000, 222, 148, 74, 9, 1348.78, 19, 1351.84, 195
3, 15:03:00-000, 208, 166, 42, 8, 1350.25, 12, 1352.41, 184
3, 15:04:00-000, 226, 205, 21, 5, 1351.60, 4, 1352.75, 213
3, 15:05:00-000, 203, 189, 14, 14, 1351.43, 1, 1352.00, 187
3, 15:06:00-000, 190, 148, 42, 7, 1349.29, 13, 1352.15, 182
3, 15:07:00-000, 223, 166, 57, 7, 1349.86, 13, 1350.31, 203
3, 15:08:00-000, 217, 175, 42, 23, 1351.00, 11, 1351.64, 183
3, 15:09:00-000, 210, 148, 62, 14, 1347.93, 13, 1350.31, 172
3, 15:10:00-000, 226, 139, 87, 18, 1348.55, 18, 1351.66, 199
3, 15:11:00-000, 196, 146, 50, 4, 1348.75, 11, 1351.64, 173
3, 15:12:00-000, 173, 113, 60, 8, 1348.25, 6, 1351.33, 169
3, 15:13:00-000, 202, 138, 64, 10, 1348.80, 4, 1351.75, 186
3, 15:14:00-000, 198, 118, 80, 8, 1348.37, 17, 1350.94, 174
3, 15:15:00-000, 198, 161, 37, 10, 1347.10, 11, 1351.27, 175
3, 15:16:00-000, 194, 136, 58, 17, 1350.06, 9, 1351.00, 167
3, 15:17:00-000, 230, 169, 61, 18, 1349.28, 16, 1350.87, 195
3, 15:18:00-000, 177, 110, 67, 18, 1347.39, 11, 1351.27, 151
3, 15:19:00-000, 186, 108, 78, 7, 1347.00, 11, 1351.54, 162
3, 15:20:00-000, 193, 120, 73, 9, 1347.67, 13, 1351.54, 170
3, 15:21:00-000, 237, 149, 88, 19, 1347.68, 13, 1350.23, 212
3, 15:22:00-000, 233, 141, 92, 19, 1348.79, 28, 1351.03, 174
3, 15:23:00-000, 188, 134, 54, 5, 1349.20, 20, 1351.15, 173
3, 15:24:00-000, 229, 153, 76, 17, 1347.59, 7, 1350.86, 206
3, 15:25:00-000, 236, 149, 87, 21, 1348.19, 23, 1351.43, 194
3, 15:26:00-000, 216, 136, 80, 13, 1348.38, 11, 1351.18, 193
3, 15:27:00-000, 205, 113, 92, 8, 1348.50, 10, 1351.00, 186
3, 15:28:00-000, 183, 122, 61, 8, 1348.37, 12, 1351.08, 158
3, 15:29:00-000, 200, 121, 79, 18, 1348.33, 4, 1350.25, 173
3, 15:30:00-000, 204, 149, 55, 17, 1348.64, 17, 1351.12, 175
3, 15:31:00-000, 229, 179, 50, 7, 1348.43, 4, 1350.50, 223
3, 15:32:00-000, 187, 118, 69, 12, 1348.17, 16, 1350.31, 154
3, 15:33:00-000, 205, 167, 38, 4, 1348.50, 15, 1351.06, 183
3, 15:34:00-000, 181, 149, 32, 23, 1349.34, 8, 1351.12, 152
3, 15:35:00-000, 178, 106, 72, 6, 1349.33, 13, 1351.84, 152
3, 15:36:00-000, 199, 143, 56, 20, 1348.10, 18, 1351.83, 172
3, 15:37:00-000, 182, 104, 78, 13, 1348.61, 19, 1351.84, 151
3, 15:38:00-000, 173, 138, 35, 19, 1350.16, 12, 1351.58, 139
3, 15:39:00-000, 226, 166, 60, 17, 1349.65, 13, 1351.46, 199
3, 15:40:00-000, 184, 111, 73, 11, 1348.91, 5, 1350.60, 160
3, 15:41:00-000, 195, 102, 93, 10, 1348.70, 13, 1351.07, 176
3, 15:42:00-000, 182, 109, 73, 16, 1348.06, 24, 1350.83, 140
3, 15:43:00-000, 193, 161, 32, 8, 1348.75, 20, 1351.65, 169
3, 15:44:00-000, 193, 160, 33, 20, 1349.55, 6, 1352.33, 170
3, 15:45:00-000, 216, 124, 92, 4, 1348.75, 5, 1350.40, 206
3, 15:46:00-000, 189, 149, 40, 7, 1347.29, 10, 1351.30, 174
3, 15:47:00-000, 239, 147, 92, 18, 1349.50, 18, 1351.22, 200
3, 15:48:00-000, 205, 129, 76, 18, 1347.16, 15, 1351.00, 165
3, 15:49:00-000, 216, 134, 82, 10, 1349.10, 12, 1350.50, 201
3, 15:50:00-000, 202, 136, 66, 20, 1349.95, 25, 1351.96, 153
3, 15:51:00-000, 198, 146, 52, 4, 1350.00, 9, 1351.67, 185
3, 15:52:00-000, 196, 160, 36, 22, 1347.59, 6, 1351.67, 171
3, 15:53:00-000, 218, 149, 69, 4, 1346.75, 15, 1350.80, 203
3, 15:54:00-000, 217, 118, 99, 28, 1350.32, 27, 1351.85, 159
3, 15:55:00-000, 216, 157, 59, 4, 1350.75, 18, 1350.77, 196
3, 15:56:00-000, 200, 157, 43, 15, 1349.00, 2, 1351.50, 184
3, 15:57:00-000, 189, 142, 47, 4, 1348.25, 9, 1351.33, 170
3, 15:58:00-000, 203, 180, 23, 5, 1347.60, 3, 1351.33, 198
3, 15:59:00-000, 211, 170, 41, 4, 1350.50, 5, 1350.00, 201
3, 16:00:00-000, 208, 188, 20, 13, 1348.23, 8, 1352.25, 189
3, 16:01:00-000, 217, 168, 49, 5, 1348.20, 7, 1353.00, 207
3, 16:02:00-000, 218, 179, 39, 5, 1347.40, 6, 1351.67, 204
3, 16:03:00-000, 184, 177, 7, 2, 1349.50, 4, 1350.25, 180
3, 16:04:00-000, 167, 141, 26, 15, 1347.93, 9, 1351.55, 143
3, 16:05:00-000, 236, 162, 74, 15, 1347.40, 13, 1351.15, 200
3, 16:06:00-000, 229, 155, 74, 15, 1348.27, 9, 1350.22, 212
3, 16:07:00-000, 209, 141, 68, 4, 1348.00, 5, 1350.40, 195
3, 16:08:00-000, 187, 107, 80, 15, 1349.53, 11, 1351.73, 158
3, 16:09:00-000, 218, 151, 67, 3, 1352.33, 6, 1352.00, 213
3, 16:10:00-000, 191, 109, 82, 17, 1348.41, 17, 1350.82, 153
3, 16:11:00-000, 180, 132, 48, 11, 1349.18, 16, 1351.62, 158
3, 16:12:00-000, 170, 127, 43, 11, 1351.45, 14, 1351.93, 148
3, 16:13:00-000, 205, 186, 19, 4, 1349.00, 4, 1349.50, 190
3, 16:14:00-000, 199, 147, 52, 24, 1348.62, 10, 1351.80, 173
3, 16:15:00-000, 193, 135, 58, 6, 1347.33, 8, 1350.00, 172
3, 16:16:00-000, 225, 130, 95, 18, 1348.05, 26, 1350.92, 175
3, 16:17:00-000, 232, 168, 64, 4, 1348.75, 15, 1350.20, 217
3, 16:18:00-000, 222, 178, 44, 16, 1348.06, 8, 1352.25, 197
3, 16:19:00-000, 203, 144, 59, 10, 1348.50, 14, 1350.50, 186
3, 16:20:00-000, 167, 126, 41, 13, 1346.38, 6, 1350.67, 141
3, 16:21:00-000, 198, 142, 56, 6, 1350.50, 10, 1351.10, 187
3, 16:22:00-000, 181, 135, 46, 3, 1348.00, 9, 1351.11, 168
3, 16:23:00-000, 181, 164, 17, 4, 1352.25, 1, 1350.00, 182
3, 16:24:00-000, 198, 141, 57, 16, 1349.19, 11, 1352.27, 166
3, 16:25:00-000, 202, 156, 46, 9, 1349.67, 11, 1352.09, 175
3, 16:26:00-000, 162, 135, 27, 16, 1348.68, 6, 1351.67, 148
3, 16:27:00-000, 195, 115, 80, 13, 1346.46, 13, 1350.15, 170
3, 16:28:00-000, 181, 105, 76, 9, 1347.89, 20, 1350.75, 154
3, 16:29:00-000, 183, 149, 34, 2, 1346.00, 5, 1350.40, 172
3, 16:30:00-000, 1, 1, 0, 0, 0.00, 0, 0.00, 0
4, 09:03:00-000, 265, 265, 0, 0, 0.00, 0, 0.00, 260
4, 09:04:00-000, 0, 0, 0, 0, 0.00, 0, 0.00, 5
4, 09:06:00-000, 290, 290, 0, 289, 1351.00, 0, 0.00, 0
4, 09:07:00-000, 1, 0, 1, 0, 0.00, 0, 0.00, 1
4, 09:08:00-000, 23, 20, 3, 4, 1350.00, 4, 1350.00, 12
4, 09:09:00-000, 107, 68, 39, 30, 1373.99, 37, 1374.61, 30
4, 09:10:00-000, 94, 84, 10, 12, 1388.17, 12, 1388.17, 55
4, 09:11:00-000, 71, 52, 19, 19, 1430.42, 19, 1430.42, 55
4, 09:12:00-000, 100, 92, 8, 8, 1477.25, 8, 1477.25, 75
4, 09:13:00-000, 79, 69, 10, 57, 1397.01, 9, 1385.00, 21
4, 09:14:00-000, 68, 56, 12, 51, 1355.77, 7, 1353.71, 10
4, 09:15:00-000, 77, 64, 13, 56, 1356.49, 10, 1355.10, 14
4, 09:16:00-000, 128, 78, 50, 65, 1363.13, 42, 1362.42, 11
4, 09:17:00-000, 61, 37, 24, 37, 1354.21, 23, 1356.52, 13
4, 09:18:00-000, 77, 49, 28, 49, 1353.40, 29, 1354.65, 1
4, 09:19:00-000, 85, 25, 60, 26, 1351.30, 46, 1351.56, 6
4, 09:20:00-000, 65, 29, 36, 29, 1356.58, 34, 1355.64, 0
4, 09:21:00-000, 98, 30, 68, 29, 1350.41, 55, 1350.39, 14
4, 09:22:00-000, 74, 50, 24, 47, 1351.95, 31, 1351.86, 2
4, 09:23:00-000, 96, 43, 53, 39, 1357.32, 38, 1356.57, 11
4, 09:24:00-000, 101, 42, 59, 37, 1352.88, 53, 1355.70, 9
4, 09:25:00-000, 84, 37, 47, 34, 1356.64, 30, 1358.36, 23
4, 09:26:00-000, 66, 29, 37, 27, 1352.77, 46, 1353.34, 3
4, 09:27:00-000, 84, 44, 40, 43, 1353.27, 32, 1352.59, 4
4, 09:28:00-000, 90, 53, 37, 48, 1351.80, 35, 1352.11, 6
4, 09:29:00-000, 95, 56, 39, 57, 1352.55, 40, 1352.07, 3
4, 09:30:00-000, 83, 33, 50, 32, 1352.52, 46, 1352.79, 2
4, 09:31:00-000, 85, 32, 53, 31, 1352.41, 38, 1352.83, 7
4, 09:32:00-000, 75, 37, 38, 35, 1350.31, 45, 1350.43, 2
4, 09:33:00-000, 107, 64, 43, 59, 1352.18, 44, 1351.92, 11
4, 09:34:00-000, 64, 29, 35, 29, 1353.68, 17, 1354.59, 8
4, 09:35:00-000, 93, 45, 48, 45, 1352.24, 37, 1351.94, 13
4, 09:36:00-000, 66, 42, 24, 41, 1350.94, 31, 1351.70, 1
4, 09:37:00-000, 70, 26, 44, 24, 1350.08, 31, 1349.99, 8
4, 09:38:00-000, 68, 31, 37, 32, 1353.84, 28, 1352.67, 8
4, 09:39:00-000, 88, 44, 44, 39, 1350.68, 41, 1350.48, 9
4, 09:40:00-000, 65, 26, 39, 24, 1352.62, 36, 1352.69, 5
4, 09:41:00-000, 69, 29, 40, 30, 1350.53, 39, 1350.22, 3
4, 09:42:00-000, 90, 56, 34, 56, 1350.63, 38, 1349.89, 0
4, 09:43:00-000, 81, 34, 47, 32, 1349.81, 29, 1350.68, 6
4, 09:44:00-000, 83, 44, 39, 40, 1352.77, 47, 1352.37, 5
4, 09:45:00-000, 71, 28, 43, 25, 1350.76, 35, 1350.68, 4
4, 09:46:00-000, 98, 58, 40, 56, 1350.56, 29, 1349.82, 15
4, 09:47:00-000, 86, 48, 38, 45, 1350.64, 34, 1350.82, 16
4, 09:48:00-000, 92, 44, 48, 42, 1350.83, 38, 1350.62, 1
4, 09:49:00-000, 107, 46, 61, 45, 1351.15, 48, 1351.34, 14
4, 09:50:00-000, 72, 37, 35, 33, 1350.96, 43, 1349.99, 3
4, 09:51:00-000, 83, 28, 55, 32, 1348.90, 33, 1348.51, 6
4, 09:52:00-000, 59, 32, 27, 24, 1354.20, 38, 1350.94, 1
4, 09:53:00-000, 74, 27, 47, 27, 1352.48, 18, 1351.89, 29
4, 09:54:00-000, 83, 43, 40, 38, 1351.33, 46, 1351.58, 4
4, 09:55:00-000, 80, 33, 47, 33, 1350.48, 36, 1350.33, 12
4, 09:56:00-000, 69, 35, 34, 36, 1350.11, 27, 1350.40, 8
4, 09:57:00-000, 68, 34, 34, 30, 1352.80, 27, 1353.18, 10
4, 09:58:00-000, 125, 57, 68, 57, 1349.95, 53, 1350.20, 10
4, 09:59:00-000, 98, 36, 62, 34, 1351.55, 58, 1350.04, 10
4, 10:00:00-000, 62, 32, 30, 34, 1351.14, 31, 1351.90, 3
4, 10:01:00-000, 98, 49, 49, 46, 1349.93, 48, 1349.74, 2
4, 10:02:00-000, 70, 27, 43, 25, 1349.63, 42, 1349.85, 2
4, 10:03:00-000, 83, 34, 49, 31, 1351.12, 36, 1351.63, 8
4, 10:04:00-000, 96, 50, 46, 51, 1350.99, 41, 1351.33, 3
4, 10:05:00-000, 72, 42, 30, 39, 1351.51, 30, 1351.03, 11
4, 10:06:00-000, 64, 40, 24, 40, 1355.12, 18, 1353.28, 5
4, 10:07:00-000, 95, 49, 46, 49, 1350.66, 42, 1350.40, 4
4, 10:08:00-000, 90, 41, 49, 41, 1350.43, 52, 1350.84, 2
4, 10:09:00-000, 82, 40, 42, 39, 1350.04, 36, 1349.97, 1
4, 10:10:00-000, 84, 35, 49, 33, 1350.54, 47, 1350.82, 7
4, 10:11:00-000, 84, 43, 41, 43, 1351.69, 35, 1352.08, 4
4, 10:12:00-000, 67, 28, 39, 27, 1352.00, 40, 1351.67, 3
4, 10:13:00-000, 113, 61, 52, 57, 1350.89, 51, 1350.58, 7
4, 10:14:00-000, 88, 49, 39, 49, 1350.85, 40, 1350.64, 0
4, 10:15:00-000, 70, 30, 40, 25, 1351.91, 32, 1351.74, 4
4, 10:16:00-000, 64, 49, 15, 46, 1353.71, 20, 1352.50, 1
4, 10:17:00-000, 114, 36, 78, 37, 1349.48, 44, 1349.81, 22
4, 10:18:00-000, 75, 40, 35, 39, 1350.02, 44, 1350.36, 5
4, 10:19:00-000, 76, 38, 38, 38, 1350.99, 26, 1351.15, 7
4, 10:20:00-000, 93, 35, 58, 33, 1349.15, 63, 1349.24, 1
4, 10:21:00-000, 95, 49, 46, 49, 1350.30, 41, 1350.41, 6
4, 10:22:00-000, 70, 28, 42, 26, 1350.53, 38, 1351.04, 3
4, 10:23:00-000, 73, 29, 44, 31, 1351.32, 34, 1350.32, 11
4, 10:24:00-000, 98, 66, 32, 46, 1352.47, 35, 1352.45, 7
4, 10:25:00-000, 92, 59, 33, 53, 1355.63, 30, 1354.40, 17
4, 10:26:00-000, 79, 24, 55, 24, 1348.08, 36, 1347.33, 9
4, 10:27:00-000, 64, 29, 35, 21, 1349.04, 28, 1347.99, 16
4, 10:28:00-000, 94, 45, 49, 50, 1350.31, 50, 1350.57, 5
4, 10:29:00-000, 78, 38, 40, 38, 1350.63, 34, 1350.49, 2
4, 10:30:00-000, 66, 40, 26, 36, 1353.05, 33, 1352.08, 0
4, 10:31:00-000, 73, 42, 31, 39, 1351.45, 25, 1351.35, 9
4, 10:32:00-000, 80, 48, 32, 37, 1352.75, 32, 1352.43, 2
4, 10:33:00-000, 83, 36, 47, 37, 1352.67, 37, 1351.32, 14
4, 10:34:00-000, 82, 28, 54, 29, 1350.75, 52, 1350.39, 3
4, 10:35:00-000, 71, 22, 49, 21, 1348.61, 42, 1348.59, 9
4, 10:36:00-000, 85, 36, 49, 36, 1350.61, 48, 1350.53, 1
4, 10:37:00-000, 78, 31, 47, 31, 1349.19, 36, 1349.60, 5
4, 10:38:00-000, 82, 46, 36, 42, 1351.54, 44, 1351.67, 5
4, 10:39:00-000, 89, 50, 39, 50, 1351.27, 30, 1350.96, 1
4, 10:40:00-000, 87, 43, 44, 45, 1349.97, 47, 1350.10, 5
4, 10:41:00-000, 123, 51, 72, 38, 1349.10, 71, 1349.68, 4
4, 10:42:00-000, 63, 32, 31, 39, 1350.15, 26, 1351.30, 3
4, 10:43:00-000, 93, 43, 50, 41, 1351.16, 41, 1351.48, 6
4, 10:44:00-000, 86, 45, 41, 46, 1349.36, 40, 1349.79, 0
4, 10:45:00-000, 89, 54, 35, 52, 1351.55, 31, 1351.54, 13
4, 10:46:00-000, 71, 29, 42, 26, 1349.03, 38, 1349.44, 3
4, 10:47:00-000, 77, 44, 33, 39, 1349.76, 35, 1349.62, 11
4, 10:48:00-000, 112, 67, 45, 67, 1349.87, 22, 1350.04, 18
4, 10:49:00-000, 66, 31, 35, 28, 1349.75, 30, 1349.70, 8
4, 10:50:00-000, 88, 41, 47, 43, 1350.32, 47, 1350.14, 0
4, 10:51:00-000, 94, 35, 59, 32, 1348.96, 47, 1349.52, 5
4, 10:52:00-000, 85, 44, 41, 48, 1350.87, 43, 1351.08, 1
4, 10:53:00-000, 61, 28, 33, 28, 1350.10, 29, 1350.44, 6
4, 10:54:00-000, 96, 39, 57, 37, 1349.89, 55, 1350.59, 6
4, 10:55:00-000, 86, 46, 40, 40, 1351.49, 29, 1351.27, 9
4, 10:56:00-000, 77, 41, 36, 36, 1351.24, 32, 1351.52, 6
4, 10:57:00-000, 77, 41, 36, 35, 1352.14, 33, 1350.39, 13
4, 10:58:00-000, 100, 52, 48, 55, 1351.72, 48, 1351.47, 3
4, 10:59:00-000, 88, 35, 53, 32, 1350.68, 28, 1349.85, 23
4, 11:00:00-000, 64, 23, 41, 21, 1349.04, 35, 1350.19, 6
4, 11:01:00-000, 73, 38, 35, 33, 1351.02, 33, 1350.99, 14
4, 11:02:00-000, 92, 51, 41, 54, 1351.40, 36, 1350.91, 1
4, 11:03:00-000, 90, 26, 64, 26, 1349.61, 53, 1349.82, 4
4, 11:04:00-000, 91, 62, 29, 53, 1350.40, 37, 1350.42, 4
4, 11:05:00-000, 79, 33, 46, 35, 1351.37, 35, 1351.11, 6
4, 11:06:00-000, 84, 41, 43, 40, 1351.37, 53, 1351.76, 1
4, 11:07:00-000, 100, 43, 57, 36, 1350.44, 34, 1350.35, 5
4, 11:08:00-000, 78, 38, 40, 46, 1349.73, 56, 1350.54, 0
4, 11:09:00-000, 102, 54, 48, 52, 1351.86, 35, 1352.14, 2
4, 11:10:00-000, 69, 35, 34, 34, 1351.23, 49, 1351.77, 1
4, 11:11:00-000, 67, 29, 38, 29, 1349.48, 25, 1350.19, 8
4, 11:12:00-000, 96, 37, 59, 35, 1349.22, 53, 1349.35, 6
4, 11:13:00-000, 84, 32, 52, 34, 1350.02, 48, 1349.60, 4
4, 11:14:00-000, 102, 43, 59, 42, 1349.54, 50, 1349.89, 6
4, 11:15:00-000, 72, 31, 41, 30, 1347.13, 40, 1347.92, 5
4, 11:16:00-000, 91, 41, 50, 42, 1350.21, 39, 1349.35, 13
4, 11:17:00-000, 73, 33, 40, 33, 1351.48, 28, 1351.71, 2
4, 11:18:00-000, 54, 30, 24, 29, 1351.17, 35, 1351.14, 2
4, 11:19:00-000, 98, 58, 40, 52, 1351.16, 29, 1351.72, 1
4, 11:20:00-000, 102, 58, 44, 57, 1351.11, 55, 1351.37, 0
4, 11:21:00-000, 64, 36, 28, 33, 1351.23, 26, 1350.96, 9
4, 11:22:00-000, 70, 27, 43, 29, 1350.10, 31, 1350.15, 3
4, 11:23:00-000, 88, 52, 36, 50, 1351.63, 39, 1351.35, 6
4, 11:24:00-000, 92, 54, 38, 46, 1350.36, 33, 1350.24, 7
4, 11:25:00-000, 80, 34, 46, 39, 1350.58, 19, 1351.79, 10
4, 11:26:00-000, 63, 40, 23, 40, 1351.49, 42, 1350.68, 1
4, 11:27:00-000, 84, 47, 37, 47, 1352.67, 23, 1352.00, 5
4, 11:28:00-000, 93, 45, 48, 38, 1352.07, 40, 1352.54, 14
4, 11:29:00-000, 71, 25, 46, 24, 1350.74, 32, 1351.09, 10
4, 11:30:00-000, 89, 37, 52, 37, 1350.32, 53, 1350.78, 2
4, 11:31:00-000, 83, 45, 38, 41, 1348.67, 32, 1348.81, 12
4, 11:32:00-000, 87, 38, 49, 41, 1350.07, 42, 1350.37, 3
4, 11:33:00-000, 74, 27, 47, 24, 1348.62, 37, 1350.23, 9
4, 11:34:00-000, 64, 29, 35, 31, 1349.64, 47, 1350.76, 1
4, 11:35:00-000, 96, 33, 63, 32, 1350.52, 51, 1350.58, 4
4, 11:36:00-000, 93, 40, 53, 32, 1350.09, 53, 1349.88, 4
4, 11:37:00-000, 64, 23, 41, 33, 1350.72, 35, 1349.85, 3
4, 11:38:00-000, 99, 50, 49, 44, 1350.95, 51, 1350.95, 5
4, 11:39:00-000, 71, 33, 38, 33, 1350.05, 37, 1351.24, 2
4, 11:40:00-000, 96, 53, 43, 55, 1351.36, 40, 1351.89, 2
4, 11:41:00-000, 56, 23, 33, 23, 1350.30, 26, 1350.38, 3
4, 11:42:00-000, 72, 44, 28, 40, 1352.47, 26, 1351.84, 0
4, 11:43:00-000, 90, 54, 36, 53, 1352.35, 41, 1352.50, 3
4, 11:44:00-000, 86, 32, 54, 33, 1348.84, 49, 1349.42, 3
4, 11:45:00-000, 94, 35, 59, 35, 1349.08, 47, 1349.03, 8
4, 11:46:00-000, 68, 35, 33, 33, 1350.51, 44, 1350.86, 1
4, 11:47:00-000, 52, 23, 29, 25, 1350.36, 29, 1350.00, 0
4, 11:48:00-000, 104, 55, 49, 55, 1353.75, 39, 1353.58, 2
4, 11:49:00-000, 57, 38, 19, 32, 1352.06, 20, 1352.20, 10
4, 11:50:00-000, 94, 50, 44, 51, 1352.79, 37, 1352.48, 6
4, 11:51:00-000, 87, 43, 44, 40, 1349.14, 42, 1348.87, 3
4, 11:52:00-000, 65, 26, 39, 26, 1349.50, 17, 1349.11, 9
4, 11:53:00-000, 90, 33, 57, 32, 1348.62, 51, 1348.68, 11
4, 11:54:00-000, 88, 43, 45, 45, 1350.61, 48, 1350.78, 2
4, 11:55:00-000, 77, 39, 38, 33, 1350.18, 34, 1350.47, 8
4, 11:56:00-000, 77, 48, 29, 47, 1352.14, 32, 1352.84, 6
4, 11:57:00-000, 80, 39, 41, 35, 1353.08, 30, 1353.39, 7
4, 11:58:00-000, 84, 36, 48, 34, 1349.67, 49, 1350.54, 2
4, 11:59:00-000, 65, 35, 30, 33, 1348.21, 25, 1348.60, 8
4, 12:00:00-000, 69, 33, 36, 35, 1347.22, 38, 1346.70, 1
4, 12:01:00-000, 87, 57, 30, 51, 1352.80, 24, 1351.75, 5
4, 12:02:00-000, 86, 58, 28, 48, 1351.12, 33, 1351.93, 4
4, 12:03:00-000, 90, 29, 61, 32, 1349.99, 37, 1350.34, 14
4, 12:04:00-000, 73, 38, 35, 37, 1351.24, 46, 1351.21, 4
4, 12:05:00-000, 75, 33, 42, 33, 1350.69, 36, 1350.71, 3
4, 12:06:00-000, 117, 53, 64, 52, 1350.32, 60, 1350.64, 10
4, 12:07:00-000, 78, 50, 28, 43, 1349.62, 27, 1350.14, 8
4, 12:08:00-000, 83, 52, 31, 50, 1352.25, 30, 1352.73, 3
4, 12:09:00-000, 75, 32, 43, 32, 1350.09, 37, 1350.70, 5
4, 12:10:00-000, 85, 38, 47, 38, 1350.49, 47, 1350.76, 2
4, 12:11:00-000, 82, 33, 49, 30, 1350.69, 37, 1350.94, 4
4, 12:12:00-000, 92, 46, 46, 46, 1350.60, 46, 1350.56, 0
4, 12:13:00-000, 77, 30, 47, 33, 1350.02, 46, 1349.82, 0
4, 12:14:00-000, 55, 29, 26, 29, 1350.03, 29, 1349.79, 1
4, 12:15:00-000, 91, 40, 51, 40, 1350.49, 48, 1350.20, 5
4, 12:16:00-000, 107, 51, 56, 51, 1351.15, 52, 1351.32, 1
4, 12:17:00-000, 71, 39, 32, 36, 1350.94, 23, 1351.47, 8
4, 12:18:00-000, 68, 29, 39, 31, 1349.83, 35, 1349.99, 9
4, 12:19:00-000, 84, 42, 42, 40, 1352.09, 38, 1352.07, 2
4, 12:20:00-000, 97, 44, 53, 41, 1350.07, 41, 1349.46, 17
4, 12:21:00-000, 100, 52, 48, 53, 1350.59, 47, 1350.33, 3
4, 12:22:00-000, 66, 20, 46, 12, 1349.00, 21, 1349.71, 16
4, 12:23:00-000, 87, 39, 48, 44, 1350.70, 43, 1350.90, 7
4, 12:24:00-000, 108, 50, 58, 37, 1350.53, 51, 1350.77, 10
4, 12:25:00-000, 103, 67, 36, 58, 1353.44, 32, 1353.59, 24
4, 12:26:00-000, 101, 45, 56, 47, 1351.33, 48, 1351.01, 10
4, 12:27:00-000, 57, 22, 35, 23, 1350.82, 29, 1350.75, 6
4, 12:28:00-000, 115, 48, 67, 44, 1349.22, 53, 1348.76, 8
4, 12:29:00-000, 84, 35, 49, 34, 1348.26, 41, 1347.65, 14
4, 12:30:00-000, 105, 46, 59, 40, 1350.19, 43, 1349.85, 10
4, 12:31:00-000, 72, 31, 41, 33, 1349.27, 38, 1349.97, 14
4, 12:32:00-000, 85, 39, 46, 35, 1350.85, 38, 1351.36, 17
4, 12:33:00-000, 83, 41, 42, 38, 1351.55, 37, 1351.86, 4
4, 12:34:00-000, 69, 41, 28, 44, 1349.99, 27, 1350.48, 5
4, 12:35:00-000, 82, 49, 33, 44, 1349.86, 27, 1349.74, 8
4, 12:36:00-000, 78, 31, 47, 23, 1350.08, 35, 1350.62, 9
4, 12:37:00-000, 87, 40, 47, 36, 1351.97, 28, 1351.92, 8
4, 12:38:00-000, 80, 46, 34, 40, 1352.69, 55, 1353.06, 8
4, 12:39:00-000, 72, 46, 26, 43, 1351.08, 28, 1350.78, 6
4, 12:40:00-000, 91, 39, 52, 35, 1351.02, 45, 1350.82, 1
4, 12:41:00-000, 100, 55, 45, 53, 1350.82, 39, 1350.84, 2
4, 12:42:00-000, 81, 36, 45, 41, 1350.16, 47, 1350.90, 9
4, 12:43:00-000, 67, 40, 27, 29, 1351.20, 27, 1350.03, 10
4, 12:44:00-000, 126, 56, 70, 53, 1352.20, 60, 1350.42, 3
4, 12:45:00-000, 98, 46, 52, 50, 1352.03, 42, 1351.21, 10
4, 12:46:00-000, 62, 28, 34, 24, 1349.33, 29, 1349.75, 6
4, 12:47:00-000, 83, 48, 35, 37, 1351.18, 34, 1351.08, 10
4, 12:48:00-000, 80, 36, 44, 41, 1351.31, 28, 1350.64, 13
4, 12:49:00-000, 114, 70, 44, 66, 1351.16, 41, 1351.24, 4
4, 12:50:00-000, 63, 20, 43, 25, 1350.08, 34, 1350.17, 5
4, 12:51:00-000, 86, 41, 45, 36, 1349.38, 53, 1349.86, 7
4, 12:52:00-000, 73, 32, 41, 32, 1349.02, 30, 1349.19, 9
4, 12:53:00-000, 73, 47, 26, 38, 1350.68, 24, 1350.58, 3
4, 12:54:00-000, 78, 38, 40, 40, 1348.59, 40, 1349.59, 8
4, 12:55:00-000, 81, 42, 39, 37, 1352.05, 27, 1351.37, 7
4, 12:56:00-000, 88, 29, 59, 32, 1349.46, 54, 1349.45, 6
4, 12:57:00-000, 77, 21, 56, 21, 1349.14, 44, 1349.15, 8
4, 12:58:00-000, 91, 47, 44, 45, 1348.68, 49, 1349.03, 9
4, 12:59:00-000, 84, 38, 46, 34, 1349.93, 45, 1349.88, 2
4, 13:00:00-000, 88, 53, 35, 59, 1350.65, 32, 1351.15, 0
4, 13:01:00-000, 94, 36, 58, 36, 1350.61, 48, 1350.10, 4
4, 13:02:00-000, 79, 30, 49, 30, 1349.56, 47, 1350.82, 1
4, 13:03:00-000, 67, 32, 35, 31, 1350.45, 27, 1349.81, 9
4, 13:04:00-000, 82, 39, 43, 40, 1350.42, 51, 1350.93, 0
4, 13:05:00-000, 101, 48, 53, 46, 1350.95, 40, 1350.99, 7
4, 13:06:00-000, 69, 43, 26, 37, 1350.13, 28, 1350.60, 10
4, 13:07:00-000, 62, 36, 26, 31, 1352.99, 24, 1350.66, 2
4, 13:08:00-000, 77, 33, 44, 38, 1351.07, 41, 1350.55, 3
4, 13:09:00-000, 78, 28, 50, 23, 1350.04, 40, 1350.12, 4
4, 13:10:00-000, 104, 46, 58, 51, 1349.68, 58, 1350.30, 7
4, 13:11:00-000, 70, 31, 39, 31, 1347.87, 24, 1348.04, 14
4, 13:12:00-000, 82, 26, 56, 25, 1349.79, 51, 1349.95, 4
4, 13:13:00-000, 67, 41, 26, 41, 1352.28, 29, 1351.72, 0
4, 13:14:00-000, 106, 47, 59, 48, 1350.74, 54, 1350.36, 6
4, 13:15:00-000, 66, 37, 29, 34, 1351.97, 25, 1352.35, 1
4, 13:16:00-000, 85, 48, 37, 49, 1352.14, 31, 1351.64, 6
4, 13:17:00-000, 99, 50, 49, 45, 1350.04, 43, 1350.16, 4
4, 13:18:00-000, 56, 17, 39, 23, 1348.69, 31, 1349.48, 7
4, 13:19:00-000, 80, 46, 34, 42, 1350.47, 29, 1350.44, 3
4, 13:20:00-000, 71, 42, 29, 39, 1349.35, 38, 1350.15, 4
4, 13:21:00-000, 75, 46, 29, 40, 1350.24, 20, 1350.35, 5
4, 13:22:00-000, 94, 60, 34, 57, 1351.57, 34, 1351.14, 8
4, 13:23:00-000, 92, 39, 53, 38, 1349.70, 38, 1349.78, 15
4, 13:24:00-000, 95, 26, 69, 29, 1350.44, 55, 1350.59, 8
4, 13:25:00-000, 108, 61, 47, 58, 1350.84, 56, 1350.72, 1
4, 13:26:00-000, 82, 40, 42, 41, 1348.99, 38, 1349.91, 4
4, 13:27:00-000, 71, 30, 41, 31, 1350.16, 24, 1349.66, 5
4, 13:28:00-000, 107, 51, 56, 48, 1350.55, 61, 1350.50, 1
4, 13:29:00-000, 74, 33, 41, 33, 1349.60, 47, 1349.76, 2
4, 13:30:00-000, 80, 42, 38, 44, 1350.94, 29, 1350.86, 1
4, 13:31:00-000, 83, 39, 44, 33, 1349.12, 33, 1349.48, 11
4, 13:32:00-000, 92, 36, 56, 38, 1348.60, 47, 1348.97, 7
4, 13:33:00-000, 80, 44, 36, 41, 1350.82, 38, 1351.02, 2
4, 13:34:00-000, 55, 32, 23, 35, 1351.28, 33, 1351.84, 2
4, 13:35:00-000, 101, 41, 60, 40, 1350.74, 35, 1349.54, 12
4, 13:36:00-000, 56, 26, 30, 23, 1349.26, 36, 1349.72, 4
4, 13:37:00-000, 98, 51, 47, 48, 1350.80, 38, 1351.05, 5
4, 13:38:00-000, 94, 40, 54, 43, 1350.39, 48, 1350.55, 10
4, 13:39:00-000, 72, 27, 45, 27, 1350.77, 36, 1349.88, 5
4, 13:40:00-000, 85, 22, 63, 22, 1349.45, 59, 1350.16, 0
4, 13:41:00-000, 100, 26, 74, 24, 1347.08, 55, 1347.26, 14
4, 13:42:00-000, 78, 39, 39, 41, 1349.55, 48, 1349.66, 8
4, 13:43:00-000, 95, 51, 44, 36, 1350.99, 40, 1351.97, 3
4, 13:44:00-000, 83, 49, 34, 61, 1350.28, 33, 1351.12, 3
4, 13:45:00-000, 80, 42, 38, 38, 1350.83, 42, 1350.28, 2
4, 13:46:00-000, 93, 53, 40, 49, 1350.13, 34, 1350.29, 0
4, 13:47:00-000, 72, 38, 34, 38, 1350.89, 33, 1350.78, 10
4, 13:48:00-000, 90, 46, 44, 44, 1350.92, 42, 1350.97, 3
4, 13:49:00-000, 106, 52, 54, 49, 1350.21, 48, 1350.68, 0
4, 13:50:00-000, 74, 39, 35, 40, 1350.72, 43, 1351.16, 0
4, 13:51:00-000, 56, 35, 21, 34, 1352.46, 17, 1351.29, 3
4, 13:52:00-000, 111, 59, 52, 53, 1351.28, 43, 1352.04, 13
4, 13:53:00-000, 77, 35, 42, 38, 1349.94, 34, 1349.85, 4
4, 13:54:00-000, 79, 33, 46, 35, 1351.88, 38, 1351.81, 3
4, 13:55:00-000, 85, 43, 42, 42, 1350.21, 40, 1350.32, 7
4, 13:56:00-000, 85, 35, 50, 36, 1350.82, 40, 1351.09, 9
4, 13:57:00-000, 68, 36, 32, 35, 1349.31, 28, 1348.35, 9
4, 13:58:00-000, 79, 26, 53, 27, 1349.18, 42, 1349.13, 0
4, 13:59:00-000, 108, 44, 64, 42, 1348.59, 46, 1349.40, 16
4, 14:00:00-000, 95, 38, 57, 39, 1348.68, 67, 1348.81, 0
4, 14:01:00-000, 61, 41, 20, 35, 1348.91, 24, 1348.58, 1
4, 14:02:00-000, 87, 41, 46, 41, 1348.94, 47, 1349.74, 8
4, 14:03:00-000, 79, 40, 39, 34, 1351.35, 26, 1351.53, 5
4, 14:04:00-000, 76, 48, 28, 50, 1350.67, 31, 1351.41, 4
4, 14:05:00-000, 81, 36, 45, 36, 1349.91, 43, 1350.08, 4
4, 14:06:00-000, 80, 47, 33, 47, 1349.99, 35, 1348.91, 1
4, 14:07:00-000, 87, 39, 48, 38, 1350.55, 36, 1349.77, 0
4, 14:08:00-000, 76, 41, 35, 42, 1349.23, 42, 1350.42, 1
4, 14:09:00-000, 88, 46, 42, 38, 1351.12, 39, 1350.35, 4
4, 14:10:00-000, 81, 40, 41, 45, 1349.17, 37, 1349.45, 1
4, 14:11:00-000, 79, 38, 41, 41, 1349.80, 32, 1350.18, 6
4, 14:12:00-000, 91, 45, 46, 45, 1351.44, 42, 1351.76, 0
4, 14:13:00-000, 86, 44, 42, 44, 1351.20, 46, 1351.14, 4
4, 14:14:00-000, 80, 38, 42, 38, 1350.18, 37, 1350.61, 4
4, 14:15:00-000, 84, 37, 47, 36, 1350.49, 42, 1349.59, 4
4, 14:16:00-000, 81, 45, 36, 37, 1350.97, 41, 1351.28, 8
4, 14:17:00-000, 87, 42, 45, 38, 1349.33, 40, 1350.52, 2
4, 14:18:00-000, 90, 40, 50, 41, 1348.04, 49, 1348.60, 1
4, 14:19:00-000, 95, 61, 34, 58, 1350.47, 30, 1349.76, 10
4, 14:20:00-000, 55, 21, 34, 23, 1349.48, 36, 1350.36, 1
4, 14:21:00-000, 78, 45, 33, 38, 1350.91, 32, 1350.65, 0
4, 14:22:00-000, 96, 44, 52, 45, 1350.01, 35, 1349.68, 4
4, 14:23:00-000, 90, 57, 33, 54, 1353.21, 32, 1352.62, 18
4, 14:24:00-000, 57, 30, 27, 32, 1348.43, 22, 1349.27, 10
4, 14:25:00-000, 113, 53, 60, 50, 1351.09, 45, 1350.99, 2
4, 14:26:00-000, 93, 39, 54, 41, 1350.16, 60, 1351.01, 7
4, 14:27:00-000, 84, 39, 45, 30, 1348.59, 38, 1348.52, 4
4, 14:28:00-000, 85, 33, 52, 41, 1349.46, 56, 1349.67, 1
4, 14:29:00-000, 76, 45, 31, 39, 1351.64, 13, 1350.92, 11
4, 14:30:00-000, 66, 28, 38, 26, 1350.19, 38, 1350.55, 6
4, 14:31:00-000, 79, 34, 45, 29, 1350.92, 38, 1351.20, 6
4, 14:32:00-000, 99, 46, 53, 52, 1350.34, 48, 1350.20, 7
4, 14:33:00-000, 70, 36, 34, 29, 1350.79, 26, 1350.34, 5
4, 14:34:00-000, 75, 26, 49, 33, 1348.54, 52, 1350.43, 7
4, 14:35:00-000, 124, 60, 64, 57, 1352.45, 54, 1351.72, 3
4, 14:36:00-000, 73, 30, 43, 31, 1350.90, 34, 1351.58, 6
4, 14:37:00-000, 79, 30, 49, 28, 1350.03, 47, 1349.31, 4
4, 14:38:00-000, 81, 38, 43, 37, 1350.53, 38, 1350.94, 8
4, 14:39:00-000, 92, 63, 29, 54, 1351.36, 36, 1351.30, 1
4, 14:40:00-000, 83, 39, 44, 44, 1349.02, 42, 1349.97, 0
4, 14:41:00-000, 94, 42, 52, 37, 1349.02, 51, 1349.07, 8
4, 14:42:00-000, 63, 37, 26, 42, 1351.35, 24, 1352.08, 1
4, 14:43:00-000, 86, 50, 36, 44, 1352.85, 27, 1353.33, 2
4, 14:44:00-000, 96, 42, 54, 48, 1350.91, 40, 1351.51, 0
4, 14:45:00-000, 77, 46, 31, 46, 1350.95, 46, 1351.49, 7
4, 14:46:00-000, 77, 44, 33, 42, 1350.75, 34, 1351.20, 1
4, 14:47:00-000, 85, 33, 52, 21, 1349.76, 23, 1349.95, 11
4, 14:48:00-000, 91, 45, 46, 50, 1350.07, 64, 1351.18, 1
4, 14:49:00-000, 71, 23, 48, 30, 1347.10, 32, 1348.24, 8
4, 14:50:00-000, 82, 40, 42, 35, 1350.62, 41, 1350.18, 2
4, 14:51:00-000, 92, 52, 40, 54, 1351.36, 44, 1351.74, 2
4, 14:52:00-000, 99, 38, 61, 40, 1349.07, 43, 1349.53, 3
4, 14:53:00-000, 55, 23, 32, 23, 1350.26, 31, 1350.44, 11
4, 14:54:00-000, 87, 45, 42, 43, 1351.41, 48, 1351.35, 1
4, 14:55:00-000, 95, 47, 48, 47, 1351.29, 40, 1351.37, 0
4, 14:56:00-000, 70, 23, 47, 25, 1350.79, 48, 1351.55, 0
4, 14:57:00-000, 74, 37, 37, 31, 1349.80, 40, 1350.07, 4
4, 14:58:00-000, 90, 49, 41, 50, 1350.73, 37, 1351.15, 5
4, 14:59:00-000, 65, 30, 35, 23, 1349.21, 29, 1350.03, 4
4, 15:00:00-000, 92, 32, 60, 38, 1349.10, 52, 1349.12, 11
4, 15:01:00-000, 88, 41, 47, 40, 1350.77, 44, 1350.67, 2
4, 15:02:00-000, 97, 61, 36, 57, 1351.50, 33, 1351.81, 2
4, 15:03:00-000, 70, 35, 35, 35, 1351.51, 21, 1351.42, 12
4, 15:04:00-000, 77, 46, 31, 46, 1353.08, 37, 1353.86, 3
4, 15:05:00-000, 102, 33, 69, 34, 1350.94, 39, 1351.20, 6
4, 15:06:00-000, 71, 37, 34, 34, 1352.23, 53, 1351.73, 6
4, 15:07:00-000, 89, 28, 61, 21, 1348.52, 49, 1348.81, 16
4, 15:08:00-000, 90, 54, 36, 51, 1352.44, 37, 1351.40, 3
4, 15:09:00-000, 83, 20, 63, 23, 1347.87, 55, 1348.34, 5
4, 15:10:00-000, 80, 43, 37, 38, 1350.91, 39, 1350.79, 3
4, 15:11:00-000, 72, 38, 34, 41, 1350.58, 30, 1350.09, 2
4, 15:12:00-000, 63, 31, 32, 31, 1350.64, 33, 1351.02, 4
4, 15:13:00-000, 74, 29, 45, 27, 1349.81, 26, 1349.42, 1
4, 15:14:00-000, 92, 51, 41, 52, 1350.57, 57, 1350.48, 3
4, 15:15:00-000, 79, 47, 32, 42, 1351.49, 26, 1351.23, 1
4, 15:16:00-000, 61, 36, 25, 41, 1350.70, 28, 1351.03, 2
4, 15:17:00-000, 78, 47, 31, 43, 1351.76, 28, 1351.28, 0
4, 15:18:00-000, 105, 58, 47, 55, 1349.63, 47, 1349.71, 3
4, 15:19:00-000, 69, 38, 31, 38, 1350.99, 31, 1351.41, 7
4, 15:20:00-000, 80, 39, 41, 38, 1350.10, 37, 1350.15, 3
4, 15:21:00-000, 75, 30, 45, 29, 1350.68, 41, 1350.60, 0
4, 15:22:00-000, 86, 34, 52, 36, 1349.99, 53, 1350.08, 0
4, 15:23:00-000, 68, 44, 24, 41, 1351.24, 22, 1351.50, 4
4, 15:24:00-000, 91, 43, 48, 42, 1348.71, 41, 1349.63, 3
4, 15:25:00-000, 92, 57, 35, 57, 1350.45, 38, 1350.34, 2
4, 15:26:00-000, 72, 42, 30, 39, 1350.58, 17, 1351.12, 5
4, 15:27:00-000, 75, 41, 34, 31, 1348.38, 41, 1349.36, 11
4, 15:28:00-000, 111, 44, 67, 52, 1350.07, 61, 1350.51, 0
4, 15:29:00-000, 78, 21, 57, 21, 1349.09, 43, 1348.04, 2
4, 15:30:00-000, 102, 41, 61, 40, 1351.54, 61, 1351.27, 12
4, 15:31:00-000, 80, 39, 41, 40, 1350.92, 42, 1350.73, 1
4, 15:32:00-000, 102, 40, 62, 33, 1350.36, 56, 1350.58, 7
4, 15:33:00-000, 101, 57, 44, 51, 1350.23, 46, 1350.27, 5
4, 15:34:00-000, 69, 46, 23, 54, 1351.08, 18, 1351.22, 2
4, 15:35:00-000, 89, 36, 53, 34, 1350.11, 43, 1350.76, 2
4, 15:36:00-000, 84, 41, 43, 39, 1351.28, 48, 1351.64, 4
4, 15:37:00-000, 77, 37, 40, 33, 1351.00, 31, 1351.41, 11
4, 15:38:00-000, 85, 40, 45, 42, 1351.30, 39, 1351.43, 1
4, 15:39:00-000, 80, 38, 42, 33, 1351.08, 33, 1351.02, 5
4, 15:40:00-000, 96, 45, 51, 51, 1350.05, 63, 1349.73, 3
4, 15:41:00-000, 86, 41, 45, 40, 1350.84, 31, 1350.16, 3
4, 15:42:00-000, 94, 55, 39, 51, 1350.97, 47, 1350.24, 1
4, 15:43:00-000, 80, 44, 36, 47, 1351.61, 35, 1351.76, 4
4, 15:44:00-000, 70, 28, 42, 28, 1351.57, 31, 1351.54, 1
4, 15:45:00-000, 55, 23, 32, 21, 1349.76, 34, 1350.64, 6
4, 15:46:00-000, 106, 50, 56, 45, 1350.12, 46, 1349.86, 10
4, 15:47:00-000, 80, 43, 37, 47, 1349.84, 36, 1349.46, 5
4, 15:48:00-000, 84, 48, 36, 42, 1348.80, 29, 1349.06, 7
4, 15:49:00-000, 82, 40, 42, 43, 1350.57, 36, 1351.22, 2
4, 15:50:00-000, 69, 34, 35, 34, 1350.99, 39, 1351.12, 1
4, 15:51:00-000, 77, 40, 37, 40, 1350.79, 38, 1351.10, 0
4, 15:52:00-000, 86, 31, 55, 29, 1350.54, 50, 1350.53, 0
4, 15:53:00-000, 87, 38, 49, 40, 1351.02, 44, 1350.88, 6
4, 15:54:00-000, 81, 33, 48, 33, 1351.66, 42, 1351.87, 0
4, 15:55:00-000, 109, 68, 41, 65, 1351.40, 52, 1351.22, 2
4, 15:56:00-000, 105, 61, 44, 62, 1350.70, 45, 1350.77, 0
4, 15:57:00-000, 106, 55, 51, 51, 1350.25, 48, 1350.87, 4
4, 15:58:00-000, 65, 31, 34, 26, 1350.57, 32, 1350.96, 2
4, 15:59:00-000, 104, 42, 62, 41, 1348.63, 44, 1349.70, 9
4, 16:00:00-000, 95, 47, 48, 47, 1351.82, 57, 1351.03, 3
4, 16:01:00-000, 63, 21, 42, 21, 1348.90, 22, 1349.99, 10
4, 16:02:00-000, 74, 44, 30, 42, 1351.80, 37, 1351.42, 6
4, 16:03:00-000, 92, 46, 46, 44, 1350.02, 36, 1350.13, 2
4, 16:04:00-000, 81, 39, 42, 43, 1350.85, 47, 1351.44, 5
4, 16:05:00-000, 77, 48, 29, 47, 1351.10, 31, 1351.45, 1
4, 16:06:00-000, 80, 35, 45, 36, 1349.97, 41, 1349.53, 1
4, 16:07:00-000, 96, 43, 53, 42, 1349.82, 42, 1349.87, 0
4, 16:08:00-000, 72, 26, 46, 27, 1349.85, 53, 1351.12, 2
4, 16:09:00-000, 88, 37, 51, 31, 1349.06, 39, 1349.30, 7
4, 16:10:00-000, 57, 32, 25, 33, 1349.99, 35, 1350.45, 1
4, 16:11:00-000, 111, 71, 40, 68, 1351.90, 26, 1350.49, 3
4, 16:12:00-000, 91, 44, 47, 47, 1352.40, 48, 1352.72, 7
4, 16:13:00-000, 77, 46, 31, 44, 1350.79, 30, 1350.66, 3
4, 16:14:00-000, 103, 40, 63, 39, 1349.53, 54, 1349.75, 4
4, 16:15:00-000, 90, 35, 55, 36, 1349.11, 54, 1349.82, 9
4, 16:16:00-000, 74, 48, 26, 43, 1351.01, 26, 1351.53, 6
4, 16:17:00-000, 84, 41, 43, 31, 1348.77, 37, 1349.53, 5
4, 16:18:00-000, 95, 36, 59, 43, 1348.02, 44, 1348.74, 5
4, 16:19:00-000, 83, 45, 38, 44, 1349.63, 40, 1349.69, 10
4, 16:20:00-000, 78, 45, 33, 44, 1350.72, 37, 1350.50, 0
4, 16:21:00-000, 86, 28, 58, 29, 1349.68, 39, 1349.33, 2
4, 16:22:00-000, 74, 32, 42, 31, 1350.86, 56, 1350.77, 3
4, 16:23:00-000, 58, 30, 28, 31, 1351.70, 20, 1352.40, 0
4, 16:24:00-000, 78, 39, 39, 37, 1351.21, 42, 1351.73, 4
4, 16:25:00-000, 64, 29, 35, 29, 1352.10, 31, 1352.32, 3
4, 16:26:00-000, 91, 46, 45, 49, 1351.97, 38, 1352.44, 1
4, 16:27:00-000, 90, 45, 45, 42, 1348.33, 36, 1348.72, 10
4, 16:28:00-000, 63, 35, 28, 28, 1350.71, 30, 1351.43, 2
4, 16:29:00-000, 92, 38, 54, 34, 1349.76, 45, 1350.01, 10
5, 09:13:00-000, 10083, 5466, 4617, 3847, 1348.05, 3749, 1349.27, 0
5, 09:14:00-000, 0, 0, 0, 1, 1347.00, 5, 1357.00, 649
5, 09:15:00-000, 0, 0, 0, 0, 0.00, 50, 1357.00, 1774
5, 09:16:00-000, 0, 0, 0, 0, 0.00, 0, 0.00, 8
5, 09:26:00-000, 10256, 5418, 4838, 3811, 1348.26, 3823, 1348.33, 0
5, 09:27:00-000, 0, 0, 0, 25, 1348.00, 60, 1356.00, 0
5, 09:28:00-000, 0, 0, 0, 44, 1347.52, 170, 1356.58, 1773
5, 09:29:00-000, 12, 10, 2, 8, 1348.37, 2, 1352.00, 550
5, 09:30:00-000, 76, 52, 24, 29, 1349.79, 22, 1349.45, 1
5, 09:31:00-000, 0, 0, 0, 0, 0.00, 2, 1360.00, 1
5, 09:32:00-000, 184, 99, 85, 83, 1348.43, 85, 1351.22, 14
5, 09:33:00-000, 414, 217, 197, 133, 1348.81, 163, 1350.11, 9
5, 09:34:00-000, 663, 335, 328, 247, 1348.94, 278, 1350.07, 47
5, 09:35:00-000, 0, 0, 0, 14, 1347.00, 13, 1356.46, 46
5, 09:36:00-000, 938, 547, 391, 371, 1349.80, 309, 1350.13, 125
5, 09:37:00-000, 1190, 639, 551, 446, 1348.27, 467, 1349.25, 164
5, 09:38:00-000, 1347, 706, 641, 479, 1349.27, 568, 1350.46, 178
5, 09:39:00-000, 0, 0, 0, 6, 1347.00, 3, 1357.00, 176
5, 09:40:00-000, 1217, 698, 519, 522, 1348.91, 474, 1349.40, 222
5, 09:41:00-000, 1299, 621, 678, 487, 1348.42, 482, 1348.78, 196
5, 09:42:00-000, 1190, 612, 578, 483, 1348.79, 484, 1349.98, 183
5, 09:43:00-000, 2, 2, 0, 42, 1346.61, 12, 1356.00, 194
5, 09:44:00-000, 1139, 620, 519, 424, 1348.71, 471, 1349.77, 177
5, 09:45:00-000, 894, 456, 438, 322, 1348.46, 376, 1349.81, 180
5, 09:46:00-000, 882, 478, 404, 371, 1348.89, 331, 1349.91, 152
5, 09:47:00-000, 1, 1, 0, 1, 1348.00, 12, 1356.00, 156
5, 09:48:00-000, 937, 494, 443, 362, 1349.09, 376, 1349.95, 124
5, 09:49:00-000, 963, 501, 462, 330, 1348.51, 339, 1348.97, 133
5, 09:50:00-000, 854, 390, 464, 319, 1347.72, 358, 1349.18, 178
5, 09:51:00-000, 0, 0, 0, 28, 1345.00, 14, 1355.00, 204
5, 09:52:00-000, 983, 504, 479, 365, 1349.02, 425, 1350.44, 91
5, 09:53:00-000, 1098, 562, 536, 375, 1348.86, 445, 1350.08, 190
5, 09:54:00-000, 1061, 559, 502, 442, 1348.27, 424, 1349.42, 143
5, 09:55:00-000, 0, 0, 0, 39, 1346.00, 43, 1357.00, 160
5, 09:56:00-000, 1087, 586, 501, 457, 1349.10, 384, 1349.55, 140
5, 09:57:00-000, 1122, 607, 515, 436, 1349.08, 446, 1349.42, 153
5, 09:58:00-000, 996, 564, 432, 412, 1349.07, 417, 1350.10, 154
5, 09:59:00-000, 1, 0, 1, 47, 1345.72, 1, 1348.00, 146
5, 10:00:00-000, 1034, 547, 487, 413, 1349.24, 425, 1350.13, 152
5, 10:01:00-000, 1057, 529, 528, 392, 1348.89, 445, 1349.44, 131
5, 10:02:00-000, 1026, 558, 468, 423, 1349.26, 395, 1349.62, 156
5, 10:03:00-000, 0, 0, 0, 0, 0.00, 46, 1357.53, 155
5, 10:04:00-000, 1029, 586, 443, 436, 1348.62, 346, 1349.70, 118
5, 10:05:00-000, 1049, 584, 465, 410, 1349.60, 421, 1350.24, 183
5, 10:06:00-000, 1048, 488, 560, 414, 1348.57, 430, 1349.71, 172
5, 10:07:00-000, 0, 0, 0, 19, 1346.00, 43, 1355.62, 112
5, 10:08:00-000, 928, 457, 471, 324, 1348.68, 380, 1349.67, 160
5, 10:09:00-000, 1031, 502, 529, 351, 1348.41, 376, 1349.08, 152
5, 10:10:00-000, 1072, 563, 509, 411, 1349.05, 456, 1350.60, 173
5, 10:11:00-000, 1, 1, 0, 23, 1346.13, 16, 1357.00, 166
5, 10:12:00-000, 1085, 625, 460, 454, 1349.33, 432, 1350.35, 198
5, 10:13:00-000, 990, 521, 469, 379, 1349.21, 365, 1350.20, 154
5, 10:14:00-000, 1119, 610, 509, 473, 1348.43, 408, 1349.19, 165
5, 10:15:00-000, 0, 0, 0, 27, 1345.00, 24, 1355.29, 128
5, 10:16:00-000, 1103, 568, 535, 412, 1348.27, 461, 1349.70, 163
5, 10:17:00-000, 881, 452, 429, 340, 1348.34, 349, 1348.93, 172
5, 10:18:00-000, 1047, 561, 486, 429, 1349.17, 370, 1349.61, 171
5, 10:19:00-000, 0, 0, 0, 0, 0.00, 21, 1355.71, 128
5, 10:20:00-000, 941, 494, 447, 328, 1348.54, 358, 1349.45, 199
5, 10:21:00-000, 1113, 585, 528, 447, 1349.02, 410, 1349.44, 171
5, 10:22:00-000, 1063, 551, 512, 413, 1348.87, 386, 1349.13, 190
5, 10:23:00-000, 0, 0, 0, 42, 1345.00, 33, 1355.00, 171
5, 10:24:00-000, 904, 429, 475, 364, 1349.08, 401, 1350.31, 144
5, 10:25:00-000, 1039, 581, 458, 391, 1349.47, 414, 1350.43, 109
5, 10:26:00-000, 975, 501, 474, 460, 1348.09, 390, 1348.83, 133
5, 10:27:00-000, 0, 0, 0, 45, 1344.64, 20, 1357.00, 105
5, 10:28:00-000, 1083, 578, 505, 468, 1348.36, 458, 1349.49, 117
5, 10:29:00-000, 1007, 501, 506, 359, 1349.17, 441, 1350.47, 120
5, 10:30:00-000, 1000, 494, 506, 365, 1348.53, 435, 1350.37, 107
5, 10:31:00-000, 0, 0, 0, 20, 1346.00, 15, 1356.00, 139
5, 10:32:00-000, 999, 563, 436, 408, 1349.36, 379, 1350.41, 166
5, 10:33:00-000, 1006, 526, 480, 350, 1349.76, 378, 1349.80, 147
5, 10:34:00-000, 1089, 577, 512, 437, 1348.38, 448, 1349.86, 159
5, 10:35:00-000, 1, 0, 1, 54, 1346.00, 19, 1356.58, 149
5, 10:36:00-000, 1027, 533, 494, 373, 1348.91, 379, 1349.34, 144
5, 10:37:00-000, 1063, 595, 468, 409, 1349.09, 349, 1349.01, 206
5, 10:38:00-000, 1092, 520, 572, 372, 1348.53, 476, 1349.80, 198
5, 10:39:00-000, 0, 0, 0, 5, 1347.00, 38, 1356.00, 193
5, 10:40:00-000, 1028, 509, 519, 442, 1348.06, 396, 1349.18, 172
5, 10:41:00-000, 1008, 496, 512, 410, 1348.35, 353, 1349.22, 158
5, 10:42:00-000, 1063, 550, 513, 406, 1348.68, 454, 1349.63, 144
5, 10:43:00-000, 6, 0, 6, 1, 1347.00, 39, 1356.10, 133
5, 10:44:00-000, 1036, 486, 550, 390, 1348.73, 435, 1349.34, 181
5, 10:45:00-000, 876, 426, 450, 304, 1349.78, 353, 1350.34, 177
5, 10:46:00-000, 1076, 539, 537, 454, 1348.38, 402, 1349.35, 126
5, 10:47:00-000, 0, 0, 0, 18, 1344.78, 16, 1355.00, 132
5, 10:48:00-000, 1146, 579, 567, 464, 1348.73, 434, 1349.30, 183
5, 10:49:00-000, 972, 511, 461, 402, 1349.04, 384, 1349.44, 156
5, 10:50:00-000, 985, 521, 464, 384, 1348.89, 376, 1349.29, 190
5, 10:51:00-000, 0, 0, 0, 13, 1346.15, 0, 0.00, 142
5, 10:52:00-000, 1028, 516, 512, 400, 1347.80, 424, 1349.05, 173
5, 10:53:00-000, 1025, 493, 532, 354, 1348.39, 332, 1348.80, 159
5, 10:54:00-000, 1058, 506, 552, 421, 1348.04, 448, 1349.19, 150
5, 10:55:00-000, 0, 0, 0, 49, 1345.16, 56, 1355.00, 176
5, 10:56:00-000, 1059, 538, 521, 387, 1348.72, 402, 1349.47, 161
5, 10:57:00-000, 936, 512, 424, 394, 1349.90, 365, 1350.55, 149
5, 10:58:00-000, 1006, 563, 443, 432, 1348.56, 381, 1349.67, 165
5, 10:59:00-000, 1, 1, 0, 22, 1345.36, 17, 1356.00, 115
5, 11:00:00-000, 978, 555, 423, 381, 1349.26, 336, 1350.06, 148
5, 11:01:00-000, 1038, 504, 534, 394, 1348.76, 412, 1349.01, 207
5, 11:02:00-000, 901, 435, 466, 320, 1348.68, 365, 1350.11, 124
5, 11:03:00-000, 0, 0, 0, 14, 1346.64, 34, 1354.44, 168
5, 11:04:00-000, 1052, 520, 532, 425, 1347.88, 433, 1349.30, 159
5, 11:05:00-000, 1053, 497, 556, 386, 1348.38, 426, 1349.24, 142
5, 11:06:00-000, 1068, 578, 490, 403, 1349.20, 458, 1350.51, 148
5, 11:07:00-000, 0, 0, 0, 32, 1346.65, 17, 1357.00, 150
5, 11:08:00-000, 1068, 564, 504, 423, 1349.13, 417, 1349.43, 149
5, 11:09:00-000, 1093, 566, 527, 394, 1349.38, 438, 1349.87, 161
5, 11:10:00-000, 1095, 539, 556, 448, 1348.50, 446, 1349.20, 168
5, 11:11:00-000, 2, 0, 2, 34, 1345.00, 15, 1355.06, 157
5, 11:12:00-000, 935, 480, 455, 405, 1348.34, 342, 1349.26, 150
5, 11:13:00-000, 1036, 570, 466, 446, 1348.91, 395, 1349.12, 158
5, 11:14:00-000, 1018, 544, 474, 423, 1348.98, 385, 1349.46, 143
5, 11:15:00-000, 1, 0, 1, 24, 1345.00, 1, 1346.00, 126
5, 11:16:00-000, 1046, 506, 540, 415, 1347.63, 441, 1349.32, 159
5, 11:17:00-000, 1065, 515, 550, 355, 1348.72, 407, 1349.19, 153
5, 11:18:00-000, 1008, 492, 516, 432, 1348.27, 390, 1349.31, 168
5, 11:19:00-000, 0, 0, 0, 4, 1344.75, 19, 1355.00, 155
5, 11:20:00-000, 1017, 574, 443, 438, 1349.84, 384, 1351.02, 165
5, 11:21:00-000, 967, 489, 478, 365, 1348.80, 412, 1349.25, 148
5, 11:22:00-000, 1085, 594, 491, 415, 1348.80, 388, 1348.97, 134
5, 11:23:00-000, 0, 0, 0, 7, 1347.00, 31, 1356.67, 136
5, 11:24:00-000, 1041, 504, 537, 423, 1348.25, 400, 1349.63, 187
5, 11:25:00-000, 1076, 485, 591, 373, 1348.48, 454, 1349.00, 176
5, 11:26:00-000, 1025, 570, 455, 429, 1349.65, 399, 1350.65, 154
5, 11:27:00-000, 1, 0, 1, 9, 1346.44, 23, 1356.34, 155
5, 11:28:00-000, 1145, 611, 534, 475, 1348.51, 489, 1350.17, 153
5, 11:29:00-000, 1033, 559, 474, 377, 1349.71, 395, 1349.97, 186
5, 11:30:00-000, 1017, 544, 473, 402, 1349.38, 346, 1350.05, 151
5, 11:31:00-000, 2, 2, 0, 38, 1345.20, 0, 0.00, 141
5, 11:32:00-000, 1017, 497, 520, 422, 1348.35, 411, 1349.00, 215
5, 11:33:00-000, 957, 466, 491, 359, 1348.69, 393, 1349.54, 146
5, 11:34:00-000, 1021, 532, 489, 384, 1348.66, 376, 1349.10, 141
5, 11:35:00-000, 0, 0, 0, 10, 1346.00, 0, 0.00, 139
5, 11:36:00-000, 963, 535, 428, 421, 1348.98, 373, 1350.09, 209
5, 11:37:00-000, 1108, 564, 544, 421, 1349.08, 443, 1349.77, 136
5, 11:38:00-000, 1033, 512, 521, 422, 1348.49, 409, 1349.52, 133
5, 11:39:00-000, 0, 0, 0, 0, 0.00, 1, 1356.00, 173
5, 11:40:00-000, 972, 552, 420, 387, 1349.08, 360, 1350.08, 201
5, 11:41:00-000, 1044, 557, 487, 396, 1348.71, 379, 1349.22, 170
5, 11:42:00-000, 1045, 500, 545, 418, 1348.71, 430, 1350.24, 122
5, 11:43:00-000, 3, 1, 2, 1, 1353.00, 15, 1355.53, 157
5, 11:44:00-000, 1104, 491, 613, 392, 1348.31, 453, 1349.51, 208
5, 11:45:00-000, 1038, 537, 501, 416, 1348.67, 392, 1349.31, 191
5, 11:46:00-000, 989, 494, 495, 381, 1348.40, 368, 1349.69, 153
5, 11:47:00-000, 0, 0, 0, 22, 1346.00, 8, 1355.50, 148
5, 11:48:00-000, 943, 483, 460, 334, 1349.21, 376, 1350.28, 212
5, 11:49:00-000, 966, 517, 449, 332, 1349.53, 373, 1349.97, 178
5, 11:50:00-000, 1079, 535, 544, 429, 1348.68, 406, 1349.39, 157
5, 11:51:00-000, 1, 0, 1, 7, 1346.00, 0, 0.00, 157
5, 11:52:00-000, 967, 496, 471, 449, 1348.30, 409, 1349.03, 182
5, 11:53:00-000, 994, 527, 467, 374, 1349.33, 386, 1349.79, 143
5, 11:54:00-000, 1152, 609, 543, 411, 1349.93, 490, 1350.60, 133
5, 11:55:00-000, 0, 0, 0, 6, 1346.33, 3, 1357.00, 148
5, 11:56:00-000, 1092, 616, 476, 465, 1349.34, 419, 1350.18, 185
5, 11:57:00-000, 987, 500, 487, 341, 1349.26, 393, 1349.88, 175
5, 11:58:00-000, 1007, 495, 512, 441, 1348.68, 422, 1349.22, 181
5, 11:59:00-000, 4, 0, 4, 70, 1343.72, 4, 1347.75, 129
5, 12:00:00-000, 1026, 500, 526, 428, 1347.55, 441, 1349.30, 118
5, 12:01:00-000, 945, 501, 444, 369, 1349.79, 364, 1350.41, 104
5, 12:02:00-000, 1110, 579, 531, 437, 1348.68, 431, 1349.52, 125
5, 12:03:00-000, 0, 0, 0, 13, 1347.00, 56, 1355.90, 100
5, 12:04:00-000, 1031, 540, 491, 407, 1348.77, 418, 1349.60, 164
5, 12:05:00-000, 980, 552, 428, 373, 1349.78, 324, 1349.75, 153
5, 12:06:00-000, 1029, 526, 503, 438, 1349.06, 444, 1349.45, 198
5, 12:07:00-000, 0, 0, 0, 20, 1345.65, 0, 0.00, 165
5, 12:08:00-000, 1067, 536, 531, 415, 1348.29, 453, 1349.70, 109
5, 12:09:00-000, 1031, 519, 512, 428, 1349.39, 409, 1350.08, 153
5, 12:10:00-000, 1037, 537, 500, 362, 1348.78, 369, 1349.23, 165
5, 12:11:00-000, 0, 0, 0, 29, 1347.00, 98, 1356.20, 113
5, 12:12:00-000, 985, 529, 456, 395, 1348.95, 411, 1350.15, 124
5, 12:13:00-000, 1038, 538, 500, 403, 1349.13, 424, 1349.88, 144
5, 12:14:00-000, 972, 535, 437, 479, 1348.93, 372, 1349.83, 170
5, 12:15:00-000, 0, 0, 0, 19, 1345.05, 3, 1356.00, 119
5, 12:16:00-000, 1045, 527, 518, 450, 1348.49, 414, 1349.46, 83
5, 12:17:00-000, 985, 462, 523, 375, 1348.64, 430, 1349.27, 141
5, 12:18:00-000, 988, 473, 515, 354, 1348.33, 384, 1349.25, 130
5, 12:19:00-000, 1, 0, 1, 0, 0.00, 58, 1354.99, 123
5, 12:20:00-000, 1085, 575, 510, 394, 1349.07, 329, 1348.17, 156
5, 12:21:00-000, 1022, 491, 531, 291, 1348.92, 325, 1348.12, 253
5, 12:22:00-000, 1018, 563, 455, 425, 1348.96, 378, 1349.24, 234
5, 12:23:00-000, 0, 0, 0, 0, 0.00, 0, 0.00, 253
5, 12:24:00-000, 1061, 552, 509, 404, 1349.22, 369, 1349.77, 208
5, 12:25:00-000, 1115, 567, 548, 400, 1349.71, 390, 1349.32, 221
5, 12:26:00-000, 1080, 590, 490, 395, 1349.47, 354, 1349.70, 235
5, 12:27:00-000, 0, 0, 0, 31, 1346.00, 0, 0.00, 240
5, 12:28:00-000, 1020, 516, 504, 389, 1349.12, 361, 1349.50, 236
5, 12:29:00-000, 886, 461, 425, 317, 1348.44, 307, 1348.30, 193
5, 12:30:00-000, 986, 487, 499, 377, 1348.58, 360, 1348.92, 186
5, 12:31:00-000, 0, 0, 0, 1, 1346.00, 28, 1353.92, 194
5, 12:32:00-000, 1000, 489, 511, 378, 1349.68, 403, 1349.17, 173
5, 12:33:00-000, 957, 508, 449, 363, 1349.17, 372, 1349.51, 178
5, 12:34:00-000, 1044, 534, 510, 444, 1348.66, 421, 1349.51, 181
5, 12:35:00-000, 0, 0, 0, 13, 1346.00, 0, 0.00, 143
5, 12:36:00-000, 1045, 561, 484, 427, 1348.86, 397, 1349.08, 142
5, 12:37:00-000, 1018, 549, 469, 399, 1349.37, 381, 1349.22, 168
5, 12:38:00-000, 1037, 540, 497, 406, 1349.35, 387, 1349.89, 158
5, 12:39:00-000, 0, 0, 0, 17, 1345.00, 0, 0.00, 173
5, 12:40:00-000, 984, 513, 471, 386, 1348.67, 394, 1349.25, 169
5, 12:41:00-000, 1067, 549, 518, 432, 1348.44, 407, 1349.03, 167
5, 12:42:00-000, 1044, 534, 510, 391, 1348.85, 439, 1349.34, 133
5, 12:43:00-000, 0, 0, 0, 10, 1345.70, 24, 1356.00, 152
5, 12:44:00-000, 1049, 517, 532, 430, 1348.47, 459, 1349.78, 170
5, 12:45:00-000, 974, 459, 515, 316, 1348.41, 415, 1349.13, 119
5, 12:46:00-000, 992, 519, 473, 392, 1348.39, 378, 1349.28, 155
5, 12:47:00-000, 0, 0, 0, 45, 1345.42, 10, 1356.00, 123
5, 12:48:00-000, 1005, 472, 533, 350, 1348.78, 388, 1349.91, 175
5, 12:49:00-000, 1091, 545, 546, 447, 1348.38, 472, 1349.01, 140
5, 12:50:00-000, 1070, 492, 578, 408, 1348.02, 431, 1348.43, 189
5, 12:51:00-000, 0, 0, 0, 0, 0.00, 10, 1352.60, 147
5, 12:52:00-000, 1013, 474, 539, 386, 1347.94, 422, 1349.11, 173
5, 12:53:00-000, 992, 527, 465, 399, 1348.78, 377, 1349.29, 141
5, 12:54:00-000, 1022, 532, 490, 406, 1348.32, 389, 1349.87, 133
5, 12:55:00-000, 0, 0, 0, 0, 0.00, 13, 1355.00, 139
5, 12:56:00-000, 1131, 567, 564, 445, 1348.30, 436, 1349.04, 182
5, 12:57:00-000, 1015, 536, 479, 378, 1349.07, 360, 1349.48, 224
5, 12:58:00-000, 1057, 548, 509, 467, 1348.57, 379, 1349.37, 171
5, 12:59:00-000, 7, 0, 7, 0, 0.00, 17, 1353.35, 171
5, 13:00:00-000, 975, 458, 517, 376, 1347.87, 361, 1349.16, 181
5, 13:01:00-000, 988, 518, 470, 437, 1348.73, 385, 1349.09, 165
5, 13:02:00-000, 1011, 522, 489, 391, 1349.02, 405, 1349.90, 181
5, 13:03:00-000, 0, 0, 0, 22, 1345.00, 15, 1355.00, 100
5, 13:04:00-000, 1008, 544, 464, 409, 1349.33, 399, 1350.81, 152
5, 13:05:00-000, 1002, 485, 517, 366, 1348.79, 397, 1349.26, 160
5, 13:06:00-000, 980, 526, 454, 476, 1347.88, 402, 1348.80, 116
5, 13:07:00-000, 0, 0, 0, 0, 0.00, 19, 1356.00, 116
5, 13:08:00-000, 1083, 622, 461, 442, 1349.49, 398, 1350.39, 141
5, 13:09:00-000, 1192, 602, 590, 427, 1348.46, 455, 1348.80, 159
5, 13:10:00-000, 1072, 502, 570, 427, 1348.67, 372, 1348.60, 179
5, 13:11:00-000, 0, 0, 0, 11, 1345.00, 49, 1354.48, 238
5, 13:12:00-000, 935, 445, 490, 365, 1347.97, 408, 1349.31, 191
5, 13:13:00-000, 1034, 539, 495, 429, 1348.89, 403, 1349.45, 89
5, 13:14:00-000, 1049, 497, 552, 373, 1349.22, 435, 1349.40, 117
5, 13:15:00-000, 6, 5, 1, 16, 1347.75, 46, 1355.06, 178
5, 13:16:00-000, 1001, 523, 478, 398, 1349.49, 430, 1350.52, 157
5, 13:17:00-000, 1005, 497, 508, 367, 1349.11, 402, 1349.81, 145
5, 13:18:00-000, 1089, 535, 554, 422, 1347.80, 397, 1348.54, 115
5, 13:19:00-000, 0, 0, 0, 21, 1344.33, 8, 1354.00, 174
5, 13:20:00-000, 950, 435, 515, 361, 1348.10, 390, 1349.30, 202
5, 13:21:00-000, 1040, 595, 445, 437, 1348.94, 375, 1349.65, 156
5, 13:22:00-000, 975, 472, 503, 367, 1348.81, 460, 1350.86, 152
5, 13:23:00-000, 0, 0, 0, 11, 1345.27, 26, 1357.00, 129
5, 13:24:00-000, 969, 524, 445, 452, 1348.93, 395, 1350.29, 98
5, 13:25:00-000, 1050, 548, 502, 386, 1348.83, 362, 1349.10, 134
5, 13:26:00-000, 1077, 539, 538, 413, 1348.53, 375, 1349.02, 127
5, 13:27:00-000, 0, 0, 0, 48, 1345.81, 16, 1355.06, 189
5, 13:28:00-000, 1086, 522, 564, 445, 1348.50, 460, 1349.68, 200
5, 13:29:00-000, 1052, 544, 508, 415, 1348.59, 363, 1349.17, 157
5, 13:30:00-000, 1085, 521, 564, 408, 1348.48, 458, 1349.56, 158
5, 13:31:00-000, 0, 0, 0, 34, 1345.17, 7, 1355.00, 165
5, 13:32:00-000, 1001, 552, 449, 420, 1348.57, 403, 1350.27, 151
5, 13:33:00-000, 1067, 563, 504, 413, 1349.01, 394, 1349.31, 156
5, 13:34:00-000, 929, 457, 472, 339, 1349.02, 399, 1349.93, 157
5, 13:35:00-000, 0, 0, 0, 4, 1346.00, 23, 1356.00, 154
5, 13:36:00-000, 1099, 580, 519, 466, 1348.34, 432, 1349.29, 142
5, 13:37:00-000, 983, 509, 474, 360, 1349.15, 389, 1349.72, 169
5, 13:38:00-000, 1084, 561, 523, 453, 1349.44, 421, 1349.83, 162
5, 13:39:00-000, 1, 0, 1, 5, 1347.00, 0, 0.00, 146
5, 13:40:00-000, 1058, 483, 575, 411, 1348.12, 459, 1349.11, 142
5, 13:41:00-000, 1020, 521, 499, 401, 1348.58, 387, 1348.96, 159
5, 13:42:00-000, 977, 494, 483, 430, 1348.11, 410, 1349.70, 158
5, 13:43:00-000, 0, 0, 0, 4, 1344.00, 13, 1356.00, 145
5, 13:44:00-000, 1094, 565, 529, 439, 1348.66, 463, 1350.03, 124
5, 13:45:00-000, 1057, 590, 467, 426, 1349.57, 369, 1350.01, 138
5, 13:46:00-000, 1059, 519, 540, 435, 1348.50, 403, 1349.08, 180
5, 13:47:00-000, 0, 0, 0, 47, 1344.57, 1, 1354.00, 141
5, 13:48:00-000, 962, 483, 479, 360, 1348.47, 412, 1349.87, 159
5, 13:49:00-000, 965, 500, 465, 356, 1348.67, 339, 1349.03, 141
5, 13:50:00-000, 1094, 552, 542, 475, 1347.66, 429, 1348.69, 148
5, 13:51:00-000, 5, 0, 5, 8, 1345.00, 41, 1353.75, 164
5, 13:52:00-000, 977, 496, 481, 372, 1349.22, 412, 1350.20, 118
5, 13:53:00-000, 1089, 560, 529, 437, 1349.03, 378, 1349.36, 175
5, 13:54:00-000, 1103, 541, 562, 420, 1348.85, 466, 1350.05, 140
5, 13:55:00-000, 2, 0, 2, 0, 0.00, 4, 1355.75, 185
5, 13:56:00-000, 1044, 509, 535, 396, 1348.25, 447, 1349.31, 180
5, 13:57:00-000, 1081, 586, 495, 406, 1348.62, 431, 1349.84, 180
5, 13:58:00-000, 962, 461, 501, 352, 1348.13, 451, 1349.75, 138
5, 13:59:00-000, 0, 0, 0, 19, 1345.00, 2, 1352.00, 163
5, 14:00:00-000, 1042, 473, 569, 366, 1348.43, 352, 1348.90, 142
5, 14:01:00-000, 988, 513, 475, 368, 1349.04, 356, 1349.48, 205
5, 14:02:00-000, 1023, 534, 489, 378, 1348.92, 423, 1349.73, 198
5, 14:03:00-000, 0, 0, 0, 28, 1346.21, 33, 1355.42, 170
5, 14:04:00-000, 1046, 547, 499, 420, 1349.33, 422, 1350.33, 177
5, 14:05:00-000, 1120, 528, 592, 398, 1348.63, 418, 1348.99, 128
5, 14:06:00-000, 1134, 575, 559, 464, 1348.23, 403, 1349.07, 193
5, 14:07:00-000, 1, 1, 0, 22, 1345.18, 13, 1353.77, 187
5, 14:08:00-000, 1068, 543, 525, 456, 1348.55, 402, 1348.99, 227
5, 14:09:00-000, 1006, 536, 470, 414, 1349.07, 373, 1349.36, 167
5, 14:10:00-000, 993, 433, 560, 357, 1347.61, 372, 1348.17, 144
5, 14:11:00-000, 1, 0, 1, 0, 0.00, 57, 1353.33, 146
5, 14:12:00-000, 948, 468, 480, 382, 1348.68, 363, 1349.67, 153
5, 14:13:00-000, 1002, 545, 457, 380, 1349.08, 386, 1350.02, 175
5, 14:14:00-000, 1021, 497, 524, 384, 1349.39, 427, 1349.97, 141
5, 14:15:00-000, 0, 0, 0, 51, 1345.51, 33, 1356.00, 104
5, 14:16:00-000, 1049, 528, 521, 421, 1348.83, 416, 1349.93, 170
5, 14:17:00-000, 1035, 520, 515, 424, 1349.04, 370, 1349.33, 151
5, 14:18:00-000, 1060, 508, 552, 450, 1347.97, 463, 1349.43, 136
5, 14:19:00-000, 0, 0, 0, 0, 0.00, 0, 0.00, 154
5, 14:20:00-000, 1029, 531, 498, 402, 1349.13, 377, 1349.61, 160
5, 14:21:00-000, 1023, 503, 520, 377, 1348.93, 404, 1349.66, 182
5, 14:22:00-000, 1056, 546, 510, 398, 1349.35, 384, 1350.00, 197
5, 14:23:00-000, 0, 0, 0, 26, 1345.77, 31, 1355.96, 138
5, 14:24:00-000, 962, 480, 482, 402, 1348.17, 379, 1348.78, 154
5, 14:25:00-000, 1024, 518, 506, 396, 1348.83, 375, 1349.28, 182
5, 14:26:00-000, 947, 469, 478, 349, 1348.42, 381, 1349.52, 126
5, 14:27:00-000, 0, 0, 0, 13, 1345.77, 53, 1355.39, 173
5, 14:28:00-000, 1021, 483, 538, 415, 1348.06, 441, 1349.28, 124
5, 14:29:00-000, 1023, 509, 514, 400, 1348.69, 387, 1349.50, 154
5, 14:30:00-000, 1020, 503, 517, 401, 1348.59, 397, 1349.51, 127
5, 14:31:00-000, 0, 0, 0, 0, 0.00, 18, 1355.00, 181
5, 14:32:00-000, 954, 487, 467, 388, 1348.19, 424, 1349.39, 143
5, 14:33:00-000, 1047, 524, 523, 381, 1348.32, 369, 1348.34, 153
5, 14:34:00-000, 1078, 558, 520, 433, 1348.94, 406, 1349.73, 110
5, 14:35:00-000, 2, 1, 1, 36, 1345.52, 30, 1354.96, 180
5, 14:36:00-000, 1017, 524, 493, 397, 1348.36, 377, 1348.83, 178
5, 14:37:00-000, 1060, 528, 532, 437, 1347.88, 410, 1348.40, 206
5, 14:38:00-000, 1074, 507, 567, 401, 1348.43, 433, 1349.20, 132
5, 14:39:00-000, 0, 0, 0, 40, 1344.00, 36, 1354.02, 112
5, 14:40:00-000, 1002, 516, 486, 405, 1349.11, 405, 1350.08, 179
5, 14:41:00-000, 983, 520, 463, 366, 1348.89, 323, 1349.53, 162
5, 14:42:00-000, 1002, 596, 406, 437, 1349.83, 349, 1350.67, 150
5, 14:43:00-000, 0, 0, 0, 39, 1346.07, 16, 1356.00, 159
5, 14:44:00-000, 943, 482, 461, 366, 1349.65, 418, 1350.67, 178
5, 14:45:00-000, 1061, 556, 505, 389, 1349.02, 405, 1349.88, 106
5, 14:46:00-000, 1072, 536, 536, 435, 1348.70, 455, 1350.46, 137
5, 14:47:00-000, 5, 5, 0, 9, 1347.67, 6, 1356.00, 167
5, 14:48:00-000, 1005, 490, 515, 350, 1348.29, 435, 1349.66, 174
5, 14:49:00-000, 1001, 481, 520, 427, 1347.92, 413, 1348.53, 160
5, 14:50:00-000, 1051, 594, 457, 428, 1349.58, 416, 1351.14, 123
5, 14:51:00-000, 0, 0, 0, 11, 1347.00, 25, 1357.00, 107
5, 14:52:00-000, 988, 473, 515, 388, 1349.12, 405, 1349.91, 170
5, 14:53:00-000, 1000, 557, 443, 406, 1349.23, 365, 1350.43, 163
5, 14:54:00-000, 1090, 512, 578, 419, 1348.61, 432, 1349.31, 137
5, 14:55:00-000, 1, 1, 0, 1, 1346.00, 0, 0.00, 156
5, 14:56:00-000, 1022, 575, 447, 451, 1349.14, 365, 1349.70, 201
5, 14:57:00-000, 1029, 509, 520, 379, 1348.84, 409, 1349.61, 156
5, 14:58:00-000, 1047, 539, 508, 464, 1348.59, 462, 1349.83, 160
5, 14:59:00-000, 0, 0, 0, 24, 1344.04, 0, 0.00, 132
5, 15:00:00-000, 1059, 515, 544, 455, 1347.78, 448, 1348.88, 110
5, 15:01:00-000, 1020, 528, 492, 407, 1348.99, 380, 1349.92, 119
5, 15:02:00-000, 1068, 540, 528, 352, 1349.10, 449, 1350.55, 140
5, 15:03:00-000, 3, 1, 2, 14, 1346.21, 31, 1355.74, 150
5, 15:04:00-000, 1036, 521, 515, 399, 1348.97, 419, 1350.11, 168
5, 15:05:00-000, 1067, 557, 510, 398, 1349.55, 443, 1350.19, 182
5, 15:06:00-000, 1041, 561, 480, 399, 1349.73, 343, 1350.29, 157
5, 15:07:00-000, 1, 1, 0, 70, 1345.51, 32, 1355.37, 170
5, 15:08:00-000, 1117, 617, 500, 454, 1348.81, 407, 1349.92, 165
5, 15:09:00-000, 972, 473, 499, 374, 1348.44, 334, 1348.52, 173
5, 15:10:00-000, 1044, 495, 549, 404, 1348.59, 477, 1349.62, 173
5, 15:11:00-000, 6, 1, 5, 1, 1353.00, 22, 1354.63, 152
5, 15:12:00-000, 1022, 541, 481, 425, 1349.23, 411, 1349.98, 157
5, 15:13:00-000, 1065, 543, 522, 361, 1348.49, 398, 1349.04, 134
5, 15:14:00-000, 994, 513, 481, 384, 1348.25, 385, 1349.26, 192
5, 15:15:00-000, 1, 1, 0, 8, 1346.00, 27, 1355.00, 192
5, 15:16:00-000, 1059, 553, 506, 408, 1349.64, 420, 1350.19, 150
5, 15:17:00-000, 1026, 495, 531, 361, 1348.60, 400, 1349.63, 182
5, 15:18:00-000, 1019, 536, 483, 379, 1348.91, 414, 1349.36, 182
5, 15:19:00-000, 4, 2, 2, 15, 1345.86, 2, 1351.00, 165
5, 15:20:00-000, 1071, 552, 519, 471, 1348.17, 437, 1349.08, 181
5, 15:21:00-000, 981, 478, 503, 345, 1348.49, 360, 1349.16, 157
5, 15:22:00-000, 1048, 550, 498, 414, 1348.68, 436, 1349.34, 147
5, 15:23:00-000, 1, 0, 1, 20, 1345.00, 41, 1356.24, 161
5, 15:24:00-000, 1089, 568, 521, 458, 1349.16, 427, 1350.09, 167
5, 15:25:00-000, 965, 464, 501, 355, 1348.93, 364, 1349.53, 137
5, 15:26:00-000, 1062, 546, 516, 422, 1348.68, 426, 1349.59, 160
5, 15:27:00-000, 6, 5, 1, 57, 1345.15, 1, 1350.00, 129
5, 15:28:00-000, 1094, 595, 499, 426, 1348.79, 391, 1349.63, 135
5, 15:29:00-000, 1097, 539, 558, 399, 1348.26, 392, 1349.02, 202
5, 15:30:00-000, 1111, 605, 506, 471, 1349.76, 432, 1350.19, 177
5, 15:31:00-000, 0, 0, 0, 29, 1347.00, 2, 1356.00, 175
5, 15:32:00-000, 977, 506, 471, 398, 1349.37, 389, 1350.36, 195
5, 15:33:00-000, 898, 452, 446, 334, 1348.75, 358, 1349.34, 161
5, 15:34:00-000, 981, 504, 477, 361, 1348.92, 367, 1349.96, 161
5, 15:35:00-000, 3, 3, 0, 17, 1345.53, 13, 1355.23, 128
5, 15:36:00-000, 1050, 538, 512, 413, 1349.03, 386, 1349.51, 187
5, 15:37:00-000, 1033, 592, 441, 384, 1350.11, 377, 1350.32, 176
5, 15:38:00-000, 1036, 542, 494, 415, 1349.21, 427, 1350.39, 187
5, 15:39:00-000, 3, 0, 3, 20, 1346.00, 36, 1356.52, 168
5, 15:40:00-000, 993, 444, 549, 318, 1348.67, 354, 1348.57, 148
5, 15:41:00-000, 1076, 600, 476, 414, 1349.32, 319, 1349.10, 217
5, 15:42:00-000, 996, 529, 467, 356, 1348.93, 357, 1348.91, 267
5, 15:43:00-000, 0, 0, 0, 0, 0.00, 0, 0.00, 200
5, 15:44:00-000, 1074, 573, 501, 423, 1349.71, 385, 1349.94, 211
5, 15:45:00-000, 962, 448, 514, 312, 1349.00, 388, 1348.84, 251
5, 15:46:00-000, 1091, 547, 544, 394, 1348.85, 399, 1348.94, 193
5, 15:47:00-000, 6, 5, 1, 5, 1348.40, 2, 1348.00, 169
5, 15:48:00-000, 936, 481, 455, 352, 1348.69, 358, 1349.11, 260
5, 15:49:00-000, 1021, 468, 553, 361, 1349.30, 375, 1349.28, 161
5, 15:50:00-000, 1041, 576, 465, 415, 1349.53, 361, 1349.47, 191
5, 15:51:00-000, 0, 0, 0, 0, 0.00, 19, 1355.00, 226
5, 15:52:00-000, 989, 450, 539, 383, 1348.23, 418, 1348.85, 156
5, 15:53:00-000, 948, 475, 473, 387, 1348.96, 359, 1349.40, 143
5, 15:54:00-000, 1076, 603, 473, 426, 1349.70, 341, 1349.89, 162
5, 15:55:00-000, 2, 1, 1, 1, 1350.00, 6, 1352.17, 173
5, 15:56:00-000, 972, 531, 441, 372, 1349.34, 359, 1349.34, 220
5, 15:57:00-000, 1004, 535, 469, 364, 1348.86, 343, 1349.49, 183
5, 15:58:00-000, 1067, 564, 503, 461, 1349.12, 407, 1349.94, 178
5, 15:59:00-000, 5, 5, 0, 22, 1345.00, 0, 0.00, 198
5, 16:00:00-000, 1180, 574, 606, 468, 1348.36, 469, 1349.23, 168
5, 16:01:00-000, 1011, 513, 498, 400, 1348.88, 399, 1349.50, 195
5, 16:02:00-000, 1039, 528, 511, 397, 1348.84, 388, 1349.22, 198
5, 16:03:00-000, 1, 1, 0, 13, 1347.15, 3, 1353.00, 133
5, 16:04:00-000, 892, 423, 469, 361, 1348.70, 383, 1350.08, 161
5, 16:05:00-000, 998, 481, 517, 347, 1349.52, 371, 1349.71, 137
5, 16:06:00-000, 1177, 590, 587, 458, 1349.18, 492, 1349.74, 167
5, 16:07:00-000, 1, 1, 0, 30, 1346.20, 8, 1355.37, 179
5, 16:08:00-000, 1008, 484, 524, 399, 1348.41, 431, 1349.83, 139
5, 16:09:00-000, 981, 543, 438, 415, 1349.55, 368, 1349.95, 152
5, 16:10:00-000, 987, 465, 522, 400, 1348.18, 387, 1349.47, 156
5, 16:11:00-000, 0, 0, 0, 0, 0.00, 26, 1355.34, 124
5, 16:12:00-000, 1219, 675, 544, 469, 1348.99, 462, 1349.45, 136
5, 16:13:00-000, 1102, 539, 563, 389, 1348.91, 397, 1349.28, 164
5, 16:14:00-000, 1141, 575, 566, 480, 1348.80, 416, 1349.71, 227
5, 16:15:00-000, 4, 3, 1, 28, 1345.32, 17, 1354.70, 186
5, 16:16:00-000, 1087, 522, 565, 421, 1349.53, 450, 1350.42, 181
5, 16:17:00-000, 852, 459, 393, 361, 1348.86, 311, 1349.42, 213
5, 16:18:00-000, 1097, 592, 505, 459, 1349.03, 422, 1350.11, 169
5, 16:19:00-000, 1, 0, 1, 25, 1345.24, 42, 1356.49, 86
5, 16:20:00-000, 1044, 547, 497, 459, 1348.43, 395, 1349.27, 119
5, 16:21:00-000, 1014, 482, 532, 373, 1348.16, 398, 1348.64, 190
5, 16:22:00-000, 1013, 538, 475, 387, 1349.69, 408, 1350.58, 116
5, 16:23:00-000, 0, 0, 0, 19, 1346.00, 24, 1356.00, 154
5, 16:24:00-000, 1059, 553, 506, 407, 1349.41, 403, 1350.07, 142
5, 16:25:00-000, 1061, 539, 522, 438, 1349.45, 454, 1350.40, 177
5, 16:26:00-000, 994, 448, 546, 361, 1348.47, 405, 1349.14, 174
5, 16:27:00-000, 2, 1, 1, 2, 1344.00, 1, 1351.00, 132
5, 16:28:00-000, 1030, 509, 521, 466, 1348.10, 413, 1349.53, 185
5, 16:29:00-000, 984, 513, 471, 363, 1348.75, 348, 1349.19, 126
6, 12:20:00-000, 6953, 3429, 3524, 1545, 1347.87, 1630, 1348.52, 0
6, 12:21:00-000, 0, 0, 0, 77, 1347.00, 46, 1353.00, 0
6, 12:22:00-000, 0, 0, 0, 80, 1346.47, 96, 1353.97, 0
6, 12:23:00-000, 0, 0, 0, 49, 1346.00, 71, 1354.00, 0
6, 12:24:00-000, 0, 0, 0, 91, 1346.00, 77, 1354.00, 0
6, 12:25:00-000, 0, 0, 0, 12, 1346.00, 96, 1355.00, 0
6, 12:26:00-000, 0, 0, 0, 39, 1346.00, 20, 1355.00, 0
6, 12:27:00-000, 0, 0, 0, 16, 1346.00, 27, 1355.00, 0
6, 12:28:00-000, 0, 0, 0, 0, 0.00, 3, 1355.00, 0
6, 12:31:00-000, 0, 0, 0, 4, 1345.00, 39, 1355.00, 0
6, 12:32:00-000, 0, 0, 0, 36, 1345.00, 45, 1355.00, 0
6, 12:33:00-000, 0, 0, 0, 0, 0.00, 40, 1356.00, 0
6, 12:34:00-000, 0, 0, 0, 0, 0.00, 22, 1356.00, 0
6, 12:35:00-000, 0, 0, 0, 9, 1345.00, 0, 0.00, 0
6, 12:36:00-000, 0, 0, 0, 82, 1345.00, 93, 1356.00, 0
6, 12:37:00-000, 0, 0, 0, 34, 1345.00, 40, 1356.00, 0
6, 12:38:00-000, 0, 0, 0, 45, 1345.00, 5, 1356.00, 0
6, 12:39:00-000, 0, 0, 0, 0, 0.00, 5, 1356.00, 0
6, 12:40:00-000, 0, 0, 0, 0, 0.00, 13, 1356.00, 116
6, 12:41:00-000, 0, 0, 0, 0, 0.00, 1, 1356.00, 129
6, 12:42:00-000, 0, 0, 0, 0, 0.00, 42, 1356.00, 126
6, 12:43:00-000, 0, 0, 0, 0, 0.00, 0, 0.00, 129
6, 12:44:00-000, 0, 0, 0, 0, 0.00, 0, 0.00, 138
6, 12:45:00-000, 0, 0, 0, 0, 0.00, 0, 0.00, 118
6, 12:46:00-000, 0, 0, 0, 0, 0.00, 0, 0.00, 125
6, 12:47:00-000, 0, 0, 0, 3, 1344.00, 0, 0.00, 125
6, 12:48:00-000, 0, 0, 0, 0, 0.00, 0, 0.00, 136
6, 12:49:00-000, 0, 0, 0, 0, 0.00, 0, 0.00, 120
6, 12:50:00-000, 0, 0, 0, 84, 1344.00, 0, 0.00, 107
6, 12:51:00-000, 0, 0, 0, 21, 1344.00, 0, 0.00, 108
6, 12:52:00-000, 0, 0, 0, 14, 1343.71, 0, 0.00, 122
6, 12:53:00-000, 0, 0, 0, 0, 0.00, 0, 0.00, 110
6, 12:54:00-000, 0, 0, 0, 0, 0.00, 0, 0.00, 85
6, 12:55:00-000, 0, 0, 0, 0, 0.00, 0, 0.00, 106
6, 12:56:00-000, 0, 0, 0, 0, 0.00, 0, 0.00, 85
6, 12:57:00-000, 0, 0, 0, 0, 0.00, 0, 0.00, 90
6, 12:58:00-000, 0, 0, 0, 0, 0.00, 0, 0.00, 114
6, 12:59:00-000, 0, 0, 0, 0, 0.00, 0, 0.00, 111
6, 13:00:00-000, 0, 0, 0, 0, 0.00, 0, 0.00, 1
6, 15:40:00-000, 6944, 3408, 3536, 1578, 1347.63, 1560, 1348.04, 0
6, 15:41:00-000, 0, 0, 0, 0, 0.00, 139, 1353.00, 0
6, 15:42:00-000, 0, 0, 0, 72, 1346.00, 114, 1353.81, 0
6, 15:43:00-000, 0, 0, 0, 0, 0.00, 90, 1354.00, 0
6, 15:44:00-000, 0, 0, 0, 0, 0.00, 114, 1354.39, 0
6, 15:45:00-000, 0, 0, 0, 112, 1346.00, 0, 0.00, 0
6, 15:46:00-000, 0, 0, 0, 115, 1345.47, 1, 1355.00, 0
6, 15:47:00-000, 0, 0, 0, 81, 1345.00, 0, 0.00, 0
6, 15:48:00-000, 0, 0, 0, 70, 1345.00, 36, 1355.00, 0
6, 15:49:00-000, 0, 0, 0, 21, 1345.00, 53, 1355.00, 0
6, 15:50:00-000, 0, 0, 0, 0, 0.00, 86, 1355.00, 0
6, 15:51:00-000, 0, 0, 0, 0, 0.00, 7, 1355.00, 0
6, 15:52:00-000, 0, 0, 0, 20, 1345.00, 0, 0.00, 0
6, 15:54:00-000, 0, 0, 0, 0, 0.00, 54, 1356.00, 0
6, 15:55:00-000, 0, 0, 0, 0, 0.00, 11, 1356.00, 0
6, 15:56:00-000, 0, 0, 0, 0, 0.00, 5, 1356.00, 0
6, 15:58:00-000, 0, 0, 0, 0, 0.00, 84, 1356.00, 0
6, 15:59:00-000, 0, 0, 0, 0, 0.00, 16, 1356.00, 0
6, 16:00:00-000, 4, 1, 3, 0, 0.00, 3, 1351.67, 124
6, 16:01:00-000, 0, 0, 0, 0, 0.00, 0, 0.00, 124
6, 16:02:00-000, 0, 0, 0, 26, 1344.00, 6, 1356.00, 103
6, 16:03:00-000, 0, 0, 0, 0, 0.00, 26, 1356.00, 105
6, 16:04:00-000, 0, 0, 0, 0, 0.00, 21, 1356.00, 143
6, 16:05:00-000, 0, 0, 0, 0, 0.00, 0, 0.00, 115
6, 16:06:00-000, 0, 0, 0, 0, 0.00, 0, 0.00, 129
6, 16:07:00-000, 0, 0, 0, 0, 0.00, 0, 0.00, 131
6, 16:08:00-000, 1, 0, 1, 0, 0.00, 0, 0.00, 103
6, 16:09:00-000, 2, 2, 0, 1, 1351.00, 0, 0.00, 101
6, 16:10:00-000, 0, 0, 0, 1, 1345.00, 12, 1357.00, 114
6, 16:11:00-000, 0, 0, 0, 40, 1344.00, 0, 0.00, 116
6, 16:12:00-000, 0, 0, 0, 2, 1344.00, 0, 0.00, 133
6, 16:13:00-000, 0, 0, 0, 0, 0.00, 0, 0.00, 102
6, 16:14:00-000, 0, 0, 0, 0, 0.00, 0, 0.00, 112
6, 16:15:00-000, 0, 0, 0, 0, 0.00, 0, 0.00, 137
6, 16:16:00-000, 0, 0, 0, 0, 0.00, 0, 0.00, 132
6, 16:17:00-000, 0, 0, 0, 0, 0.00, 0, 0.00, 114
6, 16:18:00-000, 0, 0, 0, 0, 0.00, 0, 0.00, 123
6, 16:19:00-000, 0, 0, 0, 0, 0.00, 3, 1357.00, 106
6, 16:20:00-000, 10, 6, 4, 5, 1347.20, 4, 1353.75, 2
6, 16:21:00-000, 0, 0, 0, 0, 0.00, 0, 0.00, 1
7, 09:07:00-000, 5062, 1170, 3892, 0, 0.00, 0, 0.00, 5062
7, 09:08:00-000, 580, 560, 20, 0, 0.00, 0, 0.00, 580
7, 09:17:00-000, 876, 871, 5, 1, 1353.00, 1, 1351.00, 874
7, 09:24:00-000, 10287, 4937, 5350, 0, 0.00, 0, 0.00, 10287
7, 09:26:00-000, 363, 273, 90, 90, 1354.01, 90, 1352.00, 183
7, 09:29:00-000, 1261, 11, 1250, 0, 0.00, 0, 0.00, 1261
7, 09:42:00-000, 7287, 2993, 4294, 39, 1352.77, 39, 1351.20, 7209
7, 09:43:00-000, 11264, 5722, 5542, 5, 1349.40, 4, 1347.25, 11255
7, 09:44:00-000, 1, 0, 1, 0, 0.00, 1, 1354.00, 0
7, 09:46:00-000, 6111, 4606, 1505, 0, 0.00, 0, 0.00, 6111
7, 09:47:00-000, 6173, 2332, 3841, 4, 1352.00, 4, 1352.00, 6165
7, 09:50:00-000, 1065, 1060, 5, 0, 0.00, 0, 0.00, 1065
7, 09:51:00-000, 14544, 8966, 5578, 0, 0.00, 0, 0.00, 14522
7, 09:52:00-000, 2134, 2078, 56, 56, 1350.57, 56, 1350.21, 2044
7, 09:55:00-000, 2423, 1298, 1125, 0, 0.00, 0, 0.00, 2423
7, 09:56:00-000, 19060, 11634, 7426, 14, 1349.21, 14, 1350.07, 19032
7, 09:59:00-000, 2981, 2260, 721, 0, 0.00, 0, 0.00, 2981
7, 10:02:00-000, 2651, 1150, 1501, 2, 1350.00, 11, 1350.73, 2638
7, 10:03:00-000, 9, 9, 0, 9, 1356.00, 0, 0.00, 0
7, 10:04:00-000, 1184, 826, 358, 0, 0.00, 0, 0.00, 1184
7, 10:06:00-000, 3181, 1157, 2024, 0, 0.00, 0, 0.00, 3085
7, 10:07:00-000, 17387, 8998, 8389, 7, 1350.57, 7, 1350.00, 17469
7, 10:08:00-000, 9718, 5696, 4022, 50, 1347.49, 50, 1349.23, 9618
7, 10:09:00-000, 4830, 2157, 2673, 15, 1351.00, 15, 1348.93, 4800
7, 10:10:00-000, 10627, 6327, 4300, 8, 1349.87, 8, 1351.00, 10611
7, 10:14:00-000, 16046, 6909, 9137, 7, 1351.71, 12, 1351.42, 16027
7, 10:15:00-000, 9898, 3143, 6755, 13, 1353.92, 8, 1351.00, 9867
7, 10:16:00-000, 0, 0, 0, 0, 0.00, 0, 0.00, 10
7, 10:17:00-000, 2698, 2690, 8, 0, 0.00, 0, 0.00, 2698
7, 10:18:00-000, 10197, 7648, 2549, 45, 1353.51, 54, 1352.17, 10098
7, 10:19:00-000, 9, 9, 0, 9, 1355.00, 0, 0.00, 0
7, 10:20:00-000, 10196, 5350, 4846, 0, 0.00, 0, 0.00, 10196
7, 10:21:00-000, 10471, 2793, 7678, 4, 1350.50, 4, 1350.50, 10463
7, 10:22:00-000, 20700, 7797, 12903, 0, 0.00, 0, 0.00, 20700
7, 10:23:00-000, 9190, 4686, 4504, 0, 0.00, 0, 0.00, 9180
7, 10:24:00-000, 0, 0, 0, 0, 0.00, 0, 0.00, 10
7, 10:28:00-000, 2687, 1705, 982, 6, 1350.00, 6, 1351.50, 2675
7, 10:30:00-000, 704, 2, 702, 2, 1345.00, 1, 1349.00, 701
7, 10:31:00-000, 4856, 1123, 3733, 0, 0.00, 1, 1351.00, 4855
7, 10:36:00-000, 2848, 1005, 1843, 0, 0.00, 0, 0.00, 2848
7, 10:37:00-000, 5229, 1979, 3250, 18, 1352.11, 16, 1351.44, 5195
7, 10:38:00-000, 1005, 980, 25, 12, 1348.00, 14, 1351.93, 979
7, 10:39:00-000, 1181, 1180, 1, 0, 0.00, 0, 0.00, 1181
7, 10:40:00-000, 4963, 2101, 2862, 5, 1350.60, 5, 1350.40, 4953
7, 10:41:00-000, 9447, 4031, 5416, 0, 0.00, 0, 0.00, 9447
7, 10:42:00-000, 4029, 1309, 2720, 9, 1351.67, 9, 1351.22, 4011
7, 10:44:00-000, 7760, 3542, 4218, 1, 1347.00, 1, 1349.00, 7758
7, 10:45:00-000, 8363, 3212, 5151, 5, 1351.00, 5, 1350.20, 8353
7, 10:46:00-000, 12422, 5165, 7257, 12, 1350.17, 12, 1349.75, 12398
7, 10:47:00-000, 21596, 10488, 11108, 0, 0.00, 0, 0.00, 21596
7, 10:48:00-000, 3686, 3600, 86, 61, 1347.76, 61, 1348.50, 3564
7, 10:49:00-000, 23336, 12783, 10553, 6, 1349.67, 6, 1351.00, 23324
7, 10:50:00-000, 10251, 2631, 7620, 17, 1348.18, 17, 1350.06, 8975
7, 10:51:00-000, 2598, 1720, 878, 1, 1350.00, 1, 1349.00, 3838
7, 10:52:00-000, 7306, 1321, 5985, 3, 1348.33, 3, 1350.00, 7300
7, 10:53:00-000, 13489, 3837, 9652, 0, 0.00, 0, 0.00, 13489
7, 10:54:00-000, 19359, 14929, 4430, 16, 1350.69, 16, 1348.94, 19327
7, 10:55:00-000, 10412, 7100, 3312, 0, 0.00, 0, 0.00, 9005
7, 10:56:00-000, 5308, 2199, 3109, 58, 1349.58, 58, 1349.22, 6599
7, 10:57:00-000, 3145, 64, 3081, 1, 1349.00, 1, 1351.00, 3143
7, 10:58:00-000, 13471, 6569, 6902, 36, 1354.53, 36, 1351.77, 13399
7, 10:59:00-000, 1937, 17, 1920, 0, 0.00, 0, 0.00, 1937
7, 11:00:00-000, 610, 10, 600, 8, 1348.50, 8, 1352.00, 594
7, 11:02:00-000, 17554, 8625, 8929, 21, 1351.66, 25, 1352.04, 17508
7, 11:03:00-000, 8316, 4385, 3931, 29, 1352.38, 25, 1351.12, 8262
7, 11:04:00-000, 11263, 8031, 3232, 2, 1353.00, 2, 1350.50, 10705
7, 11:05:00-000, 13600, 8190, 5410, 0, 0.00, 0, 0.00, 14072
7, 11:06:00-000, 7498, 3212, 4286, 15, 1350.80, 15, 1351.00, 7550
7, 11:07:00-000, 11071, 5157, 5914, 1, 1350.00, 1, 1346.00, 10081
7, 11:08:00-000, 5564, 2539, 3025, 35, 1349.86, 35, 1351.43, 6482
7, 11:09:00-000, 2144, 924, 1220, 11, 1354.82, 11, 1352.00, 2122
7, 11:10:00-000, 8886, 5538, 3348, 16, 1345.56, 15, 1347.47, 8855
7, 11:11:00-000, 16687, 2898, 13789, 0, 0.00, 1, 1348.00, 16686
7, 11:12:00-000, 4113, 3236, 877, 3, 1345.00, 3, 1348.33, 4107
7, 11:13:00-000, 12205, 10285, 1920, 21, 1348.76, 21, 1351.28, 12163
7, 11:14:00-000, 4931, 3260, 1671, 8, 1345.50, 8, 1346.38, 4915
7, 11:16:00-000, 829, 771, 58, 34, 1347.18, 34, 1347.26, 761
7, 11:17:00-000, 8852, 2752, 6100, 9, 1349.00, 9, 1347.44, 8834
7, 11:18:00-000, 5309, 694, 4615, 2, 1349.00, 2, 1348.00, 5305
7, 11:20:00-000, 6535, 2572, 3963, 5, 1351.60, 5, 1352.00, 6525
7, 11:22:00-000, 6735, 5956, 779, 0, 0.00, 0, 0.00, 6735
7, 11:24:00-000, 10651, 6168, 4483, 4, 1354.50, 6, 1351.83, 10641
7, 11:25:00-000, 4408, 1893, 2515, 65, 1347.31, 51, 1348.35, 4292
7, 11:26:00-000, 3438, 1591, 1847, 27, 1346.66, 26, 1351.57, 3385
7, 11:27:00-000, 1884, 20, 1864, 0, 0.00, 13, 1348.38, 1871
7, 11:30:00-000, 817, 17, 800, 0, 0.00, 0, 0.00, 817
7, 11:31:00-000, 1553, 73, 1480, 0, 0.00, 0, 0.00, 1553
7, 11:32:00-000, 16594, 10966, 5628, 26, 1348.77, 26, 1345.96, 16542
7, 11:33:00-000, 14077, 5641, 8436, 16, 1350.69, 16, 1351.00, 14045
7, 11:34:00-000, 4036, 839, 3197, 17, 1353.41, 17, 1351.00, 4002
7, 11:35:00-000, 14080, 7850, 6230, 4, 1348.00, 4, 1350.00, 14063
7, 11:36:00-000, 0, 0, 0, 0, 0.00, 0, 0.00, 9
7, 11:37:00-000, 2073, 1342, 731, 2, 1349.00, 2, 1350.00, 2069
7, 11:38:00-000, 3600, 1710, 1890, 13, 1351.46, 13, 1352.00, 3574
7, 11:39:00-000, 17027, 9515, 7512, 7, 1348.71, 7, 1351.00, 16227
7, 11:40:00-000, 1973, 1318, 655, 5, 1345.00, 5, 1351.20, 2749
7, 11:41:00-000, 9354, 4327, 5027, 7, 1351.86, 7, 1352.71, 9340
7, 11:44:00-000, 15937, 14361, 1576, 19, 1348.47, 19, 1351.47, 15899
7, 11:45:00-000, 13897, 6503, 7394, 15, 1350.07, 15, 1348.33, 13867
7, 11:46:00-000, 5090, 3352, 1738, 22, 1351.95, 22, 1351.68, 5046
7, 11:47:00-000, 8559, 4351, 4208, 6, 1349.67, 6, 1353.00, 8547
7, 11:48:00-000, 3731, 1433, 2298, 39, 1349.56, 39, 1346.90, 3653
7, 11:49:00-000, 2745, 1611, 1134, 1, 1353.00, 1, 1352.00, 2743
7, 11:50:00-000, 4525, 1670, 2855, 34, 1346.85, 34, 1348.32, 4457
7, 11:51:00-000, 15656, 6848, 8808, 31, 1350.51, 31, 1351.71, 15594
7, 11:52:00-000, 5723, 2827, 2896, 1, 1351.00, 1, 1350.00, 5721
7, 11:53:00-000, 8334, 5470, 2864, 25, 1350.24, 25, 1351.88, 8284
7, 11:54:00-000, 814, 812, 2, 2, 1351.00, 2, 1352.00, 810
7, 11:59:00-000, 10100, 8074, 2026, 8, 1350.25, 8, 1348.12, 10084
7, 12:00:00-000, 887, 836, 51, 0, 0.00, 0, 0.00, 887
7, 12:01:00-000, 9497, 5226, 4271, 18, 1354.05, 18, 1349.94, 9461
7, 12:02:00-000, 9519, 3047, 6472, 0, 0.00, 0, 0.00, 9519
7, 12:04:00-000, 940, 10, 930, 3, 1352.00, 3, 1352.00, 934
7, 12:06:00-000, 8680, 3705, 4975, 20, 1351.75, 29, 1351.89, 8631
7, 12:07:00-000, 2719, 2685, 34, 9, 1355.33, 0, 0.00, 2710
7, 12:08:00-000, 9973, 4660, 5313, 0, 0.00, 0, 0.00, 9973
7, 12:09:00-000, 2849, 1708, 1141, 4, 1352.00, 4, 1351.25, 2841
7, 12:10:00-000, 17220, 9426, 7794, 25, 1350.04, 64, 1351.85, 16228
7, 12:11:00-000, 46, 46, 0, 45, 1355.02, 6, 1351.00, 898
7, 12:14:00-000, 3216, 3175, 41, 0, 0.00, 0, 0.00, 1710
7, 12:15:00-000, 17622, 10403, 7219, 18, 1347.78, 18, 1351.44, 19092
7, 12:16:00-000, 6127, 5043, 1084, 22, 1349.27, 22, 1350.77, 6083
7, 12:17:00-000, 9574, 3189, 6385, 0, 0.00, 0, 0.00, 9574
7, 12:18:00-000, 7558, 6363, 1195, 5, 1349.00, 5, 1347.60, 7548
7, 12:19:00-000, 5300, 2568, 2732, 2, 1350.00, 2, 1350.00, 5296
7, 12:20:00-000, 1400, 364, 1036, 1, 1349.00, 1, 1351.00, 1398
7, 12:21:00-000, 3512, 2540, 972, 7, 1350.29, 7, 1350.86, 3498
7, 12:22:00-000, 903, 890, 13, 0, 0.00, 0, 0.00, 903
7, 12:24:00-000, 455, 450, 5, 0, 0.00, 0, 0.00, 455
7, 12:26:00-000, 1067, 1055, 12, 5, 1353.00, 5, 1352.00, 1057
7, 12:28:00-000, 1336, 16, 1320, 15, 1349.67, 15, 1352.00, 1306
7, 12:30:00-000, 834, 831, 3, 1, 1352.00, 1, 1351.00, 832
7, 12:31:00-000, 2939, 2065, 874, 0, 0.00, 0, 0.00, 2939
7, 12:35:00-000, 12276, 7116, 5160, 1, 1352.00, 1, 1351.00, 12274
7, 12:36:00-000, 840, 820, 20, 3, 1349.00, 3, 1350.00, 834
7, 12:41:00-000, 9794, 6208, 3586, 0, 0.00, 0, 0.00, 9794
7, 12:42:00-000, 8283, 3491, 4792, 14, 1348.29, 14, 1347.43, 8255
7, 12:44:00-000, 2460, 2317, 143, 2, 1347.00, 2, 1346.00, 2456
7, 12:45:00-000, 1574, 108, 1466, 0, 0.00, 0, 0.00, 1574
7, 12:46:00-000, 4905, 4174, 731, 0, 0.00, 0, 0.00, 4905
7, 12:48:00-000, 16939, 10220, 6719, 8, 1348.00, 8, 1349.50, 16923
7, 12:49:00-000, 1135, 1122, 13, 2, 1353.00, 2, 1352.00, 1131
7, 12:51:00-000, 6109, 841, 5268, 7, 1349.00, 7, 1344.00, 6095
7, 12:52:00-000, 3109, 1474, 1635, 4, 1351.00, 4, 1352.00, 3101
7, 12:53:00-000, 4339, 1234, 3105, 53, 1349.47, 46, 1351.21, 4240
7, 12:54:00-000, 10, 0, 10, 0, 0.00, 7, 1348.29, 3
7, 12:55:00-000, 8454, 2815, 5639, 0, 0.00, 0, 0.00, 8454
7, 12:56:00-000, 2477, 24, 2453, 24, 1347.25, 24, 1346.46, 2429
7, 12:57:00-000, 150, 7, 143, 2, 1348.00, 2, 1347.00, 146
7, 12:58:00-000, 2663, 1126, 1537, 4, 1351.00, 4, 1349.75, 2655
7, 12:59:00-000, 2960, 18, 2942, 10, 1348.00, 10, 1350.80, 2940
7, 13:00:00-000, 3040, 820, 2220, 14, 1350.14, 14, 1349.50, 3012
7, 13:01:00-000, 15496, 6236, 9260, 6, 1351.00, 6, 1351.00, 15479
7, 13:02:00-000, 2888, 1969, 919, 2, 1351.00, 2, 1352.00, 2889
7, 13:03:00-000, 7718, 4608, 3110, 5, 1347.00, 5, 1351.00, 7708
7, 13:04:00-000, 11518, 4102, 7416, 25, 1349.76, 25, 1352.00, 11468
7, 13:05:00-000, 3865, 2683, 1182, 1, 1353.00, 1, 1352.00, 3863
7, 13:06:00-000, 11315, 7497, 3818, 1, 1354.00, 1, 1350.00, 11313
7, 13:07:00-000, 8686, 4650, 4036, 4, 1352.00, 4, 1352.00, 8678
7, 13:09:00-000, 1071, 1070, 1, 0, 0.00, 0, 0.00, 0
7, 13:10:00-000, 11583, 5507, 6076, 26, 1347.34, 26, 1348.88, 12602
7, 13:12:00-000, 1986, 1963, 23, 19, 1349.79, 19, 1351.21, 1948
7, 13:13:00-000, 2579, 2540, 39, 0, 0.00, 0, 0.00, 2579
7, 13:14:00-000, 14074, 8919, 5155, 39, 1349.87, 39, 1351.53, 13996
7, 13:15:00-000, 1269, 9, 1260, 0, 0.00, 0, 0.00, 1269
7, 13:16:00-000, 1548, 28, 1520, 0, 0.00, 0, 0.00, 1548
7, 13:17:00-000, 10540, 3456, 7084, 0, 0.00, 0, 0.00, 10540
7, 13:18:00-000, 8645, 5491, 3154, 21, 1348.14, 21, 1348.24, 8603
7, 13:19:00-000, 14528, 3634, 10894, 15, 1350.66, 15, 1349.93, 14495
7, 13:20:00-000, 10563, 7369, 3194, 0, 0.00, 0, 0.00, 10566
7, 13:21:00-000, 745, 5, 740, 0, 0.00, 0, 0.00, 745
7, 13:22:00-000, 1709, 100, 1609, 0, 0.00, 0, 0.00, 1709
7, 13:23:00-000, 9882, 1070, 8812, 0, 0.00, 0, 0.00, 8447
7, 13:24:00-000, 5731, 2206, 3525, 1, 1353.00, 1, 1351.00, 7159
7, 13:25:00-000, 5081, 2743, 2338, 1, 1351.00, 1, 1351.00, 5078
7, 13:26:00-000, 10985, 8386, 2599, 17, 1348.94, 17, 1351.41, 10957
7, 13:27:00-000, 4038, 1385, 2653, 4, 1350.50, 4, 1349.50, 4030
7, 13:28:00-000, 12526, 8970, 3556, 7, 1349.14, 7, 1349.29, 12512
7, 13:29:00-000, 4788, 1544, 3244, 13, 1351.00, 13, 1350.77, 4762
7, 13:30:00-000, 9716, 2829, 6887, 6, 1349.50, 6, 1349.83, 9704
7, 13:31:00-000, 20873, 12632, 8241, 4, 1348.75, 4, 1349.00, 20865
7, 13:32:00-000, 6500, 3630, 2870, 4, 1351.50, 4, 1349.50, 6492
7, 13:33:00-000, 5910, 2522, 3388, 0, 0.00, 0, 0.00, 5910
7, 13:34:00-000, 16568, 6242, 10326, 21, 1349.33, 23, 1351.30, 16524
7, 13:35:00-000, 14629, 10600, 4029, 25, 1349.00, 23, 1350.00, 14581
7, 13:36:00-000, 10015, 5949, 4066, 37, 1351.21, 37, 1351.54, 9941
7, 13:38:00-000, 1030, 1030, 0, 0, 0.00, 0, 0.00, 1030
7, 13:39:00-000, 2192, 872, 1320, 1, 1352.00, 1, 1347.00, 2190
7, 13:40:00-000, 2712, 1318, 1394, 12, 1350.58, 12, 1350.00, 2688
7, 13:41:00-000, 1404, 1380, 24, 24, 1345.50, 24, 1347.33, 1356
7, 13:42:00-000, 13296, 6543, 6753, 71, 1347.67, 80, 1349.47, 13145
7, 13:43:00-000, 1371, 31, 1340, 19, 1354.79, 10, 1345.00, 1342
7, 13:44:00-000, 855, 15, 840, 0, 0.00, 0, 0.00, 855
7, 13:45:00-000, 4461, 3027, 1434, 7, 1350.00, 7, 1352.00, 4447
7, 13:46:00-000, 23014, 14115, 8899, 3, 1349.00, 3, 1349.33, 22205
7, 13:47:00-000, 20668, 11116, 9552, 0, 0.00, 0, 0.00, 21471
7, 13:48:00-000, 4942, 4117, 825, 14, 1352.78, 14, 1352.29, 4914
7, 13:49:00-000, 9669, 8058, 1611, 9, 1349.78, 9, 1351.55, 9651
7, 13:50:00-000, 12039, 3074, 8965, 5, 1351.80, 5, 1351.60, 12029
7, 13:51:00-000, 9230, 5591, 3639, 10, 1354.40, 10, 1351.70, 9210
7, 13:52:00-000, 7808, 4531, 3277, 30, 1347.83, 30, 1350.90, 7748
7, 13:53:00-000, 9047, 1650, 7397, 3, 1350.00, 3, 1349.00, 9041
7, 13:54:00-000, 4439, 2500, 1939, 4, 1354.00, 4, 1352.50, 4431
7, 13:55:00-000, 2659, 1003, 1656, 3, 1350.33, 2, 1352.00, 2654
7, 13:56:00-000, 5001, 4960, 41, 0, 0.00, 1, 1349.00, 5000
7, 13:57:00-000, 2897, 1442, 1455, 32, 1349.72, 32, 1348.65, 2833
7, 13:58:00-000, 661, 660, 1, 0, 0.00, 0, 0.00, 661
7, 13:59:00-000, 8144, 2289, 5855, 1, 1348.00, 1, 1348.00, 7157
7, 14:00:00-000, 5263, 2298, 2965, 36, 1348.83, 31, 1350.84, 6181
7, 14:01:00-000, 4243, 3378, 865, 2, 1351.00, 7, 1345.71, 4234
7, 14:02:00-000, 10545, 5055, 5490, 0, 0.00, 0, 0.00, 10545
7, 14:03:00-000, 91, 11, 80, 0, 0.00, 0, 0.00, 91
7, 14:04:00-000, 5007, 2486, 2521, 0, 0.00, 0, 0.00, 5007
7, 14:05:00-000, 17486, 10754, 6732, 3, 1349.00, 3, 1349.00, 17480
7, 14:06:00-000, 4354, 875, 3479, 38, 1350.73, 38, 1351.84, 4278
7, 14:07:00-000, 11090, 5097, 5993, 0, 0.00, 0, 0.00, 9970
7, 14:08:00-000, 8213, 4037, 4176, 2, 1349.00, 1, 1347.00, 9330
7, 14:09:00-000, 1, 0, 1, 0, 0.00, 1, 1346.00, 0
7, 14:10:00-000, 7481, 1563, 5918, 6, 1347.00, 6, 1347.83, 7469
7, 14:11:00-000, 5210, 1404, 3806, 0, 0.00, 0, 0.00, 5210
7, 14:12:00-000, 8115, 4816, 3299, 22, 1352.63, 22, 1351.95, 7585
7, 14:13:00-000, 18558, 11643, 6915, 0, 0.00, 0, 0.00, 17518
7, 14:14:00-000, 4090, 846, 3244, 23, 1348.56, 17, 1349.29, 5576
7, 14:15:00-000, 2673, 17, 2656, 3, 1352.00, 9, 1347.89, 2661
7, 14:16:00-000, 9290, 1751, 7539, 54, 1353.98, 54, 1349.25, 9175
7, 14:17:00-000, 16050, 11605, 4445, 33, 1348.94, 33, 1350.45, 15991
7, 14:18:00-000, 4237, 3308, 929, 4, 1345.00, 4, 1346.25, 4229
7, 14:19:00-000, 3773, 2679, 1094, 12, 1347.00, 12, 1350.25, 3192
7, 14:20:00-000, 2637, 2281, 356, 0, 0.00, 0, 0.00, 3194
7, 14:21:00-000, 3638, 1550, 2088, 26, 1351.69, 26, 1351.92, 3586
7, 14:22:00-000, 11462, 4291, 7171, 9, 1350.78, 9, 1349.89, 11444
7, 14:23:00-000, 10326, 6171, 4155, 1, 1356.00, 1, 1352.00, 10324
7, 14:24:00-000, 2895, 55, 2840, 42, 1347.66, 43, 1348.69, 2810
7, 14:25:00-000, 10398, 6326, 4072, 1, 1353.00, 0, 0.00, 10397
7, 14:26:00-000, 12038, 7987, 4051, 22, 1348.23, 22, 1349.77, 11994
7, 14:27:00-000, 6894, 3513, 3381, 10, 1350.80, 10, 1349.80, 6874
7, 14:28:00-000, 12957, 7826, 5131, 8, 1348.88, 6, 1344.00, 12943
7, 14:29:00-000, 2935, 2017, 918, 11, 1349.36, 13, 1348.77, 2911
7, 14:30:00-000, 4072, 2889, 1183, 4, 1348.75, 4, 1347.25, 4064
7, 14:31:00-000, 5154, 1955, 3199, 34, 1352.05, 34, 1351.68, 5086
7, 14:32:00-000, 1024, 8, 1016, 8, 1345.00, 8, 1347.12, 1008
7, 14:33:00-000, 9961, 1326, 8635, 13, 1346.31, 13, 1348.61, 9935
7, 14:34:00-000, 13522, 4496, 9026, 4, 1348.00, 4, 1348.75, 13514
7, 14:36:00-000, 14411, 6429, 7982, 2, 1351.00, 3, 1350.33, 13751
7, 14:37:00-000, 11768, 8635, 3133, 2, 1349.00, 1, 1344.00, 12420
7, 14:38:00-000, 2296, 1205, 1091, 4, 1349.00, 4, 1350.00, 2288
7, 14:39:00-000, 6008, 1634, 4374, 0, 0.00, 0, 0.00, 6008
7, 14:40:00-000, 2131, 987, 1144, 38, 1348.92, 38, 1348.94, 2055
7, 14:41:00-000, 8304, 2642, 5662, 4, 1348.75, 4, 1348.75, 8225
7, 14:42:00-000, 15444, 10884, 4560, 8, 1353.25, 8, 1351.87, 15499
7, 14:43:00-000, 3219, 3163, 56, 3, 1355.00, 3, 1351.00, 3213
7, 14:44:00-000, 1499, 9, 1490, 0, 0.00, 0, 0.00, 1499
7, 14:45:00-000, 4685, 3111, 1574, 18, 1350.67, 6, 1350.00, 4661
7, 14:46:00-000, 12, 0, 12, 0, 0.00, 12, 1349.17, 0
7, 14:47:00-000, 16853, 7528, 9325, 5, 1349.00, 5, 1346.00, 15991
7, 14:48:00-000, 6771, 4731, 2040, 22, 1350.63, 22, 1351.91, 7579
7, 14:49:00-000, 1453, 1430, 23, 1, 1347.00, 1, 1349.00, 1451
7, 14:50:00-000, 8660, 6764, 1896, 3, 1347.00, 3, 1346.00, 8654
7, 14:53:00-000, 3963, 2693, 1270, 20, 1355.90, 20, 1352.00, 3923
7, 14:54:00-000, 5932, 1712, 4220, 0, 0.00, 0, 0.00, 5932
7, 14:55:00-000, 897, 882, 15, 2, 1354.00, 2, 1350.00, 893
7, 14:56:00-000, 8838, 3900, 4938, 5, 1354.00, 6, 1352.83, 8827
7, 14:57:00-000, 1997, 1958, 39, 5, 1351.00, 4, 1350.00, 1988
7, 14:58:00-000, 3964, 2984, 980, 2, 1352.00, 2, 1351.00, 3960
7, 14:59:00-000, 9646, 5232, 4414, 32, 1347.87, 32, 1344.15, 9582
7, 15:00:00-000, 6049, 1502, 4547, 0, 0.00, 0, 0.00, 6049
7, 15:01:00-000, 17681, 10957, 6724, 22, 1348.18, 16, 1349.44, 17643
7, 15:02:00-000, 3274, 1851, 1423, 1, 1353.00, 7, 1347.57, 3266
7, 15:05:00-000, 3596, 2095, 1501, 21, 1346.52, 21, 1350.24, 3554
7, 15:06:00-000, 2340, 110, 2230, 54, 1350.99, 81, 1352.00, 2205
7, 15:07:00-000, 2761, 1662, 1099, 27, 1350.89, 0, 0.00, 2734
7, 15:08:00-000, 4892, 2200, 2692, 38, 1354.73, 38, 1351.81, 4816
7, 15:09:00-000, 10911, 5691, 5220, 12, 1348.16, 12, 1347.83, 10887
7, 15:10:00-000, 21262, 12642, 8620, 11, 1353.00, 11, 1352.00, 21240
7, 15:11:00-000, 17108, 8314, 8794, 3, 1350.00, 1, 1351.00, 15939
7, 15:12:00-000, 9223, 4493, 4730, 12, 1348.33, 5, 1349.00, 10371
7, 15:13:00-000, 949, 940, 9, 0, 0.00, 9, 1347.33, 940
7, 15:14:00-000, 3934, 782, 3152, 0, 0.00, 0, 0.00, 3934
7, 15:15:00-000, 6136, 6086, 50, 6, 1351.33, 6, 1351.33, 6124
7, 15:16:00-000, 6535, 3873, 2662, 11, 1348.00, 15, 1350.60, 6509
7, 15:17:00-000, 6638, 5254, 1384, 8, 1351.38, 4, 1352.00, 5809
7, 15:18:00-000, 17156, 11093, 6063, 8, 1348.38, 8, 1347.75, 17957
7, 15:19:00-000, 7776, 5347, 2429, 1, 1350.00, 1, 1351.00, 7774
7, 15:20:00-000, 8059, 4664, 3395, 3, 1345.00, 5, 1351.00, 8051
7, 15:21:00-000, 12170, 5343, 6827, 18, 1351.28, 16, 1351.00, 11185
7, 15:22:00-000, 11881, 3269, 8612, 0, 0.00, 0, 0.00, 12832
7, 15:23:00-000, 3745, 761, 2984, 17, 1351.29, 17, 1351.00, 3711
7, 15:24:00-000, 4719, 1181, 3538, 9, 1349.55, 9, 1348.44, 4701
7, 15:25:00-000, 3169, 3140, 29, 0, 0.00, 0, 0.00, 3169
7, 15:26:00-000, 10143, 5592, 4551, 0, 0.00, 0, 0.00, 10143
7, 15:27:00-000, 12358, 4478, 7880, 1, 1349.00, 1, 1345.00, 12356
7, 15:28:00-000, 14158, 7462, 6696, 10, 1350.80, 10, 1352.20, 14138
7, 15:29:00-000, 5528, 985, 4543, 1, 1346.00, 1, 1351.00, 5526
7, 15:30:00-000, 7087, 585, 6502, 12, 1346.92, 11, 1349.18, 7064
7, 15:31:00-000, 15570, 8609, 6961, 0, 0.00, 1, 1349.00, 14026
7, 15:32:00-000, 12406, 3710, 8696, 13, 1349.61, 13, 1349.15, 13923
7, 15:33:00-000, 9969, 4813, 5156, 5, 1350.20, 5, 1351.20, 9959
7, 15:34:00-000, 15191, 6027, 9164, 0, 0.00, 0, 0.00, 15191
7, 15:35:00-000, 8481, 5812, 2669, 4, 1350.50, 4, 1348.25, 8473
7, 15:36:00-000, 10623, 6035, 4588, 28, 1352.85, 28, 1351.78, 10567
7, 15:37:00-000, 4215, 25, 4190, 9, 1352.44, 9, 1351.78, 4197
7, 15:40:00-000, 366, 360, 6, 0, 0.00, 0, 0.00, 366
7, 15:41:00-000, 6246, 5229, 1017, 3, 1349.00, 3, 1349.00, 6240
7, 15:42:00-000, 5011, 3472, 1539, 0, 0.00, 0, 0.00, 5011
7, 15:44:00-000, 1553, 43, 1510, 43, 1353.44, 43, 1352.00, 1467
7, 15:46:00-000, 9499, 4912, 4587, 1, 1351.00, 1, 1351.00, 9497
7, 15:50:00-000, 4296, 1276, 3020, 0, 0.00, 0, 0.00, 4296
7, 15:52:00-000, 6172, 1091, 5081, 1, 1353.00, 1, 1351.00, 6170
7, 15:53:00-000, 5141, 1537, 3604, 0, 0.00, 0, 0.00, 5141
7, 15:56:00-000, 7166, 3182, 3984, 35, 1346.74, 19, 1350.42, 7112
7, 15:57:00-000, 6835, 4342, 2493, 32, 1352.93, 48, 1350.20, 6300
7, 15:58:00-000, 904, 900, 4, 0, 0.00, 1, 1351.00, 1358
7, 15:59:00-000, 1, 1, 0, 1, 1352.00, 0, 0.00, 0
7, 16:00:00-000, 816, 8, 808, 8, 1349.00, 8, 1345.12, 800
7, 16:01:00-000, 5071, 3326, 1745, 0, 0.00, 0, 0.00, 5071
7, 16:03:00-000, 11137, 4391, 6746, 0, 0.00, 0, 0.00, 11137
7, 16:05:00-000, 2296, 2291, 5, 1, 1353.00, 1, 1351.00, 2294
7, 16:06:00-000, 2852, 22, 2830, 0, 0.00, 0, 0.00, 2852
7, 16:07:00-000, 1492, 11, 1481, 2, 1347.00, 2, 1350.00, 1488
7, 16:08:00-000, 907, 890, 17, 0, 0.00, 0, 0.00, 907
7, 16:09:00-000, 1986, 780, 1206, 0, 0.00, 0, 0.00, 1986
7, 16:10:00-000, 10994, 6274, 4720, 10, 1354.10, 17, 1351.88, 10967
7, 16:11:00-000, 14, 14, 0, 7, 1353.29, 0, 0.00, 7
7, 16:12:00-000, 670, 670, 0, 0, 0.00, 0, 0.00, 670
7, 16:13:00-000, 6304, 4106, 2198, 0, 0.00, 0, 0.00, 6304
7, 16:14:00-000, 2733, 1994, 739, 8, 1349.00, 8, 1348.13, 2717
7, 16:15:00-000, 9467, 5201, 4266, 0, 0.00, 0, 0.00, 9467
7, 16:16:00-000, 404, 4, 400, 0, 0.00, 0, 0.00, 404
7, 16:17:00-000, 5137, 3524, 1613, 38, 1351.55, 40, 1351.75, 5059
7, 16:18:00-000, 7017, 1627, 5390, 19, 1351.89, 15, 1349.60, 6983
7, 16:19:00-000, 2, 0, 2, 0, 0.00, 2, 1347.00, 0
7, 16:20:00-000, 11193, 7784, 3409, 10, 1352.80, 10, 1350.90, 11170
7, 16:21:00-000, 10410, 6873, 3537, 39, 1347.92, 39, 1349.18, 10335
7, 16:22:00-000, 3883, 1262, 2621, 2, 1350.00, 2, 1352.00, 3879
7, 16:23:00-000, 3693, 2235, 1458, 8, 1348.00, 8, 1353.13, 3677
7, 16:24:00-000, 15636, 9339, 6297, 12, 1347.58, 12, 1350.92, 15612
7, 16:26:00-000, 3990, 2194, 1796, 3, 1350.00, 1, 1346.00, 3986
7, 16:27:00-000, 12844, 3991, 8853, 40, 1347.67, 42, 1347.92, 12762
7, 16:28:00-000, 3370, 2194, 1176, 9, 1350.00, 9, 1347.33, 3352
7, 16:29:00-000, 3191, 1711, 1480, 32, 1346.90, 32, 1347.53, 3127
9, 09:07:00-000, 4130, 710, 3420, 0, 0.00, 0, 0.00, 3320
9, 09:08:00-000, 0, 0, 0, 0, 0.00, 0, 0.00, 810
9, 09:24:00-000, 3170, 1420, 1750, 0, 0.00, 0, 0.00, 3170
9, 09:42:00-000, 4080, 2730, 1350, 0, 0.00, 0, 0.00, 4080
9, 09:43:00-000, 6560, 1940, 4620, 0, 0.00, 0, 0.00, 6560
9, 09:46:00-000, 3760, 2380, 1380, 0, 0.00, 0, 0.00, 3760
9, 09:47:00-000, 2400, 2400, 0, 0, 0.00, 0, 0.00, 2400
9, 09:50:00-000, 810, 810, 0, 0, 0.00, 0, 0.00, 810
9, 09:51:00-000, 6830, 3180, 3650, 0, 0.00, 0, 0.00, 6830
9, 09:54:00-000, 840, 0, 840, 0, 0.00, 0, 0.00, 840
9, 09:55:00-000, 1620, 830, 790, 0, 0.00, 0, 0.00, 1620
9, 09:56:00-000, 5840, 1090, 4750, 0, 0.00, 0, 0.00, 5840
9, 09:59:00-000, 3200, 0, 3200, 0, 0.00, 0, 0.00, 3200
9, 10:02:00-000, 1460, 70, 1390, 47, 1354.12, 47, 1352.00, 1366
9, 10:04:00-000, 3090, 2030, 1060, 0, 0.00, 0, 0.00, 3090
9, 10:05:00-000, 1230, 1230, 0, 0, 0.00, 0, 0.00, 1230
9, 10:07:00-000, 9010, 4250, 4760, 0, 0.00, 0, 0.00, 9010
9, 10:08:00-000, 5440, 5440, 0, 0, 0.00, 0, 0.00, 5440
9, 10:09:00-000, 1090, 1090, 0, 0, 0.00, 0, 0.00, 1090
9, 10:10:00-000, 6040, 3530, 2510, 0, 0.00, 0, 0.00, 6040
9, 10:14:00-000, 9802, 3891, 5911, 37, 1348.78, 67, 1350.01, 9698
9, 10:15:00-000, 3821, 1411, 2410, 30, 1351.40, 0, 0.00, 2291
9, 10:16:00-000, 0, 0, 0, 0, 0.00, 0, 0.00, 1500
9, 10:17:00-000, 3340, 2150, 1190, 0, 0.00, 0, 0.00, 3340
9, 10:18:00-000, 11760, 6060, 5700, 0, 0.00, 0, 0.00, 11760
9, 10:20:00-000, 3395, 5, 3390, 3, 1349.67, 3, 1352.00, 3389
9, 10:21:00-000, 9400, 4390, 5010, 0, 0.00, 0, 0.00, 9400
9, 10:22:00-000, 9140, 2650, 6490, 0, 0.00, 0, 0.00, 9140
9, 10:23:00-000, 4440, 2320, 2120, 0, 0.00, 0, 0.00, 3050
9, 10:24:00-000, 2, 2, 0, 2, 1354.00, 2, 1351.00, 1388
9, 10:27:00-000, 980, 980, 0, 0, 0.00, 0, 0.00, 980
9, 10:28:00-000, 2210, 2210, 0, 0, 0.00, 0, 0.00, 2210
9, 10:31:00-000, 920, 920, 0, 0, 0.00, 0, 0.00, 0
9, 10:32:00-000, 1515, 5, 1510, 4, 1352.50, 4, 1353.00, 2427
9, 10:36:00-000, 1030, 0, 1030, 0, 0.00, 0, 0.00, 1030
9, 10:37:00-000, 3030, 1851, 1179, 57, 1351.14, 57, 1352.54, 2916
9, 10:39:00-000, 1160, 1160, 0, 0, 0.00, 0, 0.00, 1160
9, 10:41:00-000, 5995, 305, 5690, 130, 1352.85, 130, 1351.00, 5735
9, 10:42:00-000, 870, 0, 870, 0, 0.00, 0, 0.00, 870
9, 10:43:00-000, 811, 800, 11, 11, 1349.00, 11, 1348.73, 789
9, 10:44:00-000, 3360, 1320, 2040, 0, 0.00, 0, 0.00, 3360
9, 10:45:00-000, 5684, 3600, 2084, 16, 1349.00, 16, 1350.00, 5652
9, 10:46:00-000, 7637, 1847, 5790, 21, 1350.14, 21, 1352.00, 7595
9, 10:47:00-000, 8610, 5200, 3410, 0, 0.00, 0, 0.00, 8610
9, 10:48:00-000, 4771, 2540, 2231, 11, 1346.18, 8, 1348.38, 4052
9, 10:49:00-000, 10633, 4530, 6103, 0, 0.00, 3, 1349.00, 11330
9, 10:50:00-000, 4220, 1590, 2630, 0, 0.00, 0, 0.00, 4220
9, 10:51:00-000, 2220, 0, 2220, 0, 0.00, 0, 0.00, 1080
9, 10:52:00-000, 1430, 0, 1430, 0, 0.00, 0, 0.00, 2570
9, 10:53:00-000, 9800, 2680, 7120, 30, 1351.93, 30, 1352.00, 9740
9, 10:54:00-000, 7580, 2440, 5140, 20, 1353.65, 20, 1352.00, 7540
9, 10:55:00-000, 2310, 0, 2310, 0, 0.00, 0, 0.00, 2310
9, 10:56:00-000, 1058, 1050, 8, 8, 1348.00, 8, 1346.00, 1042
9, 10:57:00-000, 3260, 3260, 0, 0, 0.00, 0, 0.00, 3260
9, 10:58:00-000, 2090, 0, 2090, 0, 0.00, 0, 0.00, 2090
9, 11:02:00-000, 8120, 2510, 5610, 0, 0.00, 0, 0.00, 8120
9, 11:03:00-000, 2630, 1510, 1120, 0, 0.00, 0, 0.00, 2630
9, 11:04:00-000, 880, 880, 0, 0, 0.00, 0, 0.00, 880
9, 11:05:00-000, 11323, 3413, 7910, 52, 1355.13, 52, 1349.00, 11219
9, 11:06:00-000, 2371, 11, 2360, 11, 1352.00, 11, 1352.00, 2349
9, 11:07:00-000, 4880, 0, 4880, 0, 0.00, 0, 0.00, 4880
9, 11:09:00-000, 940, 0, 940, 0, 0.00, 0, 0.00, 940
9, 11:10:00-000, 7216, 2706, 4510, 15, 1352.40, 20, 1352.00, 5721
9, 11:11:00-000, 3529, 2345, 1184, 20, 1347.95, 15, 1348.67, 4954
9, 11:12:00-000, 1599, 810, 789, 19, 1348.00, 19, 1346.00, 791
9, 11:13:00-000, 5800, 2590, 3210, 0, 0.00, 0, 0.00, 6570
9, 11:14:00-000, 3310, 1300, 2010, 0, 0.00, 0, 0.00, 3310
9, 11:17:00-000, 1996, 1160, 836, 22, 1346.86, 22, 1349.36, 1952
9, 11:18:00-000, 10331, 6600, 3731, 47, 1347.36, 47, 1346.33, 10237
9, 11:20:00-000, 4260, 3210, 1050, 0, 0.00, 0, 0.00, 4260
9, 11:21:00-000, 1074, 1060, 14, 14, 1348.00, 14, 1349.00, 1046
9, 11:22:00-000, 6210, 4220, 1990, 0, 0.00, 0, 0.00, 6210
9, 11:24:00-000, 9430, 6140, 3290, 0, 0.00, 0, 0.00, 9430
9, 11:26:00-000, 1120, 1120, 0, 0, 0.00, 0, 0.00, 1120
9, 11:27:00-000, 6270, 1920, 4350, 0, 0.00, 0, 0.00, 6270
9, 11:28:00-000, 2040, 1010, 1030, 0, 0.00, 0, 0.00, 2040
9, 11:31:00-000, 3515, 1435, 2080, 5, 1349.80, 5, 1353.00, 3505
9, 11:32:00-000, 10137, 4670, 5467, 27, 1347.00, 21, 1347.62, 10089
9, 11:33:00-000, 9006, 4850, 4156, 0, 0.00, 6, 1345.33, 9000
9, 11:34:00-000, 5246, 3650, 1596, 6, 1347.00, 1, 1350.00, 5239
9, 11:35:00-000, 4315, 1290, 3025, 0, 0.00, 5, 1348.20, 4310
9, 11:37:00-000, 1290, 1290, 0, 0, 0.00, 0, 0.00, 1290
9, 11:38:00-000, 1010, 0, 1010, 0, 0.00, 5, 1352.00, 1005
9, 11:39:00-000, 10919, 2619, 8300, 5, 1351.00, 0, 0.00, 10914
9, 11:41:00-000, 4382, 682, 3700, 2, 1352.00, 2, 1352.00, 4378
9, 11:42:00-000, 3190, 820, 2370, 0, 0.00, 0, 0.00, 3190
9, 11:43:00-000, 2430, 1130, 1300, 0, 0.00, 0, 0.00, 2430
9, 11:44:00-000, 3130, 1810, 1320, 0, 0.00, 0, 0.00, 3130
9, 11:45:00-000, 4850, 3830, 1020, 0, 0.00, 0, 0.00, 4850
9, 11:46:00-000, 5909, 929, 4980, 12, 1352.17, 39, 1352.00, 5858
9, 11:47:00-000, 3887, 1407, 2480, 27, 1352.66, 0, 0.00, 3860
9, 11:49:00-000, 860, 860, 0, 0, 0.00, 0, 0.00, 860
9, 11:50:00-000, 4813, 3370, 1443, 3, 1348.00, 3, 1348.00, 4807
9, 11:51:00-000, 5810, 4290, 1520, 0, 0.00, 0, 0.00, 5810
9, 11:52:00-000, 3730, 0, 3730, 0, 0.00, 0, 0.00, 3730
9, 11:53:00-000, 4460, 4450, 10, 10, 1348.00, 10, 1346.80, 3410
9, 11:54:00-000, 1360, 1360, 0, 0, 0.00, 0, 0.00, 2390
9, 11:59:00-000, 6790, 3740, 3050, 0, 0.00, 0, 0.00, 6790
9, 12:00:00-000, 2740, 0, 2740, 0, 0.00, 0, 0.00, 2740
9, 12:01:00-000, 3930, 3930, 0, 0, 0.00, 0, 0.00, 3930
9, 12:02:00-000, 3820, 2170, 1650, 0, 0.00, 0, 0.00, 3820
9, 12:06:00-000, 1110, 1110, 0, 0, 0.00, 0, 0.00, 1110
9, 12:07:00-000, 780, 0, 780, 0, 0.00, 0, 0.00, 780
9, 12:08:00-000, 3172, 2032, 1140, 2, 1355.00, 2, 1352.00, 3168
9, 12:09:00-000, 4449, 2380, 2069, 25, 1348.00, 25, 1346.48, 4399
9, 12:10:00-000, 10509, 4739, 5770, 11, 1351.00, 39, 1352.00, 10459
9, 12:11:00-000, 1600, 1600, 0, 28, 1353.71, 0, 0.00, 1572
9, 12:14:00-000, 1510, 1510, 0, 0, 0.00, 0, 0.00, 1510
9, 12:15:00-000, 9890, 2990, 6900, 0, 0.00, 0, 0.00, 8860
9, 12:16:00-000, 921, 11, 910, 7, 1353.00, 7, 1354.00, 1937
9, 12:17:00-000, 4200, 3170, 1030, 0, 0.00, 0, 0.00, 4200
9, 12:18:00-000, 5410, 2550, 2860, 0, 0.00, 0, 0.00, 5410
9, 12:19:00-000, 3210, 2480, 730, 0, 0.00, 0, 0.00, 3210
9, 12:20:00-000, 689, 670, 19, 19, 1348.00, 19, 1347.31, 651
9, 12:21:00-000, 1140, 0, 1140, 0, 0.00, 0, 0.00, 1140
9, 12:31:00-000, 3170, 2170, 1000, 0, 0.00, 0, 0.00, 3170
9, 12:35:00-000, 4870, 2530, 2340, 0, 0.00, 0, 0.00, 4870
9, 12:40:00-000, 2231, 1, 2230, 1, 1354.00, 1, 1352.00, 2229
9, 12:41:00-000, 5810, 1940, 3870, 0, 0.00, 0, 0.00, 5810
9, 12:42:00-000, 2473, 1023, 1450, 3, 1352.67, 3, 1353.00, 2467
9, 12:44:00-000, 1520, 0, 1520, 0, 0.00, 0, 0.00, 1520
9, 12:45:00-000, 1820, 0, 1820, 0, 0.00, 0, 0.00, 1820
9, 12:46:00-000, 2980, 2250, 730, 0, 0.00, 0, 0.00, 2980
9, 12:48:00-000, 3680, 1350, 2330, 0, 0.00, 0, 0.00, 3680
9, 12:49:00-000, 2000, 930, 1070, 0, 0.00, 0, 0.00, 2000
9, 12:50:00-000, 940, 0, 940, 0, 0.00, 0, 0.00, 940
9, 12:51:00-000, 4504, 2564, 1940, 24, 1349.29, 24, 1352.00, 4456
9, 12:52:00-000, 1330, 0, 1330, 0, 0.00, 0, 0.00, 1330
9, 12:53:00-000, 1360, 0, 1360, 0, 0.00, 0, 0.00, 1360
9, 12:55:00-000, 6100, 2280, 3820, 0, 0.00, 0, 0.00, 6100
9, 12:57:00-000, 714, 700, 14, 14, 1349.00, 14, 1347.00, 686
9, 12:58:00-000, 2428, 1158, 1270, 1, 1353.00, 18, 1352.00, 2409
9, 12:59:00-000, 17, 17, 0, 17, 1353.53, 0, 0.00, 0
9, 13:00:00-000, 1500, 1500, 0, 0, 0.00, 0, 0.00, 1500
9, 13:01:00-000, 10200, 4660, 5540, 0, 0.00, 0, 0.00, 10150
9, 13:02:00-000, 4731, 2376, 2355, 30, 1349.17, 30, 1349.46, 4721
9, 13:03:00-000, 7210, 2700, 4510, 0, 0.00, 0, 0.00, 7210
9, 13:04:00-000, 3530, 1340, 2190, 0, 0.00, 0, 0.00, 3530
9, 13:06:00-000, 2740, 1230, 1510, 0, 0.00, 0, 0.00, 2740
9, 13:07:00-000, 2150, 2150, 0, 0, 0.00, 0, 0.00, 2150
9, 13:10:00-000, 9260, 2370, 6890, 0, 0.00, 0, 0.00, 9260
9, 13:11:00-000, 1190, 1190, 0, 0, 0.00, 0, 0.00, 0
9, 13:12:00-000, 970, 970, 0, 0, 0.00, 0, 0.00, 2160
9, 13:13:00-000, 5810, 4110, 1700, 0, 0.00, 0, 0.00, 5810
9, 13:14:00-000, 3121, 2230, 891, 24, 1348.00, 24, 1348.08, 3073
9, 13:15:00-000, 1700, 840, 860, 0, 0.00, 0, 0.00, 1700
9, 13:16:00-000, 2210, 840, 1370, 0, 0.00, 0, 0.00, 2210
9, 13:17:00-000, 9362, 5130, 4232, 2, 1348.00, 2, 1349.00, 7858
9, 13:18:00-000, 4330, 1280, 3050, 0, 0.00, 0, 0.00, 4610
9, 13:19:00-000, 3776, 2920, 856, 16, 1348.00, 16, 1346.69, 4964
9, 13:20:00-000, 4420, 2640, 1780, 0, 0.00, 0, 0.00, 4420
9, 13:22:00-000, 2858, 2031, 827, 38, 1354.73, 38, 1351.36, 2782
9, 13:23:00-000, 3510, 0, 3510, 0, 0.00, 0, 0.00, 3510
9, 13:24:00-000, 5630, 1600, 4030, 0, 0.00, 0, 0.00, 5630
9, 13:25:00-000, 7330, 4090, 3240, 0, 0.00, 0, 0.00, 5930
9, 13:26:00-000, 4280, 3110, 1170, 0, 0.00, 0, 0.00, 5680
9, 13:28:00-000, 1170, 0, 1170, 0, 0.00, 0, 0.00, 1170
9, 13:29:00-000, 3021, 2471, 550, 31, 1353.84, 32, 1353.00, 2958
9, 13:30:00-000, 10871, 6571, 4300, 1, 1353.00, 0, 0.00, 10870
9, 13:31:00-000, 9540, 3140, 6400, 0, 0.00, 0, 0.00, 9090
9, 13:32:00-000, 1910, 380, 1530, 0, 0.00, 0, 0.00, 2360
9, 13:33:00-000, 3250, 860, 2390, 0, 0.00, 0, 0.00, 3250
9, 13:34:00-000, 2270, 2270, 0, 0, 0.00, 0, 0.00, 2270
9, 13:35:00-000, 6873, 3503, 3370, 3, 1353.67, 3, 1352.33, 6867
9, 13:36:00-000, 7050, 3970, 3080, 0, 0.00, 0, 0.00, 7050
9, 13:37:00-000, 1020, 0, 1020, 0, 0.00, 0, 0.00, 1020
9, 13:39:00-000, 1340, 1340, 0, 0, 0.00, 0, 0.00, 1340
9, 13:40:00-000, 1820, 792, 1028, 31, 1352.87, 31, 1352.42, 1758
9, 13:41:00-000, 1260, 1260, 0, 0, 0.00, 0, 0.00, 1260
9, 13:42:00-000, 7940, 5160, 2780, 0, 0.00, 0, 0.00, 7940
9, 13:43:00-000, 2218, 18, 2200, 15, 1354.13, 15, 1352.00, 2188
9, 13:44:00-000, 2300, 0, 2300, 0, 0.00, 0, 0.00, 2300
9, 13:45:00-000, 7170, 3650, 3520, 0, 0.00, 0, 0.00, 5760
9, 13:46:00-000, 8820, 2170, 6650, 0, 0.00, 0, 0.00, 10230
9, 13:47:00-000, 7970, 6090, 1880, 0, 0.00, 0, 0.00, 7970
9, 13:48:00-000, 780, 780, 0, 0, 0.00, 0, 0.00, 780
9, 13:49:00-000, 4670, 1270, 3400, 0, 0.00, 0, 0.00, 4670
9, 13:50:00-000, 8209, 2009, 6200, 19, 1351.58, 28, 1352.64, 8162
9, 13:51:00-000, 6685, 2465, 4220, 12, 1351.83, 3, 1351.00, 6670
9, 13:52:00-000, 2851, 2840, 11, 11, 1348.00, 2, 1351.00, 2838
9, 13:53:00-000, 6459, 2270, 4189, 0, 0.00, 9, 1348.56, 6450
9, 13:54:00-000, 4513, 1280, 3233, 3, 1348.00, 3, 1349.00, 4507
9, 13:55:00-000, 5371, 3030, 2341, 24, 1347.42, 12, 1348.66, 5335
9, 13:56:00-000, 3632, 1430, 2202, 0, 0.00, 12, 1345.08, 3620
9, 13:57:00-000, 2000, 0, 2000, 0, 0.00, 0, 0.00, 2000
9, 13:58:00-000, 587, 570, 17, 17, 1347.00, 17, 1346.47, 553
9, 13:59:00-000, 5430, 0, 5430, 0, 0.00, 0, 0.00, 5430
9, 14:00:00-000, 3429, 1730, 1699, 19, 1346.74, 19, 1344.84, 3391
9, 14:01:00-000, 3020, 3020, 0, 0, 0.00, 0, 0.00, 3020
9, 14:02:00-000, 7681, 2134, 5547, 26, 1349.08, 31, 1350.45, 7624
9, 14:03:00-000, 5, 5, 0, 5, 1351.00, 0, 0.00, 0
9, 14:04:00-000, 1070, 1070, 0, 0, 0.00, 0, 0.00, 1070
9, 14:05:00-000, 9422, 3300, 6122, 2, 1348.00, 2, 1349.00, 9418
9, 14:06:00-000, 7648, 6500, 1148, 20, 1347.60, 20, 1346.90, 7608
9, 14:07:00-000, 5101, 3800, 1301, 1, 1347.00, 1, 1348.00, 5099
9, 14:08:00-000, 5674, 2004, 3670, 14, 1354.00, 14, 1352.00, 5646
9, 14:09:00-000, 2120, 870, 1250, 0, 0.00, 0, 0.00, 2120
9, 14:10:00-000, 2642, 1330, 1312, 12, 1346.00, 4, 1351.00, 2626
9, 14:11:00-000, 2755, 750, 2005, 0, 0.00, 8, 1348.38, 1587
9, 14:12:00-000, 6690, 4230, 2460, 0, 0.00, 0, 0.00, 7850
9, 14:13:00-000, 11960, 6800, 5160, 0, 0.00, 0, 0.00, 11960
9, 14:14:00-000, 1061, 1, 1060, 1, 1352.00, 1, 1353.00, 1059
9, 14:15:00-000, 1380, 0, 1380, 0, 0.00, 0, 0.00, 1380
9, 14:16:00-000, 4261, 1351, 2910, 11, 1350.27, 11, 1353.00, 4239
9, 14:17:00-000, 877, 17, 860, 9, 1353.00, 9, 1352.00, 859
9, 14:18:00-000, 1070, 1070, 0, 0, 0.00, 0, 0.00, 1070
9, 14:19:00-000, 4380, 1250, 3130, 0, 0.00, 0, 0.00, 4380
9, 14:20:00-000, 1764, 754, 1010, 1, 1349.00, 4, 1352.00, 1759
9, 14:21:00-000, 5208, 865, 4343, 20, 1350.60, 17, 1351.47, 5171
9, 14:22:00-000, 4860, 2390, 2470, 0, 0.00, 0, 0.00, 4860
9, 14:23:00-000, 8574, 4674, 3900, 14, 1356.00, 14, 1352.71, 8546
9, 14:24:00-000, 2693, 1200, 1493, 3, 1348.00, 3, 1352.00, 2687
9, 14:25:00-000, 3350, 1050, 2300, 0, 0.00, 0, 0.00, 3350
9, 14:26:00-000, 9820, 3928, 5892, 43, 1347.83, 52, 1349.44, 9725
9, 14:27:00-000, 4422, 3295, 1127, 36, 1349.94, 27, 1347.52, 4359
9, 14:28:00-000, 7692, 4042, 3650, 2, 1352.00, 2, 1351.00, 6198
9, 14:29:00-000, 3960, 0, 3960, 0, 0.00, 0, 0.00, 5450
9, 14:30:00-000, 1637, 1630, 7, 7, 1349.71, 7, 1348.86, 1623
9, 14:31:00-000, 2760, 2030, 730, 0, 0.00, 0, 0.00, 2760
9, 14:34:00-000, 6979, 2099, 4880, 12, 1350.33, 19, 1352.00, 6948
9, 14:35:00-000, 1118, 1058, 60, 17, 1353.41, 10, 1354.00, 1091
9, 14:36:00-000, 7460, 950, 6510, 0, 0.00, 0, 0.00, 7460
9, 14:37:00-000, 7930, 3480, 4450, 0, 0.00, 0, 0.00, 7930
9, 14:38:00-000, 2500, 0, 2500, 0, 0.00, 0, 0.00, 2500
9, 14:40:00-000, 1390, 1390, 0, 0, 0.00, 0, 0.00, 1390
9, 14:41:00-000, 6729, 979, 5750, 9, 1350.78, 9, 1352.00, 6711
9, 14:42:00-000, 7080, 2200, 4880, 0, 0.00, 0, 0.00, 7080
9, 14:43:00-000, 1230, 1230, 0, 0, 0.00, 0, 0.00, 1230
9, 14:44:00-000, 826, 810, 16, 16, 1350.44, 16, 1347.06, 794
9, 14:45:00-000, 5411, 2120, 3291, 25, 1348.00, 25, 1348.72, 5361
9, 14:46:00-000, 1460, 1460, 0, 0, 0.00, 0, 0.00, 1460
9, 14:47:00-000, 12516, 6740, 5776, 15, 1344.60, 15, 1348.33, 12486
9, 14:48:00-000, 2670, 1700, 970, 12, 1345.42, 0, 0.00, 2658
9, 14:49:00-000, 1102, 0, 1102, 0, 0.00, 12, 1346.83, 1090
9, 14:50:00-000, 3930, 0, 3930, 0, 0.00, 0, 0.00, 3930
9, 14:52:00-000, 773, 760, 13, 13, 1348.00, 5, 1347.20, 755
9, 14:53:00-000, 4818, 1290, 3528, 0, 0.00, 8, 1346.00, 4810
9, 14:54:00-000, 3654, 1484, 2170, 4, 1353.00, 4, 1354.00, 3646
9, 14:55:00-000, 3717, 2257, 1460, 17, 1354.12, 17, 1352.00, 3683
9, 14:56:00-000, 7349, 2229, 5120, 30, 1350.23, 30, 1351.23, 7289
9, 14:57:00-000, 2352, 2340, 12, 10, 1348.00, 10, 1348.60, 2332
9, 14:58:00-000, 3160, 0, 3160, 0, 0.00, 0, 0.00, 3160
9, 14:59:00-000, 3430, 2560, 870, 0, 0.00, 0, 0.00, 3430
9, 15:00:00-000, 2550, 1230, 1320, 0, 0.00, 0, 0.00, 2550
9, 15:01:00-000, 6186, 1196, 4990, 16, 1353.94, 16, 1351.00, 6154
9, 15:02:00-000, 3591, 1437, 2154, 11, 1353.09, 11, 1353.27, 3569
9, 15:08:00-000, 7214, 6170, 1044, 4, 1348.00, 4, 1354.00, 6076
9, 15:09:00-000, 6560, 5100, 1460, 0, 0.00, 0, 0.00, 7690
9, 15:10:00-000, 6220, 5340, 880, 0, 0.00, 0, 0.00, 6220
9, 15:11:00-000, 4070, 0, 4070, 0, 0.00, 0, 0.00, 4070
9, 15:12:00-000, 4831, 3190, 1641, 1, 1348.00, 1, 1351.00, 4829
9, 15:14:00-000, 4121, 3130, 991, 21, 1348.00, 21, 1347.81, 4079
9, 15:15:00-000, 5826, 3326, 2500, 14, 1353.14, 34, 1353.00, 5778
9, 15:16:00-000, 2260, 2260, 0, 20, 1355.15, 0, 0.00, 2240
9, 15:17:00-000, 9009, 4645, 4364, 24, 1348.62, 20, 1350.45, 8965
9, 15:18:00-000, 7597, 3290, 4307, 3, 1348.33, 7, 1348.71, 7587
9, 15:19:00-000, 5500, 2260, 3240, 0, 0.00, 0, 0.00, 4110
9, 15:20:00-000, 10070, 2820, 7250, 0, 0.00, 0, 0.00, 11460
9, 15:21:00-000, 6346, 5586, 760, 6, 1351.50, 6, 1351.00, 6334
9, 15:22:00-000, 11110, 5730, 5380, 0, 0.00, 0, 0.00, 11110
9, 15:23:00-000, 1280, 1280, 0, 0, 0.00, 0, 0.00, 1280
9, 15:24:00-000, 2346, 1360, 986, 6, 1348.00, 6, 1349.00, 2334
9, 15:25:00-000, 7272, 3541, 3731, 2, 1351.50, 2, 1349.00, 7268
9, 15:26:00-000, 7850, 1150, 6700, 0, 0.00, 0, 0.00, 7010
9, 15:27:00-000, 11220, 4370, 6850, 0, 0.00, 1, 1349.00, 12059
9, 15:28:00-000, 8751, 5481, 3270, 1, 1351.00, 0, 0.00, 8750
9, 15:29:00-000, 5983, 4650, 1333, 3, 1349.00, 3, 1347.67, 5977
9, 15:30:00-000, 1130, 1130, 0, 0, 0.00, 0, 0.00, 1130
9, 15:31:00-000, 4500, 0, 4500, 0, 0.00, 0, 0.00, 4500
9, 15:32:00-000, 3490, 910, 2580, 0, 0.00, 0, 0.00, 3490
9, 15:33:00-000, 8992, 6100, 2892, 2, 1347.00, 2, 1349.00, 8988
9, 15:34:00-000, 5600, 1290, 4310, 10, 1348.00, 2, 1348.50, 5588
9, 15:35:00-000, 5790, 0, 5790, 0, 0.00, 8, 1346.00, 5782
9, 15:36:00-000, 3440, 2150, 1290, 0, 0.00, 0, 0.00, 3440
9, 15:37:00-000, 2388, 28, 2360, 17, 1354.29, 17, 1352.00, 2354
9, 15:41:00-000, 4560, 2180, 2380, 0, 0.00, 0, 0.00, 4560
9, 15:42:00-000, 4750, 2350, 2400, 0, 0.00, 0, 0.00, 4750
9, 15:44:00-000, 1000, 0, 1000, 0, 0.00, 0, 0.00, 1000
9, 15:46:00-000, 8951, 7080, 1871, 1, 1348.00, 1, 1347.00, 8949
9, 15:52:00-000, 3030, 2200, 830, 0, 0.00, 0, 0.00, 3030
9, 15:53:00-000, 2040, 1070, 970, 0, 0.00, 0, 0.00, 2040
9, 15:54:00-000, 1049, 9, 1040, 9, 1354.11, 9, 1352.00, 1031
9, 15:56:00-000, 3276, 2140, 1136, 10, 1347.70, 10, 1349.40, 3256
9, 15:57:00-000, 3520, 880, 2640, 0, 0.00, 1, 1353.00, 3519
9, 15:58:00-000, 1, 1, 0, 1, 1352.00, 0, 0.00, 0
9, 15:59:00-000, 1840, 0, 1840, 0, 0.00, 0, 0.00, 1840
9, 16:01:00-000, 1240, 0, 1240, 0, 0.00, 0, 0.00, 1240
9, 16:03:00-000, 5043, 3690, 1353, 3, 1348.00, 3, 1349.67, 5037
9, 16:04:00-000, 3574, 2170, 1404, 14, 1349.00, 14, 1349.21, 3546
9, 16:05:00-000, 2362, 2, 2360, 2, 1352.00, 2, 1353.00, 2358
9, 16:07:00-000, 1220, 0, 1220, 0, 0.00, 0, 0.00, 1220
9, 16:08:00-000, 1590, 1590, 0, 0, 0.00, 0, 0.00, 1590
9, 16:09:00-000, 4210, 750, 3460, 0, 0.00, 0, 0.00, 2810
9, 16:10:00-000, 2276, 16, 2260, 16, 1351.94, 16, 1352.00, 3644
9, 16:13:00-000, 6130, 4640, 1490, 0, 0.00, 0, 0.00, 6130
9, 16:15:00-000, 2560, 1510, 1050, 0, 0.00, 0, 0.00, 2560
9, 16:16:00-000, 4768, 3360, 1408, 13, 1348.00, 13, 1349.08, 4742
9, 16:17:00-000, 3560, 2180, 1380, 0, 0.00, 0, 0.00, 3560
9, 16:18:00-000, 2404, 4, 2400, 4, 1353.00, 4, 1351.00, 2396
9, 16:20:00-000, 6870, 2070, 4800, 0, 0.00, 0, 0.00, 6870
9, 16:21:00-000, 7550, 3240, 4310, 0, 0.00, 0, 0.00, 7550
9, 16:22:00-000, 2240, 0, 2240, 0, 0.00, 3, 1351.00, 2237
9, 16:23:00-000, 2169, 1149, 1020, 9, 1355.67, 6, 1353.00, 2154
9, 16:24:00-000, 1120, 1120, 0, 0, 0.00, 0, 0.00, 1120
9, 16:26:00-000, 5171, 5130, 41, 43, 1348.34, 38, 1346.34, 5090
9, 16:27:00-000, 3185, 750, 2435, 0, 0.00, 5, 1345.00, 3180
9, 16:28:00-000, 780, 10, 770, 10, 1351.00, 10, 1352.00, 760
9, 16:29:00-000, 2106, 6, 2100, 6, 1350.33, 6, 1351.00, 2094
