TraderType,Time,EnterQty,BuyEnterQty,SellEnterQty,BuyExecutedQty,BuyExecutedPx,SellExecutedQty,SellExecutedPx,CanceledQty
1, 09:06:00-000, 3147, 3147, 0, 927, 1347.90, 0, 0.00, 0
1, 09:07:00-000, 0, 0, 0, 0, 0.00, 0, 0.00, 2209
1, 09:08:00-000, 0, 0, 0, 0, 0.00, 0, 0.00, 11
1, 09:13:00-000, 3266, 2339, 927, 1253, 1347.72, 927, 1347.22, 0
1, 09:14:00-000, 13, 11, 2, 0, 0.00, 2, 1354.00, 1086
1, 09:15:00-000, 23, 11, 12, 2, 1348.00, 12, 1349.67, 11
1, 09:16:00-000, 162, 107, 55, 54, 1350.06, 55, 1352.17, 8
1, 09:17:00-000, 185, 118, 67, 8, 1351.00, 67, 1365.41, 51
1, 09:18:00-000, 698, 427, 271, 304, 1348.32, 271, 1354.41, 116
1, 09:19:00-000, 426, 248, 178, 91, 1348.55, 178, 1355.09, 119
1, 09:20:00-000, 787, 470, 317, 183, 1348.61, 311, 1353.52, 192
1, 09:21:00-000, 372, 274, 98, 97, 1349.72, 98, 1349.91, 239
1, 09:22:00-000, 659, 371, 288, 332, 1347.31, 288, 1346.86, 151
1, 09:23:00-000, 215, 162, 53, 90, 1347.91, 53, 1347.22, 85
1, 09:24:00-000, 582, 372, 210, 261, 1347.71, 210, 1347.35, 75
1, 09:25:00-000, 293, 194, 99, 119, 1348.26, 99, 1348.24, 96
1, 09:26:00-000, 644, 447, 197, 246, 1348.50, 197, 1348.80, 129
1, 09:27:00-000, 336, 234, 102, 126, 1348.23, 102, 1348.21, 140
1, 09:28:00-000, 577, 374, 203, 139, 1348.68, 203, 1348.37, 177
1, 09:29:00-000, 288, 152, 136, 150, 1347.38, 136, 1347.22, 140
1, 09:30:00-000, 678, 408, 270, 232, 1347.73, 270, 1350.07, 84
1, 09:31:00-000, 295, 179, 116, 110, 1348.86, 116, 1350.09, 102
1, 09:32:00-000, 728, 451, 277, 248, 1348.81, 276, 1352.19, 142
1, 09:33:00-000, 296, 205, 91, 133, 1348.67, 91, 1347.86, 141
1, 09:34:00-000, 606, 413, 193, 234, 1347.61, 193, 1347.56, 111
1, 09:35:00-000, 318, 234, 84, 105, 1347.63, 84, 1347.09, 155
1, 09:36:00-000, 584, 360, 224, 245, 1348.33, 224, 1347.90, 119
1, 09:37:00-000, 377, 225, 152, 165, 1347.78, 152, 1347.54, 112
1, 09:38:00-000, 618, 406, 212, 232, 1348.35, 212, 1348.42, 132
1, 09:39:00-000, 282, 170, 112, 82, 1347.54, 112, 1348.88, 113
1, 09:40:00-000, 582, 359, 223, 245, 1347.77, 223, 1347.65, 100
1, 09:41:00-000, 338, 178, 160, 131, 1347.45, 160, 1347.42, 87
1, 09:42:00-000, 588, 364, 224, 245, 1347.82, 224, 1347.48, 75
1, 09:43:00-000, 258, 157, 101, 126, 1348.42, 101, 1348.09, 86
1, 09:44:00-000, 673, 335, 338, 229, 1347.42, 338, 1347.42, 78
1, 09:45:00-000, 297, 191, 106, 71, 1347.95, 106, 1349.18, 72
1, 09:46:00-000, 648, 384, 264, 270, 1348.38, 264, 1347.98, 139
1, 09:47:00-000, 230, 144, 86, 94, 1348.17, 86, 1347.83, 106
1, 09:48:00-000, 615, 380, 235, 223, 1347.90, 235, 1348.23, 88
1, 09:49:00-000, 317, 215, 102, 136, 1347.48, 101, 1348.44, 90
1, 09:50:00-000, 556, 347, 209, 168, 1348.25, 210, 1348.25, 164
1, 09:51:00-000, 322, 182, 140, 112, 1347.63, 140, 1348.19, 107
1, 09:52:00-000, 636, 381, 255, 265, 1347.47, 255, 1347.12, 110
1, 09:53:00-000, 319, 207, 112, 93, 1349.58, 112, 1348.69, 102
1, 09:54:00-000, 637, 390, 247, 282, 1348.30, 247, 1347.74, 141
1, 09:55:00-000, 305, 172, 133, 118, 1347.88, 133, 1347.99, 69
1, 09:56:00-000, 568, 358, 210, 238, 1348.88, 210, 1347.78, 80
1, 09:57:00-000, 265, 204, 61, 126, 1348.64, 61, 1347.99, 87
1, 09:58:00-000, 675, 421, 254, 251, 1348.06, 254, 1347.40, 122
1, 09:59:00-000, 319, 228, 91, 117, 1348.17, 91, 1347.89, 133
1, 10:00:00-000, 554, 323, 231, 227, 1347.59, 231, 1346.89, 118
1, 10:01:00-000, 272, 188, 84, 97, 1349.09, 84, 1348.05, 82
1, 10:02:00-000, 643, 359, 284, 242, 1348.21, 284, 1347.49, 105
1, 10:03:00-000, 308, 181, 127, 139, 1348.15, 127, 1348.28, 105
1, 10:04:00-000, 606, 352, 254, 256, 1348.40, 254, 1348.28, 79
1, 10:05:00-000, 357, 254, 103, 150, 1349.15, 103, 1348.53, 75
1, 10:06:00-000, 639, 371, 268, 270, 1348.58, 268, 1347.82, 105
1, 10:07:00-000, 316, 214, 102, 106, 1347.91, 102, 1347.95, 94
1, 10:08:00-000, 593, 332, 261, 241, 1348.13, 261, 1347.87, 105
1, 10:09:00-000, 309, 180, 129, 122, 1347.46, 125, 1346.77, 94
1, 10:10:00-000, 646, 377, 269, 254, 1347.76, 273, 1347.02, 91
1, 10:11:00-000, 251, 134, 117, 106, 1346.96, 117, 1345.30, 83
1, 10:12:00-000, 559, 363, 196, 184, 1348.92, 196, 1348.08, 53
1, 10:13:00-000, 377, 234, 143, 163, 1347.99, 143, 1348.10, 121
1, 10:14:00-000, 725, 445, 280, 298, 1348.32, 280, 1348.37, 125
1, 10:15:00-000, 305, 187, 118, 122, 1347.73, 118, 1346.99, 121
1, 10:16:00-000, 690, 427, 263, 301, 1347.68, 263, 1346.99, 101
1, 10:17:00-000, 268, 167, 101, 80, 1349.31, 101, 1348.08, 100
1, 10:18:00-000, 593, 366, 227, 226, 1348.18, 227, 1347.81, 127
1, 10:19:00-000, 339, 178, 161, 151, 1347.17, 161, 1346.63, 81
1, 10:20:00-000, 586, 353, 233, 204, 1347.78, 233, 1347.69, 87
1, 10:21:00-000, 333, 183, 150, 120, 1348.38, 150, 1348.37, 98
1, 10:22:00-000, 680, 402, 278, 272, 1349.08, 278, 1348.69, 96
1, 10:23:00-000, 319, 210, 109, 128, 1347.85, 109, 1347.39, 82
1, 10:24:00-000, 613, 391, 222, 250, 1348.15, 222, 1348.17, 122
1, 10:25:00-000, 296, 191, 105, 145, 1347.93, 105, 1347.25, 102
1, 10:26:00-000, 596, 360, 236, 226, 1349.47, 236, 1348.72, 91
1, 10:27:00-000, 303, 194, 109, 130, 1347.71, 109, 1347.17, 102
1, 10:28:00-000, 612, 344, 268, 279, 1348.03, 268, 1348.05, 83
1, 10:29:00-000, 269, 178, 91, 127, 1348.44, 91, 1347.69, 61
1, 10:30:00-000, 656, 377, 279, 286, 1347.72, 279, 1347.05, 43
1, 10:31:00-000, 274, 145, 129, 130, 1346.84, 129, 1346.87, 69
1, 10:32:00-000, 620, 325, 295, 287, 1347.17, 295, 1345.79, 48
1, 10:33:00-000, 359, 221, 138, 143, 1348.27, 138, 1347.39, 40
1, 10:34:00-000, 543, 314, 229, 231, 1347.32, 229, 1347.46, 52
1, 10:35:00-000, 225, 125, 100, 105, 1347.55, 100, 1347.39, 76
1, 10:36:00-000, 639, 343, 296, 253, 1347.43, 296, 1347.32, 56
1, 10:37:00-000, 305, 168, 137, 121, 1347.58, 137, 1347.07, 81
1, 10:38:00-000, 654, 340, 314, 282, 1347.02, 314, 1346.25, 59
1, 10:39:00-000, 306, 171, 135, 127, 1347.71, 135, 1346.53, 42
1, 10:40:00-000, 557, 356, 201, 271, 1347.88, 201, 1346.97, 50
1, 10:41:00-000, 364, 196, 168, 172, 1347.85, 165, 1347.15, 74
1, 10:42:00-000, 516, 278, 238, 212, 1347.06, 241, 1346.94, 45
1, 10:43:00-000, 302, 201, 101, 145, 1348.36, 101, 1347.76, 47
1, 10:44:00-000, 594, 363, 231, 248, 1348.35, 231, 1347.87, 93
1, 10:45:00-000, 338, 189, 149, 139, 1347.66, 149, 1347.11, 62
1, 10:46:00-000, 616, 340, 276, 239, 1347.48, 276, 1347.08, 65
1, 10:47:00-000, 306, 144, 162, 139, 1347.88, 158, 1346.76, 84
1, 10:48:00-000, 619, 333, 286, 245, 1347.18, 288, 1347.33, 47
1, 10:49:00-000, 382, 211, 171, 174, 1347.33, 173, 1346.42, 58
1, 10:50:00-000, 523, 328, 195, 251, 1347.82, 195, 1347.29, 72
1, 10:51:00-000, 324, 189, 135, 128, 1348.08, 135, 1348.39, 49
1, 10:52:00-000, 613, 372, 241, 237, 1347.72, 241, 1347.15, 96
1, 10:53:00-000, 369, 237, 132, 131, 1348.28, 132, 1348.22, 103
1, 10:54:00-000, 638, 366, 272, 255, 1348.07, 272, 1347.60, 96
1, 10:55:00-000, 289, 183, 106, 122, 1347.85, 106, 1347.45, 107
1, 10:56:00-000, 635, 366, 269, 262, 1347.78, 269, 1347.22, 105
1, 10:57:00-000, 316, 158, 158, 109, 1347.04, 158, 1346.32, 82
1, 10:58:00-000, 675, 391, 284, 282, 1346.84, 284, 1346.60, 50
1, 10:59:00-000, 287, 188, 99, 131, 1347.18, 99, 1347.16, 97
1, 11:00:00-000, 599, 350, 249, 243, 1347.95, 249, 1347.43, 100
1, 11:01:00-000, 277, 155, 122, 101, 1347.38, 122, 1348.24, 67
1, 11:02:00-000, 673, 428, 245, 288, 1348.11, 245, 1347.52, 54
1, 11:03:00-000, 290, 186, 104, 152, 1349.17, 104, 1348.77, 123
1, 11:04:00-000, 648, 348, 300, 233, 1347.74, 300, 1347.71, 85
1, 11:05:00-000, 318, 193, 125, 96, 1349.80, 125, 1349.03, 88
1, 11:06:00-000, 575, 354, 221, 222, 1348.18, 221, 1347.36, 132
1, 11:07:00-000, 344, 207, 137, 136, 1347.92, 137, 1347.19, 77
1, 11:08:00-000, 689, 376, 313, 308, 1347.91, 313, 1346.94, 90
1, 11:09:00-000, 331, 208, 123, 111, 1348.95, 123, 1347.75, 63
1, 11:10:00-000, 595, 383, 212, 242, 1348.28, 212, 1347.52, 123
1, 11:11:00-000, 322, 183, 139, 143, 1348.42, 139, 1347.95, 89
1, 11:12:00-000, 631, 370, 261, 270, 1348.35, 261, 1348.14, 96
1, 11:13:00-000, 361, 213, 148, 130, 1347.43, 148, 1346.87, 69
1, 11:14:00-000, 689, 398, 291, 305, 1348.18, 291, 1347.50, 100
1, 11:15:00-000, 322, 232, 90, 127, 1348.30, 90, 1347.72, 84
1, 11:16:00-000, 646, 389, 257, 278, 1348.63, 257, 1348.13, 86
1, 11:17:00-000, 301, 184, 117, 138, 1347.99, 117, 1346.87, 97
1, 11:18:00-000, 635, 337, 298, 262, 1347.93, 298, 1347.35, 92
1, 11:19:00-000, 246, 182, 64, 80, 1348.35, 64, 1348.61, 58
1, 11:20:00-000, 559, 334, 225, 245, 1347.84, 222, 1347.35, 94
1, 11:21:00-000, 347, 178, 169, 155, 1347.70, 172, 1347.51, 74
1, 11:22:00-000, 603, 368, 235, 176, 1348.54, 235, 1348.46, 93
1, 11:23:00-000, 309, 162, 147, 150, 1347.70, 147, 1347.81, 109
1, 11:24:00-000, 681, 412, 269, 286, 1347.92, 269, 1346.94, 59
1, 11:25:00-000, 338, 193, 145, 138, 1348.72, 145, 1348.73, 100
1, 11:26:00-000, 550, 283, 267, 191, 1347.48, 267, 1347.43, 72
1, 11:27:00-000, 293, 185, 108, 128, 1348.50, 108, 1347.66, 76
1, 11:28:00-000, 690, 396, 294, 268, 1347.42, 294, 1347.02, 94
1, 11:29:00-000, 238, 142, 96, 134, 1347.32, 96, 1346.47, 87
1, 11:30:00-000, 650, 388, 262, 311, 1347.97, 262, 1346.49, 22
1, 11:31:00-000, 295, 175, 120, 121, 1348.44, 120, 1348.33, 77
1, 11:32:00-000, 546, 329, 217, 202, 1348.30, 217, 1348.15, 75
1, 11:33:00-000, 302, 170, 132, 134, 1347.48, 132, 1346.53, 107
1, 11:34:00-000, 561, 328, 233, 263, 1347.26, 233, 1346.66, 36
1, 11:35:00-000, 339, 182, 157, 165, 1346.44, 157, 1346.29, 55
1, 11:36:00-000, 572, 323, 249, 187, 1347.90, 249, 1348.12, 51
1, 11:37:00-000, 321, 191, 130, 154, 1347.76, 130, 1347.58, 96
1, 11:38:00-000, 607, 355, 252, 221, 1348.06, 252, 1348.42, 78
1, 11:39:00-000, 275, 133, 142, 107, 1347.07, 142, 1346.59, 86
1, 11:40:00-000, 576, 346, 230, 229, 1348.14, 230, 1347.74, 78
1, 11:41:00-000, 289, 149, 140, 143, 1346.31, 140, 1346.26, 71
1, 11:42:00-000, 624, 364, 260, 243, 1348.00, 260, 1346.85, 55
1, 11:43:00-000, 286, 179, 107, 132, 1347.88, 107, 1346.60, 68
1, 11:44:00-000, 553, 369, 184, 209, 1349.16, 184, 1347.76, 76
1, 11:45:00-000, 335, 189, 146, 162, 1347.96, 146, 1347.51, 109
1, 11:46:00-000, 620, 394, 226, 289, 1348.59, 226, 1348.04, 60
1, 11:47:00-000, 315, 192, 123, 143, 1348.93, 121, 1348.61, 102
1, 11:48:00-000, 560, 305, 255, 248, 1348.22, 257, 1347.84, 66
1, 11:49:00-000, 344, 197, 147, 141, 1347.19, 147, 1346.47, 52
1, 11:50:00-000, 610, 341, 269, 244, 1347.96, 269, 1347.68, 71
1, 11:51:00-000, 336, 195, 141, 158, 1347.05, 137, 1346.86, 78
1, 11:52:00-000, 562, 348, 214, 225, 1348.75, 211, 1348.06, 76
1, 11:53:00-000, 312, 204, 108, 105, 1348.00, 111, 1347.87, 86
1, 11:54:00-000, 598, 349, 249, 231, 1347.99, 248, 1347.43, 119
1, 11:55:00-000, 354, 195, 159, 154, 1347.99, 160, 1347.49, 79
1, 11:56:00-000, 641, 334, 307, 275, 1347.29, 307, 1346.37, 79
1, 11:57:00-000, 322, 167, 155, 89, 1348.47, 155, 1347.77, 52
1, 11:58:00-000, 530, 326, 204, 222, 1348.52, 204, 1348.15, 89
1, 11:59:00-000, 352, 245, 107, 145, 1348.74, 107, 1348.11, 64
1, 12:00:00-000, 631, 362, 269, 269, 1348.23, 269, 1347.24, 137
1, 12:01:00-000, 296, 192, 104, 136, 1348.41, 104, 1347.63, 59
1, 12:02:00-000, 674, 389, 285, 280, 1348.13, 285, 1347.35, 68
1, 12:03:00-000, 290, 139, 151, 146, 1346.54, 151, 1345.66, 84
1, 12:04:00-000, 617, 367, 250, 242, 1348.63, 250, 1348.39, 54
1, 12:05:00-000, 271, 155, 116, 134, 1347.47, 116, 1346.96, 82
1, 12:06:00-000, 615, 381, 234, 234, 1348.15, 234, 1347.13, 84
1, 12:07:00-000, 297, 184, 113, 122, 1348.64, 113, 1347.45, 96
1, 12:08:00-000, 588, 338, 250, 205, 1347.80, 250, 1347.59, 91
1, 12:09:00-000, 324, 181, 143, 137, 1347.74, 143, 1347.35, 81
1, 12:10:00-000, 713, 427, 286, 296, 1348.36, 286, 1347.28, 93
1, 12:11:00-000, 275, 156, 119, 120, 1347.70, 119, 1346.77, 91
1, 12:12:00-000, 601, 349, 252, 229, 1349.14, 252, 1348.84, 88
1, 12:13:00-000, 321, 185, 136, 84, 1348.64, 136, 1347.84, 83
1, 12:14:00-000, 546, 315, 231, 211, 1347.67, 231, 1347.09, 110
1, 12:15:00-000, 383, 204, 179, 156, 1347.54, 179, 1347.01, 80
1, 12:16:00-000, 675, 458, 217, 296, 1348.39, 217, 1347.78, 87
1, 12:17:00-000, 297, 181, 116, 159, 1347.59, 116, 1346.78, 97
1, 12:18:00-000, 560, 375, 185, 224, 1348.31, 185, 1347.57, 78
1, 12:19:00-000, 322, 210, 112, 149, 1350.81, 112, 1349.26, 112
1, 12:20:00-000, 659, 428, 231, 255, 1348.63, 231, 1347.41, 113
1, 12:21:00-000, 294, 183, 111, 98, 1348.09, 111, 1347.28, 138
1, 12:22:00-000, 672, 351, 321, 223, 1348.96, 321, 1347.18, 136
1, 12:23:00-000, 304, 171, 133, 108, 1348.79, 133, 1347.64, 92
1, 12:24:00-000, 630, 361, 269, 228, 1348.36, 269, 1347.20, 82
1, 12:25:00-000, 343, 182, 161, 132, 1347.76, 161, 1346.64, 106
1, 12:26:00-000, 593, 330, 263, 211, 1348.00, 263, 1346.70, 81
1, 12:27:00-000, 335, 226, 109, 144, 1348.72, 109, 1347.88, 91
1, 12:28:00-000, 564, 362, 202, 229, 1348.43, 202, 1347.61, 96
1, 12:29:00-000, 313, 183, 130, 154, 1347.60, 130, 1346.43, 70
1, 12:30:00-000, 636, 436, 200, 223, 1348.45, 200, 1347.36, 112
1, 12:31:00-000, 304, 185, 119, 132, 1347.18, 119, 1346.92, 136
1, 12:32:00-000, 602, 358, 244, 216, 1347.41, 244, 1346.88, 126
1, 12:33:00-000, 348, 233, 115, 138, 1348.04, 115, 1347.28, 108
1, 12:34:00-000, 583, 315, 268, 219, 1347.63, 268, 1346.85, 101
1, 12:35:00-000, 313, 187, 126, 119, 1348.74, 126, 1347.02, 97
1, 12:36:00-000, 586, 364, 222, 277, 1348.14, 222, 1347.26, 90
1, 12:37:00-000, 308, 204, 104, 122, 1349.00, 104, 1347.20, 68
1, 12:38:00-000, 656, 362, 294, 267, 1347.36, 294, 1346.90, 69
1, 12:39:00-000, 335, 208, 127, 129, 1348.01, 127, 1347.39, 100
1, 12:40:00-000, 634, 406, 228, 255, 1348.83, 228, 1348.52, 98
1, 12:41:00-000, 305, 191, 114, 121, 1347.45, 114, 1346.63, 121
1, 12:42:00-000, 565, 361, 204, 221, 1348.07, 204, 1348.04, 123
1, 12:43:00-000, 370, 211, 159, 151, 1348.25, 159, 1347.85, 76
1, 12:44:00-000, 615, 300, 315, 239, 1347.84, 315, 1346.69, 90
1, 12:45:00-000, 289, 154, 135, 121, 1347.48, 135, 1346.67, 53
1, 12:46:00-000, 632, 392, 240, 254, 1347.35, 240, 1346.72, 44
1, 12:47:00-000, 295, 184, 111, 148, 1348.60, 111, 1348.03, 89
1, 12:48:00-000, 596, 371, 225, 272, 1347.20, 225, 1346.37, 84
1, 12:49:00-000, 325, 175, 150, 129, 1347.69, 150, 1347.03, 68
1, 12:50:00-000, 567, 381, 186, 238, 1348.23, 186, 1347.82, 91
1, 12:51:00-000, 333, 192, 141, 130, 1348.20, 141, 1347.42, 86
1, 12:52:00-000, 546, 335, 211, 257, 1347.63, 211, 1347.46, 89
1, 12:53:00-000, 282, 158, 124, 94, 1347.80, 124, 1347.27, 85
1, 12:54:00-000, 612, 317, 295, 267, 1346.79, 295, 1346.06, 51
1, 12:55:00-000, 276, 153, 123, 102, 1347.86, 123, 1346.87, 51
1, 12:56:00-000, 722, 423, 299, 316, 1347.80, 299, 1346.16, 96
1, 12:57:00-000, 297, 163, 134, 110, 1347.19, 134, 1347.07, 80
1, 12:58:00-000, 602, 362, 240, 253, 1347.90, 240, 1347.25, 63
1, 12:59:00-000, 256, 143, 113, 111, 1346.87, 113, 1346.62, 60
1, 13:00:00-000, 594, 361, 233, 266, 1347.59, 233, 1346.95, 100
1, 13:01:00-000, 298, 189, 109, 90, 1348.90, 107, 1348.52, 64
1, 13:02:00-000, 666, 333, 333, 315, 1347.41, 335, 1346.46, 56
1, 13:03:00-000, 292, 182, 110, 133, 1347.71, 110, 1347.52, 57
1, 13:04:00-000, 602, 340, 262, 246, 1347.16, 262, 1346.65, 74
1, 13:05:00-000, 294, 165, 129, 101, 1348.40, 129, 1347.82, 69
1, 13:06:00-000, 582, 336, 246, 272, 1348.00, 246, 1347.21, 57
1, 13:07:00-000, 281, 166, 115, 135, 1347.56, 115, 1346.93, 65
1, 13:08:00-000, 583, 328, 255, 242, 1347.19, 255, 1346.53, 44
1, 13:09:00-000, 309, 169, 140, 102, 1348.48, 140, 1348.74, 68
1, 13:10:00-000, 609, 384, 225, 264, 1347.71, 225, 1347.20, 97
1, 13:11:00-000, 343, 188, 155, 154, 1347.58, 155, 1346.79, 72
1, 13:12:00-000, 633, 376, 257, 258, 1348.18, 257, 1347.14, 85
1, 13:13:00-000, 247, 124, 123, 135, 1347.80, 123, 1347.91, 63
1, 13:14:00-000, 641, 416, 225, 281, 1347.74, 225, 1347.84, 46
1, 13:15:00-000, 311, 189, 122, 143, 1347.66, 122, 1347.51, 93
1, 13:16:00-000, 568, 334, 234, 183, 1348.22, 234, 1348.20, 86
1, 13:17:00-000, 315, 194, 121, 129, 1348.54, 121, 1349.26, 78
1, 13:18:00-000, 629, 365, 264, 240, 1348.72, 264, 1347.65, 134
1, 13:19:00-000, 375, 222, 153, 158, 1347.88, 153, 1347.15, 102
1, 13:20:00-000, 670, 391, 279, 308, 1348.03, 279, 1347.10, 83
1, 13:21:00-000, 392, 223, 169, 166, 1348.58, 169, 1347.34, 57
1, 13:22:00-000, 557, 356, 201, 203, 1349.31, 201, 1349.16, 91
1, 13:23:00-000, 363, 203, 160, 168, 1347.88, 160, 1347.15, 79
1, 13:24:00-000, 611, 353, 258, 288, 1347.59, 258, 1346.64, 82
1, 13:25:00-000, 294, 196, 98, 110, 1347.95, 98, 1347.62, 70
1, 13:26:00-000, 657, 354, 303, 293, 1347.10, 303, 1346.62, 45
1, 13:27:00-000, 304, 167, 137, 151, 1347.16, 137, 1346.38, 77
1, 13:28:00-000, 602, 313, 289, 247, 1347.53, 289, 1347.43, 54
1, 13:29:00-000, 331, 175, 156, 117, 1347.06, 156, 1347.27, 49
1, 13:30:00-000, 606, 362, 244, 244, 1347.51, 244, 1347.08, 100
1, 13:31:00-000, 284, 153, 131, 123, 1347.77, 131, 1346.27, 69
1, 13:32:00-000, 556, 284, 272, 243, 1347.50, 272, 1346.40, 38
1, 13:33:00-000, 302, 189, 113, 117, 1348.09, 113, 1348.27, 39
1, 13:34:00-000, 670, 406, 264, 301, 1347.75, 262, 1347.30, 77
1, 13:35:00-000, 254, 142, 112, 108, 1347.61, 114, 1347.01, 93
1, 13:36:00-000, 620, 374, 246, 240, 1348.26, 246, 1346.82, 67
1, 13:37:00-000, 354, 213, 141, 162, 1348.24, 141, 1347.80, 101
1, 13:38:00-000, 613, 365, 248, 233, 1347.69, 248, 1347.32, 70
1, 13:39:00-000, 336, 205, 131, 161, 1348.58, 131, 1347.45, 81
1, 13:40:00-000, 537, 336, 201, 240, 1348.30, 201, 1348.32, 100
1, 13:41:00-000, 301, 173, 128, 120, 1348.41, 128, 1346.97, 79
1, 13:42:00-000, 595, 333, 262, 223, 1348.16, 262, 1347.39, 78
1, 13:43:00-000, 376, 213, 163, 143, 1347.26, 163, 1346.73, 86
1, 13:44:00-000, 533, 291, 242, 191, 1347.60, 242, 1347.48, 99
1, 13:45:00-000, 319, 214, 105, 116, 1348.29, 105, 1347.39, 70
1, 13:46:00-000, 707, 401, 306, 262, 1348.27, 306, 1348.02, 123
1, 13:47:00-000, 318, 171, 147, 115, 1348.65, 147, 1347.54, 109
1, 13:48:00-000, 603, 379, 224, 263, 1347.89, 224, 1347.41, 79
1, 13:49:00-000, 297, 176, 121, 117, 1348.86, 121, 1347.96, 105
1, 13:50:00-000, 608, 391, 217, 252, 1348.44, 217, 1347.65, 87
1, 13:51:00-000, 321, 195, 126, 140, 1348.70, 126, 1348.29, 79
1, 13:52:00-000, 645, 393, 252, 238, 1348.57, 252, 1347.77, 84
1, 13:53:00-000, 250, 169, 81, 71, 1349.04, 81, 1349.18, 163
1, 13:54:00-000, 625, 364, 261, 225, 1349.05, 261, 1348.91, 95
1, 13:55:00-000, 350, 194, 156, 143, 1348.61, 156, 1347.60, 110
1, 13:56:00-000, 614, 363, 251, 269, 1347.64, 251, 1347.61, 89
1, 13:57:00-000, 304, 182, 122, 125, 1349.31, 122, 1348.30, 76
1, 13:58:00-000, 582, 371, 211, 232, 1348.23, 211, 1347.85, 64
1, 13:59:00-000, 350, 222, 128, 122, 1349.78, 128, 1349.37, 120
1, 14:00:00-000, 699, 443, 256, 317, 1348.59, 256, 1348.08, 113
1, 14:01:00-000, 385, 240, 145, 170, 1348.41, 145, 1347.12, 104
1, 14:02:00-000, 591, 329, 262, 218, 1348.34, 262, 1348.42, 115
1, 14:03:00-000, 339, 231, 108, 125, 1348.53, 108, 1348.46, 92
1, 14:04:00-000, 698, 376, 322, 268, 1347.88, 322, 1347.38, 116
1, 14:05:00-000, 290, 218, 72, 118, 1349.11, 72, 1348.46, 94
1, 14:06:00-000, 589, 350, 239, 292, 1348.19, 239, 1347.46, 81
1, 14:07:00-000, 340, 182, 158, 137, 1348.28, 158, 1346.55, 59
1, 14:08:00-000, 635, 395, 240, 289, 1348.24, 240, 1347.12, 89
1, 14:09:00-000, 312, 175, 137, 139, 1347.86, 137, 1346.92, 58
1, 14:10:00-000, 616, 350, 266, 257, 1347.91, 264, 1346.61, 76
1, 14:11:00-000, 264, 158, 106, 135, 1348.15, 108, 1347.74, 70
1, 14:12:00-000, 615, 343, 272, 269, 1347.71, 272, 1346.68, 56
1, 14:13:00-000, 345, 185, 160, 141, 1348.30, 160, 1346.87, 55
1, 14:14:00-000, 528, 281, 247, 206, 1347.77, 247, 1346.50, 43
1, 14:15:00-000, 291, 181, 110, 110, 1346.77, 110, 1346.30, 62
1, 14:16:00-000, 622, 340, 282, 290, 1348.63, 282, 1347.22, 83
1, 14:17:00-000, 299, 172, 127, 106, 1348.22, 127, 1348.32, 51
1, 14:18:00-000, 640, 372, 268, 275, 1348.04, 268, 1346.86, 45
1, 14:19:00-000, 308, 200, 108, 125, 1348.45, 108, 1347.72, 103
1, 14:20:00-000, 624, 382, 242, 242, 1348.80, 242, 1348.82, 99
1, 14:21:00-000, 335, 197, 138, 106, 1349.10, 138, 1347.58, 114
1, 14:22:00-000, 609, 352, 257, 228, 1349.09, 257, 1348.98, 123
1, 14:23:00-000, 310, 158, 152, 130, 1348.13, 152, 1347.31, 98
1, 14:24:00-000, 567, 319, 248, 212, 1348.55, 248, 1347.81, 68
1, 14:25:00-000, 368, 227, 141, 147, 1349.13, 141, 1348.14, 68
1, 14:26:00-000, 633, 395, 238, 285, 1348.28, 238, 1347.66, 84
1, 14:27:00-000, 373, 187, 186, 175, 1347.53, 186, 1347.49, 74
1, 14:28:00-000, 616, 402, 214, 280, 1347.94, 214, 1347.11, 71
1, 14:29:00-000, 317, 203, 114, 138, 1347.63, 114, 1347.16, 93
1, 14:30:00-000, 572, 342, 230, 252, 1348.23, 229, 1347.34, 100
1, 14:31:00-000, 335, 199, 136, 146, 1348.37, 137, 1347.28, 72
1, 14:32:00-000, 671, 408, 263, 291, 1348.21, 263, 1347.65, 74
1, 14:33:00-000, 275, 150, 125, 106, 1348.72, 125, 1347.77, 75
1, 14:34:00-000, 570, 295, 275, 200, 1347.48, 275, 1346.74, 66
1, 14:35:00-000, 304, 165, 139, 114, 1347.89, 139, 1347.41, 86
1, 14:36:00-000, 683, 424, 259, 290, 1347.91, 259, 1347.34, 82
1, 14:37:00-000, 382, 203, 179, 152, 1348.88, 179, 1348.48, 90
1, 14:38:00-000, 591, 317, 274, 277, 1348.36, 274, 1348.02, 47
1, 14:39:00-000, 279, 137, 142, 82, 1347.10, 142, 1346.15, 54
1, 14:40:00-000, 610, 369, 241, 292, 1347.91, 241, 1346.75, 79
1, 14:41:00-000, 281, 180, 101, 127, 1348.59, 101, 1347.69, 51
1, 14:42:00-000, 659, 385, 274, 241, 1347.98, 274, 1346.71, 85
1, 14:43:00-000, 340, 179, 161, 136, 1348.19, 161, 1346.63, 88
1, 14:44:00-000, 584, 400, 184, 182, 1348.69, 184, 1348.29, 107
1, 14:45:00-000, 328, 172, 156, 141, 1347.79, 156, 1347.44, 134
1, 14:46:00-000, 628, 363, 265, 249, 1347.61, 265, 1347.02, 94
1, 14:47:00-000, 294, 196, 98, 134, 1348.64, 98, 1347.91, 92
1, 14:48:00-000, 648, 404, 244, 282, 1347.24, 244, 1346.68, 84
1, 14:49:00-000, 321, 184, 137, 124, 1346.89, 137, 1346.49, 103
1, 14:50:00-000, 632, 385, 247, 266, 1348.89, 247, 1347.82, 83
1, 14:51:00-000, 353, 200, 153, 158, 1348.08, 153, 1347.00, 93
1, 14:52:00-000, 695, 428, 267, 249, 1348.39, 267, 1347.79, 72
1, 14:53:00-000, 280, 169, 111, 113, 1348.22, 111, 1347.32, 133
1, 14:54:00-000, 601, 407, 194, 285, 1348.64, 194, 1347.67, 84
1, 14:55:00-000, 337, 180, 157, 154, 1348.03, 157, 1345.80, 87
1, 14:56:00-000, 709, 414, 295, 277, 1348.21, 295, 1347.25, 84
1, 14:57:00-000, 347, 214, 133, 139, 1348.22, 133, 1347.74, 94
1, 14:58:00-000, 671, 390, 281, 288, 1347.86, 281, 1347.40, 102
1, 14:59:00-000, 267, 110, 157, 103, 1347.29, 157, 1346.60, 73
1, 15:00:00-000, 565, 346, 219, 234, 1349.34, 219, 1348.20, 58
1, 15:01:00-000, 286, 167, 119, 122, 1347.68, 119, 1346.55, 75
1, 15:02:00-000, 598, 340, 258, 211, 1348.28, 258, 1348.05, 76
1, 15:03:00-000, 339, 189, 150, 149, 1347.72, 150, 1346.70, 68
1, 15:04:00-000, 711, 396, 315, 305, 1347.87, 315, 1346.78, 103
1, 15:05:00-000, 348, 187, 161, 130, 1348.39, 161, 1347.55, 69
1, 15:06:00-000, 583, 360, 223, 225, 1348.81, 223, 1347.55, 67
1, 15:07:00-000, 244, 153, 91, 116, 1347.78, 91, 1347.84, 105
1, 15:08:00-000, 592, 351, 241, 215, 1348.23, 241, 1347.81, 69
1, 15:09:00-000, 315, 208, 107, 130, 1348.13, 107, 1348.13, 88
1, 15:10:00-000, 641, 373, 268, 273, 1348.41, 268, 1347.38, 108
1, 15:11:00-000, 315, 156, 159, 138, 1347.87, 159, 1347.32, 78
1, 15:12:00-000, 629, 395, 234, 267, 1347.81, 234, 1347.03, 41
1, 15:13:00-000, 309, 192, 117, 124, 1348.04, 117, 1347.67, 103
1, 15:14:00-000, 647, 370, 277, 245, 1348.77, 277, 1347.95, 97
1, 15:15:00-000, 325, 206, 119, 120, 1348.71, 119, 1348.75, 102
1, 15:16:00-000, 528, 298, 230, 237, 1347.85, 230, 1346.71, 96
1, 15:17:00-000, 300, 164, 136, 113, 1348.31, 136, 1347.60, 76
1, 15:18:00-000, 625, 364, 261, 238, 1348.21, 261, 1347.33, 61
1, 15:19:00-000, 369, 201, 168, 167, 1347.02, 168, 1346.58, 87
1, 15:20:00-000, 635, 425, 210, 259, 1349.19, 210, 1347.68, 78
1, 15:21:00-000, 318, 199, 119, 173, 1347.94, 119, 1347.03, 92
1, 15:22:00-000, 659, 399, 260, 324, 1347.91, 260, 1347.40, 78
1, 15:23:00-000, 336, 170, 166, 153, 1347.07, 166, 1345.72, 37
1, 15:24:00-000, 573, 362, 211, 230, 1348.69, 211, 1348.11, 87
1, 15:25:00-000, 321, 192, 129, 130, 1348.42, 129, 1347.37, 64
1, 15:26:00-000, 656, 345, 311, 253, 1348.03, 311, 1347.27, 93
1, 15:27:00-000, 301, 172, 129, 124, 1348.10, 129, 1347.54, 75
1, 15:28:00-000, 635, 353, 282, 242, 1347.84, 282, 1348.05, 99
1, 15:29:00-000, 346, 199, 147, 146, 1347.73, 147, 1346.50, 59
1, 15:30:00-000, 617, 336, 281, 254, 1348.09, 281, 1347.51, 93
1, 15:31:00-000, 306, 172, 134, 100, 1347.94, 134, 1346.55, 54
1, 15:32:00-000, 581, 368, 213, 260, 1348.15, 213, 1348.01, 119
1, 15:33:00-000, 331, 206, 125, 110, 1348.68, 125, 1348.01, 64
1, 15:34:00-000, 698, 425, 273, 295, 1348.39, 273, 1347.78, 150
1, 15:35:00-000, 342, 207, 135, 123, 1349.50, 135, 1348.88, 73
1, 15:36:00-000, 598, 374, 224, 279, 1348.23, 224, 1347.46, 103
1, 15:37:00-000, 293, 152, 141, 110, 1347.86, 141, 1347.56, 67
1, 15:38:00-000, 557, 345, 212, 243, 1347.55, 212, 1346.97, 76
1, 15:39:00-000, 320, 186, 134, 149, 1348.10, 134, 1346.95, 69
1, 15:40:00-000, 675, 404, 271, 206, 1349.26, 271, 1347.87, 96
1, 15:41:00-000, 315, 183, 132, 92, 1348.59, 132, 1347.48, 149
1, 15:42:00-000, 682, 366, 316, 245, 1348.06, 316, 1346.89, 120
1, 15:43:00-000, 238, 131, 107, 74, 1348.37, 107, 1346.34, 87
1, 15:44:00-000, 676, 436, 240, 294, 1348.54, 236, 1347.38, 94
1, 15:45:00-000, 290, 193, 97, 135, 1347.32, 101, 1347.17, 108
1, 15:46:00-000, 647, 398, 249, 263, 1348.30, 249, 1346.91, 97
1, 15:47:00-000, 311, 182, 129, 112, 1348.32, 129, 1346.92, 79
1, 15:48:00-000, 497, 310, 187, 230, 1347.82, 187, 1347.05, 98
1, 15:49:00-000, 341, 214, 127, 164, 1348.56, 127, 1347.44, 73
1, 15:50:00-000, 644, 386, 258, 260, 1347.25, 258, 1346.67, 92
1, 15:51:00-000, 333, 188, 145, 119, 1347.50, 145, 1346.17, 92
1, 15:52:00-000, 590, 296, 294, 248, 1347.68, 294, 1346.44, 73
1, 15:53:00-000, 301, 179, 122, 116, 1346.65, 122, 1345.68, 40
1, 15:54:00-000, 562, 350, 212, 253, 1348.00, 212, 1346.32, 90
1, 15:55:00-000, 309, 176, 133, 132, 1347.43, 133, 1345.98, 64
1, 15:56:00-000, 610, 345, 265, 230, 1348.23, 265, 1347.52, 80
1, 15:57:00-000, 295, 197, 98, 129, 1348.99, 98, 1348.68, 78
1, 15:58:00-000, 610, 357, 253, 254, 1347.50, 253, 1347.24, 77
1, 15:59:00-000, 334, 171, 163, 128, 1346.80, 163, 1346.53, 81
1, 16:00:00-000, 658, 378, 280, 285, 1348.05, 280, 1347.12, 70
1, 16:01:00-000, 296, 181, 115, 113, 1347.44, 115, 1346.96, 87
1, 16:02:00-000, 591, 379, 212, 263, 1348.68, 212, 1347.78, 75
1, 16:03:00-000, 296, 172, 124, 115, 1347.64, 124, 1347.13, 94
1, 16:04:00-000, 564, 348, 216, 243, 1348.50, 216, 1347.47, 94
1, 16:05:00-000, 310, 192, 118, 105, 1349.09, 118, 1348.00, 76
1, 16:06:00-000, 662, 374, 288, 281, 1346.89, 288, 1346.56, 114
1, 16:07:00-000, 341, 228, 113, 146, 1348.04, 113, 1346.46, 72
1, 16:08:00-000, 658, 417, 241, 282, 1347.80, 241, 1347.52, 87
1, 16:09:00-000, 310, 147, 163, 140, 1347.60, 163, 1347.89, 94
1, 16:10:00-000, 652, 406, 246, 269, 1348.21, 246, 1347.68, 69
1, 16:11:00-000, 268, 150, 118, 105, 1347.73, 118, 1347.16, 89
1, 16:12:00-000, 586, 331, 255, 197, 1348.46, 255, 1347.53, 95
1, 16:13:00-000, 266, 160, 106, 146, 1347.36, 106, 1347.62, 45
1, 16:14:00-000, 664, 376, 288, 268, 1347.25, 288, 1346.49, 90
1, 16:15:00-000, 317, 213, 104, 124, 1347.96, 104, 1346.75, 84
1, 16:16:00-000, 620, 360, 260, 289, 1348.24, 260, 1347.29, 80
1, 16:17:00-000, 322, 176, 146, 139, 1346.69, 146, 1346.25, 62
1, 16:18:00-000, 616, 351, 265, 265, 1346.89, 265, 1346.63, 75
1, 16:19:00-000, 347, 204, 143, 165, 1347.42, 143, 1346.74, 62
1, 16:20:00-000, 619, 358, 261, 317, 1347.48, 261, 1346.31, 40
1, 16:21:00-000, 303, 167, 136, 99, 1348.58, 136, 1347.90, 53
1, 16:22:00-000, 506, 256, 250, 207, 1348.54, 250, 1347.04, 83
1, 16:23:00-000, 272, 159, 113, 114, 1347.77, 113, 1346.90, 30
1, 16:24:00-000, 640, 332, 308, 262, 1347.15, 308, 1346.21, 51
1, 16:25:00-000, 337, 180, 157, 119, 1348.32, 157, 1347.05, 45
1, 16:26:00-000, 564, 302, 262, 272, 1347.63, 262, 1347.22, 85
1, 16:27:00-000, 367, 238, 129, 155, 1348.65, 129, 1348.51, 33
1, 16:28:00-000, 668, 425, 243, 291, 1348.24, 243, 1347.37, 107
1, 16:29:00-000, 247, 157, 90, 121, 1348.16, 90, 1347.49, 101
2, 09:06:00-000, 3120, 0, 3120, 0, 0.00, 1237, 1348.58, 0
2, 09:07:00-000, 0, 0, 0, 0, 0.00, 0, 0.00, 1878
2, 09:08:00-000, 0, 0, 0, 0, 0.00, 0, 0.00, 5
2, 09:13:00-000, 3166, 1237, 1929, 1237, 1352.53, 1564, 1351.28, 0
2, 09:14:00-000, 5, 1, 4, 1, 1356.00, 23, 1355.82, 346
2, 09:15:00-000, 18, 8, 10, 8, 1352.87, 1, 1355.00, 0
2, 09:16:00-000, 173, 87, 86, 83, 1353.59, 95, 1352.80, 0
2, 09:17:00-000, 173, 100, 73, 104, 1358.95, 73, 1355.93, 0
2, 09:18:00-000, 723, 324, 399, 321, 1357.54, 391, 1352.56, 0
2, 09:19:00-000, 377, 214, 163, 217, 1356.27, 159, 1353.09, 0
2, 09:20:00-000, 810, 443, 367, 441, 1355.32, 334, 1353.12, 0
2, 09:21:00-000, 435, 227, 208, 229, 1353.52, 226, 1353.50, 0
2, 09:22:00-000, 506, 204, 302, 204, 1351.98, 236, 1351.62, 31
2, 09:23:00-000, 393, 196, 197, 196, 1353.80, 224, 1353.27, 28
2, 09:24:00-000, 511, 200, 311, 200, 1352.39, 246, 1351.71, 17
2, 09:25:00-000, 320, 164, 156, 164, 1353.37, 172, 1353.39, 15
2, 09:26:00-000, 591, 287, 304, 287, 1354.41, 281, 1352.58, 0
2, 09:27:00-000, 354, 164, 190, 164, 1353.69, 176, 1352.73, 29
2, 09:28:00-000, 616, 307, 309, 307, 1353.98, 272, 1351.92, 33
2, 09:29:00-000, 348, 168, 180, 168, 1352.92, 172, 1352.53, 24
2, 09:30:00-000, 679, 367, 312, 367, 1354.54, 332, 1352.95, 0
2, 09:31:00-000, 268, 136, 132, 136, 1354.32, 115, 1352.98, 0
2, 09:32:00-000, 615, 322, 293, 322, 1355.01, 273, 1352.33, 0
2, 09:33:00-000, 290, 101, 189, 101, 1352.57, 140, 1351.53, 19
2, 09:34:00-000, 688, 305, 383, 305, 1352.09, 302, 1351.51, 65
2, 09:35:00-000, 379, 177, 202, 177, 1351.89, 188, 1351.55, 63
2, 09:36:00-000, 539, 244, 295, 244, 1353.62, 247, 1351.65, 29
2, 09:37:00-000, 302, 144, 158, 144, 1352.41, 156, 1351.19, 31
2, 09:38:00-000, 627, 330, 297, 330, 1353.37, 241, 1352.01, 36
2, 09:39:00-000, 326, 156, 170, 156, 1352.53, 154, 1351.14, 37
2, 09:40:00-000, 562, 243, 319, 243, 1352.69, 263, 1350.76, 28
2, 09:41:00-000, 388, 199, 189, 199, 1353.83, 173, 1352.23, 30
2, 09:42:00-000, 624, 280, 344, 280, 1352.49, 279, 1350.84, 57
2, 09:43:00-000, 306, 112, 194, 112, 1351.58, 153, 1351.94, 25
2, 09:44:00-000, 644, 295, 349, 295, 1352.46, 304, 1352.31, 41
2, 09:45:00-000, 304, 166, 138, 166, 1354.18, 126, 1352.75, 45
2, 09:46:00-000, 612, 280, 332, 280, 1352.24, 288, 1351.77, 27
2, 09:47:00-000, 286, 129, 157, 129, 1352.91, 134, 1351.45, 46
2, 09:48:00-000, 603, 289, 314, 289, 1352.80, 257, 1351.74, 37
2, 09:49:00-000, 366, 169, 197, 169, 1352.92, 172, 1351.11, 28
2, 09:50:00-000, 623, 311, 312, 311, 1353.58, 291, 1352.42, 41
2, 09:51:00-000, 312, 143, 169, 143, 1353.01, 159, 1352.02, 23
2, 09:52:00-000, 657, 296, 361, 296, 1352.74, 310, 1351.40, 19
2, 09:53:00-000, 344, 163, 181, 163, 1353.03, 154, 1351.89, 33
2, 09:54:00-000, 603, 282, 321, 282, 1353.81, 282, 1352.24, 24
2, 09:55:00-000, 306, 155, 151, 155, 1353.56, 135, 1351.68, 32
2, 09:56:00-000, 589, 255, 334, 255, 1352.83, 258, 1352.03, 34
2, 09:57:00-000, 314, 146, 168, 146, 1352.52, 146, 1352.36, 58
2, 09:58:00-000, 693, 319, 374, 319, 1352.66, 276, 1351.79, 50
2, 09:59:00-000, 277, 142, 135, 142, 1352.96, 141, 1352.11, 60
2, 10:00:00-000, 658, 285, 373, 285, 1352.86, 306, 1351.48, 33
2, 10:01:00-000, 310, 145, 165, 145, 1352.72, 140, 1351.14, 57
2, 10:02:00-000, 604, 261, 343, 261, 1352.58, 248, 1351.64, 34
2, 10:03:00-000, 297, 123, 174, 123, 1353.33, 126, 1351.12, 76
2, 10:04:00-000, 666, 288, 378, 288, 1352.15, 278, 1351.78, 91
2, 10:05:00-000, 252, 99, 153, 99, 1352.61, 126, 1351.26, 57
2, 10:06:00-000, 621, 261, 360, 261, 1352.14, 281, 1350.85, 39
2, 10:07:00-000, 292, 154, 138, 154, 1353.40, 132, 1352.55, 58
2, 10:08:00-000, 676, 276, 400, 276, 1352.81, 271, 1351.31, 50
2, 10:09:00-000, 352, 178, 174, 178, 1352.72, 167, 1351.79, 74
2, 10:10:00-000, 681, 264, 417, 264, 1351.77, 301, 1350.96, 65
2, 10:11:00-000, 259, 97, 162, 95, 1351.93, 107, 1351.07, 76
2, 10:12:00-000, 611, 282, 329, 283, 1352.71, 236, 1351.80, 90
2, 10:13:00-000, 304, 134, 170, 134, 1352.97, 122, 1351.45, 57
2, 10:14:00-000, 647, 301, 346, 301, 1352.80, 318, 1351.52, 51
2, 10:15:00-000, 290, 129, 161, 129, 1352.36, 128, 1351.30, 27
2, 10:16:00-000, 668, 289, 379, 289, 1351.89, 312, 1350.74, 57
2, 10:17:00-000, 326, 148, 178, 148, 1352.71, 129, 1352.32, 43
2, 10:18:00-000, 637, 299, 338, 299, 1353.14, 278, 1352.03, 46
2, 10:19:00-000, 308, 123, 185, 123, 1352.74, 149, 1351.12, 63
2, 10:20:00-000, 579, 263, 316, 263, 1352.40, 264, 1351.74, 43
2, 10:21:00-000, 293, 151, 142, 151, 1353.03, 123, 1351.81, 50
2, 10:22:00-000, 623, 255, 368, 255, 1352.94, 292, 1351.81, 42
2, 10:23:00-000, 309, 124, 185, 124, 1352.46, 150, 1351.73, 51
2, 10:24:00-000, 618, 307, 311, 304, 1353.51, 273, 1352.02, 44
2, 10:25:00-000, 323, 128, 195, 131, 1351.99, 115, 1350.67, 37
2, 10:26:00-000, 600, 276, 324, 276, 1353.39, 277, 1352.26, 67
2, 10:27:00-000, 350, 129, 221, 129, 1352.10, 154, 1351.22, 60
2, 10:28:00-000, 647, 278, 369, 278, 1352.51, 318, 1350.85, 58
2, 10:29:00-000, 319, 150, 169, 150, 1353.14, 146, 1351.78, 37
2, 10:30:00-000, 624, 287, 337, 287, 1352.61, 263, 1351.06, 53
2, 10:31:00-000, 317, 145, 172, 145, 1351.27, 130, 1351.27, 67
2, 10:32:00-000, 650, 277, 373, 275, 1351.29, 276, 1350.40, 69
2, 10:33:00-000, 316, 161, 155, 163, 1353.43, 101, 1351.58, 63
2, 10:34:00-000, 605, 247, 358, 247, 1352.98, 286, 1352.00, 66
2, 10:35:00-000, 294, 125, 169, 125, 1352.25, 127, 1351.52, 61
2, 10:36:00-000, 702, 313, 389, 313, 1352.78, 313, 1351.51, 51
2, 10:37:00-000, 311, 109, 202, 109, 1351.68, 158, 1350.42, 57
2, 10:38:00-000, 701, 288, 413, 288, 1351.44, 299, 1350.86, 62
2, 10:39:00-000, 311, 151, 160, 151, 1352.66, 124, 1352.04, 89
2, 10:40:00-000, 636, 279, 357, 279, 1352.60, 265, 1351.50, 68
2, 10:41:00-000, 342, 153, 189, 153, 1352.70, 171, 1351.07, 59
2, 10:42:00-000, 713, 331, 382, 331, 1351.72, 294, 1351.26, 46
2, 10:43:00-000, 292, 134, 158, 134, 1353.13, 132, 1351.48, 70
2, 10:44:00-000, 667, 274, 393, 274, 1352.09, 318, 1351.17, 61
2, 10:45:00-000, 252, 95, 157, 95, 1351.43, 121, 1350.84, 46
2, 10:46:00-000, 624, 293, 331, 293, 1352.10, 277, 1351.21, 44
2, 10:47:00-000, 298, 115, 183, 115, 1352.73, 147, 1351.82, 46
2, 10:48:00-000, 604, 301, 303, 301, 1352.53, 287, 1351.02, 29
2, 10:49:00-000, 280, 114, 166, 114, 1350.74, 131, 1349.64, 30
2, 10:50:00-000, 587, 254, 333, 254, 1352.68, 268, 1350.97, 46
2, 10:51:00-000, 366, 173, 193, 173, 1352.92, 163, 1351.46, 29
2, 10:52:00-000, 659, 328, 331, 328, 1353.04, 241, 1351.71, 78
2, 10:53:00-000, 309, 191, 118, 191, 1354.10, 115, 1351.90, 55
2, 10:54:00-000, 657, 230, 427, 230, 1352.35, 298, 1351.69, 36
2, 10:55:00-000, 329, 108, 221, 108, 1351.26, 131, 1350.60, 103
2, 10:56:00-000, 610, 265, 345, 265, 1353.15, 308, 1351.76, 69
2, 10:57:00-000, 320, 146, 174, 146, 1352.30, 161, 1350.68, 32
2, 10:58:00-000, 614, 264, 350, 264, 1351.92, 269, 1351.10, 48
2, 10:59:00-000, 361, 134, 227, 134, 1351.44, 160, 1350.44, 73
2, 11:00:00-000, 597, 280, 317, 280, 1352.83, 256, 1351.54, 73
2, 11:01:00-000, 366, 210, 156, 210, 1353.13, 158, 1352.38, 40
2, 11:02:00-000, 631, 245, 386, 245, 1353.08, 290, 1350.96, 47
2, 11:03:00-000, 275, 111, 164, 111, 1353.77, 161, 1352.69, 30
2, 11:04:00-000, 671, 320, 351, 320, 1352.84, 287, 1351.48, 42
2, 11:05:00-000, 299, 157, 142, 157, 1352.21, 125, 1351.79, 44
2, 11:06:00-000, 654, 287, 367, 287, 1353.22, 283, 1351.63, 34
2, 11:07:00-000, 280, 137, 143, 137, 1353.44, 162, 1351.45, 44
2, 11:08:00-000, 673, 304, 369, 304, 1352.86, 265, 1351.82, 33
2, 11:09:00-000, 332, 152, 180, 152, 1352.73, 136, 1351.03, 88
2, 11:10:00-000, 557, 252, 305, 252, 1352.06, 272, 1351.28, 36
2, 11:11:00-000, 298, 145, 153, 145, 1352.70, 136, 1351.95, 34
2, 11:12:00-000, 685, 347, 338, 347, 1353.71, 277, 1351.69, 33
2, 11:13:00-000, 290, 135, 155, 135, 1351.69, 108, 1350.91, 53
2, 11:14:00-000, 625, 278, 347, 278, 1352.65, 272, 1350.89, 49
2, 11:15:00-000, 288, 129, 159, 129, 1353.17, 137, 1351.92, 47
2, 11:16:00-000, 576, 249, 327, 249, 1352.63, 250, 1351.63, 79
2, 11:17:00-000, 325, 120, 205, 120, 1351.37, 134, 1350.69, 46
2, 11:18:00-000, 578, 250, 328, 250, 1352.51, 267, 1351.04, 74
2, 11:19:00-000, 329, 160, 169, 160, 1353.45, 142, 1351.76, 49
2, 11:20:00-000, 646, 259, 387, 259, 1351.96, 299, 1350.97, 55
2, 11:21:00-000, 362, 190, 172, 190, 1352.49, 167, 1351.93, 35
2, 11:22:00-000, 544, 243, 301, 243, 1352.89, 245, 1352.00, 41
2, 11:23:00-000, 335, 138, 197, 138, 1353.03, 160, 1351.02, 40
2, 11:24:00-000, 601, 252, 349, 252, 1352.42, 300, 1350.91, 51
2, 11:25:00-000, 404, 190, 214, 190, 1353.10, 181, 1351.27, 39
2, 11:26:00-000, 584, 225, 359, 225, 1351.93, 281, 1350.80, 38
2, 11:27:00-000, 368, 181, 187, 181, 1352.08, 173, 1352.03, 47
2, 11:28:00-000, 653, 267, 386, 267, 1352.38, 280, 1351.18, 62
2, 11:29:00-000, 326, 133, 193, 133, 1350.72, 101, 1349.39, 98
2, 11:30:00-000, 685, 327, 358, 322, 1351.16, 306, 1350.93, 45
2, 11:31:00-000, 276, 139, 137, 142, 1353.47, 113, 1352.55, 61
2, 11:32:00-000, 584, 315, 269, 315, 1354.17, 277, 1352.78, 34
2, 11:33:00-000, 286, 111, 175, 111, 1351.81, 92, 1350.51, 21
2, 11:34:00-000, 673, 304, 369, 304, 1352.22, 305, 1350.57, 89
2, 11:35:00-000, 356, 161, 195, 156, 1351.23, 149, 1350.38, 55
2, 11:36:00-000, 561, 279, 282, 284, 1352.81, 249, 1351.46, 42
2, 11:37:00-000, 333, 153, 180, 153, 1354.04, 144, 1351.18, 23
2, 11:38:00-000, 608, 265, 343, 265, 1353.11, 274, 1351.00, 65
2, 11:39:00-000, 310, 114, 196, 114, 1350.46, 140, 1349.63, 58
2, 11:40:00-000, 564, 258, 306, 258, 1352.18, 304, 1351.68, 29
2, 11:41:00-000, 316, 117, 199, 117, 1351.94, 112, 1350.00, 24
2, 11:42:00-000, 613, 257, 356, 257, 1351.32, 250, 1350.55, 67
2, 11:43:00-000, 307, 140, 167, 140, 1351.69, 141, 1350.52, 104
2, 11:44:00-000, 582, 250, 332, 250, 1352.37, 237, 1351.85, 64
2, 11:45:00-000, 343, 162, 181, 162, 1353.08, 136, 1351.21, 59
2, 11:46:00-000, 567, 229, 338, 229, 1353.40, 276, 1351.34, 56
2, 11:47:00-000, 310, 148, 162, 148, 1352.79, 147, 1351.49, 54
2, 11:48:00-000, 640, 312, 328, 312, 1352.96, 271, 1351.55, 36
2, 11:49:00-000, 277, 117, 160, 117, 1352.16, 101, 1350.74, 59
2, 11:50:00-000, 653, 310, 343, 310, 1352.74, 302, 1351.00, 69
2, 11:51:00-000, 309, 113, 196, 113, 1352.20, 137, 1350.02, 29
2, 11:52:00-000, 596, 257, 339, 257, 1352.43, 275, 1351.43, 82
2, 11:53:00-000, 284, 103, 181, 103, 1351.27, 99, 1351.14, 38
2, 11:54:00-000, 609, 257, 352, 257, 1351.82, 233, 1350.75, 93
2, 11:55:00-000, 360, 147, 213, 147, 1352.42, 190, 1351.42, 69
2, 11:56:00-000, 609, 243, 366, 243, 1350.90, 234, 1350.43, 88
2, 11:57:00-000, 326, 165, 161, 165, 1351.49, 139, 1351.81, 94
2, 11:58:00-000, 631, 319, 312, 319, 1353.20, 269, 1351.80, 37
2, 11:59:00-000, 279, 116, 163, 116, 1352.99, 145, 1351.78, 31
2, 12:00:00-000, 631, 257, 374, 257, 1351.91, 258, 1351.46, 60
2, 12:01:00-000, 312, 133, 179, 133, 1352.65, 116, 1351.08, 63
2, 12:02:00-000, 626, 247, 379, 247, 1352.56, 291, 1351.57, 73
2, 12:03:00-000, 314, 130, 184, 128, 1351.91, 144, 1351.59, 90
2, 12:04:00-000, 626, 282, 344, 282, 1353.03, 288, 1351.82, 41
2, 12:05:00-000, 316, 119, 197, 119, 1351.38, 141, 1350.63, 60
2, 12:06:00-000, 619, 231, 388, 231, 1351.94, 272, 1350.96, 73
2, 12:07:00-000, 273, 149, 124, 149, 1353.14, 123, 1351.17, 77
2, 12:08:00-000, 580, 215, 365, 215, 1351.24, 213, 1351.11, 76
2, 12:09:00-000, 299, 161, 138, 161, 1351.71, 92, 1350.95, 91
2, 12:10:00-000, 595, 268, 327, 268, 1352.65, 225, 1350.87, 62
2, 12:11:00-000, 303, 129, 174, 129, 1352.60, 140, 1351.68, 75
2, 12:12:00-000, 658, 294, 364, 292, 1352.56, 325, 1351.50, 47
2, 12:13:00-000, 287, 140, 147, 142, 1352.99, 133, 1351.90, 48
2, 12:14:00-000, 659, 327, 332, 327, 1352.59, 271, 1351.37, 25
2, 12:15:00-000, 274, 112, 162, 112, 1351.74, 114, 1351.54, 54
2, 12:16:00-000, 634, 242, 392, 242, 1351.64, 292, 1350.78, 70
2, 12:17:00-000, 315, 92, 223, 92, 1350.96, 111, 1350.36, 80
2, 12:18:00-000, 567, 223, 344, 223, 1352.34, 261, 1350.75, 102
2, 12:19:00-000, 279, 141, 138, 141, 1355.07, 159, 1353.73, 44
2, 12:20:00-000, 553, 232, 321, 232, 1351.77, 170, 1350.35, 49
2, 12:21:00-000, 345, 141, 204, 141, 1351.94, 120, 1350.70, 101
2, 12:22:00-000, 697, 301, 396, 298, 1351.52, 219, 1350.41, 144
2, 12:23:00-000, 323, 150, 173, 153, 1352.75, 94, 1350.91, 138
2, 12:24:00-000, 574, 261, 313, 261, 1352.73, 221, 1350.71, 101
2, 12:25:00-000, 297, 108, 189, 108, 1351.99, 124, 1350.15, 71
2, 12:26:00-000, 573, 229, 344, 229, 1351.76, 228, 1350.30, 78
2, 12:27:00-000, 304, 111, 193, 111, 1352.34, 120, 1350.77, 87
2, 12:28:00-000, 638, 219, 419, 219, 1351.87, 235, 1350.91, 121
2, 12:29:00-000, 323, 111, 212, 111, 1352.32, 174, 1350.36, 106
2, 12:30:00-000, 612, 232, 380, 232, 1351.70, 281, 1350.66, 119
2, 12:31:00-000, 295, 91, 204, 91, 1351.81, 129, 1350.65, 62
2, 12:32:00-000, 669, 270, 399, 270, 1351.44, 275, 1350.99, 97
2, 12:33:00-000, 331, 113, 218, 113, 1352.01, 158, 1351.25, 87
2, 12:34:00-000, 572, 237, 335, 237, 1352.22, 242, 1351.31, 105
2, 12:35:00-000, 313, 119, 194, 119, 1351.27, 137, 1351.47, 60
2, 12:36:00-000, 678, 281, 397, 281, 1352.80, 286, 1351.57, 70
2, 12:37:00-000, 350, 137, 213, 137, 1352.28, 172, 1351.01, 91
2, 12:38:00-000, 610, 212, 398, 212, 1351.93, 270, 1350.14, 84
2, 12:39:00-000, 315, 157, 158, 157, 1353.02, 146, 1350.98, 74
2, 12:40:00-000, 620, 327, 293, 327, 1353.47, 210, 1351.28, 76
2, 12:41:00-000, 350, 140, 210, 140, 1352.09, 123, 1350.39, 45
2, 12:42:00-000, 602, 267, 335, 267, 1352.48, 233, 1351.56, 94
2, 12:43:00-000, 313, 133, 180, 133, 1352.04, 141, 1351.22, 80
2, 12:44:00-000, 664, 300, 364, 300, 1351.71, 289, 1350.34, 66
2, 12:45:00-000, 308, 117, 191, 117, 1351.24, 130, 1349.98, 63
2, 12:46:00-000, 586, 243, 343, 243, 1352.55, 269, 1351.13, 55
2, 12:47:00-000, 316, 169, 147, 169, 1354.01, 158, 1352.14, 46
2, 12:48:00-000, 618, 245, 373, 245, 1351.29, 284, 1350.35, 30
2, 12:49:00-000, 309, 117, 192, 117, 1351.56, 129, 1350.31, 83
2, 12:50:00-000, 646, 265, 381, 265, 1352.70, 271, 1351.39, 58
2, 12:51:00-000, 292, 116, 176, 116, 1352.68, 142, 1351.57, 101
2, 12:52:00-000, 663, 299, 364, 299, 1352.27, 270, 1351.30, 68
2, 12:53:00-000, 317, 140, 177, 140, 1351.69, 117, 1351.35, 65
2, 12:54:00-000, 676, 290, 386, 290, 1351.38, 308, 1350.88, 66
2, 12:55:00-000, 343, 164, 179, 164, 1350.80, 160, 1350.86, 56
2, 12:56:00-000, 582, 232, 350, 232, 1351.54, 250, 1350.69, 38
2, 12:57:00-000, 341, 160, 181, 160, 1351.99, 126, 1350.63, 86
2, 12:58:00-000, 573, 221, 352, 221, 1351.81, 246, 1350.78, 90
2, 12:59:00-000, 304, 139, 165, 139, 1352.62, 147, 1350.97, 65
2, 13:00:00-000, 676, 300, 376, 300, 1352.19, 268, 1351.18, 65
2, 13:01:00-000, 321, 180, 141, 180, 1354.12, 125, 1351.86, 60
2, 13:02:00-000, 647, 246, 401, 246, 1350.91, 293, 1350.38, 72
2, 13:03:00-000, 305, 158, 147, 158, 1352.62, 166, 1351.28, 45
2, 13:04:00-000, 670, 253, 417, 253, 1351.28, 233, 1350.50, 46
2, 13:05:00-000, 300, 149, 151, 149, 1352.70, 160, 1352.39, 83
2, 13:06:00-000, 585, 246, 339, 246, 1351.92, 260, 1350.66, 73
2, 13:07:00-000, 343, 112, 231, 112, 1351.78, 149, 1349.74, 70
2, 13:08:00-000, 606, 259, 347, 259, 1352.35, 292, 1350.93, 94
2, 13:09:00-000, 331, 177, 154, 177, 1353.00, 119, 1351.40, 27
2, 13:10:00-000, 638, 265, 373, 265, 1353.02, 317, 1351.53, 37
2, 13:11:00-000, 314, 140, 174, 140, 1352.08, 145, 1351.45, 55
2, 13:12:00-000, 638, 253, 385, 253, 1351.97, 273, 1351.49, 43
2, 13:13:00-000, 339, 156, 183, 156, 1352.92, 155, 1352.30, 71
2, 13:14:00-000, 680, 323, 357, 323, 1352.40, 287, 1350.89, 74
2, 13:15:00-000, 314, 132, 182, 132, 1352.13, 147, 1350.77, 63
2, 13:16:00-000, 584, 272, 312, 272, 1352.48, 258, 1351.83, 33
2, 13:17:00-000, 337, 170, 167, 170, 1353.42, 154, 1352.34, 44
2, 13:18:00-000, 543, 251, 292, 251, 1353.26, 230, 1352.07, 44
2, 13:19:00-000, 339, 143, 196, 143, 1352.01, 174, 1351.13, 44
2, 13:20:00-000, 631, 284, 347, 284, 1352.84, 306, 1351.42, 32
2, 13:21:00-000, 325, 150, 175, 150, 1351.73, 127, 1350.96, 33
2, 13:22:00-000, 649, 352, 297, 352, 1353.62, 262, 1352.17, 44
2, 13:23:00-000, 250, 105, 145, 105, 1353.78, 125, 1351.70, 38
2, 13:24:00-000, 645, 218, 427, 218, 1351.80, 284, 1350.21, 38
2, 13:25:00-000, 278, 143, 135, 143, 1351.79, 130, 1351.11, 84
2, 13:26:00-000, 531, 232, 299, 232, 1351.62, 200, 1350.06, 52
2, 13:27:00-000, 326, 175, 151, 175, 1352.27, 140, 1351.09, 75
2, 13:28:00-000, 666, 320, 346, 319, 1351.95, 242, 1351.16, 51
2, 13:29:00-000, 279, 108, 171, 109, 1351.58, 110, 1349.99, 72
2, 13:30:00-000, 629, 268, 361, 268, 1351.89, 268, 1351.12, 72
2, 13:31:00-000, 338, 106, 232, 106, 1350.54, 118, 1350.34, 87
2, 13:32:00-000, 653, 254, 399, 254, 1352.18, 274, 1351.26, 135
2, 13:33:00-000, 297, 125, 172, 125, 1350.89, 121, 1350.58, 99
2, 13:34:00-000, 612, 219, 393, 219, 1351.81, 271, 1351.27, 58
2, 13:35:00-000, 351, 177, 174, 177, 1353.01, 151, 1351.10, 95
2, 13:36:00-000, 680, 278, 402, 278, 1351.50, 311, 1351.48, 62
2, 13:37:00-000, 278, 116, 162, 116, 1352.28, 116, 1351.70, 74
2, 13:38:00-000, 556, 214, 342, 214, 1351.57, 253, 1350.53, 76
2, 13:39:00-000, 305, 113, 192, 113, 1351.76, 116, 1350.20, 66
2, 13:40:00-000, 712, 324, 388, 324, 1352.85, 341, 1351.79, 63
2, 13:41:00-000, 374, 137, 237, 137, 1351.59, 162, 1351.17, 43
2, 13:42:00-000, 647, 267, 380, 267, 1352.01, 292, 1351.52, 78
2, 13:43:00-000, 358, 164, 194, 164, 1352.50, 144, 1352.16, 62
2, 13:44:00-000, 604, 254, 350, 254, 1351.92, 261, 1350.96, 93
2, 13:45:00-000, 289, 117, 172, 117, 1352.40, 144, 1350.76, 75
2, 13:46:00-000, 627, 326, 301, 326, 1353.08, 266, 1351.26, 24
2, 13:47:00-000, 334, 153, 181, 153, 1352.21, 133, 1352.16, 46
2, 13:48:00-000, 624, 265, 359, 265, 1352.13, 287, 1351.18, 69
2, 13:49:00-000, 319, 178, 141, 178, 1354.11, 146, 1352.42, 32
2, 13:50:00-000, 673, 286, 387, 286, 1351.84, 282, 1350.87, 32
2, 13:51:00-000, 352, 140, 212, 140, 1352.13, 162, 1351.24, 78
2, 13:52:00-000, 615, 273, 342, 273, 1352.21, 254, 1351.56, 69
2, 13:53:00-000, 286, 123, 163, 123, 1352.84, 130, 1351.45, 71
2, 13:54:00-000, 608, 284, 324, 284, 1352.92, 268, 1351.77, 49
2, 13:55:00-000, 367, 177, 190, 177, 1352.76, 180, 1352.12, 43
2, 13:56:00-000, 640, 260, 380, 260, 1352.24, 286, 1351.08, 29
2, 13:57:00-000, 302, 139, 163, 139, 1352.70, 159, 1352.45, 51
2, 13:58:00-000, 561, 241, 320, 241, 1353.20, 257, 1351.79, 43
2, 13:59:00-000, 368, 169, 199, 169, 1352.63, 174, 1352.45, 39
2, 14:00:00-000, 612, 272, 340, 272, 1352.97, 278, 1351.77, 61
2, 14:01:00-000, 339, 131, 208, 131, 1352.28, 144, 1351.45, 41
2, 14:02:00-000, 716, 337, 379, 337, 1352.03, 282, 1351.42, 70
2, 14:03:00-000, 322, 157, 165, 157, 1352.88, 153, 1351.47, 83
2, 14:04:00-000, 661, 314, 347, 314, 1352.11, 292, 1351.63, 31
2, 14:05:00-000, 267, 120, 147, 120, 1352.77, 129, 1350.71, 48
2, 14:06:00-000, 635, 265, 370, 265, 1353.95, 272, 1351.20, 17
2, 14:07:00-000, 324, 130, 194, 130, 1350.66, 145, 1351.08, 89
2, 14:08:00-000, 636, 272, 364, 272, 1351.94, 289, 1351.06, 72
2, 14:09:00-000, 290, 155, 135, 155, 1351.69, 66, 1350.82, 61
2, 14:10:00-000, 576, 254, 322, 254, 1352.15, 271, 1351.32, 51
2, 14:11:00-000, 344, 150, 194, 150, 1352.95, 139, 1351.25, 58
2, 14:12:00-000, 640, 248, 392, 248, 1351.51, 270, 1350.59, 80
2, 14:13:00-000, 318, 150, 168, 150, 1352.51, 135, 1351.21, 97
2, 14:14:00-000, 624, 269, 355, 269, 1351.59, 273, 1350.93, 68
2, 14:15:00-000, 342, 158, 184, 158, 1352.36, 169, 1350.98, 42
2, 14:16:00-000, 637, 234, 403, 234, 1351.90, 252, 1351.20, 58
2, 14:17:00-000, 301, 132, 169, 132, 1352.83, 146, 1352.35, 79
2, 14:18:00-000, 682, 283, 399, 283, 1351.84, 313, 1350.99, 56
2, 14:19:00-000, 280, 107, 173, 107, 1352.06, 130, 1350.89, 93
2, 14:20:00-000, 632, 302, 330, 302, 1353.95, 279, 1352.40, 49
2, 14:21:00-000, 236, 90, 146, 90, 1351.74, 108, 1352.20, 40
2, 14:22:00-000, 649, 322, 327, 322, 1352.69, 261, 1351.40, 44
2, 14:23:00-000, 322, 137, 185, 137, 1352.01, 145, 1350.98, 56
2, 14:24:00-000, 586, 280, 306, 280, 1352.72, 267, 1351.50, 42
2, 14:25:00-000, 309, 142, 167, 142, 1353.23, 130, 1351.84, 47
2, 14:26:00-000, 603, 275, 328, 272, 1352.66, 280, 1350.98, 56
2, 14:27:00-000, 301, 136, 165, 139, 1352.52, 146, 1351.17, 24
2, 14:28:00-000, 580, 231, 349, 231, 1352.44, 276, 1351.62, 33
2, 14:29:00-000, 345, 163, 182, 163, 1352.89, 177, 1350.95, 40
2, 14:30:00-000, 634, 273, 361, 273, 1351.77, 273, 1350.47, 45
2, 14:31:00-000, 287, 131, 156, 131, 1352.27, 119, 1351.63, 49
2, 14:32:00-000, 517, 233, 284, 233, 1353.44, 237, 1351.06, 59
2, 14:33:00-000, 300, 138, 162, 138, 1353.53, 145, 1352.19, 33
2, 14:34:00-000, 666, 323, 343, 323, 1352.63, 262, 1351.50, 53
2, 14:35:00-000, 398, 181, 217, 181, 1352.89, 164, 1352.97, 42
2, 14:36:00-000, 642, 267, 375, 267, 1351.80, 304, 1350.70, 94
2, 14:37:00-000, 279, 163, 116, 163, 1353.40, 132, 1352.70, 22
2, 14:38:00-000, 562, 236, 326, 236, 1352.82, 233, 1350.75, 34
2, 14:39:00-000, 322, 147, 175, 147, 1351.60, 119, 1350.27, 49
2, 14:40:00-000, 643, 271, 372, 271, 1352.28, 265, 1351.05, 72
2, 14:41:00-000, 291, 120, 171, 120, 1351.66, 116, 1350.17, 103
2, 14:42:00-000, 615, 257, 358, 257, 1351.90, 274, 1351.27, 66
2, 14:43:00-000, 312, 144, 168, 144, 1351.84, 135, 1351.28, 59
2, 14:44:00-000, 644, 247, 397, 247, 1352.30, 283, 1351.51, 53
2, 14:45:00-000, 325, 156, 169, 156, 1352.14, 133, 1351.84, 83
2, 14:46:00-000, 648, 297, 351, 297, 1352.17, 273, 1351.34, 83
2, 14:47:00-000, 264, 92, 172, 92, 1351.77, 126, 1350.96, 64
2, 14:48:00-000, 569, 206, 363, 206, 1352.09, 257, 1350.41, 57
2, 14:49:00-000, 333, 128, 205, 128, 1351.25, 140, 1350.38, 98
2, 14:50:00-000, 720, 354, 366, 354, 1352.57, 306, 1351.52, 54
2, 14:51:00-000, 274, 107, 167, 107, 1352.43, 131, 1351.87, 58
2, 14:52:00-000, 588, 277, 311, 277, 1352.41, 248, 1351.71, 63
2, 14:53:00-000, 353, 164, 189, 164, 1352.60, 147, 1351.55, 41
2, 14:54:00-000, 562, 224, 338, 224, 1352.20, 284, 1351.26, 64
2, 14:55:00-000, 343, 129, 214, 129, 1352.30, 165, 1350.78, 23
2, 14:56:00-000, 669, 277, 392, 277, 1352.72, 271, 1351.45, 78
2, 14:57:00-000, 366, 137, 229, 137, 1352.33, 170, 1351.42, 91
2, 14:58:00-000, 693, 290, 403, 290, 1351.63, 320, 1350.97, 84
2, 14:59:00-000, 310, 142, 168, 142, 1352.44, 131, 1351.89, 63
2, 15:00:00-000, 626, 288, 338, 288, 1353.32, 247, 1351.51, 46
2, 15:01:00-000, 327, 150, 177, 150, 1351.84, 149, 1351.07, 73
2, 15:02:00-000, 649, 291, 358, 291, 1352.62, 313, 1351.36, 53
2, 15:03:00-000, 339, 127, 212, 127, 1351.60, 143, 1351.00, 30
2, 15:04:00-000, 662, 327, 335, 327, 1352.29, 279, 1351.17, 73
2, 15:05:00-000, 295, 136, 159, 136, 1352.07, 119, 1351.19, 52
2, 15:06:00-000, 610, 285, 325, 285, 1353.12, 279, 1352.05, 56
2, 15:07:00-000, 280, 121, 159, 121, 1352.63, 123, 1350.50, 37
2, 15:08:00-000, 653, 305, 348, 305, 1352.32, 286, 1351.49, 43
2, 15:09:00-000, 335, 114, 221, 114, 1352.02, 154, 1351.28, 47
2, 15:10:00-000, 586, 260, 326, 260, 1352.16, 263, 1351.78, 59
2, 15:11:00-000, 355, 186, 169, 186, 1352.82, 154, 1351.98, 56
2, 15:12:00-000, 597, 263, 334, 263, 1351.54, 235, 1350.81, 65
2, 15:13:00-000, 361, 149, 212, 149, 1352.73, 130, 1351.10, 70
2, 15:14:00-000, 547, 283, 264, 283, 1353.15, 219, 1352.15, 81
2, 15:15:00-000, 332, 173, 159, 173, 1353.80, 135, 1353.18, 26
2, 15:16:00-000, 641, 247, 394, 247, 1352.41, 282, 1350.53, 56
2, 15:17:00-000, 312, 144, 168, 144, 1353.31, 155, 1351.87, 69
2, 15:18:00-000, 644, 260, 384, 260, 1352.58, 271, 1351.26, 50
2, 15:19:00-000, 362, 132, 230, 132, 1350.32, 157, 1350.07, 94
2, 15:20:00-000, 610, 250, 360, 250, 1352.67, 309, 1351.98, 76
2, 15:21:00-000, 279, 115, 164, 115, 1353.09, 124, 1350.86, 59
2, 15:22:00-000, 650, 277, 373, 277, 1352.41, 258, 1350.67, 65
2, 15:23:00-000, 316, 166, 150, 166, 1352.39, 141, 1351.99, 55
2, 15:24:00-000, 586, 256, 330, 256, 1352.91, 276, 1350.83, 62
2, 15:25:00-000, 256, 117, 139, 117, 1352.25, 89, 1351.35, 36
2, 15:26:00-000, 680, 251, 429, 251, 1352.08, 318, 1350.70, 72
2, 15:27:00-000, 319, 150, 169, 150, 1352.89, 139, 1351.77, 73
2, 15:28:00-000, 671, 304, 367, 304, 1352.64, 302, 1351.29, 30
2, 15:29:00-000, 297, 113, 184, 113, 1351.36, 121, 1350.79, 79
2, 15:30:00-000, 678, 308, 370, 308, 1351.44, 269, 1350.78, 77
2, 15:31:00-000, 301, 133, 168, 133, 1351.46, 131, 1350.96, 58
2, 15:32:00-000, 599, 281, 318, 281, 1352.35, 217, 1350.50, 100
2, 15:33:00-000, 256, 108, 148, 108, 1352.18, 115, 1351.53, 63
2, 15:34:00-000, 612, 267, 345, 267, 1352.57, 288, 1351.20, 61
2, 15:35:00-000, 333, 172, 161, 172, 1352.99, 137, 1351.61, 33
2, 15:36:00-000, 637, 258, 379, 258, 1352.85, 281, 1351.13, 53
2, 15:37:00-000, 289, 143, 146, 143, 1351.75, 82, 1350.02, 78
2, 15:38:00-000, 561, 219, 342, 219, 1351.81, 227, 1350.46, 77
2, 15:39:00-000, 287, 101, 186, 101, 1351.87, 129, 1351.67, 80
2, 15:40:00-000, 644, 284, 360, 284, 1351.43, 211, 1350.68, 99
2, 15:41:00-000, 313, 137, 176, 137, 1351.69, 90, 1350.36, 124
2, 15:42:00-000, 598, 259, 339, 259, 1351.71, 223, 1350.00, 124
2, 15:43:00-000, 299, 140, 159, 140, 1352.96, 80, 1348.96, 57
2, 15:44:00-000, 644, 250, 394, 250, 1352.51, 254, 1350.58, 118
2, 15:45:00-000, 350, 111, 239, 111, 1351.37, 136, 1349.53, 119
2, 15:46:00-000, 598, 212, 386, 212, 1352.00, 276, 1351.07, 111
2, 15:47:00-000, 316, 125, 191, 125, 1351.70, 153, 1350.78, 108
2, 15:48:00-000, 528, 174, 354, 174, 1351.31, 215, 1350.24, 64
2, 15:49:00-000, 380, 132, 248, 132, 1351.24, 189, 1350.09, 94
2, 15:50:00-000, 646, 241, 405, 241, 1351.02, 246, 1350.28, 113
2, 15:51:00-000, 375, 158, 217, 158, 1350.78, 163, 1350.54, 108
2, 15:52:00-000, 583, 226, 357, 226, 1352.15, 246, 1350.85, 84
2, 15:53:00-000, 349, 121, 228, 121, 1351.77, 151, 1349.83, 78
2, 15:54:00-000, 632, 228, 404, 228, 1352.04, 292, 1349.89, 116
2, 15:55:00-000, 316, 135, 181, 135, 1352.91, 148, 1351.48, 69
2, 15:56:00-000, 598, 290, 308, 290, 1353.12, 198, 1351.28, 57
2, 15:57:00-000, 303, 114, 189, 114, 1352.31, 133, 1351.12, 106
2, 15:58:00-000, 692, 322, 370, 322, 1352.79, 293, 1350.96, 76
2, 15:59:00-000, 285, 110, 175, 110, 1351.79, 103, 1350.41, 54
2, 16:00:00-000, 711, 289, 422, 289, 1351.02, 296, 1350.93, 87
2, 16:01:00-000, 366, 175, 191, 175, 1352.13, 141, 1351.26, 94
2, 16:02:00-000, 567, 227, 340, 227, 1352.19, 257, 1351.35, 73
2, 16:03:00-000, 284, 123, 161, 123, 1352.25, 120, 1350.92, 62
2, 16:04:00-000, 616, 229, 387, 229, 1352.09, 288, 1351.78, 95
2, 16:05:00-000, 353, 172, 181, 172, 1352.21, 150, 1351.53, 45
2, 16:06:00-000, 543, 200, 343, 200, 1351.29, 245, 1350.05, 73
2, 16:07:00-000, 325, 151, 174, 151, 1352.18, 144, 1350.90, 59
2, 16:08:00-000, 615, 271, 344, 271, 1351.71, 255, 1350.98, 52
2, 16:09:00-000, 349, 169, 180, 169, 1351.77, 121, 1351.32, 65
2, 16:10:00-000, 637, 286, 351, 286, 1352.82, 301, 1351.81, 70
2, 16:11:00-000, 295, 107, 188, 107, 1352.04, 116, 1350.83, 65
2, 16:12:00-000, 541, 255, 286, 255, 1352.63, 188, 1351.03, 78
2, 16:13:00-000, 310, 164, 146, 164, 1352.60, 101, 1351.30, 86
2, 16:14:00-000, 660, 277, 383, 277, 1352.19, 262, 1351.18, 59
2, 16:15:00-000, 280, 137, 143, 137, 1353.00, 123, 1351.86, 82
2, 16:16:00-000, 647, 258, 389, 258, 1351.78, 270, 1351.01, 71
2, 16:17:00-000, 284, 144, 140, 144, 1352.96, 148, 1351.20, 76
2, 16:18:00-000, 585, 240, 345, 240, 1351.66, 263, 1350.99, 24
2, 16:19:00-000, 329, 111, 218, 111, 1351.75, 159, 1350.28, 57
2, 16:20:00-000, 630, 227, 403, 227, 1351.54, 266, 1350.65, 97
2, 16:21:00-000, 278, 117, 161, 117, 1351.68, 103, 1350.88, 96
2, 16:22:00-000, 721, 275, 446, 275, 1352.27, 333, 1351.51, 67
2, 16:23:00-000, 265, 145, 120, 145, 1353.00, 116, 1352.62, 85
2, 16:24:00-000, 556, 225, 331, 225, 1352.28, 231, 1350.87, 45
2, 16:25:00-000, 260, 130, 130, 130, 1353.26, 114, 1351.92, 55
2, 16:26:00-000, 731, 318, 413, 318, 1351.69, 330, 1350.98, 60
2, 16:27:00-000, 305, 147, 158, 147, 1352.84, 132, 1351.36, 66
2, 16:28:00-000, 563, 214, 349, 214, 1351.38, 254, 1350.89, 60
2, 16:29:00-000, 319, 120, 199, 119, 1352.16, 152, 1351.55, 48
3, 09:00:00-000, 196, 175, 21, 2, 1349.00, 2, 1349.00, 185
3, 09:01:00-000, 217, 217, 0, 0, 0.00, 0, 0.00, 222
3, 09:02:00-000, 212, 212, 0, 0, 0.00, 0, 0.00, 210
3, 09:03:00-000, 193, 193, 0, 0, 0.00, 0, 0.00, 191
3, 09:04:00-000, 216, 216, 0, 0, 0.00, 0, 0.00, 214
3, 09:05:00-000, 205, 205, 0, 0, 0.00, 0, 0.00, 199
3, 09:06:00-000, 168, 168, 0, 0, 0.00, 0, 0.00, 182
3, 09:07:00-000, 228, 228, 0, 0, 0.00, 0, 0.00, 225
3, 09:08:00-000, 181, 181, 0, 0, 0.00, 0, 0.00, 183
3, 09:09:00-000, 172, 172, 0, 0, 0.00, 0, 0.00, 162
3, 09:10:00-000, 190, 190, 0, 2, 1391.00, 0, 0.00, 197
3, 09:11:00-000, 178, 178, 0, 1, 1418.00, 0, 0.00, 174
3, 09:12:00-000, 205, 205, 0, 0, 0.00, 0, 0.00, 202
3, 09:13:00-000, 184, 176, 8, 11, 1441.45, 4, 1353.25, 172
3, 09:14:00-000, 201, 199, 2, 4, 1354.25, 2, 1355.00, 194
3, 09:15:00-000, 232, 232, 0, 1, 1351.00, 0, 0.00, 235
3, 09:16:00-000, 188, 188, 0, 3, 1354.00, 0, 0.00, 186
3, 09:17:00-000, 210, 209, 1, 6, 1371.50, 1, 1360.00, 204
3, 09:18:00-000, 181, 178, 3, 12, 1350.58, 1, 1357.00, 163
3, 09:19:00-000, 185, 151, 34, 9, 1355.11, 14, 1355.21, 156
3, 09:20:00-000, 199, 176, 23, 18, 1351.05, 15, 1352.46, 167
3, 09:21:00-000, 211, 183, 28, 12, 1352.00, 3, 1352.00, 205
3, 09:22:00-000, 184, 137, 47, 3, 1346.67, 2, 1351.00, 177
3, 09:23:00-000, 200, 150, 50, 2, 1347.50, 6, 1350.00, 187
3, 09:24:00-000, 172, 133, 39, 7, 1348.71, 7, 1351.57, 155
3, 09:25:00-000, 241, 212, 29, 7, 1353.57, 12, 1354.67, 230
3, 09:26:00-000, 231, 205, 26, 6, 1351.00, 1, 1350.00, 218
3, 09:27:00-000, 182, 157, 25, 0, 0.00, 2, 1351.00, 188
3, 09:28:00-000, 197, 168, 29, 10, 1348.70, 8, 1351.00, 173
3, 09:29:00-000, 205, 176, 29, 7, 1348.29, 3, 1351.33, 201
3, 09:30:00-000, 208, 177, 31, 16, 1348.19, 9, 1355.78, 179
3, 09:31:00-000, 167, 134, 33, 0, 0.00, 8, 1353.25, 161
3, 09:32:00-000, 182, 144, 38, 17, 1359.41, 7, 1362.43, 155
3, 09:33:00-000, 190, 113, 77, 13, 1349.23, 1, 1353.00, 175
3, 09:34:00-000, 205, 125, 80, 1, 1348.00, 20, 1351.25, 182
3, 09:35:00-000, 206, 187, 19, 1, 1347.00, 7, 1350.00, 185
3, 09:36:00-000, 189, 138, 51, 15, 1348.13, 6, 1351.33, 186
3, 09:37:00-000, 173, 122, 51, 13, 1348.15, 2, 1353.00, 159
3, 09:38:00-000, 194, 138, 56, 7, 1351.14, 17, 1351.70, 160
3, 09:39:00-000, 178, 132, 46, 5, 1350.20, 16, 1350.94, 169
3, 09:40:00-000, 167, 150, 17, 12, 1350.83, 2, 1352.00, 152
3, 09:41:00-000, 191, 157, 34, 5, 1350.00, 9, 1352.67, 179
3, 09:42:00-000, 204, 170, 34, 16, 1347.37, 10, 1352.00, 171
3, 09:43:00-000, 208, 161, 47, 0, 0.00, 3, 1352.00, 207
3, 09:44:00-000, 199, 164, 35, 6, 1351.17, 6, 1349.67, 188
3, 09:45:00-000, 224, 193, 31, 6, 1350.50, 10, 1352.30, 209
3, 09:46:00-000, 184, 159, 25, 13, 1351.15, 4, 1353.50, 166
3, 09:47:00-000, 243, 194, 49, 4, 1349.00, 24, 1351.75, 218
3, 09:48:00-000, 200, 181, 19, 6, 1349.00, 1, 1352.00, 189
3, 09:49:00-000, 203, 181, 22, 8, 1347.62, 6, 1351.33, 190
3, 09:50:00-000, 208, 169, 39, 7, 1351.43, 9, 1354.44, 185
3, 09:51:00-000, 188, 177, 11, 2, 1354.00, 4, 1354.50, 175
3, 09:52:00-000, 179, 140, 39, 13, 1349.61, 1, 1350.00, 181
3, 09:53:00-000, 201, 176, 25, 5, 1345.80, 8, 1353.25, 188
3, 09:54:00-000, 180, 132, 48, 9, 1348.56, 10, 1351.60, 162
3, 09:55:00-000, 248, 175, 73, 5, 1348.00, 0, 0.00, 239
3, 09:56:00-000, 195, 143, 52, 5, 1349.40, 12, 1350.08, 182
3, 09:57:00-000, 227, 199, 28, 9, 1349.44, 7, 1351.14, 206
3, 09:58:00-000, 216, 195, 21, 8, 1347.50, 6, 1349.00, 203
3, 09:59:00-000, 194, 171, 23, 1, 1350.00, 14, 1351.50, 183
3, 10:00:00-000, 212, 180, 32, 11, 1350.73, 6, 1352.33, 191
3, 10:01:00-000, 175, 140, 35, 13, 1354.54, 1, 1356.00, 163
3, 10:02:00-000, 184, 136, 48, 5, 1346.20, 2, 1350.50, 172
3, 10:03:00-000, 185, 97, 88, 4, 1349.50, 3, 1350.00, 182
3, 10:04:00-000, 197, 127, 70, 4, 1350.00, 6, 1350.83, 188
3, 10:05:00-000, 237, 168, 69, 1, 1347.00, 20, 1350.25, 216
3, 10:06:00-000, 215, 181, 34, 8, 1348.12, 6, 1350.00, 201
3, 10:07:00-000, 203, 177, 26, 2, 1348.00, 4, 1350.25, 193
3, 10:08:00-000, 195, 170, 25, 22, 1348.00, 4, 1351.00, 176
3, 10:09:00-000, 210, 150, 60, 4, 1345.00, 7, 1350.00, 199
3, 10:10:00-000, 205, 154, 51, 8, 1348.00, 11, 1352.27, 177
3, 10:11:00-000, 205, 156, 49, 2, 1352.00, 9, 1352.00, 186
3, 10:12:00-000, 217, 145, 72, 32, 1349.03, 8, 1350.62, 185
3, 10:13:00-000, 178, 115, 63, 7, 1349.57, 10, 1351.30, 169
3, 10:14:00-000, 198, 118, 80, 8, 1350.62, 7, 1351.86, 178
3, 10:15:00-000, 209, 130, 79, 2, 1346.00, 7, 1350.71, 192
3, 10:16:00-000, 197, 155, 42, 5, 1347.40, 11, 1350.64, 194
3, 10:17:00-000, 200, 150, 50, 10, 1346.90, 15, 1351.40, 174
3, 10:18:00-000, 200, 147, 53, 11, 1349.27, 24, 1352.41, 163
3, 10:19:00-000, 223, 177, 46, 8, 1347.87, 4, 1351.25, 210
3, 10:20:00-000, 193, 171, 22, 10, 1349.00, 14, 1351.43, 166
3, 10:21:00-000, 178, 169, 9, 6, 1349.33, 7, 1352.29, 170
3, 10:22:00-000, 227, 218, 9, 9, 1353.22, 1, 1350.00, 213
3, 10:23:00-000, 205, 186, 19, 5, 1350.60, 5, 1352.40, 191
3, 10:24:00-000, 180, 170, 10, 10, 1350.70, 9, 1353.55, 171
3, 10:25:00-000, 154, 141, 13, 8, 1351.12, 2, 1351.00, 137
3, 10:26:00-000, 203, 157, 46, 12, 1349.67, 4, 1351.50, 181
3, 10:27:00-000, 229, 131, 98, 4, 1347.50, 9, 1350.00, 226
3, 10:28:00-000, 194, 174, 20, 9, 1350.11, 7, 1352.00, 181
3, 10:29:00-000, 182, 160, 22, 12, 1350.17, 5, 1351.80, 161
3, 10:30:00-000, 172, 133, 39, 13, 1348.15, 3, 1351.33, 159
3, 10:31:00-000, 191, 133, 58, 5, 1350.00, 14, 1350.57, 169
3, 10:32:00-000, 176, 132, 44, 5, 1346.20, 2, 1350.50, 171
3, 10:33:00-000, 195, 111, 84, 14, 1347.50, 11, 1351.36, 170
3, 10:34:00-000, 233, 132, 101, 3, 1348.33, 8, 1351.00, 210
3, 10:35:00-000, 166, 110, 56, 2, 1349.50, 3, 1351.33, 171
3, 10:36:00-000, 198, 159, 39, 20, 1348.55, 11, 1350.27, 169
3, 10:37:00-000, 253, 132, 121, 6, 1348.00, 3, 1351.67, 245
3, 10:38:00-000, 250, 128, 122, 16, 1347.00, 26, 1351.65, 209
3, 10:39:00-000, 182, 137, 45, 5, 1346.00, 10, 1351.40, 162
3, 10:40:00-000, 175, 103, 72, 7, 1348.29, 11, 1351.36, 155
3, 10:41:00-000, 173, 126, 47, 5, 1349.00, 11, 1351.64, 165
3, 10:42:00-000, 225, 186, 39, 14, 1348.43, 12, 1352.08, 191
3, 10:43:00-000, 184, 148, 36, 4, 1349.00, 6, 1351.50, 175
3, 10:44:00-000, 208, 147, 61, 8, 1348.50, 14, 1350.57, 191
3, 10:45:00-000, 226, 178, 48, 20, 1349.25, 5, 1351.40, 195
3, 10:46:00-000, 217, 172, 45, 9, 1347.89, 18, 1350.83, 194
3, 10:47:00-000, 204, 191, 13, 9, 1349.11, 7, 1353.00, 179
3, 10:48:00-000, 250, 193, 57, 29, 1349.10, 19, 1350.89, 204
3, 10:49:00-000, 211, 157, 54, 7, 1345.86, 13, 1351.15, 201
3, 10:50:00-000, 243, 154, 89, 9, 1347.55, 7, 1352.71, 225
3, 10:51:00-000, 204, 95, 109, 11, 1347.73, 0, 0.00, 193
3, 10:52:00-000, 221, 127, 94, 1, 1348.00, 24, 1350.29, 199
3, 10:53:00-000, 183, 150, 33, 2, 1347.50, 7, 1351.86, 169
3, 10:54:00-000, 177, 154, 23, 6, 1348.67, 12, 1351.17, 164
3, 10:55:00-000, 201, 149, 52, 19, 1347.63, 2, 1347.50, 174
3, 10:56:00-000, 195, 154, 41, 10, 1348.00, 7, 1351.71, 181
3, 10:57:00-000, 188, 123, 65, 11, 1347.82, 8, 1350.37, 166
3, 10:58:00-000, 221, 128, 93, 9, 1348.44, 7, 1350.86, 198
3, 10:59:00-000, 202, 116, 86, 10, 1346.70, 22, 1351.32, 180
3, 11:00:00-000, 188, 119, 69, 12, 1347.67, 12, 1352.33, 164
3, 11:01:00-000, 165, 110, 55, 8, 1350.37, 8, 1352.62, 147
3, 11:02:00-000, 208, 152, 56, 15, 1347.93, 5, 1350.60, 188
3, 11:03:00-000, 216, 153, 63, 9, 1348.67, 10, 1350.70, 197
3, 11:04:00-000, 193, 138, 55, 9, 1348.67, 19, 1350.42, 166
3, 11:05:00-000, 181, 147, 34, 11, 1349.36, 2, 1351.00, 163
3, 11:06:00-000, 245, 189, 56, 19, 1349.58, 11, 1351.64, 215
3, 11:07:00-000, 212, 160, 52, 3, 1352.00, 16, 1351.93, 199
3, 11:08:00-000, 198, 149, 49, 5, 1347.80, 2, 1351.00, 179
3, 11:09:00-000, 154, 113, 41, 4, 1347.25, 7, 1352.00, 151
3, 11:10:00-000, 223, 184, 39, 11, 1351.27, 13, 1353.61, 199
3, 11:11:00-000, 197, 171, 26, 3, 1348.33, 3, 1350.33, 193
3, 11:12:00-000, 194, 172, 22, 6, 1348.67, 11, 1350.18, 180
3, 11:13:00-000, 194, 155, 39, 13, 1348.77, 8, 1350.62, 174
3, 11:14:00-000, 217, 157, 60, 25, 1348.87, 18, 1352.61, 166
3, 11:15:00-000, 217, 175, 42, 9, 1349.33, 12, 1350.17, 197
3, 11:16:00-000, 231, 198, 33, 2, 1347.50, 5, 1352.20, 231
3, 11:17:00-000, 195, 147, 48, 12, 1350.33, 1, 1351.00, 179
3, 11:18:00-000, 217, 168, 49, 5, 1348.00, 14, 1351.00, 193
3, 11:19:00-000, 191, 172, 19, 5, 1348.60, 7, 1350.43, 183
3, 11:20:00-000, 197, 148, 49, 20, 1348.95, 11, 1352.09, 170
3, 11:21:00-000, 200, 155, 45, 2, 1347.50, 10, 1351.00, 181
3, 11:22:00-000, 192, 161, 31, 21, 1349.33, 8, 1351.00, 169
3, 11:23:00-000, 214, 154, 60, 2, 1348.50, 2, 1350.00, 212
3, 11:24:00-000, 234, 137, 97, 9, 1347.33, 6, 1349.33, 215
3, 11:25:00-000, 204, 151, 53, 7, 1348.00, 16, 1351.19, 182
3, 11:26:00-000, 247, 179, 68, 23, 1347.43, 15, 1351.00, 195
3, 11:27:00-000, 190, 116, 74, 3, 1350.00, 6, 1352.00, 198
3, 11:28:00-000, 204, 132, 72, 19, 1346.05, 12, 1351.41, 165
3, 11:29:00-000, 187, 111, 76, 1, 1348.00, 8, 1350.62, 168
3, 11:30:00-000, 216, 114, 102, 12, 1347.25, 11, 1352.45, 210
3, 11:31:00-000, 206, 122, 84, 8, 1348.37, 13, 1351.61, 180
3, 11:32:00-000, 194, 146, 48, 11, 1349.54, 14, 1352.07, 174
3, 11:33:00-000, 211, 165, 46, 9, 1349.11, 8, 1349.75, 194
3, 11:34:00-000, 180, 122, 58, 13, 1347.31, 7, 1351.00, 154
3, 11:35:00-000, 184, 146, 38, 0, 0.00, 9, 1351.78, 181
3, 11:36:00-000, 192, 132, 60, 13, 1351.92, 18, 1353.05, 160
3, 11:37:00-000, 191, 154, 37, 5, 1347.00, 4, 1351.25, 173
3, 11:38:00-000, 193, 150, 43, 11, 1347.73, 4, 1350.75, 188
3, 11:39:00-000, 165, 121, 44, 4, 1347.00, 11, 1349.27, 144
3, 11:40:00-000, 185, 159, 26, 11, 1349.09, 11, 1351.54, 170
3, 11:41:00-000, 230, 195, 35, 10, 1347.10, 0, 0.00, 210
3, 11:42:00-000, 206, 173, 33, 11, 1348.64, 4, 1350.00, 189
3, 11:43:00-000, 228, 125, 103, 10, 1348.60, 16, 1350.62, 211
3, 11:44:00-000, 221, 151, 70, 13, 1348.54, 18, 1351.50, 190
3, 11:45:00-000, 224, 183, 41, 12, 1349.00, 25, 1352.24, 186
3, 11:46:00-000, 179, 144, 35, 19, 1347.89, 8, 1351.62, 154
3, 11:47:00-000, 213, 172, 41, 2, 1351.00, 2, 1352.00, 208
3, 11:48:00-000, 224, 147, 77, 18, 1348.94, 17, 1350.82, 187
3, 11:49:00-000, 207, 138, 69, 6, 1347.83, 6, 1351.50, 198
3, 11:50:00-000, 226, 150, 76, 13, 1351.08, 26, 1351.81, 189
3, 11:51:00-000, 177, 123, 54, 8, 1350.25, 5, 1353.00, 158
3, 11:52:00-000, 197, 132, 65, 12, 1348.92, 14, 1352.86, 174
3, 11:53:00-000, 206, 181, 25, 3, 1350.67, 13, 1351.69, 183
3, 11:54:00-000, 208, 179, 29, 22, 1348.82, 8, 1351.37, 179
3, 11:55:00-000, 196, 180, 16, 3, 1349.33, 3, 1351.33, 196
3, 11:56:00-000, 226, 151, 75, 17, 1347.06, 13, 1351.54, 190
3, 11:57:00-000, 199, 160, 39, 18, 1348.89, 14, 1351.93, 174
3, 11:58:00-000, 210, 172, 38, 21, 1346.90, 8, 1351.00, 183
3, 11:59:00-000, 198, 126, 72, 3, 1350.33, 21, 1350.90, 168
3, 12:00:00-000, 223, 182, 41, 12, 1348.58, 13, 1349.92, 199
3, 12:01:00-000, 184, 163, 21, 2, 1349.50, 4, 1352.75, 176
3, 12:02:00-000, 213, 156, 57, 23, 1347.82, 7, 1350.86, 182
3, 12:03:00-000, 185, 105, 80, 1, 1348.00, 2, 1350.00, 187
3, 12:04:00-000, 199, 129, 70, 10, 1348.30, 9, 1351.22, 171
3, 12:05:00-000, 187, 102, 85, 12, 1347.16, 15, 1350.93, 167
3, 12:06:00-000, 194, 102, 92, 9, 1347.33, 6, 1350.33, 172
3, 12:07:00-000, 198, 148, 50, 4, 1347.25, 17, 1351.41, 188
3, 12:08:00-000, 222, 185, 37, 19, 1348.73, 9, 1351.33, 188
3, 12:09:00-000, 213, 119, 94, 11, 1349.45, 13, 1350.77, 192
3, 12:10:00-000, 222, 96, 126, 9, 1347.89, 4, 1351.50, 209
3, 12:11:00-000, 209, 141, 68, 4, 1346.00, 7, 1350.71, 201
3, 12:12:00-000, 205, 163, 42, 7, 1350.71, 16, 1350.62, 180
3, 12:13:00-000, 215, 193, 22, 10, 1350.70, 15, 1351.73, 190
3, 12:14:00-000, 218, 201, 17, 14, 1349.86, 12, 1351.50, 195
3, 12:15:00-000, 210, 176, 34, 11, 1348.73, 9, 1350.44, 180
3, 12:16:00-000, 204, 149, 55, 15, 1348.53, 6, 1350.00, 176
3, 12:17:00-000, 175, 104, 71, 8, 1348.25, 6, 1351.33, 176
3, 12:18:00-000, 184, 130, 54, 7, 1347.43, 27, 1351.81, 152
3, 12:19:00-000, 202, 167, 35, 12, 1352.42, 14, 1352.14, 174
3, 12:20:00-000, 180, 158, 22, 4, 1349.00, 1, 1351.00, 176
3, 12:21:00-000, 202, 185, 17, 8, 1348.25, 3, 1351.33, 188
3, 12:22:00-000, 216, 184, 32, 17, 1347.88, 5, 1351.40, 185
3, 12:23:00-000, 209, 139, 70, 5, 1348.00, 2, 1352.00, 210
3, 12:24:00-000, 194, 122, 72, 18, 1349.05, 24, 1352.25, 152
3, 12:25:00-000, 208, 159, 49, 11, 1349.27, 2, 1350.00, 187
3, 12:26:00-000, 215, 129, 86, 10, 1345.70, 3, 1352.33, 203
3, 12:27:00-000, 212, 114, 98, 10, 1347.60, 8, 1351.37, 206
3, 12:28:00-000, 222, 102, 120, 19, 1349.63, 19, 1351.52, 176
3, 12:29:00-000, 230, 125, 105, 4, 1347.50, 6, 1350.33, 222
3, 12:30:00-000, 190, 92, 98, 2, 1348.00, 9, 1350.89, 182
3, 12:31:00-000, 213, 126, 87, 2, 1348.00, 7, 1350.57, 202
3, 12:32:00-000, 208, 144, 64, 0, 0.00, 9, 1352.89, 195
3, 12:33:00-000, 178, 146, 32, 4, 1351.00, 14, 1350.86, 163
3, 12:34:00-000, 210, 166, 44, 18, 1347.94, 13, 1352.38, 171
3, 12:35:00-000, 175, 128, 47, 5, 1350.00, 14, 1350.50, 157
3, 12:36:00-000, 185, 130, 55, 9, 1347.00, 7, 1351.29, 180
3, 12:37:00-000, 200, 143, 57, 8, 1348.00, 11, 1350.36, 175
3, 12:38:00-000, 197, 176, 21, 27, 1348.92, 7, 1352.57, 160
3, 12:39:00-000, 245, 127, 118, 20, 1350.70, 14, 1351.43, 208
3, 12:40:00-000, 175, 127, 48, 3, 1347.33, 12, 1351.00, 173
3, 12:41:00-000, 188, 163, 25, 1, 1348.00, 2, 1351.00, 180
3, 12:42:00-000, 216, 189, 27, 12, 1347.58, 3, 1350.33, 205
3, 12:43:00-000, 215, 137, 78, 5, 1346.20, 14, 1351.64, 190
3, 12:44:00-000, 216, 169, 47, 19, 1347.05, 8, 1351.50, 195
3, 12:45:00-000, 224, 168, 56, 19, 1348.89, 18, 1350.78, 186
3, 12:46:00-000, 206, 155, 51, 10, 1348.70, 10, 1351.90, 175
3, 12:47:00-000, 217, 167, 50, 7, 1349.00, 5, 1351.00, 217
3, 12:48:00-000, 180, 118, 62, 7, 1347.29, 13, 1351.84, 151
3, 12:49:00-000, 190, 129, 61, 10, 1348.50, 11, 1350.73, 171
3, 12:50:00-000, 205, 138, 67, 18, 1348.00, 14, 1350.43, 180
3, 12:51:00-000, 210, 136, 74, 10, 1347.80, 23, 1351.91, 177
3, 12:52:00-000, 213, 150, 63, 11, 1347.18, 6, 1351.17, 183
3, 12:53:00-000, 205, 142, 63, 11, 1350.54, 12, 1350.83, 193
3, 12:54:00-000, 204, 155, 49, 6, 1350.00, 10, 1351.30, 182
3, 12:55:00-000, 210, 152, 58, 5, 1349.40, 4, 1352.00, 197
3, 12:56:00-000, 211, 165, 46, 7, 1347.29, 6, 1350.67, 204
3, 12:57:00-000, 194, 154, 40, 14, 1347.14, 4, 1351.75, 179
3, 12:58:00-000, 179, 83, 96, 22, 1347.50, 14, 1348.07, 145
3, 12:59:00-000, 194, 129, 65, 1, 1349.00, 8, 1351.00, 186
3, 13:00:00-000, 219, 175, 44, 7, 1346.71, 13, 1351.00, 182
3, 13:01:00-000, 207, 161, 46, 11, 1348.00, 6, 1351.33, 203
3, 13:02:00-000, 199, 117, 82, 11, 1347.63, 11, 1351.09, 174
3, 13:03:00-000, 212, 146, 66, 5, 1348.40, 12, 1351.75, 201
3, 13:04:00-000, 224, 154, 70, 28, 1347.92, 15, 1350.87, 173
3, 13:05:00-000, 195, 109, 86, 9, 1349.22, 10, 1351.40, 186
3, 13:06:00-000, 182, 143, 39, 8, 1347.00, 23, 1350.95, 149
3, 13:07:00-000, 201, 178, 23, 20, 1346.70, 7, 1351.00, 177
3, 13:08:00-000, 200, 132, 68, 10, 1347.30, 11, 1351.18, 171
3, 13:09:00-000, 212, 118, 94, 8, 1347.62, 8, 1350.25, 197
3, 13:10:00-000, 202, 102, 100, 4, 1346.75, 4, 1351.25, 183
3, 13:11:00-000, 194, 128, 66, 11, 1349.27, 17, 1350.29, 182
3, 13:12:00-000, 205, 115, 90, 13, 1348.38, 11, 1351.64, 179
3, 13:13:00-000, 197, 131, 66, 14, 1347.79, 5, 1350.40, 179
3, 13:14:00-000, 205, 115, 90, 8, 1346.87, 10, 1351.20, 184
3, 13:15:00-000, 174, 135, 39, 2, 1348.00, 9, 1350.67, 168
3, 13:16:00-000, 242, 197, 45, 34, 1349.11, 14, 1351.71, 184
3, 13:17:00-000, 191, 127, 64, 2, 1349.00, 11, 1351.36, 189
3, 13:18:00-000, 178, 145, 33, 13, 1348.69, 10, 1352.40, 148
3, 13:19:00-000, 226, 136, 90, 4, 1347.25, 17, 1350.59, 210
3, 13:20:00-000, 208, 136, 72, 22, 1348.13, 19, 1352.37, 165
3, 13:21:00-000, 231, 179, 52, 6, 1349.33, 10, 1352.20, 213
3, 13:22:00-000, 172, 127, 45, 5, 1349.20, 12, 1351.00, 155
3, 13:23:00-000, 179, 146, 33, 2, 1348.00, 0, 0.00, 183
3, 13:24:00-000, 188, 138, 50, 10, 1348.20, 8, 1350.13, 163
3, 13:25:00-000, 219, 175, 44, 12, 1347.17, 13, 1351.15, 196
3, 13:26:00-000, 198, 124, 74, 15, 1348.40, 12, 1351.08, 173
3, 13:27:00-000, 206, 164, 42, 2, 1348.00, 11, 1350.91, 191
3, 13:28:00-000, 190, 157, 33, 16, 1349.37, 10, 1351.70, 157
3, 13:29:00-000, 215, 158, 57, 19, 1347.05, 4, 1351.00, 202
3, 13:30:00-000, 213, 114, 99, 16, 1346.81, 15, 1350.60, 182
3, 13:31:00-000, 186, 103, 83, 17, 1347.47, 12, 1350.58, 159
3, 13:32:00-000, 217, 110, 107, 9, 1348.11, 24, 1351.50, 175
3, 13:33:00-000, 178, 122, 56, 6, 1347.67, 5, 1350.40, 159
3, 13:34:00-000, 196, 162, 34, 1, 1345.00, 4, 1350.50, 205
3, 13:35:00-000, 204, 176, 28, 1, 1349.00, 4, 1350.75, 201
3, 13:36:00-000, 194, 155, 39, 17, 1347.94, 10, 1352.10, 159
3, 13:37:00-000, 214, 136, 78, 2, 1346.00, 17, 1350.65, 200
3, 13:38:00-000, 188, 134, 54, 10, 1347.70, 5, 1350.20, 169
3, 13:39:00-000, 224, 181, 43, 0, 0.00, 10, 1350.30, 217
3, 13:40:00-000, 224, 170, 54, 10, 1349.60, 4, 1352.50, 211
3, 13:41:00-000, 180, 142, 38, 5, 1349.00, 5, 1351.20, 164
3, 13:42:00-000, 173, 111, 62, 13, 1347.77, 16, 1351.69, 152
3, 13:43:00-000, 189, 147, 42, 4, 1347.00, 2, 1349.00, 184
3, 13:44:00-000, 221, 133, 88, 28, 1349.39, 28, 1351.67, 155
3, 13:45:00-000, 225, 164, 61, 7, 1348.00, 13, 1352.00, 212
3, 13:46:00-000, 215, 177, 38, 13, 1348.08, 4, 1351.00, 201
3, 13:47:00-000, 202, 149, 53, 9, 1346.78, 6, 1351.00, 182
3, 13:48:00-000, 205, 162, 43, 23, 1348.43, 13, 1351.15, 165
3, 13:49:00-000, 232, 133, 99, 21, 1348.52, 18, 1350.44, 202
3, 13:50:00-000, 156, 84, 72, 5, 1349.00, 13, 1352.15, 136
3, 13:51:00-000, 178, 137, 41, 6, 1349.67, 16, 1351.12, 158
3, 13:52:00-000, 189, 123, 66, 34, 1346.82, 21, 1352.00, 135
3, 13:53:00-000, 176, 134, 42, 6, 1349.33, 16, 1353.06, 150
3, 13:54:00-000, 211, 161, 50, 16, 1351.19, 13, 1351.77, 178
3, 13:55:00-000, 184, 133, 51, 4, 1350.50, 10, 1353.80, 173
3, 13:56:00-000, 189, 139, 50, 16, 1351.25, 8, 1352.37, 162
3, 13:57:00-000, 194, 97, 97, 10, 1348.50, 13, 1350.08, 176
3, 13:58:00-000, 193, 137, 56, 11, 1351.73, 15, 1350.87, 165
3, 13:59:00-000, 202, 140, 62, 5, 1352.00, 14, 1352.14, 187
3, 14:00:00-000, 209, 184, 25, 13, 1351.08, 9, 1352.67, 184
3, 14:01:00-000, 214, 167, 47, 11, 1349.54, 8, 1350.50, 187
3, 14:02:00-000, 191, 130, 61, 27, 1349.33, 8, 1352.37, 162
3, 14:03:00-000, 175, 90, 85, 3, 1350.67, 13, 1351.69, 155
3, 14:04:00-000, 168, 102, 66, 8, 1349.50, 16, 1350.81, 154
3, 14:05:00-000, 217, 167, 50, 7, 1350.14, 7, 1351.28, 199
3, 14:06:00-000, 208, 150, 58, 23, 1347.74, 14, 1351.00, 171
3, 14:07:00-000, 232, 133, 99, 5, 1348.00, 8, 1352.25, 219
3, 14:08:00-000, 215, 89, 126, 20, 1349.30, 13, 1351.15, 184
3, 14:09:00-000, 206, 108, 98, 25, 1349.24, 21, 1350.38, 152
3, 14:10:00-000, 197, 152, 45, 8, 1347.37, 14, 1352.00, 176
3, 14:11:00-000, 195, 152, 43, 0, 0.00, 3, 1350.33, 196
3, 14:12:00-000, 180, 131, 49, 15, 1348.33, 6, 1351.00, 163
3, 14:13:00-000, 222, 140, 82, 3, 1346.33, 20, 1351.30, 192
3, 14:14:00-000, 206, 133, 73, 8, 1346.62, 9, 1349.89, 182
3, 14:15:00-000, 199, 149, 50, 4, 1348.25, 10, 1351.70, 198
3, 14:16:00-000, 208, 188, 20, 10, 1350.30, 15, 1351.80, 178
3, 14:17:00-000, 197, 174, 23, 10, 1347.60, 0, 0.00, 190
3, 14:18:00-000, 217, 188, 29, 18, 1351.00, 20, 1351.85, 173
3, 14:19:00-000, 195, 177, 18, 3, 1349.33, 8, 1350.38, 192
3, 14:20:00-000, 177, 138, 39, 17, 1348.65, 3, 1350.00, 155
3, 14:21:00-000, 193, 126, 67, 15, 1348.26, 17, 1351.47, 163
3, 14:22:00-000, 200, 175, 25, 23, 1349.52, 11, 1353.00, 163
3, 14:23:00-000, 236, 140, 96, 10, 1347.40, 14, 1352.93, 208
3, 14:24:00-000, 213, 176, 37, 8, 1350.50, 18, 1350.55, 188
3, 14:25:00-000, 187, 152, 35, 13, 1348.31, 9, 1350.67, 170
3, 14:26:00-000, 224, 178, 46, 15, 1348.33, 17, 1352.47, 187
3, 14:27:00-000, 182, 141, 41, 14, 1351.14, 7, 1353.00, 163
3, 14:28:00-000, 203, 142, 61, 15, 1347.93, 23, 1351.17, 170
3, 14:29:00-000, 206, 159, 47, 13, 1350.07, 4, 1351.00, 189
3, 14:30:00-000, 201, 138, 63, 14, 1350.00, 12, 1352.50, 171
3, 14:31:00-000, 221, 140, 81, 8, 1348.63, 11, 1351.09, 199
3, 14:32:00-000, 202, 145, 57, 3, 1348.33, 15, 1350.13, 176
3, 14:33:00-000, 212, 178, 34, 7, 1349.29, 11, 1351.91, 210
3, 14:34:00-000, 192, 169, 23, 10, 1347.00, 3, 1350.67, 176
3, 14:35:00-000, 200, 146, 54, 11, 1348.73, 12, 1352.00, 178
3, 14:36:00-000, 192, 143, 49, 6, 1347.17, 9, 1350.78, 168
3, 14:37:00-000, 209, 181, 28, 8, 1349.50, 10, 1350.20, 198
3, 14:38:00-000, 252, 182, 70, 33, 1350.15, 11, 1352.91, 205
3, 14:39:00-000, 217, 127, 90, 12, 1346.25, 7, 1350.00, 198
3, 14:40:00-000, 200, 95, 105, 12, 1347.00, 8, 1350.25, 184
3, 14:41:00-000, 188, 105, 83, 0, 0.00, 9, 1350.44, 177
3, 14:42:00-000, 206, 127, 79, 10, 1348.70, 14, 1351.14, 182
3, 14:43:00-000, 189, 134, 55, 7, 1347.71, 8, 1351.25, 176
3, 14:44:00-000, 222, 118, 104, 17, 1349.06, 8, 1351.37, 198
3, 14:45:00-000, 216, 94, 122, 5, 1347.80, 11, 1351.73, 193
3, 14:46:00-000, 188, 122, 66, 12, 1349.92, 21, 1350.95, 163
3, 14:47:00-000, 181, 109, 72, 9, 1346.44, 10, 1350.80, 158
3, 14:48:00-000, 214, 106, 108, 18, 1348.05, 11, 1351.91, 183
3, 14:49:00-000, 169, 107, 62, 5, 1347.00, 19, 1351.10, 142
3, 14:50:00-000, 205, 159, 46, 11, 1347.45, 4, 1350.50, 189
3, 14:51:00-000, 206, 154, 52, 2, 1349.50, 7, 1351.71, 207
3, 14:52:00-000, 189, 119, 70, 21, 1348.14, 12, 1350.17, 156
3, 14:53:00-000, 210, 167, 43, 4, 1346.50, 11, 1351.73, 193
3, 14:54:00-000, 211, 158, 53, 22, 1348.04, 9, 1351.78, 176
3, 14:55:00-000, 177, 100, 77, 7, 1347.86, 14, 1351.21, 160
3, 14:56:00-000, 207, 93, 114, 26, 1347.34, 21, 1350.71, 160
3, 14:57:00-000, 176, 93, 83, 12, 1348.42, 30, 1351.43, 135
3, 14:58:00-000, 230, 184, 46, 18, 1348.78, 5, 1351.20, 205
3, 14:59:00-000, 217, 162, 55, 9, 1348.11, 16, 1351.44, 191
3, 15:00:00-000, 194, 155, 39, 16, 1349.00, 13, 1351.61, 168
3, 15:01:00-000, 183, 143, 40, 9, 1349.78, 10, 1352.60, 155
3, 15:02:00-000, 201, 156, 45, 13, 1349.85, 7, 1350.14, 191
3, 15:03:00-000, 213, 134, 79, 8, 1347.00, 11, 1351.64, 190
3, 15:04:00-000, 204, 109, 95, 7, 1348.57, 10, 1349.50, 181
3, 15:05:00-000, 194, 105, 89, 20, 1347.80, 9, 1351.22, 165
3, 15:06:00-000, 170, 124, 46, 18, 1349.50, 17, 1352.65, 144
3, 15:07:00-000, 193, 150, 43, 7, 1347.71, 7, 1351.43, 171
3, 15:08:00-000, 217, 154, 63, 6, 1348.33, 7, 1353.00, 211
3, 15:09:00-000, 224, 157, 67, 8, 1349.00, 12, 1351.25, 201
3, 15:10:00-000, 196, 131, 65, 11, 1347.64, 7, 1350.86, 183
3, 15:11:00-000, 180, 124, 56, 4, 1348.00, 4, 1352.25, 168
3, 15:12:00-000, 230, 148, 82, 9, 1347.67, 12, 1350.66, 192
3, 15:13:00-000, 214, 157, 57, 9, 1348.11, 17, 1351.35, 204
3, 15:14:00-000, 161, 131, 30, 8, 1348.25, 8, 1351.37, 144
3, 15:15:00-000, 202, 155, 47, 2, 1350.50, 13, 1351.23, 187
3, 15:16:00-000, 202, 156, 46, 29, 1347.48, 6, 1350.67, 172
3, 15:17:00-000, 178, 114, 64, 13, 1348.15, 15, 1352.67, 151
3, 15:18:00-000, 208, 157, 51, 3, 1347.67, 10, 1351.30, 192
3, 15:19:00-000, 196, 125, 71, 12, 1347.50, 3, 1351.33, 181
3, 15:20:00-000, 206, 123, 83, 16, 1348.75, 19, 1352.26, 163
3, 15:21:00-000, 218, 152, 66, 13, 1346.84, 17, 1350.47, 192
3, 15:22:00-000, 218, 155, 63, 19, 1346.84, 17, 1351.41, 189
3, 15:23:00-000, 214, 132, 82, 1, 1347.00, 9, 1350.22, 197
3, 15:24:00-000, 213, 184, 29, 13, 1349.23, 3, 1352.33, 199
3, 15:25:00-000, 177, 130, 47, 15, 1349.27, 18, 1351.27, 148
3, 15:26:00-000, 225, 147, 78, 19, 1348.37, 12, 1352.00, 192
3, 15:27:00-000, 194, 113, 81, 8, 1349.00, 11, 1350.82, 166
3, 15:28:00-000, 188, 107, 81, 7, 1348.00, 25, 1351.28, 162
3, 15:29:00-000, 186, 124, 62, 8, 1347.62, 7, 1350.86, 177
3, 15:30:00-000, 210, 156, 54, 20, 1347.75, 18, 1351.72, 173
3, 15:31:00-000, 194, 140, 54, 4, 1350.00, 9, 1352.00, 177
3, 15:32:00-000, 230, 163, 67, 21, 1348.09, 19, 1350.31, 192
3, 15:33:00-000, 220, 173, 47, 5, 1348.20, 22, 1350.77, 192
3, 15:34:00-000, 185, 169, 16, 24, 1347.71, 3, 1351.00, 157
3, 15:35:00-000, 178, 128, 50, 13, 1350.61, 17, 1352.29, 146
3, 15:36:00-000, 198, 141, 57, 17, 1349.00, 17, 1350.76, 169
3, 15:37:00-000, 213, 181, 32, 9, 1349.44, 11, 1351.54, 191
3, 15:38:00-000, 181, 173, 8, 5, 1349.40, 4, 1351.50, 174
3, 15:39:00-000, 180, 144, 36, 9, 1348.11, 2, 1350.00, 168
3, 15:40:00-000, 192, 130, 62, 20, 1349.05, 3, 1350.67, 165
3, 15:41:00-000, 191, 140, 51, 6, 1348.83, 16, 1350.62, 170
3, 15:42:00-000, 220, 162, 58, 19, 1347.42, 4, 1351.00, 193
3, 15:43:00-000, 174, 116, 58, 3, 1346.33, 8, 1351.00, 160
3, 15:44:00-000, 185, 134, 51, 5, 1349.00, 13, 1350.46, 177
3, 15:45:00-000, 242, 191, 51, 10, 1348.10, 9, 1350.78, 223
3, 15:46:00-000, 217, 134, 83, 14, 1349.28, 21, 1351.90, 174
3, 15:47:00-000, 192, 136, 56, 6, 1352.50, 16, 1352.44, 178
3, 15:48:00-000, 204, 149, 55, 10, 1349.10, 12, 1350.67, 176
3, 15:49:00-000, 214, 139, 75, 23, 1350.43, 6, 1351.00, 188
3, 15:50:00-000, 237, 123, 114, 15, 1347.20, 9, 1351.89, 213
3, 15:51:00-000, 196, 110, 86, 4, 1350.00, 3, 1349.00, 194
3, 15:52:00-000, 201, 126, 75, 8, 1347.87, 13, 1350.54, 178
3, 15:53:00-000, 204, 136, 68, 13, 1347.38, 9, 1351.55, 177
3, 15:54:00-000, 166, 107, 59, 7, 1345.43, 8, 1351.12, 155
3, 15:55:00-000, 184, 141, 43, 5, 1348.00, 11, 1351.09, 163
3, 15:56:00-000, 179, 145, 34, 5, 1350.40, 15, 1351.06, 163
3, 15:57:00-000, 202, 155, 47, 18, 1349.89, 5, 1350.80, 182
3, 15:58:00-000, 195, 139, 56, 6, 1348.50, 7, 1350.14, 181
3, 15:59:00-000, 178, 114, 64, 8, 1351.00, 18, 1350.83, 151
3, 16:00:00-000, 220, 148, 72, 19, 1347.42, 20, 1350.95, 182
3, 16:01:00-000, 195, 171, 24, 16, 1348.31, 11, 1351.09, 164
3, 16:02:00-000, 231, 177, 54, 14, 1349.93, 18, 1351.83, 204
3, 16:03:00-000, 219, 189, 30, 3, 1350.00, 9, 1353.00, 193
3, 16:04:00-000, 212, 159, 53, 24, 1349.20, 11, 1351.27, 184
3, 16:05:00-000, 204, 138, 66, 10, 1348.70, 11, 1350.64, 188
3, 16:06:00-000, 207, 147, 60, 20, 1347.10, 6, 1351.50, 182
3, 16:07:00-000, 204, 79, 125, 8, 1346.38, 10, 1350.90, 182
3, 16:08:00-000, 219, 116, 103, 17, 1348.23, 29, 1351.07, 173
3, 16:09:00-000, 205, 150, 55, 10, 1349.00, 10, 1350.80, 190
3, 16:10:00-000, 222, 148, 74, 11, 1350.54, 20, 1351.85, 191
3, 16:11:00-000, 207, 147, 60, 1, 1350.00, 8, 1353.00, 196
3, 16:12:00-000, 192, 170, 22, 16, 1346.75, 9, 1351.67, 166
3, 16:13:00-000, 224, 199, 25, 8, 1348.50, 1, 1351.00, 206
3, 16:14:00-000, 208, 132, 76, 12, 1347.17, 10, 1350.70, 194
3, 16:15:00-000, 179, 109, 70, 2, 1345.00, 12, 1352.50, 168
3, 16:16:00-000, 201, 169, 32, 27, 1348.66, 9, 1351.89, 164
3, 16:17:00-000, 190, 119, 71, 12, 1347.50, 3, 1352.33, 177
3, 16:18:00-000, 213, 126, 87, 10, 1347.00, 25, 1350.28, 178
3, 16:19:00-000, 193, 122, 71, 1, 1349.00, 14, 1351.00, 173
3, 16:20:00-000, 197, 102, 95, 17, 1348.70, 18, 1350.83, 166
3, 16:21:00-000, 251, 179, 72, 12, 1346.50, 26, 1350.30, 211
3, 16:22:00-000, 241, 194, 47, 27, 1347.37, 16, 1351.62, 192
3, 16:23:00-000, 188, 155, 33, 10, 1349.90, 10, 1351.60, 168
3, 16:24:00-000, 177, 117, 60, 20, 1346.85, 6, 1349.83, 161
3, 16:25:00-000, 197, 124, 73, 10, 1347.40, 4, 1350.00, 180
3, 16:26:00-000, 175, 92, 83, 6, 1346.67, 16, 1350.43, 151
3, 16:27:00-000, 208, 132, 76, 15, 1348.13, 1, 1351.00, 191
3, 16:28:00-000, 231, 133, 98, 17, 1347.70, 33, 1350.45, 186
3, 16:29:00-000, 226, 165, 61, 17, 1348.41, 19, 1351.31, 190
4, 09:03:00-000, 277, 277, 0, 0, 0.00, 0, 0.00, 277
4, 09:06:00-000, 311, 311, 0, 310, 1351.00, 0, 0.00, 0
4, 09:07:00-000, 5, 5, 0, 0, 0.00, 0, 0.00, 1
4, 09:08:00-000, 31, 25, 6, 6, 1352.67, 6, 1352.67, 12
4, 09:09:00-000, 78, 59, 19, 19, 1368.47, 19, 1368.47, 30
4, 09:10:00-000, 112, 76, 36, 34, 1382.94, 36, 1383.38, 38
4, 09:11:00-000, 62, 37, 25, 23, 1414.26, 24, 1414.41, 35
4, 09:12:00-000, 68, 59, 9, 10, 1441.90, 10, 1441.90, 46
4, 09:13:00-000, 63, 47, 16, 40, 1396.24, 14, 1398.57, 15
4, 09:14:00-000, 62, 57, 5, 48, 1356.30, 5, 1355.40, 11
4, 09:15:00-000, 90, 58, 32, 49, 1355.11, 22, 1354.31, 6
4, 09:16:00-000, 79, 51, 28, 47, 1357.29, 37, 1357.29, 2
4, 09:17:00-000, 110, 80, 30, 53, 1364.12, 30, 1361.39, 14
4, 09:18:00-000, 79, 43, 36, 59, 1356.31, 33, 1352.30, 2
4, 09:19:00-000, 100, 67, 33, 66, 1354.14, 32, 1352.43, 3
4, 09:20:00-000, 52, 35, 17, 34, 1352.99, 16, 1352.43, 3
4, 09:21:00-000, 84, 31, 53, 31, 1351.80, 42, 1351.66, 4
4, 09:22:00-000, 75, 30, 45, 21, 1348.95, 34, 1349.99, 11
4, 09:23:00-000, 83, 34, 49, 36, 1349.35, 41, 1348.58, 18
4, 09:24:00-000, 71, 28, 43, 28, 1349.03, 33, 1349.08, 4
4, 09:25:00-000, 86, 43, 43, 35, 1353.16, 42, 1350.40, 12
4, 09:26:00-000, 64, 19, 45, 27, 1351.55, 34, 1351.43, 3
4, 09:27:00-000, 64, 32, 32, 31, 1350.67, 27, 1350.70, 12
4, 09:28:00-000, 107, 54, 53, 53, 1351.20, 41, 1350.82, 4
4, 09:29:00-000, 78, 29, 49, 27, 1352.14, 40, 1352.16, 17
4, 09:30:00-000, 78, 41, 37, 43, 1350.99, 36, 1350.80, 3
4, 09:31:00-000, 81, 30, 51, 30, 1352.26, 37, 1354.05, 10
4, 09:32:00-000, 81, 41, 40, 40, 1360.17, 45, 1359.28, 1
4, 09:33:00-000, 78, 26, 52, 25, 1349.88, 38, 1349.78, 3
4, 09:34:00-000, 92, 37, 55, 37, 1350.13, 47, 1350.12, 8
4, 09:35:00-000, 77, 37, 40, 36, 1350.35, 39, 1350.32, 12
4, 09:36:00-000, 88, 45, 43, 38, 1350.28, 42, 1350.63, 6
4, 09:37:00-000, 75, 25, 50, 24, 1348.62, 28, 1349.53, 15
4, 09:38:00-000, 67, 37, 30, 39, 1352.40, 37, 1351.99, 4
4, 09:39:00-000, 78, 28, 50, 28, 1351.24, 35, 1351.53, 7
4, 09:40:00-000, 104, 57, 47, 46, 1352.08, 51, 1351.99, 5
4, 09:41:00-000, 59, 30, 29, 28, 1352.49, 23, 1352.56, 14
4, 09:42:00-000, 58, 25, 33, 24, 1352.62, 33, 1352.05, 3
4, 09:43:00-000, 80, 35, 45, 35, 1350.31, 39, 1350.22, 2
4, 09:44:00-000, 95, 51, 44, 52, 1350.14, 44, 1350.06, 1
4, 09:45:00-000, 79, 49, 30, 45, 1351.77, 31, 1351.48, 0
4, 09:46:00-000, 63, 35, 28, 37, 1352.45, 24, 1353.16, 6
4, 09:47:00-000, 100, 53, 47, 52, 1351.72, 40, 1351.37, 4
4, 09:48:00-000, 98, 45, 53, 39, 1352.04, 53, 1351.76, 6
4, 09:49:00-000, 77, 34, 43, 35, 1351.19, 46, 1349.88, 3
4, 09:50:00-000, 90, 53, 37, 53, 1353.29, 31, 1351.67, 2
4, 09:51:00-000, 88, 58, 30, 47, 1352.57, 25, 1353.16, 12
4, 09:52:00-000, 53, 22, 31, 27, 1350.07, 29, 1349.58, 5
4, 09:53:00-000, 101, 57, 44, 54, 1351.62, 43, 1351.88, 3
4, 09:54:00-000, 100, 48, 52, 40, 1349.64, 44, 1350.27, 5
4, 09:55:00-000, 100, 41, 59, 41, 1348.70, 49, 1349.46, 11
4, 09:56:00-000, 56, 30, 26, 30, 1350.49, 32, 1350.90, 3
4, 09:57:00-000, 89, 55, 34, 55, 1350.85, 34, 1350.85, 2
4, 09:58:00-000, 78, 29, 49, 29, 1349.30, 28, 1349.60, 6
4, 09:59:00-000, 97, 53, 44, 49, 1351.05, 48, 1351.22, 3
4, 10:00:00-000, 74, 41, 33, 43, 1352.55, 38, 1352.78, 5
4, 10:01:00-000, 89, 43, 46, 42, 1352.54, 37, 1352.10, 7
4, 10:02:00-000, 110, 37, 73, 35, 1349.45, 60, 1349.55, 9
4, 10:03:00-000, 82, 38, 44, 35, 1350.14, 33, 1349.96, 8
4, 10:04:00-000, 108, 52, 56, 55, 1350.85, 58, 1350.63, 9
4, 10:05:00-000, 80, 41, 39, 41, 1350.11, 31, 1350.15, 1
4, 10:06:00-000, 67, 28, 39, 28, 1349.53, 35, 1350.11, 4
4, 10:07:00-000, 86, 37, 49, 37, 1350.27, 50, 1350.49, 2
4, 10:08:00-000, 72, 31, 41, 31, 1350.09, 35, 1350.34, 4
4, 10:09:00-000, 71, 34, 37, 27, 1349.37, 32, 1350.27, 13
4, 10:10:00-000, 89, 36, 53, 40, 1349.69, 38, 1349.54, 4
4, 10:11:00-000, 79, 42, 37, 42, 1351.63, 31, 1349.64, 17
4, 10:12:00-000, 85, 38, 47, 38, 1350.76, 40, 1351.19, 0
4, 10:13:00-000, 72, 36, 36, 35, 1350.39, 26, 1350.76, 8
4, 10:14:00-000, 106, 31, 75, 32, 1349.68, 71, 1349.47, 5
4, 10:15:00-000, 81, 35, 46, 32, 1349.27, 42, 1349.33, 13
4, 10:16:00-000, 71, 32, 39, 31, 1350.73, 36, 1350.77, 1
4, 10:17:00-000, 84, 40, 44, 40, 1351.54, 34, 1351.23, 4
4, 10:18:00-000, 94, 64, 30, 62, 1352.47, 42, 1352.70, 1
4, 10:19:00-000, 78, 39, 39, 33, 1351.08, 31, 1350.93, 4
4, 10:20:00-000, 73, 40, 33, 42, 1351.44, 34, 1352.55, 0
4, 10:21:00-000, 94, 53, 41, 37, 1352.80, 33, 1351.87, 17
4, 10:22:00-000, 69, 46, 23, 40, 1351.99, 21, 1351.42, 15
4, 10:23:00-000, 67, 31, 36, 32, 1351.62, 27, 1350.44, 9
4, 10:24:00-000, 89, 45, 44, 44, 1352.83, 38, 1352.57, 1
4, 10:25:00-000, 68, 27, 41, 27, 1350.25, 29, 1350.75, 23
4, 10:26:00-000, 70, 39, 31, 35, 1351.65, 30, 1351.19, 1
4, 10:27:00-000, 68, 29, 39, 28, 1349.81, 31, 1350.12, 8
4, 10:28:00-000, 92, 38, 54, 38, 1351.81, 53, 1350.07, 6
4, 10:29:00-000, 66, 35, 31, 31, 1351.45, 32, 1352.02, 3
4, 10:30:00-000, 90, 35, 55, 34, 1349.64, 39, 1350.02, 13
4, 10:31:00-000, 103, 51, 52, 51, 1350.21, 55, 1350.17, 4
4, 10:32:00-000, 67, 21, 46, 13, 1347.38, 30, 1347.43, 7
4, 10:33:00-000, 82, 43, 39, 42, 1351.70, 42, 1351.66, 11
4, 10:34:00-000, 72, 32, 40, 36, 1349.69, 32, 1349.53, 1
4, 10:35:00-000, 87, 34, 53, 30, 1350.09, 42, 1350.21, 10
4, 10:36:00-000, 69, 34, 35, 37, 1350.51, 39, 1351.79, 1
4, 10:37:00-000, 78, 25, 53, 24, 1348.41, 49, 1348.56, 5
4, 10:38:00-000, 102, 66, 36, 56, 1351.35, 37, 1351.18, 12
4, 10:39:00-000, 94, 34, 60, 35, 1349.97, 43, 1348.65, 5
4, 10:40:00-000, 71, 24, 47, 24, 1351.08, 44, 1350.06, 4
4, 10:41:00-000, 93, 40, 53, 40, 1349.39, 32, 1348.49, 16
4, 10:42:00-000, 82, 53, 29, 42, 1352.75, 34, 1350.64, 5
4, 10:43:00-000, 71, 24, 47, 29, 1350.96, 43, 1351.55, 11
4, 10:44:00-000, 85, 40, 45, 38, 1349.76, 46, 1350.36, 4
4, 10:45:00-000, 76, 45, 31, 45, 1351.10, 26, 1351.26, 3
4, 10:46:00-000, 85, 51, 34, 43, 1350.76, 38, 1351.07, 5
4, 10:47:00-000, 89, 61, 28, 50, 1352.65, 26, 1351.80, 11
4, 10:48:00-000, 64, 28, 36, 31, 1351.09, 33, 1351.99, 2
4, 10:49:00-000, 90, 47, 43, 40, 1350.92, 35, 1350.39, 13
4, 10:50:00-000, 84, 47, 37, 36, 1350.91, 40, 1351.14, 5
4, 10:51:00-000, 100, 45, 55, 40, 1349.04, 34, 1349.11, 11
4, 10:52:00-000, 90, 46, 44, 54, 1349.47, 48, 1350.20, 0
4, 10:53:00-000, 69, 28, 41, 26, 1351.53, 41, 1351.68, 4
4, 10:54:00-000, 83, 39, 44, 41, 1350.99, 35, 1350.96, 5
4, 10:55:00-000, 105, 46, 59, 45, 1348.72, 61, 1349.04, 3
4, 10:56:00-000, 98, 53, 45, 53, 1351.03, 41, 1351.29, 3
4, 10:57:00-000, 91, 40, 51, 39, 1350.99, 47, 1350.31, 8
4, 10:58:00-000, 84, 39, 45, 40, 1349.32, 44, 1349.47, 1
4, 10:59:00-000, 92, 51, 41, 47, 1350.33, 37, 1350.02, 12
4, 11:00:00-000, 99, 44, 55, 44, 1349.88, 53, 1349.73, 1
4, 11:01:00-000, 75, 36, 39, 36, 1353.13, 32, 1351.37, 7
4, 11:02:00-000, 89, 37, 52, 35, 1349.19, 46, 1349.23, 6
4, 11:03:00-000, 77, 44, 33, 42, 1350.30, 31, 1350.09, 1
4, 11:04:00-000, 73, 32, 41, 26, 1350.53, 42, 1351.21, 3
4, 11:05:00-000, 100, 49, 51, 49, 1349.95, 49, 1349.85, 9
4, 11:06:00-000, 92, 40, 52, 38, 1353.31, 42, 1352.59, 4
4, 11:07:00-000, 83, 43, 40, 42, 1352.47, 34, 1352.32, 10
4, 11:08:00-000, 83, 38, 45, 39, 1349.38, 42, 1349.78, 1
4, 11:09:00-000, 78, 47, 31, 46, 1351.69, 26, 1352.11, 7
4, 11:10:00-000, 79, 44, 35, 41, 1354.09, 23, 1353.39, 3
4, 11:11:00-000, 86, 38, 48, 37, 1350.10, 46, 1350.43, 13
4, 11:12:00-000, 64, 23, 41, 23, 1350.26, 33, 1350.54, 4
4, 11:13:00-000, 83, 46, 37, 40, 1349.72, 38, 1350.33, 4
4, 11:14:00-000, 66, 41, 25, 46, 1351.68, 22, 1352.09, 6
4, 11:15:00-000, 112, 55, 57, 55, 1350.41, 57, 1350.18, 3
4, 11:16:00-000, 63, 23, 40, 19, 1350.47, 33, 1348.87, 4
4, 11:17:00-000, 77, 26, 51, 29, 1350.75, 39, 1350.53, 9
4, 11:18:00-000, 85, 41, 44, 41, 1350.53, 43, 1349.92, 0
4, 11:19:00-000, 75, 38, 37, 32, 1349.93, 34, 1349.93, 14
4, 11:20:00-000, 55, 23, 32, 25, 1351.15, 28, 1351.39, 2
4, 11:21:00-000, 94, 54, 40, 49, 1351.52, 40, 1350.72, 1
4, 11:22:00-000, 73, 41, 32, 46, 1351.75, 31, 1352.99, 0
4, 11:23:00-000, 122, 44, 78, 40, 1348.94, 65, 1348.99, 12
4, 11:24:00-000, 90, 37, 53, 39, 1349.04, 42, 1350.04, 12
4, 11:25:00-000, 63, 28, 35, 30, 1350.26, 29, 1349.79, 6
4, 11:26:00-000, 95, 56, 39, 54, 1351.08, 38, 1350.89, 4
4, 11:27:00-000, 92, 40, 52, 41, 1350.43, 50, 1350.41, 2
4, 11:28:00-000, 63, 31, 32, 32, 1350.24, 33, 1350.99, 0
4, 11:29:00-000, 85, 46, 39, 37, 1347.05, 33, 1348.33, 2
4, 11:30:00-000, 57, 27, 30, 36, 1350.55, 23, 1350.60, 0
4, 11:31:00-000, 109, 65, 44, 62, 1350.20, 51, 1349.70, 5
4, 11:32:00-000, 65, 35, 30, 30, 1351.53, 28, 1351.46, 1
4, 11:33:00-000, 91, 28, 63, 32, 1349.59, 56, 1349.81, 8
4, 11:34:00-000, 71, 29, 42, 28, 1350.64, 34, 1350.93, 8
4, 11:35:00-000, 57, 31, 26, 24, 1350.95, 28, 1351.21, 2
4, 11:36:00-000, 106, 62, 44, 64, 1352.67, 40, 1352.57, 1
4, 11:37:00-000, 97, 53, 44, 50, 1351.31, 41, 1351.63, 10
4, 11:38:00-000, 80, 29, 51, 25, 1350.56, 38, 1351.10, 15
4, 11:39:00-000, 85, 42, 43, 37, 1348.40, 31, 1348.83, 7
4, 11:40:00-000, 93, 53, 40, 56, 1350.31, 47, 1350.39, 1
4, 11:41:00-000, 93, 35, 58, 35, 1348.45, 36, 1348.44, 6
4, 11:42:00-000, 60, 27, 33, 28, 1349.60, 46, 1349.75, 4
4, 11:43:00-000, 73, 38, 35, 36, 1350.47, 24, 1351.20, 5
4, 11:44:00-000, 90, 48, 42, 46, 1350.77, 48, 1351.35, 4
4, 11:45:00-000, 93, 44, 49, 44, 1351.04, 43, 1351.22, 2
4, 11:46:00-000, 72, 36, 36, 36, 1351.05, 42, 1351.23, 0
4, 11:47:00-000, 83, 32, 51, 30, 1349.30, 33, 1349.87, 5
4, 11:48:00-000, 112, 60, 52, 57, 1351.13, 51, 1351.15, 12
4, 11:49:00-000, 65, 24, 41, 25, 1349.76, 39, 1350.09, 4
4, 11:50:00-000, 82, 48, 34, 48, 1351.57, 37, 1353.37, 1
4, 11:51:00-000, 113, 31, 82, 30, 1349.69, 65, 1350.57, 5
4, 11:52:00-000, 74, 37, 37, 32, 1351.71, 34, 1350.29, 12
4, 11:53:00-000, 87, 35, 52, 36, 1351.60, 44, 1350.72, 5
4, 11:54:00-000, 94, 49, 45, 45, 1351.64, 56, 1351.54, 3
4, 11:55:00-000, 78, 40, 38, 40, 1351.09, 32, 1350.81, 3
4, 11:56:00-000, 87, 45, 42, 44, 1350.15, 33, 1350.08, 15
4, 11:57:00-000, 102, 59, 43, 53, 1351.58, 35, 1351.40, 5
4, 11:58:00-000, 96, 38, 58, 40, 1350.47, 45, 1350.35, 13
4, 11:59:00-000, 91, 60, 31, 57, 1350.64, 33, 1350.48, 7
4, 12:00:00-000, 84, 40, 44, 36, 1350.80, 41, 1351.53, 3
4, 12:01:00-000, 81, 41, 40, 38, 1351.07, 40, 1351.02, 3
4, 12:02:00-000, 91, 48, 43, 50, 1349.77, 34, 1349.43, 6
4, 12:03:00-000, 86, 42, 44, 31, 1350.19, 41, 1349.60, 12
4, 12:04:00-000, 78, 30, 48, 30, 1350.56, 52, 1351.05, 2
4, 12:05:00-000, 86, 48, 38, 47, 1350.71, 40, 1350.29, 0
4, 12:06:00-000, 81, 36, 45, 37, 1348.99, 34, 1349.14, 12
4, 12:07:00-000, 83, 44, 39, 42, 1351.25, 35, 1351.93, 2
4, 12:08:00-000, 89, 50, 39, 45, 1350.28, 40, 1350.82, 3
4, 12:09:00-000, 96, 28, 68, 33, 1350.69, 46, 1350.34, 11
4, 12:10:00-000, 81, 32, 49, 32, 1350.37, 44, 1350.42, 15
4, 12:11:00-000, 90, 37, 53, 36, 1347.71, 37, 1348.53, 4
4, 12:12:00-000, 82, 43, 39, 42, 1351.04, 45, 1350.90, 0
4, 12:13:00-000, 95, 55, 40, 54, 1352.32, 37, 1352.75, 8
4, 12:14:00-000, 90, 53, 37, 45, 1352.30, 40, 1352.42, 4
4, 12:15:00-000, 76, 39, 37, 37, 1351.21, 32, 1351.68, 6
4, 12:16:00-000, 104, 48, 56, 46, 1350.12, 50, 1349.97, 10
4, 12:17:00-000, 80, 27, 53, 27, 1349.11, 40, 1349.72, 9
4, 12:18:00-000, 71, 48, 23, 40, 1351.94, 24, 1351.24, 8
4, 12:19:00-000, 89, 50, 39, 52, 1353.45, 34, 1353.35, 4
4, 12:20:00-000, 73, 32, 41, 32, 1349.87, 32, 1350.12, 6
4, 12:21:00-000, 105, 48, 57, 43, 1350.97, 40, 1350.77, 10
4, 12:22:00-000, 77, 31, 46, 26, 1351.15, 61, 1351.10, 10
4, 12:23:00-000, 78, 30, 48, 27, 1349.95, 35, 1349.71, 7
4, 12:24:00-000, 85, 50, 35, 47, 1352.67, 38, 1352.07, 4
4, 12:25:00-000, 87, 41, 46, 41, 1349.58, 36, 1350.13, 8
4, 12:26:00-000, 75, 37, 38, 31, 1349.67, 38, 1350.41, 5
4, 12:27:00-000, 73, 40, 33, 41, 1351.72, 31, 1351.96, 9
4, 12:28:00-000, 78, 32, 46, 32, 1351.93, 35, 1350.25, 9
4, 12:29:00-000, 98, 40, 58, 38, 1349.52, 55, 1349.66, 3
4, 12:30:00-000, 75, 32, 43, 33, 1348.51, 46, 1349.21, 1
4, 12:31:00-000, 86, 45, 41, 43, 1350.39, 36, 1349.91, 3
4, 12:32:00-000, 78, 34, 44, 28, 1348.85, 45, 1349.62, 4
4, 12:33:00-000, 97, 70, 27, 67, 1351.79, 26, 1351.34, 7
4, 12:34:00-000, 65, 38, 27, 35, 1352.88, 22, 1352.00, 4
4, 12:35:00-000, 82, 39, 43, 38, 1350.23, 38, 1350.15, 5
4, 12:36:00-000, 91, 42, 49, 41, 1351.60, 48, 1351.60, 2
4, 12:37:00-000, 76, 39, 37, 29, 1350.44, 35, 1350.88, 8
4, 12:38:00-000, 73, 44, 29, 46, 1351.99, 29, 1351.38, 6
4, 12:39:00-000, 92, 46, 46, 46, 1351.38, 40, 1350.89, 5
4, 12:40:00-000, 72, 31, 41, 28, 1350.78, 36, 1350.69, 6
4, 12:41:00-000, 89, 33, 56, 27, 1348.48, 49, 1348.83, 6
4, 12:42:00-000, 72, 35, 37, 41, 1349.38, 40, 1349.84, 4
4, 12:43:00-000, 88, 42, 46, 38, 1350.52, 40, 1350.52, 7
4, 12:44:00-000, 75, 30, 45, 32, 1350.90, 37, 1350.86, 5
4, 12:45:00-000, 70, 40, 30, 41, 1351.36, 32, 1351.59, 2
4, 12:46:00-000, 81, 42, 39, 42, 1351.56, 38, 1351.70, 1
4, 12:47:00-000, 53, 25, 28, 21, 1350.85, 17, 1351.29, 13
4, 12:48:00-000, 104, 44, 60, 44, 1350.33, 43, 1350.06, 3
4, 12:49:00-000, 70, 32, 38, 29, 1349.34, 30, 1350.03, 12
4, 12:50:00-000, 92, 44, 48, 43, 1349.39, 59, 1349.32, 1
4, 12:51:00-000, 75, 41, 34, 44, 1350.56, 25, 1350.67, 7
4, 12:52:00-000, 81, 51, 30, 32, 1350.46, 27, 1351.40, 12
4, 12:53:00-000, 102, 52, 50, 60, 1349.87, 41, 1350.21, 3
4, 12:54:00-000, 88, 43, 45, 44, 1351.33, 39, 1351.07, 11
4, 12:55:00-000, 93, 40, 53, 35, 1349.65, 41, 1350.16, 5
4, 12:56:00-000, 91, 41, 50, 43, 1347.45, 54, 1348.16, 8
4, 12:57:00-000, 70, 35, 35, 27, 1349.25, 33, 1350.42, 1
4, 12:58:00-000, 93, 40, 53, 46, 1347.86, 41, 1349.63, 6
4, 12:59:00-000, 97, 51, 46, 43, 1350.29, 45, 1350.43, 1
4, 13:00:00-000, 106, 55, 51, 55, 1350.03, 60, 1350.87, 2
4, 13:01:00-000, 75, 32, 43, 36, 1350.33, 33, 1349.96, 4
4, 13:02:00-000, 102, 35, 67, 35, 1350.48, 65, 1350.31, 8
4, 13:03:00-000, 90, 49, 41, 49, 1351.38, 37, 1351.37, 0
4, 13:04:00-000, 70, 28, 42, 23, 1348.95, 42, 1350.28, 5
4, 13:05:00-000, 93, 53, 40, 52, 1350.86, 33, 1350.09, 7
4, 13:06:00-000, 86, 56, 30, 55, 1351.41, 34, 1351.99, 3
4, 13:07:00-000, 116, 63, 53, 57, 1351.55, 42, 1351.52, 13
4, 13:08:00-000, 66, 31, 35, 32, 1350.18, 28, 1350.85, 5
4, 13:09:00-000, 85, 36, 49, 34, 1350.23, 51, 1350.01, 4
4, 13:10:00-000, 99, 36, 63, 38, 1350.31, 54, 1350.34, 5
4, 13:11:00-000, 75, 34, 41, 33, 1350.66, 42, 1350.54, 5
4, 13:12:00-000, 64, 22, 42, 22, 1349.00, 32, 1349.65, 4
4, 13:13:00-000, 93, 39, 54, 38, 1349.25, 35, 1348.70, 8
4, 13:14:00-000, 75, 28, 47, 26, 1348.38, 60, 1348.67, 3
4, 13:15:00-000, 60, 29, 31, 27, 1349.70, 20, 1349.10, 9
4, 13:16:00-000, 89, 54, 35, 51, 1351.64, 36, 1351.99, 5
4, 13:17:00-000, 81, 39, 42, 37, 1350.61, 36, 1350.05, 4
4, 13:18:00-000, 87, 51, 36, 43, 1352.85, 37, 1352.67, 10
4, 13:19:00-000, 82, 36, 46, 39, 1350.43, 37, 1350.61, 5
4, 13:20:00-000, 87, 60, 27, 53, 1351.95, 36, 1351.38, 0
4, 13:21:00-000, 66, 30, 36, 30, 1351.36, 28, 1351.49, 5
4, 13:22:00-000, 78, 30, 48, 30, 1350.53, 51, 1350.93, 4
4, 13:23:00-000, 92, 24, 68, 25, 1348.19, 52, 1348.39, 9
4, 13:24:00-000, 87, 50, 37, 44, 1350.01, 42, 1350.04, 1
4, 13:25:00-000, 92, 43, 49, 43, 1350.55, 49, 1350.32, 5
4, 13:26:00-000, 75, 38, 37, 36, 1351.33, 37, 1351.10, 2
4, 13:27:00-000, 97, 53, 44, 49, 1351.87, 36, 1351.91, 1
4, 13:28:00-000, 76, 40, 36, 47, 1351.01, 31, 1352.12, 1
4, 13:29:00-000, 84, 48, 36, 40, 1351.02, 40, 1351.49, 2
4, 13:30:00-000, 55, 31, 24, 38, 1349.81, 29, 1350.68, 0
4, 13:31:00-000, 71, 36, 35, 36, 1350.60, 29, 1350.62, 0
4, 13:32:00-000, 99, 51, 48, 47, 1351.35, 44, 1351.38, 1
4, 13:33:00-000, 60, 22, 38, 22, 1350.59, 40, 1350.62, 8
4, 13:34:00-000, 89, 47, 42, 45, 1349.70, 42, 1349.82, 4
4, 13:35:00-000, 57, 27, 30, 27, 1349.96, 28, 1349.82, 3
4, 13:36:00-000, 81, 49, 32, 48, 1350.33, 34, 1350.91, 1
4, 13:37:00-000, 81, 44, 37, 38, 1349.62, 32, 1350.78, 1
4, 13:38:00-000, 94, 40, 54, 44, 1350.15, 49, 1350.52, 9
4, 13:39:00-000, 76, 33, 43, 32, 1350.49, 41, 1350.60, 3
4, 13:40:00-000, 60, 39, 21, 33, 1351.66, 17, 1351.35, 4
4, 13:41:00-000, 95, 38, 57, 38, 1350.94, 51, 1350.58, 5
4, 13:42:00-000, 89, 41, 48, 44, 1348.81, 34, 1349.55, 7
4, 13:43:00-000, 77, 41, 36, 38, 1349.23, 40, 1349.07, 6
4, 13:44:00-000, 122, 68, 54, 69, 1351.73, 57, 1352.43, 1
4, 13:45:00-000, 92, 39, 53, 34, 1349.91, 43, 1350.30, 3
4, 13:46:00-000, 81, 34, 47, 33, 1350.24, 49, 1350.79, 7
4, 13:47:00-000, 85, 34, 51, 35, 1349.68, 40, 1349.32, 6
4, 13:48:00-000, 98, 47, 51, 45, 1350.55, 60, 1350.59, 1
4, 13:49:00-000, 68, 32, 36, 26, 1350.69, 34, 1351.26, 0
4, 13:50:00-000, 92, 45, 47, 52, 1349.16, 40, 1348.97, 9
4, 13:51:00-000, 95, 49, 46, 49, 1350.73, 35, 1351.22, 1
4, 13:52:00-000, 97, 46, 51, 46, 1351.86, 50, 1351.47, 5
4, 13:53:00-000, 70, 53, 17, 41, 1352.36, 22, 1353.31, 1
4, 13:54:00-000, 69, 26, 43, 37, 1350.64, 29, 1349.86, 4
4, 13:55:00-000, 86, 46, 40, 42, 1352.73, 37, 1351.64, 11
4, 13:56:00-000, 88, 43, 45, 43, 1350.11, 36, 1350.55, 1
4, 13:57:00-000, 68, 34, 34, 34, 1348.79, 32, 1349.71, 11
4, 13:58:00-000, 99, 47, 52, 45, 1350.55, 49, 1350.95, 8
4, 13:59:00-000, 89, 50, 39, 48, 1353.34, 38, 1352.73, 0
4, 14:00:00-000, 71, 26, 45, 31, 1352.25, 37, 1352.10, 4
4, 14:01:00-000, 90, 45, 45, 41, 1351.50, 34, 1351.55, 11
4, 14:02:00-000, 95, 57, 38, 49, 1351.79, 34, 1351.52, 0
4, 14:03:00-000, 94, 38, 56, 42, 1350.52, 47, 1350.22, 15
4, 14:04:00-000, 68, 21, 47, 21, 1349.66, 40, 1350.77, 12
4, 14:05:00-000, 76, 42, 34, 40, 1351.24, 28, 1351.46, 7
4, 14:06:00-000, 86, 42, 44, 42, 1349.63, 41, 1350.09, 7
4, 14:07:00-000, 79, 36, 43, 33, 1350.42, 40, 1350.29, 3
4, 14:08:00-000, 95, 47, 48, 47, 1350.12, 36, 1350.58, 6
4, 14:09:00-000, 106, 57, 49, 51, 1349.80, 50, 1349.73, 6
4, 14:10:00-000, 60, 24, 36, 31, 1349.41, 26, 1348.92, 5
4, 14:11:00-000, 84, 27, 57, 23, 1347.69, 33, 1347.45, 12
4, 14:12:00-000, 87, 43, 44, 40, 1350.74, 59, 1349.74, 8
4, 14:13:00-000, 82, 31, 51, 32, 1350.06, 36, 1350.13, 3
4, 14:14:00-000, 77, 42, 35, 33, 1348.63, 45, 1349.52, 12
4, 14:15:00-000, 95, 47, 48, 42, 1351.78, 42, 1350.92, 1
4, 14:16:00-000, 66, 25, 41, 30, 1350.49, 38, 1351.68, 2
4, 14:17:00-000, 85, 34, 51, 32, 1348.40, 45, 1349.01, 10
4, 14:18:00-000, 91, 53, 38, 48, 1352.43, 29, 1352.30, 10
4, 14:19:00-000, 71, 37, 34, 31, 1351.06, 32, 1352.02, 9
4, 14:20:00-000, 92, 51, 41, 48, 1349.28, 33, 1348.93, 13
4, 14:21:00-000, 66, 37, 29, 37, 1352.13, 29, 1351.58, 4
4, 14:22:00-000, 88, 50, 38, 51, 1352.93, 41, 1352.21, 0
4, 14:23:00-000, 63, 32, 31, 31, 1351.67, 22, 1351.22, 4
4, 14:24:00-000, 85, 38, 47, 38, 1352.04, 42, 1352.02, 1
4, 14:25:00-000, 81, 37, 44, 36, 1349.94, 44, 1350.29, 4
4, 14:26:00-000, 90, 44, 46, 43, 1352.67, 39, 1351.63, 4
4, 14:27:00-000, 77, 32, 45, 32, 1352.81, 28, 1349.92, 15
4, 14:28:00-000, 80, 35, 45, 32, 1352.65, 43, 1351.85, 8
4, 14:29:00-000, 98, 43, 55, 43, 1350.32, 49, 1350.44, 16
4, 14:30:00-000, 51, 26, 25, 24, 1351.24, 18, 1351.39, 0
4, 14:31:00-000, 81, 30, 51, 31, 1350.13, 43, 1349.90, 10
4, 14:32:00-000, 90, 47, 43, 41, 1349.55, 39, 1350.07, 14
4, 14:33:00-000, 75, 43, 32, 37, 1350.56, 28, 1350.49, 1
4, 14:34:00-000, 93, 44, 49, 38, 1348.60, 40, 1349.69, 16
4, 14:35:00-000, 80, 42, 38, 39, 1351.74, 27, 1351.62, 4
4, 14:36:00-000, 74, 33, 41, 40, 1350.32, 43, 1350.60, 7
4, 14:37:00-000, 76, 39, 37, 34, 1351.35, 32, 1351.34, 4
4, 14:38:00-000, 91, 41, 50, 46, 1351.14, 44, 1351.58, 5
4, 14:39:00-000, 84, 39, 45, 33, 1347.51, 40, 1348.82, 7
4, 14:40:00-000, 69, 32, 37, 37, 1348.70, 31, 1349.32, 1
4, 14:41:00-000, 89, 44, 45, 42, 1349.78, 50, 1350.03, 1
4, 14:42:00-000, 99, 44, 55, 40, 1349.72, 48, 1349.99, 10
4, 14:43:00-000, 85, 45, 40, 38, 1350.39, 33, 1350.11, 3
4, 14:44:00-000, 82, 39, 43, 46, 1349.45, 48, 1350.03, 1
4, 14:45:00-000, 89, 42, 47, 38, 1349.44, 44, 1349.47, 1
4, 14:46:00-000, 81, 39, 42, 43, 1350.11, 47, 1352.10, 0
4, 14:47:00-000, 116, 49, 67, 48, 1349.62, 54, 1349.77, 9
4, 14:48:00-000, 74, 36, 38, 33, 1350.51, 37, 1350.80, 2
4, 14:49:00-000, 103, 55, 48, 55, 1351.01, 46, 1351.15, 5
4, 14:50:00-000, 102, 52, 50, 52, 1349.76, 46, 1350.32, 8
4, 14:51:00-000, 75, 45, 30, 35, 1350.88, 23, 1351.08, 2
4, 14:52:00-000, 73, 21, 52, 31, 1349.06, 49, 1349.97, 2
4, 14:53:00-000, 82, 41, 41, 30, 1350.99, 36, 1350.74, 7
4, 14:54:00-000, 82, 40, 42, 49, 1350.32, 44, 1350.47, 1
4, 14:55:00-000, 92, 52, 40, 41, 1348.72, 26, 1349.30, 9
4, 14:56:00-000, 70, 39, 31, 40, 1349.62, 38, 1351.12, 7
4, 14:57:00-000, 71, 42, 29, 42, 1349.68, 30, 1350.79, 0
4, 14:58:00-000, 85, 45, 40, 38, 1350.97, 40, 1351.29, 1
4, 14:59:00-000, 93, 46, 47, 50, 1351.29, 47, 1351.50, 4
4, 15:00:00-000, 79, 34, 45, 26, 1350.38, 42, 1351.06, 0
4, 15:01:00-000, 81, 42, 39, 39, 1350.38, 42, 1350.90, 3
4, 15:02:00-000, 100, 42, 58, 50, 1350.05, 45, 1350.12, 3
4, 15:03:00-000, 72, 34, 38, 30, 1349.16, 30, 1349.23, 13
4, 15:04:00-000, 86, 34, 52, 33, 1348.78, 38, 1349.78, 7
4, 15:05:00-000, 77, 46, 31, 39, 1351.17, 37, 1351.32, 6
4, 15:06:00-000, 65, 35, 30, 42, 1350.80, 26, 1351.38, 7
4, 15:07:00-000, 100, 45, 55, 42, 1350.73, 46, 1350.14, 1
4, 15:08:00-000, 70, 33, 37, 34, 1349.79, 38, 1350.57, 3
4, 15:09:00-000, 91, 40, 51, 41, 1350.82, 50, 1350.81, 3
4, 15:10:00-000, 81, 24, 57, 24, 1348.62, 57, 1348.94, 6
4, 15:11:00-000, 88, 40, 48, 40, 1350.07, 38, 1350.57, 1
4, 15:12:00-000, 69, 31, 38, 32, 1349.78, 31, 1350.70, 5
4, 15:13:00-000, 75, 43, 32, 42, 1351.68, 38, 1351.81, 0
4, 15:14:00-000, 93, 43, 50, 44, 1349.74, 44, 1350.22, 5
4, 15:15:00-000, 71, 31, 40, 28, 1350.39, 31, 1351.03, 5
4, 15:16:00-000, 84, 45, 39, 37, 1350.02, 39, 1349.97, 11
4, 15:17:00-000, 68, 38, 30, 33, 1351.05, 30, 1351.19, 8
4, 15:18:00-000, 72, 31, 41, 35, 1350.99, 30, 1350.93, 0
4, 15:19:00-000, 107, 49, 58, 51, 1350.58, 54, 1350.06, 3
4, 15:20:00-000, 78, 29, 49, 30, 1349.89, 43, 1351.23, 0
4, 15:21:00-000, 89, 45, 44, 39, 1349.56, 43, 1349.67, 14
4, 15:22:00-000, 91, 54, 37, 51, 1350.58, 37, 1350.94, 3
4, 15:23:00-000, 107, 67, 40, 57, 1349.87, 41, 1350.46, 8
4, 15:24:00-000, 66, 35, 31, 38, 1350.67, 28, 1350.92, 2
4, 15:25:00-000, 73, 45, 28, 42, 1351.80, 31, 1351.73, 3
4, 15:26:00-000, 94, 56, 38, 50, 1350.15, 36, 1350.19, 12
4, 15:27:00-000, 67, 31, 36, 31, 1350.80, 27, 1351.51, 4
4, 15:28:00-000, 66, 35, 31, 30, 1349.96, 32, 1350.40, 0
4, 15:29:00-000, 85, 26, 59, 30, 1348.99, 51, 1349.46, 5
4, 15:30:00-000, 80, 40, 40, 36, 1352.44, 40, 1351.87, 9
4, 15:31:00-000, 78, 40, 38, 37, 1353.05, 28, 1351.89, 9
4, 15:32:00-000, 82, 31, 51, 33, 1348.63, 55, 1348.83, 2
4, 15:33:00-000, 74, 30, 44, 27, 1350.88, 36, 1350.94, 1
4, 15:34:00-000, 108, 52, 56, 44, 1351.65, 55, 1351.65, 4
4, 15:35:00-000, 66, 31, 35, 33, 1351.90, 31, 1351.32, 11
4, 15:36:00-000, 76, 40, 36, 44, 1350.77, 36, 1350.72, 5
4, 15:37:00-000, 87, 30, 57, 29, 1350.10, 40, 1350.79, 2
4, 15:38:00-000, 93, 45, 48, 46, 1351.17, 52, 1350.89, 0
4, 15:39:00-000, 75, 41, 34, 32, 1349.56, 33, 1350.54, 13
4, 15:40:00-000, 61, 35, 26, 38, 1349.78, 25, 1349.92, 4
4, 15:41:00-000, 99, 50, 49, 51, 1350.44, 42, 1350.28, 2
4, 15:42:00-000, 66, 24, 42, 22, 1350.00, 37, 1350.43, 6
4, 15:43:00-000, 94, 55, 39, 42, 1350.75, 40, 1350.54, 2
4, 15:44:00-000, 84, 41, 43, 46, 1350.40, 45, 1350.19, 8
4, 15:45:00-000, 75, 39, 36, 35, 1350.11, 29, 1350.10, 0
4, 15:46:00-000, 103, 59, 44, 61, 1351.36, 38, 1351.70, 1
4, 15:47:00-000, 72, 48, 24, 46, 1352.10, 21, 1351.90, 17
4, 15:48:00-000, 76, 27, 49, 28, 1348.42, 32, 1348.15, 7
4, 15:49:00-000, 90, 36, 54, 35, 1351.88, 41, 1349.63, 13
4, 15:50:00-000, 71, 23, 48, 20, 1349.00, 48, 1350.36, 4
4, 15:51:00-000, 97, 37, 60, 38, 1349.89, 64, 1349.36, 2
4, 15:52:00-000, 69, 45, 24, 42, 1350.40, 25, 1350.43, 3
4, 15:53:00-000, 73, 31, 42, 28, 1350.03, 39, 1350.27, 2
4, 15:54:00-000, 73, 41, 32, 41, 1349.87, 28, 1350.28, 6
4, 15:55:00-000, 98, 51, 47, 51, 1350.74, 43, 1350.55, 3
4, 15:56:00-000, 63, 38, 25, 29, 1351.17, 31, 1351.51, 7
4, 15:57:00-000, 85, 39, 46, 35, 1351.02, 41, 1350.82, 1
4, 15:58:00-000, 85, 36, 49, 35, 1350.93, 45, 1351.08, 3
4, 15:59:00-000, 87, 43, 44, 43, 1349.46, 44, 1349.90, 8
4, 16:00:00-000, 88, 50, 38, 40, 1350.51, 38, 1350.65, 0
4, 16:01:00-000, 76, 44, 32, 54, 1351.40, 23, 1351.52, 11
4, 16:02:00-000, 93, 42, 51, 41, 1351.72, 27, 1352.48, 0
4, 16:03:00-000, 94, 52, 42, 48, 1353.03, 51, 1352.01, 19
4, 16:04:00-000, 88, 44, 44, 46, 1350.77, 41, 1349.70, 3
4, 16:05:00-000, 70, 35, 35, 31, 1350.38, 35, 1350.34, 3
4, 16:06:00-000, 102, 35, 67, 36, 1348.77, 46, 1350.23, 4
4, 16:07:00-000, 76, 37, 39, 30, 1348.73, 33, 1347.99, 16
4, 16:08:00-000, 67, 25, 42, 28, 1349.39, 41, 1350.09, 7
4, 16:09:00-000, 73, 39, 34, 28, 1350.17, 30, 1350.29, 7
4, 16:10:00-000, 88, 48, 40, 50, 1350.27, 38, 1351.20, 1
4, 16:11:00-000, 73, 38, 35, 34, 1349.47, 34, 1350.02, 13
4, 16:12:00-000, 88, 47, 41, 43, 1351.71, 41, 1351.92, 1
4, 16:13:00-000, 68, 29, 39, 31, 1350.77, 38, 1350.49, 5
4, 16:14:00-000, 81, 29, 52, 30, 1349.16, 46, 1349.77, 2
4, 16:15:00-000, 57, 35, 22, 32, 1351.59, 24, 1350.66, 4
4, 16:16:00-000, 106, 51, 55, 53, 1351.12, 44, 1351.36, 7
4, 16:17:00-000, 76, 32, 44, 30, 1349.23, 34, 1349.52, 1
4, 16:18:00-000, 95, 56, 39, 54, 1351.12, 47, 1351.19, 5
4, 16:19:00-000, 76, 37, 39, 34, 1350.85, 39, 1351.05, 2
4, 16:20:00-000, 81, 46, 35, 39, 1351.71, 24, 1352.08, 8
4, 16:21:00-000, 86, 40, 46, 39, 1349.71, 47, 1350.82, 6
4, 16:22:00-000, 91, 40, 51, 27, 1349.51, 49, 1349.62, 11
4, 16:23:00-000, 97, 34, 63, 37, 1350.13, 35, 1349.59, 7
4, 16:24:00-000, 76, 32, 44, 31, 1347.38, 66, 1348.46, 5
4, 16:25:00-000, 99, 50, 49, 52, 1349.16, 46, 1348.32, 2
4, 16:26:00-000, 89, 44, 45, 48, 1350.35, 40, 1350.37, 1
4, 16:27:00-000, 82, 40, 42, 32, 1348.53, 41, 1348.38, 4
4, 16:28:00-000, 99, 40, 59, 47, 1350.03, 47, 1350.40, 6
4, 16:29:00-000, 71, 49, 22, 50, 1351.81, 25, 1351.56, 2
5, 09:13:00-000, 10194, 5571, 4623, 3772, 1348.41, 3804, 1349.22, 0
5, 09:14:00-000, 0, 0, 0, 0, 0.00, 21, 1357.00, 647
5, 09:15:00-000, 0, 0, 0, 0, 0.00, 25, 1357.00, 1917
5, 09:16:00-000, 0, 0, 0, 0, 0.00, 0, 0.00, 8
5, 09:26:00-000, 10409, 5719, 4690, 3773, 1348.43, 3826, 1348.52, 0
5, 09:27:00-000, 0, 0, 0, 0, 0.00, 14, 1356.00, 0
5, 09:28:00-000, 7, 6, 1, 107, 1348.02, 92, 1357.00, 1978
5, 09:29:00-000, 16, 8, 8, 7, 1351.14, 8, 1350.50, 620
5, 09:30:00-000, 56, 27, 29, 19, 1350.21, 30, 1352.59, 5
5, 09:31:00-000, 0, 0, 0, 0, 0.00, 0, 0.00, 1
5, 09:32:00-000, 192, 102, 90, 64, 1348.78, 90, 1350.73, 6
5, 09:33:00-000, 352, 184, 168, 136, 1349.51, 138, 1349.92, 23
5, 09:34:00-000, 576, 268, 308, 213, 1349.09, 228, 1349.44, 30
5, 09:35:00-000, 0, 0, 0, 5, 1346.00, 6, 1356.00, 53
5, 09:36:00-000, 847, 455, 392, 351, 1349.24, 374, 1350.58, 75
5, 09:37:00-000, 1151, 613, 538, 416, 1348.68, 424, 1349.02, 104
5, 09:38:00-000, 1400, 750, 650, 480, 1349.11, 581, 1350.24, 168
5, 09:39:00-000, 0, 0, 0, 46, 1347.63, 0, 0.00, 186
5, 09:40:00-000, 1326, 668, 658, 530, 1348.52, 537, 1349.34, 237
5, 09:41:00-000, 1225, 658, 567, 501, 1348.80, 499, 1349.68, 166
5, 09:42:00-000, 1226, 691, 535, 496, 1348.96, 478, 1349.51, 179
5, 09:43:00-000, 0, 0, 0, 0, 0.00, 14, 1356.71, 162
5, 09:44:00-000, 978, 556, 422, 442, 1348.87, 332, 1349.46, 229
5, 09:45:00-000, 899, 513, 386, 333, 1349.53, 348, 1350.42, 138
5, 09:46:00-000, 968, 471, 497, 370, 1349.33, 390, 1349.93, 168
5, 09:47:00-000, 0, 0, 0, 20, 1346.00, 15, 1357.00, 178
5, 09:48:00-000, 928, 509, 419, 357, 1348.92, 368, 1349.74, 128
5, 09:49:00-000, 912, 505, 407, 331, 1349.24, 354, 1349.68, 127
5, 09:50:00-000, 1096, 604, 492, 470, 1348.60, 468, 1349.82, 162
5, 09:51:00-000, 0, 0, 0, 29, 1347.00, 5, 1358.00, 104
5, 09:52:00-000, 980, 532, 448, 393, 1348.58, 399, 1349.73, 167
5, 09:53:00-000, 1127, 627, 500, 419, 1349.18, 417, 1349.82, 158
5, 09:54:00-000, 1094, 553, 541, 432, 1348.92, 462, 1350.01, 146
5, 09:55:00-000, 0, 0, 0, 26, 1345.81, 28, 1357.00, 140
5, 09:56:00-000, 1015, 553, 462, 422, 1349.04, 401, 1349.54, 175
5, 09:57:00-000, 1043, 509, 534, 303, 1349.43, 428, 1350.22, 157
5, 09:58:00-000, 989, 483, 506, 387, 1348.80, 430, 1350.09, 136
5, 09:59:00-000, 0, 0, 0, 0, 0.00, 15, 1355.47, 217
5, 10:00:00-000, 945, 495, 450, 390, 1348.74, 375, 1350.14, 130
5, 10:01:00-000, 1023, 526, 497, 380, 1349.47, 415, 1350.44, 131
5, 10:02:00-000, 929, 505, 424, 399, 1348.18, 348, 1349.42, 164
5, 10:03:00-000, 0, 0, 0, 16, 1346.00, 28, 1356.00, 141
5, 10:04:00-000, 1044, 537, 507, 372, 1348.56, 379, 1349.09, 135
5, 10:05:00-000, 967, 497, 470, 370, 1349.17, 381, 1349.50, 200
5, 10:06:00-000, 1001, 533, 468, 415, 1349.06, 357, 1349.88, 167
5, 10:07:00-000, 0, 0, 0, 2, 1346.00, 48, 1355.54, 169
5, 10:08:00-000, 1007, 548, 459, 397, 1349.02, 402, 1350.11, 132
5, 10:09:00-000, 1107, 554, 553, 439, 1348.66, 433, 1349.19, 173
5, 10:10:00-000, 1066, 534, 532, 438, 1348.10, 381, 1348.80, 143
5, 10:11:00-000, 0, 0, 0, 44, 1344.40, 25, 1354.68, 151
5, 10:12:00-000, 939, 483, 456, 336, 1348.78, 402, 1349.95, 161
5, 10:13:00-000, 876, 456, 420, 337, 1349.33, 366, 1349.77, 151
5, 10:14:00-000, 1035, 580, 455, 436, 1349.17, 399, 1349.93, 121
5, 10:15:00-000, 1, 0, 1, 26, 1346.00, 16, 1356.50, 126
5, 10:16:00-000, 1120, 560, 560, 431, 1347.89, 435, 1348.83, 147
5, 10:17:00-000, 978, 533, 445, 401, 1349.35, 400, 1349.86, 166
5, 10:18:00-000, 977, 506, 471, 404, 1349.05, 431, 1350.11, 155
5, 10:19:00-000, 1, 1, 0, 42, 1345.59, 12, 1357.00, 105
5, 10:20:00-000, 1018, 545, 473, 425, 1349.20, 399, 1349.69, 114
5, 10:21:00-000, 1119, 621, 498, 432, 1349.01, 433, 1349.71, 137
5, 10:22:00-000, 1074, 581, 493, 442, 1348.49, 426, 1349.40, 103
5, 10:23:00-000, 0, 0, 0, 10, 1347.00, 8, 1357.00, 205
5, 10:24:00-000, 1026, 533, 493, 400, 1349.20, 466, 1350.33, 123
5, 10:25:00-000, 1068, 559, 509, 346, 1349.00, 406, 1349.54, 182
5, 10:26:00-000, 987, 571, 416, 388, 1349.84, 390, 1351.14, 162
5, 10:27:00-000, 0, 0, 0, 17, 1347.00, 5, 1356.00, 202
5, 10:28:00-000, 975, 511, 464, 434, 1348.76, 392, 1349.79, 150
5, 10:29:00-000, 1086, 543, 543, 381, 1348.76, 427, 1349.34, 126
5, 10:30:00-000, 935, 448, 487, 362, 1347.88, 398, 1349.53, 128
5, 10:31:00-000, 0, 0, 0, 0, 0.00, 3, 1355.00, 166
5, 10:32:00-000, 1059, 513, 546, 455, 1347.85, 432, 1349.36, 165
5, 10:33:00-000, 1049, 523, 526, 410, 1348.22, 480, 1349.44, 121
5, 10:34:00-000, 1072, 599, 473, 443, 1349.79, 405, 1350.07, 136
5, 10:35:00-000, 0, 0, 0, 15, 1347.00, 5, 1357.00, 128
5, 10:36:00-000, 1103, 590, 513, 502, 1349.02, 467, 1349.84, 135
5, 10:37:00-000, 1034, 554, 480, 414, 1348.47, 326, 1348.63, 154
5, 10:38:00-000, 1039, 529, 510, 478, 1348.02, 444, 1348.92, 135
5, 10:39:00-000, 1, 1, 0, 27, 1344.00, 33, 1355.69, 130
5, 10:40:00-000, 909, 449, 460, 329, 1348.22, 389, 1349.32, 127
5, 10:41:00-000, 986, 502, 484, 424, 1348.74, 415, 1349.68, 147
5, 10:42:00-000, 1142, 549, 593, 458, 1348.44, 476, 1349.30, 103
5, 10:43:00-000, 1, 0, 1, 0, 0.00, 30, 1355.50, 83
5, 10:44:00-000, 978, 504, 474, 434, 1349.15, 389, 1349.60, 167
5, 10:45:00-000, 1076, 550, 526, 396, 1348.44, 398, 1348.74, 131
5, 10:46:00-000, 1115, 631, 484, 436, 1349.24, 411, 1350.53, 114
5, 10:47:00-000, 0, 0, 0, 49, 1346.26, 24, 1356.00, 203
5, 10:48:00-000, 1023, 511, 512, 420, 1348.25, 399, 1349.23, 189
5, 10:49:00-000, 952, 493, 459, 379, 1348.71, 362, 1349.38, 156
5, 10:50:00-000, 1026, 527, 499, 389, 1348.70, 429, 1349.58, 115
5, 10:51:00-000, 1, 0, 1, 9, 1345.00, 29, 1356.61, 148
5, 10:52:00-000, 953, 463, 490, 369, 1348.15, 435, 1350.02, 130
5, 10:53:00-000, 1096, 585, 511, 410, 1349.29, 465, 1350.57, 135
5, 10:54:00-000, 981, 537, 444, 445, 1348.76, 360, 1348.97, 145
5, 10:55:00-000, 0, 0, 0, 6, 1345.67, 0, 0.00, 154
5, 10:56:00-000, 1051, 582, 469, 423, 1348.65, 388, 1349.67, 124
5, 10:57:00-000, 1085, 574, 511, 441, 1348.08, 372, 1349.05, 175
5, 10:58:00-000, 1002, 484, 518, 406, 1348.15, 406, 1348.64, 181
5, 10:59:00-000, 0, 0, 0, 5, 1345.00, 0, 0.00, 191
5, 11:00:00-000, 977, 515, 462, 416, 1348.71, 425, 1349.95, 131
5, 11:01:00-000, 977, 511, 466, 385, 1349.26, 420, 1349.86, 124
5, 11:02:00-000, 989, 528, 461, 397, 1348.51, 394, 1349.80, 118
5, 11:03:00-000, 0, 0, 0, 0, 0.00, 8, 1356.13, 136
5, 11:04:00-000, 1034, 580, 454, 455, 1348.57, 395, 1349.81, 128
5, 11:05:00-000, 1131, 604, 527, 383, 1348.92, 395, 1349.51, 151
5, 11:06:00-000, 1087, 552, 535, 466, 1348.65, 475, 1350.00, 180
5, 11:07:00-000, 0, 0, 0, 48, 1345.24, 17, 1356.41, 153
5, 11:08:00-000, 1001, 492, 509, 404, 1347.81, 438, 1349.42, 150
5, 11:09:00-000, 997, 522, 475, 361, 1349.01, 382, 1350.15, 117
5, 11:10:00-000, 968, 502, 466, 356, 1348.69, 382, 1349.64, 163
5, 11:11:00-000, 0, 0, 0, 14, 1346.00, 18, 1356.00, 158
5, 11:12:00-000, 1029, 534, 495, 400, 1348.13, 464, 1350.21, 146
5, 11:13:00-000, 1015, 468, 547, 382, 1348.37, 398, 1349.01, 159
5, 11:14:00-000, 1007, 518, 489, 379, 1348.84, 430, 1350.42, 153
5, 11:15:00-000, 0, 0, 0, 0, 0.00, 24, 1355.95, 125
5, 11:16:00-000, 1002, 528, 474, 397, 1348.96, 400, 1349.91, 180
5, 11:17:00-000, 1022, 530, 492, 387, 1348.65, 395, 1349.09, 129
5, 11:18:00-000, 1095, 629, 466, 493, 1349.09, 429, 1350.39, 158
5, 11:19:00-000, 0, 0, 0, 4, 1346.00, 34, 1356.64, 130
5, 11:20:00-000, 1004, 525, 479, 395, 1348.99, 384, 1349.54, 150
5, 11:21:00-000, 1018, 535, 483, 392, 1349.06, 399, 1349.66, 194
5, 11:22:00-000, 1061, 596, 465, 422, 1349.66, 389, 1350.44, 139
5, 11:23:00-000, 0, 0, 0, 54, 1346.51, 10, 1356.50, 150
5, 11:24:00-000, 1044, 555, 489, 453, 1348.55, 422, 1349.68, 155
5, 11:25:00-000, 984, 556, 428, 361, 1349.50, 355, 1350.48, 104
5, 11:26:00-000, 1045, 557, 488, 469, 1348.93, 361, 1349.65, 172
5, 11:27:00-000, 0, 0, 0, 3, 1346.00, 12, 1355.00, 164
5, 11:28:00-000, 921, 458, 463, 387, 1348.70, 361, 1349.80, 153
5, 11:29:00-000, 938, 380, 558, 320, 1346.96, 387, 1347.64, 156
5, 11:30:00-000, 992, 478, 514, 357, 1348.60, 429, 1349.52, 138
5, 11:31:00-000, 0, 0, 0, 0, 0.00, 34, 1355.67, 135
5, 11:32:00-000, 1055, 556, 499, 478, 1349.18, 509, 1350.45, 169
5, 11:33:00-000, 987, 489, 498, 370, 1348.33, 368, 1349.05, 103
5, 11:34:00-000, 989, 499, 490, 405, 1348.76, 434, 1349.95, 81
5, 11:35:00-000, 0, 0, 0, 17, 1344.70, 19, 1356.00, 150
5, 11:36:00-000, 1110, 595, 515, 440, 1348.60, 432, 1349.84, 122
5, 11:37:00-000, 957, 496, 461, 364, 1348.95, 407, 1350.03, 142
5, 11:38:00-000, 1084, 611, 473, 470, 1349.24, 424, 1350.28, 154
5, 11:39:00-000, 1, 1, 0, 63, 1345.97, 1, 1357.00, 147
5, 11:40:00-000, 963, 537, 426, 394, 1348.89, 356, 1349.34, 114
5, 11:41:00-000, 946, 450, 496, 351, 1348.35, 368, 1348.95, 154
5, 11:42:00-000, 1026, 479, 547, 391, 1348.02, 390, 1349.23, 133
5, 11:43:00-000, 0, 0, 0, 19, 1345.21, 29, 1353.69, 144
5, 11:44:00-000, 860, 444, 416, 313, 1348.61, 344, 1349.61, 176
5, 11:45:00-000, 1016, 519, 497, 386, 1349.39, 416, 1350.18, 138
5, 11:46:00-000, 1037, 548, 489, 390, 1348.57, 411, 1349.55, 161
5, 11:47:00-000, 0, 0, 0, 5, 1346.00, 25, 1356.68, 148
5, 11:48:00-000, 941, 518, 423, 338, 1348.57, 377, 1350.27, 197
5, 11:49:00-000, 1062, 511, 551, 404, 1348.50, 400, 1349.12, 158
5, 11:50:00-000, 1036, 568, 468, 438, 1348.33, 414, 1350.19, 152
5, 11:51:00-000, 0, 0, 0, 33, 1345.00, 3, 1357.00, 170
5, 11:52:00-000, 1055, 574, 481, 420, 1348.70, 413, 1349.19, 169
5, 11:53:00-000, 1047, 508, 539, 370, 1348.57, 349, 1348.64, 136
5, 11:54:00-000, 1030, 522, 508, 421, 1349.14, 431, 1350.11, 190
5, 11:55:00-000, 0, 0, 0, 41, 1345.43, 0, 0.00, 190
5, 11:56:00-000, 994, 463, 531, 389, 1347.96, 381, 1349.09, 150
5, 11:57:00-000, 942, 496, 446, 363, 1349.43, 345, 1350.00, 156
5, 11:58:00-000, 1011, 512, 499, 391, 1348.65, 467, 1349.98, 136
5, 11:59:00-000, 2, 2, 0, 1, 1346.00, 16, 1357.00, 163
5, 12:00:00-000, 1102, 562, 540, 424, 1348.92, 417, 1349.69, 163
5, 12:01:00-000, 964, 477, 487, 340, 1349.04, 385, 1349.68, 170
5, 12:02:00-000, 941, 459, 482, 399, 1348.59, 382, 1349.46, 166
5, 12:03:00-000, 1, 1, 0, 32, 1344.24, 0, 0.00, 139
5, 12:04:00-000, 993, 552, 441, 427, 1350.51, 392, 1351.59, 126
5, 12:05:00-000, 1050, 529, 521, 397, 1348.50, 397, 1348.63, 122
5, 12:06:00-000, 1023, 530, 493, 428, 1348.28, 389, 1349.34, 148
5, 12:07:00-000, 0, 0, 0, 26, 1345.19, 57, 1355.57, 169
5, 12:08:00-000, 1091, 522, 569, 394, 1348.53, 368, 1348.83, 140
5, 12:09:00-000, 1028, 496, 532, 341, 1348.55, 389, 1349.33, 197
5, 12:10:00-000, 1004, 492, 512, 390, 1348.71, 451, 1350.39, 194
5, 12:11:00-000, 0, 0, 0, 38, 1345.02, 9, 1356.00, 163
5, 12:12:00-000, 1016, 593, 423, 439, 1349.73, 371, 1350.63, 133
5, 12:13:00-000, 961, 544, 417, 380, 1349.29, 349, 1350.25, 190
5, 12:14:00-000, 1073, 521, 552, 414, 1348.17, 450, 1349.78, 126
5, 12:15:00-000, 0, 0, 0, 24, 1345.71, 13, 1356.00, 172
5, 12:16:00-000, 1060, 522, 538, 367, 1348.83, 401, 1349.28, 179
5, 12:17:00-000, 1018, 503, 515, 354, 1348.63, 367, 1348.74, 160
5, 12:18:00-000, 1065, 572, 493, 425, 1349.36, 422, 1350.22, 223
5, 12:19:00-000, 0, 0, 0, 21, 1347.38, 56, 1356.00, 167
5, 12:20:00-000, 1095, 529, 566, 352, 1348.65, 350, 1348.37, 148
5, 12:21:00-000, 986, 461, 525, 296, 1348.64, 369, 1348.80, 284
5, 12:22:00-000, 919, 477, 442, 353, 1348.89, 345, 1348.91, 231
5, 12:23:00-000, 0, 0, 0, 0, 0.00, 0, 0.00, 232
5, 12:24:00-000, 1081, 559, 522, 410, 1348.89, 410, 1349.30, 189
5, 12:25:00-000, 1050, 525, 525, 405, 1348.59, 385, 1348.84, 183
5, 12:26:00-000, 1178, 600, 578, 460, 1349.01, 423, 1348.63, 192
5, 12:27:00-000, 0, 0, 0, 0, 0.00, 0, 0.00, 209
5, 12:28:00-000, 977, 521, 456, 356, 1348.70, 347, 1349.40, 226
5, 12:29:00-000, 1018, 531, 487, 406, 1349.24, 359, 1349.48, 206
5, 12:30:00-000, 969, 543, 426, 377, 1349.35, 337, 1349.13, 205
5, 12:31:00-000, 0, 0, 0, 23, 1346.21, 0, 0.00, 187
5, 12:32:00-000, 954, 479, 475, 390, 1349.12, 373, 1349.25, 168
5, 12:33:00-000, 1047, 572, 475, 381, 1349.60, 390, 1349.99, 161
5, 12:34:00-000, 1081, 555, 526, 444, 1348.72, 407, 1349.31, 148
5, 12:35:00-000, 0, 0, 0, 0, 0.00, 0, 0.00, 179
5, 12:36:00-000, 1041, 542, 499, 392, 1349.06, 398, 1349.47, 204
5, 12:37:00-000, 947, 478, 469, 372, 1348.58, 349, 1349.22, 192
5, 12:38:00-000, 1009, 555, 454, 437, 1348.65, 368, 1349.48, 180
5, 12:39:00-000, 4, 0, 4, 27, 1345.00, 3, 1350.00, 149
5, 12:40:00-000, 1089, 564, 525, 382, 1348.94, 419, 1349.87, 137
5, 12:41:00-000, 1091, 530, 561, 401, 1348.47, 402, 1349.31, 207
5, 12:42:00-000, 1024, 521, 503, 385, 1349.28, 431, 1349.74, 218
5, 12:43:00-000, 0, 0, 0, 24, 1346.00, 12, 1355.00, 198
5, 12:44:00-000, 1068, 543, 525, 454, 1347.93, 401, 1349.56, 110
5, 12:45:00-000, 1078, 529, 549, 440, 1348.72, 423, 1349.30, 148
5, 12:46:00-000, 1047, 553, 494, 410, 1349.10, 409, 1350.00, 197
5, 12:47:00-000, 0, 0, 0, 0, 0.00, 41, 1356.00, 119
5, 12:48:00-000, 960, 496, 464, 389, 1348.54, 396, 1349.11, 175
5, 12:49:00-000, 1033, 511, 522, 378, 1348.97, 343, 1349.46, 135
5, 12:50:00-000, 1043, 557, 486, 412, 1348.79, 423, 1349.38, 194
5, 12:51:00-000, 0, 0, 0, 30, 1346.00, 22, 1356.00, 165
5, 12:52:00-000, 974, 455, 519, 355, 1348.06, 440, 1348.87, 166
5, 12:53:00-000, 1021, 530, 491, 370, 1348.71, 381, 1349.15, 97
5, 12:54:00-000, 1023, 512, 511, 430, 1348.57, 412, 1349.16, 187
5, 12:55:00-000, 0, 0, 0, 0, 0.00, 1, 1356.00, 159
5, 12:56:00-000, 1003, 462, 541, 403, 1347.13, 397, 1348.54, 174
5, 12:57:00-000, 1014, 469, 545, 390, 1348.61, 404, 1349.14, 153
5, 12:58:00-000, 1089, 571, 518, 401, 1348.84, 402, 1349.33, 141
5, 12:59:00-000, 0, 0, 0, 34, 1345.58, 15, 1356.00, 165
5, 13:00:00-000, 986, 431, 555, 380, 1347.71, 434, 1348.67, 192
5, 13:01:00-000, 985, 521, 464, 378, 1348.73, 424, 1350.02, 126
5, 13:02:00-000, 996, 504, 492, 453, 1348.50, 331, 1348.95, 120
5, 13:03:00-000, 1, 0, 1, 0, 0.00, 45, 1354.77, 137
5, 13:04:00-000, 984, 483, 501, 385, 1348.58, 383, 1349.25, 156
5, 13:05:00-000, 1002, 525, 477, 375, 1349.29, 354, 1349.73, 160
5, 13:06:00-000, 1034, 516, 518, 436, 1348.54, 454, 1349.79, 137
5, 13:07:00-000, 0, 0, 0, 13, 1344.30, 24, 1356.00, 145
5, 13:08:00-000, 1016, 521, 495, 439, 1348.35, 396, 1349.37, 159
5, 13:09:00-000, 1109, 623, 486, 433, 1349.09, 436, 1349.94, 124
5, 13:10:00-000, 1089, 583, 506, 458, 1348.83, 429, 1349.50, 149
5, 13:11:00-000, 0, 0, 0, 29, 1345.00, 8, 1356.00, 157
5, 13:12:00-000, 883, 457, 426, 355, 1349.22, 328, 1350.08, 170
5, 13:13:00-000, 1008, 529, 479, 363, 1348.94, 388, 1349.11, 136
5, 13:14:00-000, 1037, 489, 548, 401, 1348.56, 457, 1349.53, 139
5, 13:15:00-000, 2, 0, 2, 8, 1345.00, 14, 1357.00, 164
5, 13:16:00-000, 1000, 516, 484, 388, 1348.39, 386, 1349.06, 145
5, 13:17:00-000, 1020, 558, 462, 372, 1349.26, 388, 1349.63, 163
5, 13:18:00-000, 1004, 504, 500, 447, 1349.15, 453, 1350.57, 167
5, 13:19:00-000, 0, 0, 0, 37, 1345.56, 0, 0.00, 111
5, 13:20:00-000, 1101, 576, 525, 464, 1348.59, 491, 1349.79, 119
5, 13:21:00-000, 1088, 536, 552, 421, 1348.50, 439, 1349.26, 127
5, 13:22:00-000, 991, 554, 437, 389, 1349.89, 453, 1351.43, 118
5, 13:23:00-000, 0, 0, 0, 54, 1346.61, 17, 1358.00, 101
5, 13:24:00-000, 1039, 525, 514, 453, 1348.19, 421, 1349.22, 88
5, 13:25:00-000, 928, 444, 484, 309, 1348.25, 327, 1348.59, 136
5, 13:26:00-000, 1142, 548, 594, 420, 1348.33, 444, 1349.68, 167
5, 13:27:00-000, 1, 1, 0, 10, 1345.20, 63, 1354.75, 146
5, 13:28:00-000, 981, 447, 534, 373, 1348.34, 430, 1349.59, 217
5, 13:29:00-000, 1035, 503, 532, 386, 1348.54, 361, 1349.11, 154
5, 13:30:00-000, 1095, 496, 599, 434, 1347.80, 444, 1348.36, 143
5, 13:31:00-000, 3, 3, 0, 24, 1345.00, 16, 1354.00, 174
5, 13:32:00-000, 1037, 555, 482, 458, 1348.79, 397, 1349.94, 151
5, 13:33:00-000, 972, 490, 482, 336, 1349.03, 327, 1348.97, 161
5, 13:34:00-000, 1075, 566, 509, 412, 1349.21, 399, 1349.22, 202
5, 13:35:00-000, 0, 0, 0, 34, 1345.05, 50, 1355.66, 178
5, 13:36:00-000, 902, 442, 460, 339, 1349.09, 352, 1349.35, 174
5, 13:37:00-000, 1072, 562, 510, 387, 1349.10, 368, 1349.38, 164
5, 13:38:00-000, 1094, 568, 526, 432, 1348.35, 378, 1348.84, 121
5, 13:39:00-000, 3, 2, 1, 32, 1346.59, 40, 1353.87, 247
5, 13:40:00-000, 1079, 583, 496, 409, 1349.42, 453, 1350.00, 168
5, 13:41:00-000, 1042, 589, 453, 392, 1349.37, 346, 1349.94, 173
5, 13:42:00-000, 1085, 563, 522, 429, 1348.98, 378, 1349.47, 174
5, 13:43:00-000, 0, 0, 0, 33, 1346.36, 27, 1355.00, 228
5, 13:44:00-000, 1075, 564, 511, 441, 1349.15, 396, 1349.69, 208
5, 13:45:00-000, 1028, 574, 454, 419, 1349.45, 387, 1350.07, 129
5, 13:46:00-000, 1049, 558, 491, 451, 1348.46, 460, 1350.22, 162
5, 13:47:00-000, 2, 2, 0, 29, 1345.20, 15, 1357.00, 133
5, 13:48:00-000, 963, 458, 505, 372, 1349.41, 379, 1349.83, 149
5, 13:49:00-000, 929, 525, 404, 354, 1349.17, 382, 1350.40, 141
5, 13:50:00-000, 1026, 489, 537, 386, 1348.89, 404, 1349.54, 126
5, 13:51:00-000, 1, 1, 0, 15, 1347.40, 36, 1355.33, 132
5, 13:52:00-000, 1008, 524, 484, 386, 1348.70, 400, 1349.46, 160
5, 13:53:00-000, 1079, 594, 485, 401, 1350.23, 393, 1350.58, 185
5, 13:54:00-000, 1032, 577, 455, 407, 1349.61, 398, 1350.73, 145
5, 13:55:00-000, 0, 0, 0, 38, 1346.00, 21, 1357.00, 168
5, 13:56:00-000, 1093, 549, 544, 445, 1349.31, 449, 1349.84, 158
5, 13:57:00-000, 945, 496, 449, 379, 1349.15, 364, 1349.34, 174
5, 13:58:00-000, 1083, 621, 462, 418, 1349.80, 415, 1350.60, 143
5, 13:59:00-000, 0, 0, 0, 20, 1348.00, 10, 1357.00, 115
5, 14:00:00-000, 989, 506, 483, 381, 1349.17, 434, 1350.06, 177
5, 14:01:00-000, 1044, 520, 524, 436, 1349.00, 458, 1349.55, 170
5, 14:02:00-000, 1003, 527, 476, 373, 1348.79, 418, 1349.71, 129
5, 14:03:00-000, 0, 0, 0, 16, 1346.00, 22, 1356.27, 113
5, 14:04:00-000, 1031, 553, 478, 459, 1349.23, 410, 1350.08, 129
5, 14:05:00-000, 1021, 501, 520, 341, 1349.15, 380, 1349.92, 136
5, 14:06:00-000, 1062, 513, 549, 437, 1348.52, 493, 1350.13, 132
5, 14:07:00-000, 0, 0, 0, 46, 1345.38, 0, 0.00, 142
5, 14:08:00-000, 978, 446, 532, 358, 1348.43, 405, 1349.43, 115
5, 14:09:00-000, 1169, 532, 637, 394, 1348.04, 493, 1348.96, 175
5, 14:10:00-000, 1067, 536, 531, 459, 1348.20, 434, 1349.28, 185
5, 14:11:00-000, 0, 0, 0, 12, 1344.00, 37, 1356.00, 142
5, 14:12:00-000, 906, 438, 468, 375, 1348.24, 340, 1349.57, 160
5, 14:13:00-000, 964, 503, 461, 394, 1348.69, 369, 1349.72, 134
5, 14:14:00-000, 1095, 562, 533, 465, 1348.27, 405, 1349.11, 123
5, 14:15:00-000, 0, 0, 0, 33, 1344.57, 18, 1355.17, 134
5, 14:16:00-000, 1071, 539, 532, 422, 1348.66, 404, 1349.70, 150
5, 14:17:00-000, 1064, 608, 456, 443, 1349.82, 400, 1349.90, 164
5, 14:18:00-000, 994, 484, 510, 400, 1348.80, 393, 1350.14, 166
5, 14:19:00-000, 0, 0, 0, 21, 1346.76, 10, 1354.60, 136
5, 14:20:00-000, 1052, 567, 485, 413, 1349.69, 465, 1350.77, 141
5, 14:21:00-000, 1011, 557, 454, 412, 1349.41, 368, 1349.74, 147
5, 14:22:00-000, 1023, 525, 498, 364, 1349.00, 396, 1350.28, 172
5, 14:23:00-000, 2, 0, 2, 38, 1345.57, 35, 1355.45, 129
5, 14:24:00-000, 982, 530, 452, 415, 1348.95, 385, 1350.28, 181
5, 14:25:00-000, 1074, 574, 500, 415, 1349.64, 422, 1350.41, 133
5, 14:26:00-000, 959, 480, 479, 349, 1349.62, 390, 1350.94, 150
5, 14:27:00-000, 0, 0, 0, 34, 1346.53, 27, 1356.77, 152
5, 14:28:00-000, 967, 498, 469, 386, 1348.82, 389, 1349.10, 146
5, 14:29:00-000, 1050, 533, 517, 412, 1349.55, 424, 1350.25, 140
5, 14:30:00-000, 1123, 531, 592, 416, 1347.72, 447, 1348.99, 129
5, 14:31:00-000, 0, 0, 0, 19, 1345.00, 25, 1355.00, 154
5, 14:32:00-000, 1093, 589, 504, 432, 1348.84, 446, 1350.28, 146
5, 14:33:00-000, 1043, 569, 474, 418, 1348.71, 397, 1349.38, 170
5, 14:34:00-000, 1040, 538, 502, 451, 1348.29, 442, 1350.01, 144
5, 14:35:00-000, 0, 0, 0, 10, 1345.00, 13, 1357.00, 153
5, 14:36:00-000, 1048, 523, 525, 412, 1348.69, 400, 1349.45, 153
5, 14:37:00-000, 1064, 569, 495, 435, 1350.08, 439, 1350.76, 156
5, 14:38:00-000, 1051, 500, 551, 381, 1348.81, 419, 1350.19, 125
5, 14:39:00-000, 5, 0, 5, 66, 1344.50, 24, 1353.91, 113
5, 14:40:00-000, 1101, 508, 593, 435, 1348.25, 502, 1349.26, 182
5, 14:41:00-000, 1072, 526, 546, 387, 1348.61, 400, 1349.20, 147
5, 14:42:00-000, 1094, 609, 485, 475, 1349.03, 413, 1349.96, 141
5, 14:43:00-000, 1, 1, 0, 42, 1345.54, 30, 1356.00, 153
5, 14:44:00-000, 1005, 540, 465, 359, 1349.75, 339, 1350.28, 142
5, 14:45:00-000, 1027, 521, 506, 399, 1348.97, 384, 1349.44, 246
5, 14:46:00-000, 1037, 538, 499, 405, 1348.93, 398, 1349.94, 172
5, 14:47:00-000, 1, 0, 1, 4, 1346.00, 1, 1354.00, 173
5, 14:48:00-000, 1045, 518, 527, 412, 1348.55, 402, 1349.18, 198
5, 14:49:00-000, 1089, 504, 585, 369, 1348.76, 339, 1349.12, 165
5, 14:50:00-000, 976, 483, 493, 352, 1348.66, 436, 1350.11, 202
5, 14:51:00-000, 0, 0, 0, 22, 1345.00, 8, 1356.00, 207
5, 14:52:00-000, 1034, 551, 483, 412, 1349.08, 412, 1349.85, 188
5, 14:53:00-000, 958, 519, 439, 372, 1349.08, 378, 1349.79, 157
5, 14:54:00-000, 997, 468, 529, 355, 1349.19, 404, 1349.57, 175
5, 14:55:00-000, 5, 4, 1, 58, 1344.59, 27, 1355.44, 135
5, 14:56:00-000, 1021, 495, 526, 429, 1347.92, 431, 1348.95, 139
5, 14:57:00-000, 990, 529, 461, 409, 1349.18, 369, 1349.37, 111
5, 14:58:00-000, 1019, 532, 487, 393, 1348.76, 368, 1349.19, 112
5, 14:59:00-000, 1, 1, 0, 61, 1344.65, 27, 1355.00, 174
5, 15:00:00-000, 1044, 553, 491, 394, 1348.45, 437, 1350.39, 120
5, 15:01:00-000, 1111, 607, 504, 395, 1349.04, 395, 1349.54, 165
5, 15:02:00-000, 940, 502, 438, 378, 1349.33, 391, 1350.40, 177
5, 15:03:00-000, 7, 7, 0, 96, 1345.22, 5, 1356.00, 197
5, 15:04:00-000, 1054, 491, 563, 430, 1347.69, 460, 1349.42, 97
5, 15:05:00-000, 932, 457, 475, 362, 1348.48, 361, 1349.19, 116
5, 15:06:00-000, 1044, 563, 481, 420, 1349.45, 445, 1350.69, 131
5, 15:07:00-000, 1, 1, 0, 6, 1346.83, 25, 1357.00, 116
5, 15:08:00-000, 1010, 519, 491, 431, 1348.76, 419, 1349.62, 104
5, 15:09:00-000, 1023, 558, 465, 397, 1349.28, 367, 1349.12, 192
5, 15:10:00-000, 1029, 507, 522, 427, 1348.81, 400, 1349.66, 107
5, 15:11:00-000, 0, 0, 0, 22, 1344.77, 35, 1355.71, 174
5, 15:12:00-000, 1026, 518, 508, 393, 1348.04, 427, 1348.73, 123
5, 15:13:00-000, 986, 511, 475, 339, 1349.15, 379, 1349.98, 172
5, 15:14:00-000, 1039, 546, 493, 407, 1348.51, 446, 1350.10, 139
5, 15:15:00-000, 0, 0, 0, 0, 0.00, 25, 1357.00, 133
5, 15:16:00-000, 1069, 515, 554, 474, 1348.25, 454, 1349.47, 177
5, 15:17:00-000, 1037, 538, 499, 392, 1349.68, 372, 1350.36, 117
5, 15:18:00-000, 928, 485, 443, 408, 1348.82, 372, 1350.32, 136
5, 15:19:00-000, 3, 0, 3, 20, 1345.00, 0, 0.00, 182
5, 15:20:00-000, 1022, 548, 474, 438, 1349.22, 412, 1349.80, 138
5, 15:21:00-000, 1044, 530, 514, 403, 1348.65, 437, 1349.20, 136
5, 15:22:00-000, 996, 415, 581, 370, 1348.00, 472, 1349.37, 117
5, 15:23:00-000, 2, 0, 2, 22, 1344.00, 42, 1355.14, 103
5, 15:24:00-000, 1112, 607, 505, 391, 1348.78, 410, 1350.27, 137
5, 15:25:00-000, 985, 501, 484, 356, 1349.01, 392, 1349.77, 165
5, 15:26:00-000, 1096, 570, 526, 500, 1348.38, 397, 1349.51, 174
5, 15:27:00-000, 2, 1, 1, 18, 1345.94, 25, 1356.00, 165
5, 15:28:00-000, 1037, 560, 477, 450, 1349.04, 392, 1349.90, 167
5, 15:29:00-000, 996, 484, 512, 390, 1348.21, 361, 1348.64, 151
5, 15:30:00-000, 1119, 571, 548, 390, 1349.12, 395, 1349.88, 131
5, 15:31:00-000, 0, 0, 0, 52, 1345.30, 29, 1354.65, 145
5, 15:32:00-000, 1016, 510, 506, 347, 1348.98, 425, 1350.05, 223
5, 15:33:00-000, 1141, 629, 512, 448, 1349.48, 413, 1350.04, 177
5, 15:34:00-000, 1111, 576, 535, 419, 1348.83, 430, 1349.74, 206
5, 15:35:00-000, 0, 0, 0, 24, 1346.00, 45, 1356.22, 157
5, 15:36:00-000, 943, 458, 485, 358, 1348.66, 394, 1349.98, 193
5, 15:37:00-000, 1044, 540, 504, 379, 1348.41, 400, 1349.16, 151
5, 15:38:00-000, 1130, 538, 592, 408, 1348.73, 438, 1349.53, 202
5, 15:39:00-000, 1, 1, 0, 20, 1345.00, 1, 1354.00, 181
5, 15:40:00-000, 1008, 522, 486, 327, 1349.12, 342, 1348.40, 224
5, 15:41:00-000, 1081, 603, 478, 396, 1349.65, 317, 1349.00, 212
5, 15:42:00-000, 1125, 542, 583, 425, 1349.02, 415, 1349.24, 250
5, 15:43:00-000, 0, 0, 0, 0, 0.00, 0, 0.00, 228
5, 15:44:00-000, 958, 488, 470, 358, 1349.07, 382, 1349.13, 232
5, 15:45:00-000, 982, 493, 489, 348, 1348.84, 367, 1348.76, 213
5, 15:46:00-000, 1069, 591, 478, 484, 1349.59, 353, 1349.31, 182
5, 15:47:00-000, 9, 8, 1, 8, 1346.50, 1, 1350.00, 177
5, 15:48:00-000, 1026, 533, 493, 383, 1348.95, 386, 1349.46, 194
5, 15:49:00-000, 1024, 496, 528, 384, 1348.93, 406, 1348.94, 180
5, 15:50:00-000, 1094, 506, 588, 409, 1348.18, 405, 1348.45, 214
5, 15:51:00-000, 2, 2, 0, 2, 1351.00, 8, 1354.00, 167
5, 15:52:00-000, 999, 501, 498, 418, 1348.43, 400, 1349.26, 164
5, 15:53:00-000, 984, 470, 514, 377, 1348.52, 370, 1348.77, 174
5, 15:54:00-000, 906, 437, 469, 354, 1348.44, 403, 1349.49, 158
5, 15:55:00-000, 5, 2, 3, 2, 1349.00, 30, 1354.00, 157
5, 15:56:00-000, 1099, 572, 527, 452, 1348.55, 419, 1349.43, 107
5, 15:57:00-000, 1006, 501, 505, 349, 1349.56, 363, 1349.81, 175
5, 15:58:00-000, 946, 489, 457, 377, 1348.46, 348, 1349.40, 187
5, 15:59:00-000, 2, 2, 0, 48, 1345.37, 0, 0.00, 173
5, 16:00:00-000, 1117, 518, 599, 416, 1347.88, 415, 1348.38, 176
5, 16:01:00-000, 1069, 491, 578, 347, 1348.83, 415, 1349.61, 175
5, 16:02:00-000, 1067, 553, 514, 372, 1349.84, 403, 1350.57, 192
5, 16:03:00-000, 3, 0, 3, 40, 1345.67, 25, 1354.76, 188
5, 16:04:00-000, 977, 499, 478, 391, 1349.26, 367, 1349.51, 220
5, 16:05:00-000, 908, 454, 454, 352, 1349.31, 356, 1350.08, 213
5, 16:06:00-000, 963, 469, 494, 406, 1348.62, 371, 1349.02, 143
5, 16:07:00-000, 2, 2, 0, 2, 1347.50, 48, 1354.60, 133
5, 16:08:00-000, 1114, 556, 558, 390, 1348.78, 422, 1349.08, 124
5, 16:09:00-000, 1041, 537, 504, 387, 1349.32, 410, 1349.61, 153
5, 16:10:00-000, 1040, 545, 495, 417, 1349.77, 393, 1349.97, 205
5, 16:11:00-000, 1, 1, 0, 34, 1345.91, 0, 0.00, 180
5, 16:12:00-000, 997, 492, 505, 403, 1348.18, 412, 1349.86, 161
5, 16:13:00-000, 916, 404, 512, 302, 1349.29, 405, 1349.85, 164
5, 16:14:00-000, 1074, 514, 560, 420, 1347.51, 417, 1348.51, 122
5, 16:15:00-000, 0, 0, 0, 8, 1344.00, 43, 1354.30, 132
5, 16:16:00-000, 1034, 481, 553, 342, 1348.71, 386, 1349.57, 167
5, 16:17:00-000, 1013, 518, 495, 419, 1348.60, 413, 1349.29, 201
5, 16:18:00-000, 1051, 554, 497, 427, 1349.01, 382, 1349.37, 157
5, 16:19:00-000, 8, 8, 0, 36, 1344.99, 5, 1355.00, 164
5, 16:20:00-000, 1083, 496, 587, 373, 1347.79, 413, 1348.50, 179
5, 16:21:00-000, 1124, 596, 528, 458, 1349.09, 397, 1349.49, 176
5, 16:22:00-000, 931, 496, 435, 479, 1348.79, 367, 1349.95, 210
5, 16:23:00-000, 3, 0, 3, 6, 1344.17, 37, 1355.10, 133
5, 16:24:00-000, 1058, 554, 504, 491, 1348.30, 418, 1349.67, 100
5, 16:25:00-000, 1053, 537, 516, 407, 1349.04, 397, 1350.21, 91
5, 16:26:00-000, 1009, 486, 523, 401, 1348.64, 400, 1349.29, 163
5, 16:27:00-000, 2, 2, 0, 4, 1344.50, 49, 1355.30, 160
5, 16:28:00-000, 934, 476, 458, 359, 1348.39, 349, 1348.72, 138
5, 16:29:00-000, 975, 475, 500, 398, 1349.26, 419, 1349.33, 173
6, 12:20:00-000, 6959, 3525, 3434, 1503, 1348.06, 1594, 1348.57, 0
6, 12:21:00-000, 0, 0, 0, 83, 1347.00, 26, 1353.00, 0
6, 12:22:00-000, 0, 0, 0, 144, 1346.53, 110, 1354.00, 0
6, 12:23:00-000, 0, 0, 0, 50, 1346.00, 79, 1354.00, 0
6, 12:24:00-000, 0, 0, 0, 85, 1346.00, 87, 1354.60, 0
6, 12:25:00-000, 0, 0, 0, 38, 1346.00, 27, 1355.00, 0
6, 12:26:00-000, 0, 0, 0, 90, 1345.00, 76, 1355.00, 0
6, 12:27:00-000, 0, 0, 0, 0, 0.00, 38, 1355.00, 0
6, 12:28:00-000, 0, 0, 0, 0, 0.00, 17, 1355.00, 0
6, 12:29:00-000, 0, 0, 0, 22, 1345.00, 11, 1355.00, 0
6, 12:30:00-000, 0, 0, 0, 45, 1345.00, 39, 1355.00, 0
6, 12:32:00-000, 0, 0, 0, 42, 1345.00, 0, 0.00, 0
6, 12:34:00-000, 0, 0, 0, 21, 1345.00, 22, 1356.00, 0
6, 12:35:00-000, 0, 0, 0, 34, 1345.00, 0, 0.00, 0
6, 12:36:00-000, 0, 0, 0, 0, 0.00, 39, 1356.00, 0
6, 12:37:00-000, 0, 0, 0, 3, 1345.00, 0, 0.00, 0
6, 12:38:00-000, 0, 0, 0, 5, 1344.00, 26, 1356.00, 0
6, 12:39:00-000, 0, 0, 0, 0, 0.00, 49, 1356.00, 0
6, 12:40:00-000, 0, 0, 0, 0, 0.00, 90, 1356.00, 123
6, 12:41:00-000, 0, 0, 0, 0, 0.00, 0, 0.00, 108
6, 12:42:00-000, 0, 0, 0, 0, 0.00, 0, 0.00, 135
6, 12:43:00-000, 0, 0, 0, 0, 0.00, 0, 0.00, 124
6, 12:44:00-000, 0, 0, 0, 12, 1344.00, 6, 1356.00, 136
6, 12:45:00-000, 0, 0, 0, 0, 0.00, 0, 0.00, 144
6, 12:46:00-000, 0, 0, 0, 7, 1344.00, 0, 0.00, 121
6, 12:47:00-000, 0, 0, 0, 0, 0.00, 13, 1357.00, 102
6, 12:48:00-000, 0, 0, 0, 4, 1344.00, 0, 0.00, 130
6, 12:49:00-000, 0, 0, 0, 0, 0.00, 0, 0.00, 111
6, 12:50:00-000, 0, 0, 0, 0, 0.00, 0, 0.00, 114
6, 12:51:00-000, 0, 0, 0, 0, 0.00, 0, 0.00, 108
6, 12:52:00-000, 0, 0, 0, 0, 0.00, 0, 0.00, 110
6, 12:53:00-000, 0, 0, 0, 0, 0.00, 0, 0.00, 126
6, 12:54:00-000, 0, 0, 0, 27, 1344.00, 0, 0.00, 128
6, 12:55:00-000, 0, 0, 0, 23, 1344.00, 0, 0.00, 103
6, 12:56:00-000, 0, 0, 0, 5, 1344.00, 0, 0.00, 124
6, 12:57:00-000, 0, 0, 0, 0, 0.00, 0, 0.00, 114
6, 12:58:00-000, 0, 0, 0, 0, 0.00, 0, 0.00, 96
6, 12:59:00-000, 0, 0, 0, 0, 0.00, 0, 0.00, 110
6, 15:40:00-000, 6951, 3456, 3495, 1545, 1347.62, 1576, 1348.18, 0
6, 15:41:00-000, 0, 0, 0, 62, 1347.00, 141, 1353.00, 0
6, 15:42:00-000, 0, 0, 0, 111, 1346.00, 84, 1354.00, 0
6, 15:43:00-000, 0, 0, 0, 83, 1346.00, 107, 1354.00, 0
6, 15:44:00-000, 0, 0, 0, 64, 1346.00, 87, 1354.73, 0
6, 15:45:00-000, 0, 0, 0, 20, 1346.00, 17, 1355.00, 0
6, 15:46:00-000, 0, 0, 0, 0, 0.00, 97, 1355.00, 0
6, 15:47:00-000, 0, 0, 0, 42, 1345.00, 19, 1355.00, 0
6, 15:48:00-000, 0, 0, 0, 7, 1345.00, 0, 0.00, 0
6, 15:49:00-000, 0, 0, 0, 49, 1345.00, 18, 1355.00, 0
6, 15:50:00-000, 0, 0, 0, 21, 1345.00, 0, 0.00, 0
6, 15:51:00-000, 0, 0, 0, 62, 1345.00, 0, 0.00, 0
6, 15:52:00-000, 0, 0, 0, 53, 1344.71, 17, 1355.00, 0
6, 15:53:00-000, 0, 0, 0, 36, 1344.00, 0, 0.00, 0
6, 15:54:00-000, 0, 0, 0, 60, 1344.00, 0, 0.00, 0
6, 15:55:00-000, 0, 0, 0, 40, 1344.00, 0, 0.00, 0
6, 15:56:00-000, 0, 0, 0, 0, 0.00, 78, 1356.00, 0
6, 15:57:00-000, 0, 0, 0, 0, 0.00, 5, 1356.00, 0
6, 15:58:00-000, 0, 0, 0, 0, 0.00, 48, 1356.00, 0
6, 15:59:00-000, 0, 0, 0, 0, 0.00, 10, 1356.00, 0
6, 16:00:00-000, 1, 1, 0, 1, 1347.00, 0, 0.00, 108
6, 16:01:00-000, 0, 0, 0, 0, 0.00, 0, 0.00, 120
6, 16:02:00-000, 0, 0, 0, 0, 0.00, 0, 0.00, 118
6, 16:03:00-000, 0, 0, 0, 0, 0.00, 0, 0.00, 101
6, 16:04:00-000, 0, 0, 0, 0, 0.00, 10, 1356.00, 130
6, 16:05:00-000, 0, 0, 0, 0, 0.00, 0, 0.00, 101
6, 16:06:00-000, 0, 0, 0, 13, 1344.00, 0, 0.00, 128
6, 16:07:00-000, 0, 0, 0, 11, 1344.00, 0, 0.00, 120
6, 16:08:00-000, 0, 0, 0, 0, 0.00, 0, 0.00, 103
6, 16:09:00-000, 0, 0, 0, 0, 0.00, 0, 0.00, 113
6, 16:10:00-000, 0, 0, 0, 0, 0.00, 35, 1356.00, 116
6, 16:11:00-000, 0, 0, 0, 0, 0.00, 5, 1356.00, 124
6, 16:12:00-000, 0, 0, 0, 0, 0.00, 9, 1356.00, 113
6, 16:13:00-000, 1, 0, 1, 0, 0.00, 0, 0.00, 122
6, 16:14:00-000, 0, 0, 0, 13, 1344.00, 0, 0.00, 119
6, 16:15:00-000, 0, 0, 0, 6, 1344.00, 0, 0.00, 100
6, 16:16:00-000, 0, 0, 0, 0, 0.00, 0, 0.00, 115
6, 16:17:00-000, 0, 0, 0, 0, 0.00, 0, 0.00, 115
6, 16:18:00-000, 1, 0, 1, 0, 0.00, 1, 1348.00, 97
6, 16:19:00-000, 0, 0, 0, 0, 0.00, 0, 0.00, 125
6, 16:20:00-000, 13, 2, 11, 1, 1345.00, 8, 1353.00, 2
6, 16:23:00-000, 0, 0, 0, 0, 0.00, 1, 1356.00, 0
7, 09:07:00-000, 3642, 1515, 2127, 0, 0.00, 0, 0.00, 3642
7, 09:22:00-000, 13184, 7646, 5538, 0, 0.00, 0, 0.00, 13184
7, 09:35:00-000, 1578, 1336, 242, 22, 1353.09, 22, 1352.18, 1534
7, 09:36:00-000, 3050, 20, 3030, 0, 0.00, 0, 0.00, 3050
7, 09:37:00-000, 8435, 3038, 5397, 0, 0.00, 0, 0.00, 8435
7, 09:40:00-000, 4999, 3936, 1063, 0, 0.00, 0, 0.00, 4999
7, 09:42:00-000, 4285, 2831, 1454, 0, 0.00, 0, 0.00, 4285
7, 09:44:00-000, 4127, 3093, 1034, 0, 0.00, 0, 0.00, 3134
7, 09:45:00-000, 0, 0, 0, 0, 0.00, 0, 0.00, 993
7, 09:46:00-000, 2708, 1293, 1415, 0, 0.00, 0, 0.00, 2708
7, 09:47:00-000, 8076, 8010, 66, 0, 0.00, 0, 0.00, 8076
7, 09:54:00-000, 2280, 788, 1492, 0, 0.00, 0, 0.00, 1488
7, 09:55:00-000, 5863, 2426, 3437, 0, 0.00, 0, 0.00, 6655
7, 09:56:00-000, 4045, 2658, 1387, 21, 1350.38, 58, 1353.00, 3966
7, 09:57:00-000, 1192, 82, 1110, 37, 1355.40, 0, 0.00, 1155
7, 09:58:00-000, 3920, 2093, 1827, 0, 0.00, 0, 0.00, 3920
7, 09:59:00-000, 820, 810, 10, 10, 1352.50, 10, 1351.60, 800
7, 10:00:00-000, 13094, 3583, 9511, 7, 1353.57, 7, 1352.00, 13080
7, 10:01:00-000, 13783, 6277, 7506, 0, 0.00, 0, 0.00, 12787
7, 10:02:00-000, 5479, 5460, 19, 0, 0.00, 0, 0.00, 6475
7, 10:03:00-000, 10618, 5443, 5175, 15, 1348.00, 15, 1348.13, 10588
7, 10:04:00-000, 11180, 6031, 5149, 0, 0.00, 0, 0.00, 11180
7, 10:05:00-000, 12382, 7424, 4958, 5, 1349.00, 5, 1349.80, 12372
7, 10:06:00-000, 1266, 1230, 36, 34, 1345.64, 34, 1347.85, 1198
7, 10:07:00-000, 1297, 1290, 7, 0, 0.00, 0, 0.00, 1297
7, 10:08:00-000, 2575, 1525, 1050, 0, 0.00, 0, 0.00, 2575
7, 10:09:00-000, 2696, 16, 2680, 2, 1350.00, 2, 1352.00, 2690
7, 10:10:00-000, 6152, 2040, 4112, 8, 1347.12, 8, 1349.00, 6138
7, 10:12:00-000, 12999, 10176, 2823, 1, 1353.00, 1, 1351.00, 12997
7, 10:15:00-000, 1382, 2, 1380, 0, 0.00, 0, 0.00, 0
7, 10:16:00-000, 3329, 2526, 803, 16, 1351.75, 16, 1351.00, 4679
7, 10:17:00-000, 923, 3, 920, 0, 0.00, 0, 0.00, 923
7, 10:19:00-000, 9983, 7866, 2117, 0, 0.00, 0, 0.00, 8523
7, 10:20:00-000, 0, 0, 0, 0, 0.00, 0, 0.00, 1460
7, 10:24:00-000, 3382, 1315, 2067, 8, 1355.37, 8, 1353.37, 3366
7, 10:27:00-000, 5626, 2510, 3116, 3, 1350.00, 3, 1348.00, 5620
7, 10:29:00-000, 2109, 19, 2090, 7, 1353.14, 7, 1352.71, 2095
7, 10:30:00-000, 18472, 14233, 4239, 27, 1346.74, 27, 1347.55, 18418
7, 10:31:00-000, 9288, 5550, 3738, 27, 1351.00, 27, 1350.66, 9234
7, 10:33:00-000, 9402, 2998, 6404, 5, 1353.60, 5, 1352.00, 9392
7, 10:34:00-000, 19477, 12376, 7101, 1, 1350.00, 1, 1350.00, 19475
7, 10:36:00-000, 8627, 5733, 2894, 16, 1350.94, 15, 1353.53, 8596
7, 10:37:00-000, 3175, 1837, 1338, 17, 1347.88, 18, 1351.33, 3140
7, 10:38:00-000, 4992, 3105, 1887, 12, 1352.08, 12, 1349.67, 4968
7, 10:39:00-000, 12303, 3439, 8864, 9, 1350.56, 9, 1350.67, 10941
7, 10:40:00-000, 15426, 8718, 6708, 11, 1348.45, 11, 1351.55, 16748
7, 10:41:00-000, 2336, 1244, 1092, 24, 1349.50, 24, 1346.83, 2288
7, 10:42:00-000, 65, 56, 9, 6, 1355.00, 6, 1352.00, 53
7, 10:43:00-000, 8430, 2078, 6352, 13, 1352.15, 13, 1352.00, 8404
7, 10:44:00-000, 8296, 4313, 3983, 13, 1349.62, 16, 1350.94, 8267
7, 10:45:00-000, 13670, 3352, 10318, 30, 1350.33, 27, 1350.92, 12783
7, 10:46:00-000, 1863, 670, 1193, 40, 1353.97, 40, 1352.00, 2613
7, 10:47:00-000, 8626, 4503, 4123, 5, 1354.00, 5, 1352.00, 8616
7, 10:48:00-000, 19232, 11176, 8056, 34, 1350.79, 34, 1352.00, 19164
7, 10:49:00-000, 11701, 2443, 9258, 1, 1348.00, 1, 1352.00, 11699
7, 10:50:00-000, 4295, 3147, 1148, 34, 1351.38, 34, 1352.00, 4227
7, 10:51:00-000, 17522, 7890, 9632, 10, 1349.20, 10, 1345.50, 16356
7, 10:52:00-000, 8608, 3168, 5440, 8, 1352.12, 8, 1350.37, 9737
7, 10:53:00-000, 4438, 2968, 1470, 11, 1352.27, 11, 1350.82, 4417
7, 10:54:00-000, 2312, 1445, 867, 0, 0.00, 0, 0.00, 2312
7, 10:55:00-000, 10689, 4284, 6405, 0, 0.00, 0, 0.00, 9723
7, 10:56:00-000, 2914, 1283, 1631, 10, 1353.40, 10, 1352.00, 3860
7, 10:57:00-000, 15571, 11027, 4544, 2, 1350.50, 2, 1351.00, 15567
7, 10:58:00-000, 7585, 4320, 3265, 41, 1349.24, 41, 1349.95, 7503
7, 10:59:00-000, 5793, 3273, 2520, 5, 1352.00, 5, 1350.00, 5783
7, 11:00:00-000, 19920, 10123, 9797, 15, 1351.87, 15, 1350.46, 19869
7, 11:01:00-000, 3717, 1613, 2104, 12, 1346.25, 12, 1350.75, 3714
7, 11:02:00-000, 1260, 0, 1260, 0, 0.00, 0, 0.00, 1260
7, 11:03:00-000, 4601, 1655, 2946, 6, 1350.00, 6, 1348.00, 4589
7, 11:04:00-000, 15794, 5126, 10668, 4, 1352.00, 4, 1352.00, 14892
7, 11:05:00-000, 14400, 7587, 6813, 4, 1351.50, 4, 1352.00, 15286
7, 11:06:00-000, 4096, 3166, 930, 0, 0.00, 0, 0.00, 3068
7, 11:07:00-000, 8670, 5327, 3343, 2, 1351.00, 2, 1351.00, 9694
7, 11:08:00-000, 7478, 2235, 5243, 11, 1348.55, 11, 1352.00, 7456
7, 11:09:00-000, 2065, 1315, 750, 2, 1345.00, 2, 1351.00, 2061
7, 11:10:00-000, 1036, 1031, 5, 5, 1349.40, 5, 1351.00, 1026
7, 11:11:00-000, 17882, 10440, 7442, 0, 0.00, 0, 0.00, 17882
7, 11:14:00-000, 9412, 3507, 5905, 0, 0.00, 0, 0.00, 8455
7, 11:15:00-000, 13738, 6748, 6990, 18, 1349.39, 18, 1349.28, 14659
7, 11:18:00-000, 7789, 2855, 4934, 1, 1353.00, 1, 1352.00, 7787
7, 11:19:00-000, 8666, 2803, 5863, 0, 0.00, 0, 0.00, 8666
7, 11:20:00-000, 9620, 7622, 1998, 0, 0.00, 0, 0.00, 9194
7, 11:21:00-000, 19141, 11242, 7899, 16, 1351.37, 16, 1352.00, 18193
7, 11:22:00-000, 930, 917, 13, 7, 1355.43, 7, 1351.00, 2258
7, 11:23:00-000, 11943, 5531, 6412, 19, 1348.00, 19, 1347.84, 10859
7, 11:24:00-000, 0, 0, 0, 0, 0.00, 0, 0.00, 1046
7, 11:25:00-000, 7470, 3995, 3475, 0, 0.00, 0, 0.00, 7468
7, 11:26:00-000, 3667, 864, 2803, 0, 0.00, 0, 0.00, 3669
7, 11:27:00-000, 15115, 6005, 9110, 12, 1350.42, 19, 1350.26, 15084
7, 11:28:00-000, 10817, 2710, 8107, 17, 1351.17, 10, 1346.20, 10790
7, 11:29:00-000, 12924, 9129, 3795, 18, 1348.44, 18, 1349.00, 12888
7, 11:30:00-000, 7771, 3486, 4285, 3, 1348.00, 3, 1347.67, 7765
7, 11:31:00-000, 13689, 6844, 6845, 7, 1350.57, 16, 1351.37, 13666
7, 11:32:00-000, 9, 9, 0, 9, 1355.22, 0, 0.00, 0
7, 11:33:00-000, 7603, 3520, 4083, 0, 0.00, 0, 0.00, 6434
7, 11:34:00-000, 20450, 11161, 9289, 8, 1351.37, 8, 1351.50, 21603
7, 11:35:00-000, 11870, 2911, 8959, 40, 1353.50, 40, 1351.00, 11790
7, 11:38:00-000, 4305, 2294, 2011, 4, 1351.00, 4, 1348.00, 4297
7, 11:39:00-000, 2793, 18, 2775, 15, 1348.40, 15, 1347.46, 2763
7, 11:40:00-000, 3107, 1909, 1198, 52, 1350.15, 52, 1348.69, 3003
7, 11:42:00-000, 17658, 10469, 7189, 41, 1348.61, 34, 1348.62, 17583
7, 11:43:00-000, 8386, 4733, 3653, 15, 1346.47, 22, 1349.27, 8349
7, 11:44:00-000, 5348, 3251, 2097, 11, 1349.45, 11, 1350.91, 5326
7, 11:45:00-000, 5923, 971, 4952, 1, 1350.00, 1, 1350.00, 5921
7, 11:46:00-000, 5294, 1868, 3426, 1, 1351.00, 1, 1351.00, 5292
7, 11:47:00-000, 11373, 6728, 4645, 8, 1348.25, 8, 1348.75, 11357
7, 11:48:00-000, 7048, 2523, 4525, 2, 1350.00, 2, 1350.00, 7044
7, 11:49:00-000, 15194, 10016, 5178, 16, 1350.81, 16, 1351.94, 15162
7, 11:50:00-000, 8702, 2390, 6312, 11, 1349.09, 16, 1351.06, 8675
7, 11:51:00-000, 893, 12, 881, 6, 1355.17, 1, 1345.00, 886
7, 11:52:00-000, 5630, 3798, 1832, 53, 1348.92, 52, 1351.65, 4471
7, 11:53:00-000, 7549, 5257, 2292, 0, 0.00, 1, 1349.00, 7118
7, 11:54:00-000, 9071, 6300, 2771, 2, 1351.00, 2, 1351.00, 9646
7, 11:55:00-000, 5037, 3494, 1543, 0, 0.00, 0, 0.00, 5942
7, 11:56:00-000, 12225, 7332, 4893, 4, 1349.00, 4, 1348.00, 12217
7, 11:57:00-000, 5532, 5419, 113, 5, 1354.00, 5, 1351.00, 5522
7, 11:58:00-000, 19342, 9307, 10035, 11, 1350.18, 11, 1350.00, 19320
7, 11:59:00-000, 2575, 2538, 37, 8, 1352.50, 8, 1352.00, 2559
7, 12:00:00-000, 8709, 4223, 4486, 0, 0.00, 0, 0.00, 7202
7, 12:01:00-000, 10854, 5342, 5512, 8, 1348.00, 8, 1352.50, 12345
7, 12:02:00-000, 2577, 7, 2570, 0, 0.00, 0, 0.00, 2577
7, 12:03:00-000, 13640, 12626, 1014, 1, 1351.00, 1, 1351.00, 12202
7, 12:04:00-000, 6201, 4121, 2080, 46, 1354.32, 46, 1352.91, 7545
7, 12:05:00-000, 11321, 7487, 3834, 7, 1350.00, 7, 1351.29, 10593
7, 12:06:00-000, 13616, 8883, 4733, 16, 1348.75, 20, 1349.55, 14294
7, 12:07:00-000, 4705, 2367, 2338, 15, 1353.46, 13, 1350.61, 4677
7, 12:08:00-000, 7036, 5596, 1440, 42, 1350.09, 40, 1349.52, 6954
7, 12:09:00-000, 9845, 2906, 6939, 5, 1347.00, 5, 1346.00, 9835
7, 12:10:00-000, 2799, 1436, 1363, 39, 1348.46, 43, 1349.53, 2717
7, 12:11:00-000, 4252, 3049, 1203, 4, 1352.00, 0, 0.00, 4248
7, 12:12:00-000, 3259, 19, 3240, 0, 0.00, 0, 0.00, 3259
7, 12:14:00-000, 3488, 2028, 1460, 0, 0.00, 7, 1352.14, 3481
7, 12:15:00-000, 3619, 3142, 477, 7, 1355.57, 0, 0.00, 3612
7, 12:16:00-000, 8577, 3384, 5193, 19, 1351.10, 19, 1352.00, 8539
7, 12:17:00-000, 4128, 943, 3185, 17, 1349.00, 17, 1347.70, 4094
7, 12:18:00-000, 3607, 94, 3513, 5, 1348.20, 5, 1352.60, 3597
7, 12:20:00-000, 12037, 6268, 5769, 0, 0.00, 0, 0.00, 12037
7, 12:26:00-000, 302, 300, 2, 0, 0.00, 0, 0.00, 302
7, 12:27:00-000, 2676, 2650, 26, 0, 0.00, 0, 0.00, 2676
7, 12:28:00-000, 1520, 1520, 0, 0, 0.00, 0, 0.00, 1520
7, 12:30:00-000, 3778, 2864, 914, 7, 1350.86, 7, 1351.43, 3764
7, 12:31:00-000, 3753, 23, 3730, 0, 0.00, 0, 0.00, 3753
7, 12:39:00-000, 2592, 1091, 1501, 0, 0.00, 0, 0.00, 2592
7, 12:41:00-000, 2563, 827, 1736, 0, 0.00, 0, 0.00, 2563
7, 12:42:00-000, 10525, 4971, 5554, 9, 1349.11, 24, 1351.87, 10492
7, 12:43:00-000, 35, 35, 0, 15, 1351.67, 0, 0.00, 20
7, 12:44:00-000, 5595, 4056, 1539, 0, 0.00, 0, 0.00, 5595
7, 12:46:00-000, 3495, 1367, 2128, 7, 1353.29, 7, 1351.86, 3481
7, 12:47:00-000, 758, 730, 28, 0, 0.00, 0, 0.00, 758
7, 12:48:00-000, 9055, 1944, 7111, 0, 0.00, 0, 0.00, 9055
7, 12:49:00-000, 1143, 1120, 23, 20, 1349.00, 20, 1351.30, 1103
7, 12:50:00-000, 10275, 6294, 3981, 7, 1350.86, 30, 1352.00, 10238
7, 12:51:00-000, 6446, 4923, 1523, 23, 1354.04, 0, 0.00, 6419
7, 12:52:00-000, 1256, 1253, 3, 3, 1352.00, 3, 1349.00, 1254
7, 12:53:00-000, 1222, 12, 1210, 10, 1348.40, 10, 1352.00, 1202
7, 12:54:00-000, 6238, 4189, 2049, 0, 0.00, 0, 0.00, 6238
7, 12:55:00-000, 5829, 4740, 1089, 3, 1348.00, 3, 1344.00, 5823
7, 12:56:00-000, 17893, 11098, 6795, 0, 0.00, 0, 0.00, 17893
7, 12:57:00-000, 11726, 10055, 1671, 19, 1346.79, 19, 1349.21, 11688
7, 12:58:00-000, 8478, 7281, 1197, 9, 1346.00, 9, 1349.00, 7096
7, 12:59:00-000, 5512, 42, 5470, 0, 0.00, 0, 0.00, 6768
7, 13:00:00-000, 12633, 9794, 2839, 7, 1346.57, 7, 1350.57, 11372
7, 13:01:00-000, 12668, 8299, 4369, 19, 1347.68, 19, 1350.73, 13985
7, 13:02:00-000, 18185, 10740, 7445, 30, 1347.83, 55, 1351.03, 18100
7, 13:03:00-000, 7931, 5077, 2854, 28, 1351.93, 3, 1349.33, 7900
7, 13:04:00-000, 7116, 2450, 4666, 7, 1350.57, 7, 1351.00, 7102
7, 13:05:00-000, 6834, 3754, 3080, 1, 1355.00, 1, 1350.00, 5374
7, 13:06:00-000, 2337, 2002, 335, 22, 1352.86, 22, 1352.04, 3751
7, 13:07:00-000, 4279, 2149, 2130, 3, 1352.33, 3, 1351.00, 4273
7, 13:08:00-000, 4263, 2690, 1573, 0, 0.00, 0, 0.00, 4253
7, 13:09:00-000, 12445, 6155, 6290, 3, 1350.00, 3, 1351.00, 12449
7, 13:11:00-000, 800, 0, 800, 0, 0.00, 0, 0.00, 800
7, 13:12:00-000, 11896, 4437, 7459, 11, 1350.36, 11, 1351.09, 11874
7, 13:14:00-000, 5713, 3902, 1811, 0, 0.00, 0, 0.00, 5713
7, 13:15:00-000, 2010, 1178, 832, 2, 1349.00, 2, 1349.00, 2006
7, 13:19:00-000, 9614, 5558, 4056, 3, 1350.67, 3, 1351.00, 9608
7, 13:20:00-000, 8038, 2636, 5402, 47, 1351.55, 47, 1352.33, 7944
7, 13:21:00-000, 8253, 3406, 4847, 7, 1351.14, 7, 1353.43, 8239
7, 13:22:00-000, 12704, 3915, 8789, 2, 1350.50, 2, 1351.00, 12700
7, 13:24:00-000, 13551, 5002, 8549, 0, 0.00, 0, 0.00, 13537
7, 13:25:00-000, 12012, 4462, 7550, 0, 0.00, 0, 0.00, 10639
7, 13:26:00-000, 4000, 3150, 850, 0, 0.00, 0, 0.00, 5387
7, 13:27:00-000, 1045, 45, 1000, 19, 1353.37, 19, 1352.00, 1007
7, 13:28:00-000, 1363, 1360, 3, 0, 0.00, 0, 0.00, 1363
7, 13:29:00-000, 2185, 1450, 735, 7, 1347.00, 7, 1348.43, 2171
7, 13:30:00-000, 3227, 974, 2253, 0, 0.00, 0, 0.00, 3227
7, 13:32:00-000, 5157, 47, 5110, 0, 0.00, 0, 0.00, 5151
7, 13:33:00-000, 13401, 5181, 8220, 7, 1350.14, 7, 1349.86, 13393
7, 13:34:00-000, 10753, 4673, 6080, 15, 1346.80, 15, 1350.67, 10723
7, 13:35:00-000, 4603, 2006, 2597, 1, 1351.00, 1, 1350.00, 4601
7, 13:36:00-000, 10807, 5847, 4960, 75, 1348.41, 44, 1351.04, 10688
7, 13:37:00-000, 8582, 6092, 2490, 17, 1346.82, 48, 1347.20, 8517
7, 13:38:00-000, 10992, 3774, 7218, 6, 1347.67, 6, 1349.67, 10980
7, 13:39:00-000, 18229, 11512, 6717, 1, 1352.00, 1, 1351.00, 18227
7, 13:40:00-000, 4029, 2022, 2007, 17, 1349.65, 17, 1350.76, 3995
7, 13:41:00-000, 1124, 1120, 4, 0, 0.00, 0, 0.00, 1124
7, 13:42:00-000, 14332, 6403, 7929, 21, 1346.52, 21, 1347.71, 14290
7, 13:43:00-000, 2825, 1740, 1085, 0, 0.00, 0, 0.00, 2825
7, 13:44:00-000, 16041, 8855, 7186, 23, 1350.04, 22, 1352.54, 15996
7, 13:45:00-000, 8306, 2315, 5991, 1, 1352.00, 2, 1349.00, 8303
7, 13:46:00-000, 1458, 1420, 38, 18, 1349.00, 18, 1346.89, 1422
7, 13:47:00-000, 1419, 16, 1403, 3, 1349.00, 3, 1347.00, 1413
7, 13:48:00-000, 9097, 8090, 1007, 6, 1351.00, 11, 1353.00, 9080
7, 13:49:00-000, 7672, 5967, 1705, 26, 1350.04, 21, 1349.24, 7625
7, 13:50:00-000, 4277, 2586, 1691, 28, 1348.24, 41, 1351.17, 4208
7, 13:51:00-000, 10571, 6794, 3777, 15, 1354.20, 2, 1348.00, 10554
7, 13:52:00-000, 12220, 3908, 8312, 5, 1351.80, 5, 1352.20, 12210
7, 13:54:00-000, 1564, 710, 854, 0, 0.00, 0, 0.00, 1564
7, 13:56:00-000, 15091, 5709, 9382, 8, 1352.25, 11, 1350.91, 15072
7, 13:57:00-000, 20411, 11680, 8731, 15, 1353.66, 12, 1352.00, 20371
7, 13:58:00-000, 14040, 6800, 7240, 7, 1349.57, 7, 1350.71, 14039
7, 14:01:00-000, 8063, 3999, 4064, 0, 0.00, 0, 0.00, 7360
7, 14:02:00-000, 10468, 4527, 5941, 1, 1355.00, 1, 1352.00, 11169
7, 14:03:00-000, 960, 940, 20, 0, 0.00, 0, 0.00, 960
7, 14:04:00-000, 13185, 9780, 3405, 21, 1349.09, 21, 1349.52, 13143
7, 14:05:00-000, 1792, 1650, 142, 12, 1349.58, 12, 1352.08, 1768
7, 14:06:00-000, 7057, 2633, 4424, 0, 0.00, 0, 0.00, 6214
7, 14:07:00-000, 21650, 12203, 9447, 2, 1350.50, 2, 1350.00, 22489
7, 14:08:00-000, 13647, 5909, 7738, 14, 1350.14, 14, 1350.14, 13619
7, 14:09:00-000, 16519, 8363, 8156, 33, 1347.88, 33, 1349.57, 16453
7, 14:10:00-000, 9052, 3343, 5709, 5, 1348.80, 5, 1347.00, 9042
7, 14:12:00-000, 7291, 4854, 2437, 3, 1348.00, 3, 1349.33, 7285
7, 14:13:00-000, 13174, 6725, 6449, 10, 1349.50, 10, 1352.00, 12017
7, 14:14:00-000, 11567, 4288, 7279, 20, 1348.40, 22, 1351.73, 11581
7, 14:15:00-000, 4036, 4022, 14, 2, 1351.00, 0, 0.00, 5115
7, 14:16:00-000, 9698, 5211, 4487, 49, 1348.67, 44, 1348.79, 9605
7, 14:17:00-000, 6916, 5536, 1380, 5, 1349.00, 10, 1348.40, 6901
7, 14:18:00-000, 3621, 3540, 81, 43, 1348.00, 44, 1349.43, 3534
7, 14:19:00-000, 13823, 7248, 6575, 3, 1349.67, 2, 1353.00, 13818
7, 14:22:00-000, 1635, 864, 771, 12, 1350.33, 34, 1352.88, 1589
7, 14:23:00-000, 17521, 5341, 12180, 22, 1354.68, 0, 0.00, 16068
7, 14:24:00-000, 3372, 2272, 1100, 0, 0.00, 0, 0.00, 4803
7, 14:25:00-000, 149, 9, 140, 1, 1351.00, 1, 1354.00, 147
7, 14:28:00-000, 6063, 2366, 3697, 3, 1349.67, 2, 1352.00, 6058
7, 14:29:00-000, 1, 0, 1, 0, 0.00, 1, 1347.00, 0
7, 14:30:00-000, 4876, 140, 4736, 5, 1354.40, 5, 1352.00, 4866
7, 14:31:00-000, 12744, 5093, 7651, 1, 1348.00, 1, 1347.00, 12090
7, 14:32:00-000, 16544, 10589, 5955, 5, 1348.00, 5, 1347.00, 17186
7, 14:33:00-000, 3757, 760, 2997, 0, 0.00, 0, 0.00, 3757
7, 14:34:00-000, 4821, 2956, 1865, 0, 0.00, 0, 0.00, 4821
7, 14:35:00-000, 3510, 2130, 1380, 0, 0.00, 0, 0.00, 3510
7, 14:36:00-000, 4772, 3323, 1449, 1, 1349.00, 1, 1348.00, 4770
7, 14:37:00-000, 6139, 2937, 3202, 2, 1350.50, 2, 1350.50, 6135
7, 14:38:00-000, 2758, 685, 2073, 15, 1348.33, 7, 1348.00, 2736
7, 14:39:00-000, 8789, 4881, 3908, 11, 1346.00, 19, 1346.32, 8759
7, 14:40:00-000, 8953, 6924, 2029, 21, 1348.04, 21, 1350.52, 8911
7, 14:41:00-000, 4952, 1267, 3685, 0, 0.00, 0, 0.00, 4952
7, 14:42:00-000, 3736, 1454, 2282, 1, 1352.00, 1, 1351.00, 3734
7, 14:43:00-000, 6241, 4114, 2127, 7, 1348.14, 7, 1349.14, 6227
7, 14:44:00-000, 4219, 2755, 1464, 8, 1349.25, 8, 1347.00, 4203
7, 14:45:00-000, 4863, 2312, 2551, 9, 1349.11, 9, 1348.00, 4845
7, 14:46:00-000, 7636, 2666, 4970, 25, 1353.60, 27, 1352.66, 7584
7, 14:47:00-000, 10378, 6455, 3923, 2, 1350.50, 0, 0.00, 10376
7, 14:48:00-000, 8747, 3957, 4790, 2, 1354.00, 2, 1352.00, 8743
7, 14:49:00-000, 11684, 6955, 4729, 7, 1351.29, 7, 1352.43, 10810
7, 14:50:00-000, 3706, 2002, 1704, 23, 1346.22, 19, 1350.68, 4524
7, 14:51:00-000, 4512, 2177, 2335, 0, 0.00, 4, 1346.25, 3675
7, 14:52:00-000, 19903, 10164, 9739, 15, 1348.47, 15, 1351.33, 20706
7, 14:53:00-000, 1872, 783, 1089, 13, 1352.00, 13, 1352.08, 1846
7, 14:54:00-000, 5232, 2323, 2909, 3, 1349.67, 3, 1348.00, 5226
7, 14:55:00-000, 8626, 2688, 5938, 6, 1348.83, 6, 1348.00, 8614
7, 14:56:00-000, 3121, 856, 2265, 7, 1348.00, 7, 1348.43, 3107
7, 14:57:00-000, 12166, 5771, 6395, 34, 1348.56, 34, 1350.53, 12098
7, 14:58:00-000, 5055, 997, 4058, 14, 1350.85, 27, 1352.04, 5014
7, 14:59:00-000, 8172, 4549, 3623, 66, 1349.42, 53, 1346.73, 8053
7, 15:00:00-000, 6668, 4131, 2537, 17, 1354.29, 17, 1351.41, 6634
7, 15:01:00-000, 18338, 10891, 7447, 1, 1351.00, 1, 1351.00, 18336
7, 15:02:00-000, 7188, 4674, 2514, 84, 1349.12, 13, 1348.23, 7091
7, 15:03:00-000, 8354, 5353, 3001, 6, 1349.00, 77, 1345.83, 6981
7, 15:04:00-000, 11942, 1741, 10201, 4, 1346.00, 4, 1352.00, 13216
7, 15:05:00-000, 17219, 7022, 10197, 8, 1350.50, 8, 1350.13, 17211
7, 15:08:00-000, 15423, 9424, 5999, 1, 1349.00, 1, 1347.00, 14341
7, 15:09:00-000, 9012, 3333, 5679, 4, 1349.00, 4, 1349.00, 10084
7, 15:10:00-000, 7151, 4216, 2935, 14, 1350.00, 14, 1349.28, 7123
7, 15:11:00-000, 17299, 9882, 7417, 1, 1349.00, 1, 1350.00, 16081
7, 15:12:00-000, 9644, 3914, 5730, 4, 1349.00, 29, 1351.52, 10076
7, 15:13:00-000, 6013, 3692, 2321, 32, 1352.06, 14, 1351.57, 6718
7, 15:14:00-000, 1147, 12, 1135, 12, 1351.00, 5, 1349.00, 1130
7, 15:16:00-000, 14323, 6879, 7444, 0, 0.00, 0, 0.00, 12964
7, 15:17:00-000, 8627, 4864, 3763, 10, 1348.00, 10, 1351.90, 9966
7, 15:18:00-000, 2288, 2260, 28, 3, 1350.00, 3, 1345.00, 2282
7, 15:19:00-000, 11460, 6699, 4761, 0, 0.00, 0, 0.00, 10025
7, 15:20:00-000, 17749, 8154, 9595, 15, 1347.73, 15, 1347.87, 19136
7, 15:21:00-000, 6625, 2785, 3840, 0, 0.00, 3, 1350.00, 6640
7, 15:22:00-000, 3945, 1198, 2747, 3, 1350.00, 0, 0.00, 3942
7, 15:23:00-000, 4293, 2435, 1858, 0, 0.00, 0, 0.00, 4293
7, 15:25:00-000, 3177, 1454, 1723, 3, 1352.00, 4, 1351.00, 3170
7, 15:26:00-000, 15702, 6876, 8826, 6, 1351.00, 5, 1350.20, 15691
7, 15:27:00-000, 12322, 3453, 8869, 12, 1347.42, 12, 1348.67, 12298
7, 15:28:00-000, 7909, 4539, 3370, 2, 1350.00, 2, 1348.00, 7894
7, 15:29:00-000, 11473, 10095, 1378, 5, 1348.00, 5, 1346.60, 11474
7, 15:30:00-000, 6191, 922, 5269, 77, 1347.98, 82, 1349.19, 6032
7, 15:31:00-000, 4384, 1335, 3049, 5, 1353.00, 0, 0.00, 4379
7, 15:32:00-000, 7203, 4967, 2236, 42, 1348.07, 55, 1350.16, 7106
7, 15:33:00-000, 22, 22, 0, 13, 1350.69, 0, 0.00, 9
7, 15:34:00-000, 1503, 10, 1493, 3, 1349.00, 3, 1353.67, 1497
7, 15:36:00-000, 10362, 3257, 7105, 8, 1352.37, 12, 1351.58, 10342
7, 15:37:00-000, 8940, 4471, 4469, 16, 1349.44, 12, 1349.58, 8912
7, 15:38:00-000, 6986, 2541, 4445, 15, 1348.67, 3, 1352.00, 6968
7, 15:39:00-000, 9280, 3286, 5994, 8, 1348.87, 20, 1346.80, 8532
7, 15:40:00-000, 1498, 715, 783, 31, 1346.35, 23, 1350.13, 2164
7, 15:41:00-000, 2915, 17, 2898, 0, 0.00, 8, 1347.62, 2907
7, 15:42:00-000, 1097, 7, 1090, 0, 0.00, 0, 0.00, 1097
7, 15:43:00-000, 6028, 3828, 2200, 0, 0.00, 0, 0.00, 6028
7, 15:45:00-000, 1536, 1520, 16, 0, 0.00, 0, 0.00, 1536
7, 15:46:00-000, 14434, 4828, 9606, 2, 1351.00, 2, 1350.00, 14430
7, 15:50:00-000, 3398, 1730, 1668, 0, 0.00, 0, 0.00, 2669
7, 15:51:00-000, 17072, 7901, 9171, 3, 1348.00, 3, 1345.00, 16480
7, 15:52:00-000, 947, 17, 930, 0, 0.00, 0, 0.00, 2262
7, 15:53:00-000, 1105, 1100, 5, 0, 0.00, 0, 0.00, 1105
7, 15:55:00-000, 770, 761, 9, 1, 1351.00, 1, 1350.00, 768
7, 15:56:00-000, 1536, 1530, 6, 0, 0.00, 0, 0.00, 1536
7, 15:57:00-000, 2767, 2743, 24, 3, 1354.00, 3, 1351.00, 2761
7, 15:58:00-000, 1282, 1280, 2, 0, 0.00, 0, 0.00, 1282
7, 15:59:00-000, 3725, 2940, 785, 1, 1349.00, 0, 0.00, 2971
7, 16:00:00-000, 5378, 36, 5342, 11, 1349.00, 12, 1348.25, 6108
7, 16:02:00-000, 3472, 2297, 1175, 25, 1352.88, 25, 1351.00, 2393
7, 16:03:00-000, 6875, 3131, 3744, 0, 0.00, 0, 0.00, 7904
7, 16:05:00-000, 6427, 3928, 2499, 0, 0.00, 0, 0.00, 6427
7, 16:06:00-000, 7011, 1338, 5673, 13, 1349.00, 13, 1346.08, 6985
7, 16:07:00-000, 4586, 3280, 1306, 14, 1350.86, 14, 1351.71, 4558
7, 16:08:00-000, 6160, 30, 6130, 7, 1348.71, 7, 1352.00, 6146
7, 16:09:00-000, 9295, 3557, 5738, 18, 1347.11, 18, 1348.05, 9259
7, 16:10:00-000, 5533, 1914, 3619, 1, 1352.00, 1, 1351.00, 5531
7, 16:11:00-000, 7551, 3563, 3988, 4, 1348.00, 4, 1349.25, 7543
7, 16:13:00-000, 5863, 4627, 1236, 8, 1350.50, 8, 1349.50, 5847
7, 16:14:00-000, 6926, 2582, 4344, 13, 1347.46, 10, 1347.70, 6888
7, 16:15:00-000, 2335, 1332, 1003, 0, 0.00, 3, 1348.00, 2347
7, 16:16:00-000, 8167, 2128, 6039, 14, 1347.07, 14, 1350.28, 8139
7, 16:17:00-000, 17336, 9616, 7720, 14, 1346.29, 14, 1346.28, 17288
7, 16:18:00-000, 12293, 6036, 6257, 1, 1351.00, 14, 1347.93, 12298
7, 16:19:00-000, 5465, 4009, 1456, 13, 1353.23, 0, 0.00, 5452
7, 16:20:00-000, 7178, 3994, 3184, 15, 1351.00, 15, 1351.00, 7142
7, 16:21:00-000, 17199, 8095, 9104, 8, 1348.25, 8, 1347.62, 16002
7, 16:22:00-000, 4488, 2714, 1774, 38, 1352.60, 38, 1350.05, 5599
7, 16:23:00-000, 6616, 4031, 2585, 0, 0.00, 0, 0.00, 6616
7, 16:24:00-000, 3092, 1934, 1158, 0, 0.00, 0, 0.00, 3092
7, 16:25:00-000, 2167, 1364, 803, 0, 0.00, 0, 0.00, 2167
7, 16:26:00-000, 11195, 4779, 6416, 6, 1347.83, 3, 1347.00, 11186
7, 16:27:00-000, 8931, 4336, 4595, 6, 1346.67, 7, 1345.14, 8918
7, 16:28:00-000, 10896, 6775, 4121, 7, 1349.57, 9, 1349.89, 10880
7, 16:29:00-000, 6617, 2626, 3991, 4, 1350.50, 4, 1352.00, 6590
9, 09:22:00-000, 1490, 1490, 0, 0, 0.00, 0, 0.00, 1490
9, 09:35:00-000, 1100, 1100, 0, 0, 0.00, 0, 0.00, 1100
9, 09:36:00-000, 2810, 1260, 1550, 0, 0.00, 0, 0.00, 2810
9, 09:37:00-000, 921, 910, 11, 11, 1348.00, 11, 1347.09, 899
9, 09:40:00-000, 810, 0, 810, 0, 0.00, 0, 0.00, 810
9, 09:42:00-000, 1729, 39, 1690, 2, 1353.00, 39, 1354.00, 1688
9, 09:43:00-000, 71, 71, 0, 37, 1356.02, 0, 0.00, 34
9, 09:46:00-000, 2180, 0, 2180, 0, 0.00, 0, 0.00, 2180
9, 09:47:00-000, 2970, 970, 2000, 0, 0.00, 0, 0.00, 2970
9, 09:54:00-000, 3750, 2560, 1190, 0, 0.00, 0, 0.00, 3750
9, 09:55:00-000, 4590, 4590, 0, 0, 0.00, 0, 0.00, 4590
9, 09:57:00-000, 1388, 1190, 198, 69, 1350.00, 69, 1348.56, 1250
9, 09:58:00-000, 6460, 5470, 990, 0, 0.00, 0, 0.00, 5730
9, 09:59:00-000, 1142, 2, 1140, 2, 1352.00, 2, 1352.00, 1868
9, 10:00:00-000, 5940, 3670, 2270, 0, 0.00, 0, 0.00, 5940
9, 10:01:00-000, 5610, 4440, 1170, 0, 0.00, 0, 0.00, 5610
9, 10:02:00-000, 3367, 1467, 1900, 7, 1349.00, 7, 1351.00, 3353
9, 10:03:00-000, 4230, 920, 3310, 0, 0.00, 0, 0.00, 4230
9, 10:04:00-000, 7088, 4950, 2138, 47, 1349.00, 47, 1348.25, 6994
9, 10:05:00-000, 1370, 0, 1370, 0, 0.00, 0, 0.00, 1370
9, 10:06:00-000, 1589, 39, 1550, 4, 1350.00, 39, 1352.00, 1546
9, 10:07:00-000, 56, 56, 0, 35, 1353.37, 0, 0.00, 21
9, 10:08:00-000, 3438, 3420, 18, 18, 1347.17, 12, 1348.58, 3408
9, 10:09:00-000, 2886, 2880, 6, 0, 0.00, 6, 1348.33, 2880
9, 10:10:00-000, 8471, 1770, 6701, 1, 1348.00, 1, 1346.00, 8469
9, 10:12:00-000, 7508, 3011, 4497, 15, 1345.07, 6, 1349.33, 7487
9, 10:13:00-000, 16, 0, 16, 0, 0.00, 9, 1349.67, 7
9, 10:14:00-000, 1588, 1580, 8, 7, 1347.00, 7, 1348.57, 1574
9, 10:16:00-000, 4057, 1290, 2767, 7, 1346.00, 7, 1345.14, 4043
9, 10:17:00-000, 2020, 1270, 750, 0, 0.00, 0, 0.00, 2020
9, 10:19:00-000, 4680, 3870, 810, 0, 0.00, 0, 0.00, 4680
9, 10:20:00-000, 1641, 11, 1630, 6, 1354.50, 6, 1352.00, 1629
9, 10:24:00-000, 2890, 2890, 0, 0, 0.00, 0, 0.00, 2890
9, 10:27:00-000, 4240, 2120, 2120, 0, 0.00, 0, 0.00, 4240
9, 10:30:00-000, 8320, 3950, 4370, 0, 0.00, 0, 0.00, 8320
9, 10:31:00-000, 4870, 3670, 1200, 0, 0.00, 0, 0.00, 4870
9, 10:33:00-000, 4250, 0, 4250, 0, 0.00, 0, 0.00, 4250
9, 10:34:00-000, 4970, 980, 3990, 0, 0.00, 0, 0.00, 4970
9, 10:35:00-000, 1350, 0, 1350, 0, 0.00, 0, 0.00, 1350
9, 10:36:00-000, 4170, 2960, 1210, 0, 0.00, 0, 0.00, 4170
9, 10:38:00-000, 3050, 3050, 0, 0, 0.00, 0, 0.00, 3050
9, 10:39:00-000, 6140, 4700, 1440, 0, 0.00, 0, 0.00, 6140
9, 10:40:00-000, 8520, 4200, 4320, 0, 0.00, 0, 0.00, 8520
9, 10:41:00-000, 6650, 2830, 3820, 0, 0.00, 0, 0.00, 6650
9, 10:43:00-000, 3770, 2780, 990, 0, 0.00, 0, 0.00, 3770
9, 10:44:00-000, 6716, 2006, 4710, 25, 1351.96, 26, 1352.00, 6665
9, 10:45:00-000, 6021, 4561, 1460, 1, 1351.00, 0, 0.00, 6020
9, 10:46:00-000, 2299, 1319, 980, 13, 1352.92, 13, 1351.00, 2273
9, 10:47:00-000, 5590, 960, 4630, 0, 0.00, 0, 0.00, 5590
9, 10:48:00-000, 10580, 2590, 7990, 0, 0.00, 0, 0.00, 10580
9, 10:49:00-000, 5470, 2910, 2560, 0, 0.00, 0, 0.00, 5470
9, 10:50:00-000, 740, 740, 0, 0, 0.00, 0, 0.00, 740
9, 10:51:00-000, 10933, 6250, 4683, 19, 1348.00, 19, 1348.37, 10895
9, 10:52:00-000, 3221, 2220, 1001, 1, 1345.00, 1, 1349.00, 3219
9, 10:53:00-000, 5778, 3638, 2140, 8, 1355.38, 8, 1353.00, 5762
9, 10:54:00-000, 1270, 0, 1270, 0, 0.00, 0, 0.00, 1270
9, 10:55:00-000, 3190, 1740, 1450, 0, 0.00, 0, 0.00, 3190
9, 10:56:00-000, 3620, 1310, 2310, 0, 0.00, 0, 0.00, 3620
9, 10:57:00-000, 2500, 0, 2500, 0, 0.00, 0, 0.00, 1600
9, 10:58:00-000, 2610, 2610, 0, 9, 1347.00, 0, 0.00, 3501
9, 10:59:00-000, 6424, 4115, 2309, 11, 1351.27, 20, 1349.40, 6393
9, 11:00:00-000, 4670, 1930, 2740, 0, 0.00, 0, 0.00, 4670
9, 11:01:00-000, 1390, 680, 710, 0, 0.00, 0, 0.00, 1390
9, 11:02:00-000, 2420, 1400, 1020, 0, 0.00, 0, 0.00, 2420
9, 11:03:00-000, 2770, 1830, 940, 26, 1349.00, 26, 1346.77, 2718
9, 11:04:00-000, 3857, 917, 2940, 7, 1349.00, 7, 1351.00, 3843
9, 11:05:00-000, 8703, 4993, 3710, 3, 1352.00, 3, 1352.00, 8697
9, 11:06:00-000, 5520, 3320, 2200, 0, 0.00, 0, 0.00, 5520
9, 11:07:00-000, 1740, 710, 1030, 0, 0.00, 0, 0.00, 1740
9, 11:08:00-000, 3964, 2760, 1204, 24, 1345.00, 24, 1344.95, 3916
9, 11:11:00-000, 6121, 2321, 3800, 1, 1352.00, 1, 1351.00, 6119
9, 11:13:00-000, 1397, 1390, 7, 7, 1348.00, 7, 1345.43, 1383
9, 11:14:00-000, 3080, 1230, 1850, 0, 0.00, 0, 0.00, 3020
9, 11:15:00-000, 5400, 0, 5400, 0, 0.00, 0, 0.00, 5460
9, 11:17:00-000, 1120, 0, 1120, 0, 0.00, 0, 0.00, 1120
9, 11:18:00-000, 8610, 2130, 6480, 0, 0.00, 0, 0.00, 8610
9, 11:19:00-000, 8703, 4320, 4383, 3, 1348.00, 3, 1350.67, 8697
9, 11:20:00-000, 13530, 8210, 5320, 0, 0.00, 0, 0.00, 13530
9, 11:21:00-000, 9555, 3760, 5795, 3, 1347.00, 3, 1351.33, 9549
9, 11:22:00-000, 1240, 1240, 0, 0, 0.00, 0, 0.00, 1240
9, 11:23:00-000, 6230, 920, 5310, 0, 0.00, 0, 0.00, 6230
9, 11:24:00-000, 1248, 1240, 8, 6, 1348.00, 6, 1345.67, 1236
9, 11:25:00-000, 6860, 3190, 3670, 0, 0.00, 0, 0.00, 6860
9, 11:26:00-000, 6330, 950, 5380, 0, 0.00, 0, 0.00, 6330
9, 11:27:00-000, 8360, 7030, 1330, 0, 0.00, 0, 0.00, 8360
9, 11:28:00-000, 8093, 4233, 3860, 3, 1351.00, 3, 1351.00, 8087
9, 11:29:00-000, 4070, 1970, 2100, 0, 0.00, 0, 0.00, 4070
9, 11:30:00-000, 5689, 3639, 2050, 2, 1348.00, 9, 1352.00, 5678
9, 11:31:00-000, 2137, 1387, 750, 7, 1350.00, 0, 0.00, 2130
9, 11:33:00-000, 2120, 1420, 700, 0, 0.00, 0, 0.00, 2120
9, 11:34:00-000, 11644, 8271, 3373, 4, 1347.25, 4, 1351.50, 11636
9, 11:35:00-000, 8550, 3090, 5460, 0, 0.00, 0, 0.00, 8550
9, 11:38:00-000, 4130, 1570, 2560, 0, 0.00, 0, 0.00, 4130
9, 11:42:00-000, 9110, 6680, 2430, 13, 1347.00, 0, 0.00, 9097
9, 11:43:00-000, 2136, 1070, 1066, 0, 0.00, 13, 1348.31, 2123
9, 11:44:00-000, 3270, 0, 3270, 0, 0.00, 0, 0.00, 3270
9, 11:45:00-000, 7446, 4006, 3440, 18, 1353.44, 18, 1352.00, 7410
9, 11:46:00-000, 790, 790, 0, 0, 0.00, 0, 0.00, 790
9, 11:47:00-000, 2160, 2160, 0, 0, 0.00, 0, 0.00, 2160
9, 11:49:00-000, 7630, 3520, 4110, 0, 0.00, 0, 0.00, 7630
9, 11:50:00-000, 6098, 2772, 3326, 66, 1354.07, 66, 1350.43, 5966
9, 11:53:00-000, 2130, 1130, 1000, 0, 0.00, 0, 0.00, 2130
9, 11:54:00-000, 5940, 4610, 1330, 0, 0.00, 0, 0.00, 5940
9, 11:56:00-000, 4673, 3280, 1393, 18, 1346.89, 18, 1346.00, 4637
9, 11:57:00-000, 4391, 961, 3430, 1, 1353.00, 1, 1352.00, 4389
9, 11:58:00-000, 13361, 8041, 5320, 1, 1352.00, 1, 1353.00, 13359
9, 11:59:00-000, 9350, 5740, 3610, 0, 0.00, 0, 0.00, 9350
9, 12:00:00-000, 1480, 1480, 0, 0, 0.00, 0, 0.00, 1480
9, 12:01:00-000, 950, 950, 0, 0, 0.00, 0, 0.00, 950
9, 12:02:00-000, 1960, 1960, 0, 0, 0.00, 0, 0.00, 1960
9, 12:03:00-000, 5680, 3690, 1990, 0, 0.00, 0, 0.00, 5680
9, 12:04:00-000, 3080, 1590, 1490, 0, 0.00, 0, 0.00, 3080
9, 12:05:00-000, 5042, 3290, 1752, 2, 1349.00, 2, 1348.00, 5038
9, 12:06:00-000, 7871, 3125, 4746, 60, 1351.46, 60, 1349.85, 7751
9, 12:07:00-000, 1040, 1040, 0, 0, 0.00, 0, 0.00, 1040
9, 12:08:00-000, 1040, 0, 1040, 0, 0.00, 0, 0.00, 1040
9, 12:09:00-000, 7095, 4190, 2905, 15, 1347.00, 15, 1348.13, 7065
9, 12:10:00-000, 893, 870, 23, 23, 1347.34, 4, 1348.00, 866
9, 12:11:00-000, 19, 0, 19, 0, 0.00, 19, 1346.00, 0
9, 12:12:00-000, 3110, 2320, 790, 0, 0.00, 0, 0.00, 3110
9, 12:14:00-000, 2444, 1504, 940, 30, 1353.16, 30, 1352.00, 2384
9, 12:16:00-000, 4317, 3547, 770, 7, 1351.71, 7, 1352.00, 4303
9, 12:17:00-000, 3570, 0, 3570, 0, 0.00, 0, 0.00, 3570
9, 12:18:00-000, 1260, 1260, 0, 0, 0.00, 0, 0.00, 1260
9, 12:20:00-000, 7820, 3790, 4030, 0, 0.00, 0, 0.00, 7820
9, 12:27:00-000, 1500, 0, 1500, 0, 0.00, 0, 0.00, 1500
9, 12:31:00-000, 930, 0, 930, 0, 0.00, 0, 0.00, 930
9, 12:41:00-000, 710, 710, 0, 0, 0.00, 0, 0.00, 0
9, 12:42:00-000, 3041, 3040, 1, 1, 1349.00, 1, 1349.00, 3749
9, 12:44:00-000, 3020, 1930, 1090, 0, 0.00, 0, 0.00, 3020
9, 12:48:00-000, 3320, 990, 2330, 0, 0.00, 0, 0.00, 3320
9, 12:49:00-000, 5820, 4650, 1170, 0, 0.00, 0, 0.00, 5820
9, 12:50:00-000, 4760, 3620, 1140, 0, 0.00, 0, 0.00, 4760
9, 12:52:00-000, 2920, 1470, 1450, 0, 0.00, 0, 0.00, 2920
9, 12:54:00-000, 6000, 3740, 2260, 0, 0.00, 0, 0.00, 6000
9, 12:55:00-000, 3552, 2370, 1182, 2, 1345.00, 2, 1344.00, 3548
9, 12:56:00-000, 9171, 4061, 5110, 1, 1351.00, 1, 1350.00, 9169
9, 12:57:00-000, 4880, 2250, 2630, 0, 0.00, 0, 0.00, 4880
9, 12:58:00-000, 6780, 4310, 2470, 0, 0.00, 0, 0.00, 6780
9, 12:59:00-000, 2930, 1950, 980, 0, 0.00, 0, 0.00, 2930
9, 13:00:00-000, 10103, 3653, 6450, 3, 1350.00, 3, 1351.00, 10097
9, 13:01:00-000, 3480, 2740, 740, 0, 0.00, 0, 0.00, 3480
9, 13:02:00-000, 15460, 8470, 6990, 0, 0.00, 0, 0.00, 15460
9, 13:03:00-000, 3770, 3770, 0, 0, 0.00, 0, 0.00, 3770
9, 13:04:00-000, 9255, 5935, 3320, 15, 1351.00, 15, 1352.00, 9225
9, 13:05:00-000, 2880, 0, 2880, 0, 0.00, 0, 0.00, 2880
9, 13:06:00-000, 6975, 1115, 5860, 45, 1354.71, 45, 1351.91, 6885
9, 13:07:00-000, 1220, 0, 1220, 0, 0.00, 0, 0.00, 1220
9, 13:08:00-000, 3134, 1324, 1810, 14, 1351.43, 14, 1352.00, 3106
9, 13:09:00-000, 7052, 4062, 2990, 2, 1351.00, 2, 1352.00, 7048
9, 13:10:00-000, 1240, 0, 1240, 0, 0.00, 0, 0.00, 1240
9, 13:11:00-000, 810, 0, 810, 0, 0.00, 0, 0.00, 810
9, 13:12:00-000, 4540, 2120, 2420, 0, 0.00, 0, 0.00, 4540
9, 13:13:00-000, 2642, 2640, 2, 2, 1348.00, 2, 1348.00, 2638
9, 13:14:00-000, 1390, 0, 1390, 0, 0.00, 0, 0.00, 1390
9, 13:15:00-000, 2760, 720, 2040, 0, 0.00, 0, 0.00, 2760
9, 13:16:00-000, 1535, 5, 1530, 5, 1353.00, 5, 1352.00, 1525
9, 13:17:00-000, 730, 730, 0, 0, 0.00, 0, 0.00, 730
9, 13:19:00-000, 5030, 3930, 1100, 0, 0.00, 0, 0.00, 5030
9, 13:20:00-000, 4116, 1526, 2590, 22, 1354.18, 22, 1352.00, 4072
9, 13:21:00-000, 8752, 5512, 3240, 7, 1352.57, 7, 1353.00, 7388
9, 13:22:00-000, 8143, 4003, 4140, 9, 1351.22, 9, 1351.00, 9475
9, 13:24:00-000, 6510, 0, 6510, 0, 0.00, 0, 0.00, 5580
9, 13:25:00-000, 16220, 8140, 8080, 0, 0.00, 0, 0.00, 17150
9, 13:26:00-000, 7964, 1084, 6880, 24, 1353.46, 24, 1351.00, 7916
9, 13:28:00-000, 924, 4, 920, 4, 1354.00, 4, 1350.00, 916
9, 13:29:00-000, 2250, 770, 1480, 30, 1348.00, 30, 1345.60, 2190
9, 13:30:00-000, 3220, 1890, 1330, 0, 0.00, 0, 0.00, 3220
9, 13:32:00-000, 1490, 1490, 0, 0, 0.00, 0, 0.00, 1490
9, 13:33:00-000, 2720, 760, 1960, 0, 0.00, 0, 0.00, 2720
9, 13:34:00-000, 6210, 1920, 4290, 0, 0.00, 0, 0.00, 6210
9, 13:35:00-000, 8880, 4770, 4110, 0, 0.00, 0, 0.00, 8880
9, 13:37:00-000, 4300, 3330, 970, 0, 0.00, 0, 0.00, 4300
9, 13:38:00-000, 5802, 2612, 3190, 2, 1352.00, 2, 1353.00, 5798
9, 13:39:00-000, 5634, 3250, 2384, 4, 1347.25, 4, 1349.25, 5626
9, 13:40:00-000, 2200, 820, 1380, 0, 0.00, 0, 0.00, 2200
9, 13:42:00-000, 3272, 1151, 2121, 12, 1348.08, 6, 1348.67, 3254
9, 13:43:00-000, 9206, 2610, 6596, 0, 0.00, 6, 1347.00, 9200
9, 13:44:00-000, 5760, 3300, 2460, 0, 0.00, 0, 0.00, 5760
9, 13:45:00-000, 3203, 2243, 960, 23, 1355.52, 23, 1353.00, 3157
9, 13:48:00-000, 3030, 1300, 1730, 0, 0.00, 0, 0.00, 3030
9, 13:49:00-000, 3330, 2140, 1190, 0, 0.00, 0, 0.00, 3330
9, 13:50:00-000, 1003, 13, 990, 1, 1352.00, 13, 1352.00, 989
9, 13:51:00-000, 6672, 5692, 980, 12, 1355.00, 0, 0.00, 6660
9, 13:52:00-000, 7140, 4310, 2830, 0, 0.00, 0, 0.00, 7140
9, 13:54:00-000, 2550, 2550, 0, 0, 0.00, 0, 0.00, 2550
9, 13:56:00-000, 6010, 4230, 1780, 0, 0.00, 0, 0.00, 5170
9, 13:57:00-000, 14108, 7120, 6988, 7, 1348.00, 7, 1349.00, 14934
9, 13:58:00-000, 13850, 8480, 5370, 0, 0.00, 0, 0.00, 13850
9, 14:01:00-000, 1530, 0, 1530, 0, 0.00, 0, 0.00, 1530
9, 14:02:00-000, 4850, 3060, 1790, 0, 0.00, 0, 0.00, 4850
9, 14:03:00-000, 1080, 0, 1080, 0, 0.00, 0, 0.00, 1080
9, 14:04:00-000, 4980, 3710, 1270, 10, 1348.00, 0, 0.00, 4970
9, 14:05:00-000, 2980, 2970, 10, 0, 0.00, 10, 1345.40, 2970
9, 14:06:00-000, 2612, 230, 2382, 2, 1347.00, 2, 1349.00, 2608
9, 14:07:00-000, 10640, 9880, 760, 0, 0.00, 0, 0.00, 10640
9, 14:08:00-000, 9960, 6669, 3291, 30, 1348.53, 33, 1349.51, 9897
9, 14:09:00-000, 7991, 4351, 3640, 11, 1353.18, 8, 1352.00, 7972
9, 14:10:00-000, 11060, 7360, 3700, 0, 0.00, 0, 0.00, 11060
9, 14:12:00-000, 8410, 4070, 4340, 0, 0.00, 0, 0.00, 8410
9, 14:13:00-000, 9540, 5220, 4320, 0, 0.00, 0, 0.00, 9540
9, 14:14:00-000, 6947, 927, 6020, 7, 1348.00, 7, 1351.00, 6933
9, 14:15:00-000, 3300, 2150, 1150, 0, 0.00, 0, 0.00, 3300
9, 14:17:00-000, 2020, 920, 1100, 0, 0.00, 0, 0.00, 2020
9, 14:18:00-000, 3390, 820, 2570, 20, 1354.80, 20, 1352.00, 3350
9, 14:19:00-000, 1730, 1730, 0, 0, 0.00, 0, 0.00, 1730
9, 14:22:00-000, 271, 270, 1, 1, 1347.00, 1, 1349.00, 269
9, 14:23:00-000, 2210, 770, 1440, 0, 0.00, 0, 0.00, 2210
9, 14:24:00-000, 3833, 1590, 2243, 13, 1345.92, 6, 1349.50, 3814
9, 14:25:00-000, 11, 0, 11, 0, 0.00, 7, 1347.00, 4
9, 14:28:00-000, 3911, 1290, 2621, 1, 1349.00, 1, 1348.00, 3909
9, 14:31:00-000, 8993, 4680, 4313, 3, 1347.00, 3, 1349.00, 8987
9, 14:32:00-000, 6791, 1621, 5170, 1, 1352.00, 1, 1352.00, 6789
9, 14:34:00-000, 4270, 1920, 2350, 0, 0.00, 0, 0.00, 4270
9, 14:35:00-000, 1280, 0, 1280, 0, 0.00, 0, 0.00, 1280
9, 14:36:00-000, 4350, 2240, 2110, 0, 0.00, 0, 0.00, 4350
9, 14:37:00-000, 7280, 4360, 2920, 0, 0.00, 0, 0.00, 7280
9, 14:38:00-000, 2015, 1000, 1015, 15, 1350.00, 15, 1349.47, 1985
9, 14:39:00-000, 5400, 2440, 2960, 0, 0.00, 0, 0.00, 5400
9, 14:40:00-000, 1430, 1430, 0, 0, 0.00, 0, 0.00, 1430
9, 14:41:00-000, 3520, 1400, 2120, 0, 0.00, 0, 0.00, 3520
9, 14:42:00-000, 1366, 26, 1340, 15, 1347.00, 15, 1352.00, 1336
9, 14:43:00-000, 5551, 4330, 1221, 1, 1347.00, 1, 1346.00, 5549
9, 14:44:00-000, 4689, 4670, 19, 19, 1349.58, 8, 1348.62, 4662
9, 14:45:00-000, 2971, 2260, 711, 0, 0.00, 11, 1347.00, 2960
9, 14:46:00-000, 5995, 1481, 4514, 29, 1352.48, 29, 1351.45, 5937
9, 14:47:00-000, 8850, 4610, 4240, 0, 0.00, 0, 0.00, 7710
9, 14:48:00-000, 7753, 4784, 2969, 21, 1348.00, 21, 1349.14, 8851
9, 14:49:00-000, 5734, 2134, 3600, 4, 1351.00, 4, 1352.00, 5726
9, 14:50:00-000, 5932, 3572, 2360, 12, 1351.33, 12, 1351.83, 5908
9, 14:51:00-000, 6463, 1890, 4573, 21, 1348.00, 19, 1348.89, 6423
9, 14:52:00-000, 12133, 6921, 5212, 1, 1351.00, 3, 1350.67, 12129
9, 14:54:00-000, 4012, 3070, 942, 19, 1347.58, 19, 1348.52, 3974
9, 14:55:00-000, 4262, 2, 4260, 2, 1351.00, 2, 1352.00, 4258
9, 14:56:00-000, 3360, 2250, 1110, 34, 1348.00, 27, 1350.74, 3299
9, 14:57:00-000, 2381, 1452, 929, 12, 1352.50, 19, 1344.58, 2350
9, 14:58:00-000, 4650, 1330, 3320, 0, 0.00, 0, 0.00, 4650
9, 14:59:00-000, 10127, 7126, 3001, 20, 1351.60, 20, 1350.65, 10087
9, 15:00:00-000, 13219, 4319, 8900, 20, 1351.00, 20, 1352.00, 12369
9, 15:01:00-000, 8390, 5780, 2610, 0, 0.00, 0, 0.00, 9200
9, 15:02:00-000, 4500, 1090, 3410, 0, 0.00, 0, 0.00, 4500
9, 15:03:00-000, 1300, 0, 1300, 0, 0.00, 0, 0.00, 1300
9, 15:04:00-000, 3620, 1410, 2210, 0, 0.00, 0, 0.00, 3620
9, 15:05:00-000, 6851, 3819, 3032, 21, 1350.00, 21, 1350.62, 6809
9, 15:08:00-000, 5910, 1670, 4240, 0, 0.00, 0, 0.00, 5910
9, 15:09:00-000, 7570, 6030, 1540, 0, 0.00, 0, 0.00, 7570
9, 15:11:00-000, 8460, 7520, 940, 0, 0.00, 0, 0.00, 8460
9, 15:12:00-000, 5400, 2980, 2420, 10, 1348.00, 10, 1346.70, 5380
9, 15:13:00-000, 2524, 763, 1761, 14, 1349.07, 14, 1350.21, 2026
9, 15:14:00-000, 1910, 1520, 390, 0, 0.00, 0, 0.00, 2380
9, 15:15:00-000, 2608, 1330, 1278, 8, 1347.00, 8, 1348.50, 2592
9, 15:16:00-000, 9895, 4945, 4950, 2, 1351.00, 15, 1352.00, 9878
9, 15:17:00-000, 7846, 3376, 4470, 29, 1353.00, 16, 1353.00, 7801
9, 15:18:00-000, 3280, 1120, 2160, 0, 0.00, 0, 0.00, 3280
9, 15:19:00-000, 3440, 1250, 2190, 0, 0.00, 0, 0.00, 3440
9, 15:20:00-000, 7030, 5690, 1340, 20, 1354.20, 20, 1352.00, 6990
9, 15:21:00-000, 6330, 3590, 2740, 0, 0.00, 0, 0.00, 6330
9, 15:22:00-000, 2048, 1048, 1000, 8, 1357.00, 8, 1351.00, 2032
9, 15:23:00-000, 6261, 1, 6260, 1, 1351.00, 1, 1351.00, 6259
9, 15:24:00-000, 1116, 6, 1110, 6, 1351.00, 6, 1352.00, 1104
9, 15:26:00-000, 5970, 3330, 2640, 0, 0.00, 0, 0.00, 5970
9, 15:27:00-000, 11460, 7140, 4320, 0, 0.00, 0, 0.00, 11460
9, 15:28:00-000, 4520, 990, 3530, 0, 0.00, 0, 0.00, 4520
9, 15:29:00-000, 9046, 5666, 3380, 6, 1350.17, 6, 1353.00, 9034
9, 15:30:00-000, 1430, 1430, 0, 0, 0.00, 0, 0.00, 1430
9, 15:31:00-000, 5660, 1360, 4300, 0, 0.00, 0, 0.00, 5660
9, 15:32:00-000, 4620, 3770, 850, 0, 0.00, 0, 0.00, 4620
9, 15:33:00-000, 1274, 34, 1240, 34, 1355.12, 34, 1352.00, 1206
9, 15:36:00-000, 3670, 2940, 730, 0, 0.00, 0, 0.00, 3670
9, 15:37:00-000, 5977, 1161, 4816, 7, 1346.14, 7, 1350.71, 5963
9, 15:38:00-000, 2440, 0, 2440, 0, 0.00, 0, 0.00, 2440
9, 15:39:00-000, 4822, 1572, 3250, 2, 1351.00, 2, 1351.00, 4818
9, 15:40:00-000, 2191, 2180, 11, 6, 1348.00, 6, 1348.00, 2179
9, 15:41:00-000, 1830, 750, 1080, 2, 1349.00, 0, 0.00, 1828
9, 15:42:00-000, 1032, 1030, 2, 0, 0.00, 2, 1347.00, 1030
9, 15:43:00-000, 3860, 3860, 0, 0, 0.00, 0, 0.00, 3860
9, 15:46:00-000, 1800, 1050, 750, 0, 0.00, 0, 0.00, 1800
9, 15:48:00-000, 1290, 0, 1290, 0, 0.00, 0, 0.00, 1290
9, 15:50:00-000, 2120, 2120, 0, 0, 0.00, 0, 0.00, 2120
9, 15:51:00-000, 7190, 2090, 5100, 0, 0.00, 0, 0.00, 7190
9, 15:52:00-000, 2920, 2920, 0, 0, 0.00, 0, 0.00, 2920
9, 15:59:00-000, 790, 0, 790, 0, 0.00, 0, 0.00, 790
9, 16:02:00-000, 2650, 1390, 1260, 0, 0.00, 0, 0.00, 2650
9, 16:03:00-000, 3129, 939, 2190, 10, 1354.60, 10, 1352.00, 3109
9, 16:05:00-000, 630, 0, 630, 0, 0.00, 0, 0.00, 630
9, 16:06:00-000, 1638, 8, 1630, 8, 1352.00, 8, 1352.00, 1622
9, 16:07:00-000, 3060, 3060, 0, 0, 0.00, 0, 0.00, 3060
9, 16:08:00-000, 1400, 0, 1400, 0, 0.00, 0, 0.00, 1400
9, 16:09:00-000, 2680, 1210, 1470, 0, 0.00, 0, 0.00, 2680
9, 16:10:00-000, 3790, 960, 2830, 0, 0.00, 0, 0.00, 3790
9, 16:11:00-000, 3080, 1600, 1480, 0, 0.00, 0, 0.00, 3080
9, 16:13:00-000, 4150, 2010, 2140, 0, 0.00, 0, 0.00, 4150
9, 16:14:00-000, 4340, 4340, 0, 0, 0.00, 0, 0.00, 4340
9, 16:15:00-000, 1340, 1340, 0, 0, 0.00, 0, 0.00, 1340
9, 16:16:00-000, 1390, 0, 1390, 0, 0.00, 0, 0.00, 1390
9, 16:17:00-000, 8432, 3592, 4840, 2, 1350.00, 2, 1352.00, 8428
9, 16:18:00-000, 8058, 4668, 3390, 18, 1350.33, 18, 1352.00, 8022
9, 16:19:00-000, 2890, 1030, 1860, 0, 0.00, 0, 0.00, 2890
9, 16:20:00-000, 2620, 2620, 0, 16, 1344.44, 0, 0.00, 2604
9, 16:21:00-000, 9770, 4350, 5420, 0, 0.00, 16, 1346.75, 9754
9, 16:22:00-000, 5209, 4040, 1169, 39, 1347.10, 39, 1347.28, 5131
9, 16:23:00-000, 6550, 1050, 5500, 0, 0.00, 0, 0.00, 6550
9, 16:24:00-000, 1240, 0, 1240, 0, 0.00, 0, 0.00, 1240
9, 16:25:00-000, 3060, 2260, 800, 0, 0.00, 0, 0.00, 3060
9, 16:26:00-000, 4640, 1690, 2950, 0, 0.00, 0, 0.00, 4640
9, 16:27:00-000, 7432, 2780, 4652, 102, 1347.14, 102, 1346.57, 7228
9, 16:28:00-000, 11530, 4610, 6920, 0, 0.00, 0, 0.00, 11530
9, 16:29:00-000, 7750, 3070, 4680, 0, 0.00, 0, 0.00, 6430
