TraderType,Time,EnterQty,BuyEnterQty,SellEnterQty,BuyExecutedQty,BuyExecutedPx,SellExecutedQty,SellExecutedPx,CanceledQty
1, 09:06:00-000, 3186, 3186, 0, 842, 1348.07, 0, 0.00, 0
1, 09:07:00-000, 0, 0, 0, 0, 0.00, 0, 0.00, 2331
1, 09:08:00-000, 0, 0, 0, 0, 0.00, 0, 0.00, 13
1, 09:13:00-000, 3079, 2237, 842, 1051, 1347.93, 842, 1347.67, 0
1, 09:14:00-000, 7, 6, 1, 6, 1349.17, 1, 1353.00, 1186
1, 09:15:00-000, 13, 10, 3, 7, 1351.28, 3, 1354.33, 0
1, 09:16:00-000, 145, 100, 45, 29, 1350.31, 45, 1353.19, 8
1, 09:17:00-000, 203, 149, 54, 35, 1350.31, 54, 1362.66, 61
1, 09:18:00-000, 675, 435, 240, 232, 1348.29, 238, 1351.17, 126
1, 09:19:00-000, 377, 246, 131, 165, 1348.16, 131, 1348.21, 156
1, 09:20:00-000, 736, 476, 260, 348, 1348.09, 260, 1347.50, 93
1, 09:21:00-000, 347, 222, 125, 76, 1349.97, 125, 1357.44, 134
1, 09:22:00-000, 638, 414, 224, 171, 1349.98, 221, 1354.81, 187
1, 09:23:00-000, 240, 139, 101, 119, 1349.12, 104, 1351.13, 178
1, 09:24:00-000, 495, 314, 181, 199, 1347.80, 181, 1349.11, 85
1, 09:25:00-000, 259, 179, 80, 111, 1348.19, 80, 1349.25, 71
1, 09:26:00-000, 616, 357, 259, 194, 1349.25, 254, 1350.31, 110
1, 09:27:00-000, 346, 214, 132, 106, 1348.05, 132, 1347.93, 152
1, 09:28:00-000, 707, 455, 252, 249, 1348.65, 252, 1348.53, 151
1, 09:29:00-000, 288, 176, 112, 129, 1346.89, 112, 1347.21, 130
1, 09:30:00-000, 564, 373, 191, 258, 1347.49, 191, 1347.41, 106
1, 09:31:00-000, 308, 202, 106, 130, 1348.02, 106, 1347.51, 80
1, 09:32:00-000, 553, 377, 176, 207, 1348.03, 176, 1348.50, 118
1, 09:33:00-000, 373, 239, 134, 165, 1347.97, 134, 1347.28, 113
1, 09:34:00-000, 619, 395, 224, 240, 1347.88, 223, 1347.68, 91
1, 09:35:00-000, 280, 175, 105, 95, 1349.26, 106, 1350.34, 131
1, 09:36:00-000, 594, 341, 253, 198, 1348.38, 253, 1348.89, 118
1, 09:37:00-000, 311, 190, 121, 157, 1348.09, 121, 1347.22, 99
1, 09:38:00-000, 719, 451, 268, 256, 1347.62, 268, 1347.84, 97
1, 09:39:00-000, 285, 186, 99, 100, 1349.10, 99, 1348.10, 143
1, 09:40:00-000, 519, 319, 200, 176, 1348.20, 200, 1347.79, 118
1, 09:41:00-000, 345, 188, 157, 148, 1348.81, 157, 1347.70, 101
1, 09:42:00-000, 616, 435, 181, 229, 1348.57, 181, 1348.60, 110
1, 09:43:00-000, 278, 150, 128, 133, 1347.73, 128, 1347.63, 128
1, 09:44:00-000, 620, 379, 241, 279, 1347.87, 241, 1346.64, 62
1, 09:45:00-000, 283, 164, 119, 134, 1347.93, 116, 1346.98, 79
1, 09:46:00-000, 564, 380, 184, 248, 1347.69, 187, 1347.49, 59
1, 09:47:00-000, 330, 182, 148, 161, 1347.69, 148, 1347.20, 67
1, 09:48:00-000, 677, 406, 271, 255, 1347.25, 271, 1347.15, 93
1, 09:49:00-000, 302, 190, 112, 137, 1348.18, 112, 1347.45, 110
1, 09:50:00-000, 687, 377, 310, 279, 1347.11, 310, 1346.93, 118
1, 09:51:00-000, 272, 164, 108, 115, 1347.94, 108, 1347.80, 53
1, 09:52:00-000, 594, 354, 240, 257, 1347.65, 240, 1347.11, 66
1, 09:53:00-000, 329, 197, 132, 130, 1348.35, 132, 1347.68, 65
1, 09:54:00-000, 706, 411, 295, 271, 1348.36, 295, 1347.85, 102
1, 09:55:00-000, 255, 179, 76, 98, 1349.29, 76, 1346.99, 117
1, 09:56:00-000, 683, 406, 277, 259, 1348.12, 277, 1348.34, 92
1, 09:57:00-000, 291, 160, 131, 135, 1347.74, 131, 1347.70, 94
1, 09:58:00-000, 638, 323, 315, 249, 1347.27, 315, 1347.08, 56
1, 09:59:00-000, 296, 174, 122, 130, 1348.12, 122, 1348.46, 77
1, 10:00:00-000, 633, 352, 281, 247, 1347.63, 281, 1346.42, 75
1, 10:01:00-000, 308, 173, 135, 92, 1348.79, 135, 1347.74, 86
1, 10:02:00-000, 678, 423, 255, 281, 1346.76, 255, 1346.60, 80
1, 10:03:00-000, 280, 187, 93, 118, 1348.14, 93, 1347.45, 138
1, 10:04:00-000, 630, 392, 238, 263, 1348.04, 238, 1347.63, 78
1, 10:05:00-000, 358, 242, 116, 154, 1348.28, 116, 1347.53, 106
1, 10:06:00-000, 562, 349, 213, 229, 1348.39, 213, 1348.56, 103
1, 10:07:00-000, 294, 151, 143, 128, 1347.35, 143, 1346.81, 82
1, 10:08:00-000, 665, 401, 264, 285, 1347.43, 264, 1346.20, 65
1, 10:09:00-000, 267, 157, 110, 111, 1347.58, 110, 1347.42, 94
1, 10:10:00-000, 669, 382, 287, 280, 1348.60, 287, 1348.07, 99
1, 10:11:00-000, 352, 203, 149, 155, 1347.60, 149, 1347.17, 70
1, 10:12:00-000, 649, 371, 278, 277, 1347.49, 278, 1347.11, 64
1, 10:13:00-000, 276, 163, 113, 67, 1348.02, 113, 1348.43, 74
1, 10:14:00-000, 614, 376, 238, 235, 1348.49, 238, 1347.14, 83
1, 10:15:00-000, 264, 152, 112, 112, 1348.21, 112, 1348.14, 145
1, 10:16:00-000, 667, 364, 303, 233, 1347.75, 298, 1347.00, 57
1, 10:17:00-000, 359, 198, 161, 147, 1348.07, 166, 1347.56, 89
1, 10:18:00-000, 606, 377, 229, 257, 1348.32, 229, 1348.56, 105
1, 10:19:00-000, 372, 230, 142, 163, 1347.77, 138, 1348.05, 80
1, 10:20:00-000, 592, 371, 221, 235, 1348.81, 225, 1348.42, 118
1, 10:21:00-000, 313, 189, 124, 92, 1348.50, 124, 1348.99, 94
1, 10:22:00-000, 630, 365, 265, 216, 1348.37, 265, 1348.14, 109
1, 10:23:00-000, 323, 228, 95, 141, 1348.56, 95, 1348.62, 122
1, 10:24:00-000, 555, 343, 212, 288, 1347.54, 212, 1346.92, 93
1, 10:25:00-000, 332, 186, 146, 134, 1347.42, 146, 1346.49, 53
1, 10:26:00-000, 760, 472, 288, 312, 1347.58, 288, 1346.93, 81
1, 10:27:00-000, 306, 193, 113, 134, 1347.75, 113, 1347.70, 124
1, 10:28:00-000, 521, 304, 217, 224, 1346.68, 217, 1346.46, 91
1, 10:29:00-000, 309, 165, 144, 120, 1347.66, 144, 1347.94, 74
1, 10:30:00-000, 670, 418, 252, 271, 1348.51, 252, 1348.47, 84
1, 10:31:00-000, 263, 182, 81, 114, 1348.62, 81, 1347.82, 115
1, 10:32:00-000, 740, 410, 330, 296, 1348.32, 330, 1348.05, 100
1, 10:33:00-000, 241, 120, 121, 57, 1347.90, 121, 1347.55, 78
1, 10:34:00-000, 689, 416, 273, 254, 1347.97, 273, 1347.25, 72
1, 10:35:00-000, 336, 209, 127, 135, 1348.70, 127, 1347.85, 132
1, 10:36:00-000, 633, 372, 261, 272, 1347.11, 261, 1346.87, 95
1, 10:37:00-000, 237, 138, 99, 90, 1349.26, 99, 1348.83, 103
1, 10:38:00-000, 648, 376, 272, 239, 1348.44, 272, 1348.17, 74
1, 10:39:00-000, 328, 210, 118, 129, 1348.36, 118, 1348.91, 105
1, 10:40:00-000, 612, 382, 230, 238, 1348.68, 229, 1348.94, 107
1, 10:41:00-000, 317, 185, 132, 115, 1347.45, 133, 1346.90, 104
1, 10:42:00-000, 589, 368, 221, 256, 1348.33, 221, 1347.90, 81
1, 10:43:00-000, 339, 190, 149, 178, 1348.56, 145, 1347.88, 83
1, 10:44:00-000, 631, 377, 254, 223, 1348.46, 257, 1348.08, 76
1, 10:45:00-000, 294, 173, 121, 148, 1347.62, 122, 1347.89, 105
1, 10:46:00-000, 631, 384, 247, 216, 1348.34, 247, 1347.90, 74
1, 10:47:00-000, 345, 203, 142, 143, 1347.54, 142, 1347.62, 128
1, 10:48:00-000, 614, 360, 254, 222, 1348.67, 254, 1347.70, 127
1, 10:49:00-000, 327, 181, 146, 113, 1348.30, 143, 1348.10, 78
1, 10:50:00-000, 564, 346, 218, 230, 1347.99, 221, 1347.83, 119
1, 10:51:00-000, 346, 231, 115, 163, 1348.96, 115, 1347.83, 62
1, 10:52:00-000, 632, 368, 264, 274, 1348.00, 264, 1347.34, 80
1, 10:53:00-000, 289, 175, 114, 102, 1349.26, 114, 1348.60, 83
1, 10:54:00-000, 606, 349, 257, 265, 1347.66, 257, 1347.03, 96
1, 10:55:00-000, 340, 224, 116, 149, 1347.22, 116, 1346.37, 59
1, 10:56:00-000, 628, 364, 264, 277, 1348.12, 264, 1347.35, 84
1, 10:57:00-000, 331, 215, 116, 98, 1348.95, 116, 1348.20, 87
1, 10:58:00-000, 617, 355, 262, 281, 1348.76, 262, 1347.71, 111
1, 10:59:00-000, 326, 214, 112, 120, 1347.96, 112, 1347.81, 83
1, 11:00:00-000, 679, 417, 262, 265, 1348.60, 262, 1348.24, 117
1, 11:01:00-000, 385, 263, 122, 100, 1348.56, 122, 1349.31, 126
1, 11:02:00-000, 592, 330, 262, 197, 1347.85, 262, 1347.20, 169
1, 11:03:00-000, 367, 224, 143, 171, 1347.94, 143, 1347.55, 103
1, 11:04:00-000, 604, 352, 252, 243, 1347.62, 252, 1346.82, 76
1, 11:05:00-000, 288, 172, 116, 134, 1347.75, 116, 1346.51, 98
1, 11:06:00-000, 672, 400, 272, 258, 1347.76, 272, 1347.74, 67
1, 11:07:00-000, 312, 201, 111, 137, 1348.95, 111, 1347.92, 104
1, 11:08:00-000, 701, 444, 257, 245, 1348.39, 257, 1347.74, 133
1, 11:09:00-000, 281, 157, 124, 155, 1347.82, 124, 1346.68, 101
1, 11:10:00-000, 627, 363, 264, 226, 1347.76, 264, 1347.60, 65
1, 11:11:00-000, 280, 157, 123, 112, 1348.76, 123, 1348.88, 110
1, 11:12:00-000, 595, 368, 227, 256, 1348.40, 227, 1347.64, 91
1, 11:13:00-000, 364, 204, 160, 123, 1348.13, 160, 1347.25, 66
1, 11:14:00-000, 623, 353, 270, 242, 1347.70, 270, 1347.55, 111
1, 11:15:00-000, 308, 173, 135, 113, 1347.46, 135, 1347.64, 72
1, 11:16:00-000, 539, 297, 242, 236, 1347.89, 242, 1347.17, 66
1, 11:17:00-000, 301, 163, 138, 123, 1347.21, 138, 1346.95, 65
1, 11:18:00-000, 584, 402, 182, 211, 1348.41, 182, 1347.61, 66
1, 11:19:00-000, 320, 202, 118, 136, 1347.54, 118, 1347.11, 158
1, 11:20:00-000, 581, 351, 230, 240, 1347.94, 230, 1347.36, 102
1, 11:21:00-000, 361, 233, 128, 115, 1348.14, 128, 1347.72, 78
1, 11:22:00-000, 581, 336, 245, 242, 1347.58, 245, 1347.01, 123
1, 11:23:00-000, 322, 176, 146, 109, 1347.46, 146, 1348.02, 100
1, 11:24:00-000, 579, 350, 229, 224, 1348.25, 229, 1347.72, 91
1, 11:25:00-000, 323, 183, 140, 160, 1347.83, 140, 1347.19, 88
1, 11:26:00-000, 564, 351, 213, 230, 1348.19, 213, 1347.30, 67
1, 11:27:00-000, 282, 148, 134, 122, 1347.22, 134, 1346.39, 68
1, 11:28:00-000, 611, 379, 232, 240, 1348.98, 232, 1348.42, 92
1, 11:29:00-000, 315, 239, 76, 118, 1348.10, 76, 1347.59, 92
1, 11:30:00-000, 591, 365, 226, 265, 1348.07, 226, 1348.08, 137
1, 11:31:00-000, 338, 223, 115, 144, 1348.41, 115, 1348.25, 79
1, 11:32:00-000, 638, 353, 285, 278, 1348.81, 285, 1347.62, 77
1, 11:33:00-000, 304, 211, 93, 103, 1348.46, 93, 1347.20, 89
1, 11:34:00-000, 598, 368, 230, 244, 1349.01, 230, 1348.67, 131
1, 11:35:00-000, 348, 185, 163, 131, 1348.23, 163, 1347.98, 86
1, 11:36:00-000, 639, 405, 234, 237, 1348.44, 234, 1347.73, 99
1, 11:37:00-000, 288, 165, 123, 155, 1347.76, 123, 1347.58, 79
1, 11:38:00-000, 628, 359, 269, 247, 1347.58, 269, 1347.22, 96
1, 11:39:00-000, 352, 174, 178, 137, 1346.72, 178, 1346.36, 70
1, 11:40:00-000, 577, 326, 251, 267, 1347.48, 251, 1346.48, 54
1, 11:41:00-000, 311, 172, 139, 116, 1346.09, 139, 1345.56, 64
1, 11:42:00-000, 614, 374, 240, 246, 1348.55, 240, 1347.85, 84
1, 11:43:00-000, 299, 197, 102, 90, 1349.66, 102, 1349.62, 78
1, 11:44:00-000, 638, 446, 192, 276, 1348.59, 192, 1348.88, 119
1, 11:45:00-000, 319, 160, 159, 158, 1347.34, 159, 1346.84, 123
1, 11:46:00-000, 595, 380, 215, 220, 1348.69, 215, 1348.11, 79
1, 11:47:00-000, 340, 168, 172, 142, 1347.40, 172, 1347.15, 106
1, 11:48:00-000, 640, 338, 302, 224, 1348.07, 302, 1346.89, 73
1, 11:49:00-000, 259, 141, 118, 80, 1348.54, 118, 1347.83, 91
1, 11:50:00-000, 707, 410, 297, 297, 1348.23, 297, 1347.82, 88
1, 11:51:00-000, 272, 168, 104, 116, 1347.57, 104, 1346.44, 84
1, 11:52:00-000, 583, 382, 201, 241, 1348.64, 201, 1347.52, 82
1, 11:53:00-000, 299, 172, 127, 150, 1347.04, 127, 1346.64, 72
1, 11:54:00-000, 616, 385, 231, 246, 1347.87, 231, 1347.35, 102
1, 11:55:00-000, 314, 203, 111, 124, 1348.78, 108, 1348.12, 101
1, 11:56:00-000, 605, 360, 245, 273, 1347.54, 248, 1346.49, 75
1, 11:57:00-000, 309, 195, 114, 136, 1347.55, 114, 1347.88, 85
1, 11:58:00-000, 635, 374, 261, 281, 1347.16, 261, 1346.74, 73
1, 11:59:00-000, 303, 159, 144, 129, 1346.81, 144, 1346.29, 76
1, 12:00:00-000, 627, 364, 263, 265, 1347.66, 263, 1347.23, 54
1, 12:01:00-000, 342, 212, 130, 143, 1348.63, 130, 1348.25, 65
1, 12:02:00-000, 593, 330, 263, 295, 1348.51, 263, 1347.63, 66
1, 12:03:00-000, 237, 107, 130, 99, 1346.65, 130, 1346.17, 46
1, 12:04:00-000, 610, 349, 261, 251, 1348.44, 261, 1347.37, 40
1, 12:05:00-000, 327, 172, 155, 131, 1347.65, 155, 1347.55, 66
1, 12:06:00-000, 628, 394, 234, 276, 1348.54, 234, 1347.17, 85
1, 12:07:00-000, 381, 214, 167, 135, 1348.47, 165, 1347.48, 85
1, 12:08:00-000, 620, 361, 259, 223, 1347.92, 261, 1348.28, 99
1, 12:09:00-000, 336, 189, 147, 137, 1347.84, 147, 1347.22, 102
1, 12:10:00-000, 618, 355, 263, 226, 1347.84, 263, 1347.34, 121
1, 12:11:00-000, 312, 171, 141, 141, 1347.85, 141, 1347.09, 77
1, 12:12:00-000, 638, 398, 240, 254, 1347.99, 240, 1347.25, 70
1, 12:13:00-000, 293, 186, 107, 88, 1347.84, 107, 1347.88, 102
1, 12:14:00-000, 597, 348, 249, 202, 1348.06, 249, 1347.32, 97
1, 12:15:00-000, 346, 198, 148, 145, 1347.68, 148, 1347.06, 128
1, 12:16:00-000, 565, 341, 224, 223, 1347.89, 224, 1347.39, 86
1, 12:17:00-000, 353, 216, 137, 138, 1348.59, 137, 1348.86, 94
1, 12:18:00-000, 642, 420, 222, 318, 1348.87, 222, 1348.41, 111
1, 12:19:00-000, 322, 188, 134, 111, 1348.74, 134, 1348.02, 73
1, 12:20:00-000, 600, 360, 240, 187, 1348.38, 240, 1347.37, 101
1, 12:21:00-000, 276, 157, 119, 94, 1347.81, 119, 1347.04, 121
1, 12:22:00-000, 616, 369, 247, 221, 1348.52, 247, 1346.60, 125
1, 12:23:00-000, 344, 262, 82, 122, 1350.02, 82, 1349.04, 128
1, 12:24:00-000, 612, 378, 234, 243, 1348.75, 234, 1347.70, 156
1, 12:25:00-000, 311, 176, 135, 98, 1348.32, 135, 1347.37, 105
1, 12:26:00-000, 626, 355, 271, 252, 1348.47, 271, 1346.90, 97
1, 12:27:00-000, 344, 216, 128, 144, 1348.55, 128, 1347.18, 87
1, 12:28:00-000, 612, 379, 233, 252, 1348.77, 233, 1347.27, 102
1, 12:29:00-000, 242, 164, 78, 111, 1348.77, 78, 1348.96, 83
1, 12:30:00-000, 650, 409, 241, 240, 1349.42, 241, 1347.10, 100
1, 12:31:00-000, 312, 198, 114, 143, 1348.67, 114, 1347.55, 109
1, 12:32:00-000, 626, 393, 233, 250, 1348.26, 233, 1347.39, 111
1, 12:33:00-000, 288, 179, 109, 99, 1349.24, 109, 1348.46, 126
1, 12:34:00-000, 651, 401, 250, 271, 1348.77, 250, 1347.62, 75
1, 12:35:00-000, 375, 219, 156, 143, 1347.64, 156, 1347.97, 114
1, 12:36:00-000, 602, 370, 232, 239, 1348.96, 232, 1348.14, 110
1, 12:37:00-000, 344, 216, 128, 152, 1347.69, 128, 1347.75, 84
1, 12:38:00-000, 586, 346, 240, 200, 1348.31, 240, 1348.00, 119
1, 12:39:00-000, 304, 191, 113, 145, 1348.99, 113, 1348.10, 81
1, 12:40:00-000, 661, 424, 237, 277, 1348.26, 237, 1348.23, 94
1, 12:41:00-000, 335, 166, 169, 146, 1347.18, 169, 1347.08, 106
1, 12:42:00-000, 667, 378, 289, 241, 1348.44, 289, 1347.42, 96
1, 12:43:00-000, 290, 178, 112, 126, 1347.73, 112, 1346.93, 86
1, 12:44:00-000, 636, 411, 225, 286, 1348.37, 225, 1347.51, 76
1, 12:45:00-000, 351, 201, 150, 148, 1347.51, 150, 1346.95, 86
1, 12:46:00-000, 689, 434, 255, 303, 1347.94, 255, 1347.01, 116
1, 12:47:00-000, 299, 162, 137, 145, 1346.98, 137, 1346.84, 68
1, 12:48:00-000, 604, 347, 257, 263, 1347.40, 257, 1346.69, 59
1, 12:49:00-000, 278, 140, 138, 115, 1347.91, 138, 1347.02, 57
1, 12:50:00-000, 657, 385, 272, 245, 1347.43, 272, 1346.67, 69
1, 12:51:00-000, 285, 156, 129, 129, 1347.66, 129, 1346.74, 87
1, 12:52:00-000, 650, 385, 265, 284, 1347.30, 265, 1346.70, 75
1, 12:53:00-000, 285, 140, 145, 80, 1348.77, 145, 1348.18, 57
1, 12:54:00-000, 652, 355, 297, 256, 1347.81, 297, 1347.06, 64
1, 12:55:00-000, 358, 228, 130, 147, 1347.32, 130, 1347.10, 84
1, 12:56:00-000, 550, 348, 202, 228, 1348.78, 202, 1348.30, 140
1, 12:57:00-000, 287, 149, 138, 107, 1347.83, 138, 1347.45, 70
1, 12:58:00-000, 581, 334, 247, 195, 1348.27, 247, 1347.02, 80
1, 12:59:00-000, 325, 201, 124, 112, 1348.35, 123, 1347.61, 100
1, 13:00:00-000, 626, 362, 264, 243, 1348.03, 265, 1347.30, 106
1, 13:01:00-000, 360, 202, 158, 135, 1347.36, 158, 1346.62, 98
1, 13:02:00-000, 644, 364, 280, 301, 1347.61, 280, 1347.07, 78
1, 13:03:00-000, 297, 189, 108, 132, 1348.73, 108, 1348.22, 73
1, 13:04:00-000, 607, 370, 237, 251, 1348.22, 237, 1348.11, 77
1, 13:05:00-000, 347, 228, 119, 113, 1349.41, 119, 1348.87, 100
1, 13:06:00-000, 449, 285, 164, 203, 1347.75, 164, 1347.24, 122
1, 13:07:00-000, 296, 161, 135, 134, 1347.55, 135, 1346.68, 63
1, 13:08:00-000, 505, 342, 163, 221, 1349.09, 163, 1347.94, 69
1, 13:09:00-000, 336, 212, 124, 162, 1348.11, 124, 1347.49, 72
1, 13:10:00-000, 652, 337, 315, 267, 1348.25, 315, 1347.10, 72
1, 13:11:00-000, 358, 221, 137, 132, 1347.09, 137, 1346.06, 58
1, 13:12:00-000, 626, 377, 249, 254, 1347.15, 249, 1347.25, 116
1, 13:13:00-000, 326, 163, 163, 152, 1348.01, 163, 1347.63, 62
1, 13:14:00-000, 574, 356, 218, 267, 1348.80, 218, 1347.92, 75
1, 13:15:00-000, 348, 224, 124, 136, 1347.60, 124, 1347.53, 69
1, 13:16:00-000, 608, 361, 247, 275, 1348.01, 247, 1347.66, 92
1, 13:17:00-000, 271, 165, 106, 104, 1349.05, 106, 1347.57, 75
1, 13:18:00-000, 711, 339, 372, 277, 1348.29, 372, 1347.46, 58
1, 13:19:00-000, 291, 186, 105, 124, 1349.21, 105, 1348.54, 55
1, 13:20:00-000, 557, 304, 253, 235, 1348.11, 253, 1347.22, 65
1, 13:21:00-000, 308, 150, 158, 89, 1348.01, 158, 1347.44, 76
1, 13:22:00-000, 591, 349, 242, 235, 1348.00, 242, 1347.63, 71
1, 13:23:00-000, 398, 260, 138, 135, 1348.67, 138, 1348.87, 104
1, 13:24:00-000, 544, 310, 234, 248, 1347.54, 234, 1347.13, 103
1, 13:25:00-000, 313, 199, 114, 161, 1348.01, 114, 1346.72, 83
1, 13:26:00-000, 611, 340, 271, 250, 1348.00, 271, 1346.99, 43
1, 13:27:00-000, 275, 165, 110, 95, 1349.03, 110, 1349.20, 77
1, 13:28:00-000, 625, 379, 246, 251, 1348.25, 246, 1347.72, 77
1, 13:29:00-000, 269, 204, 65, 122, 1347.83, 65, 1347.71, 109
1, 13:30:00-000, 588, 357, 231, 253, 1348.54, 231, 1348.19, 107
1, 13:31:00-000, 325, 176, 149, 124, 1347.56, 149, 1347.58, 89
1, 13:32:00-000, 540, 260, 280, 230, 1346.90, 280, 1346.03, 50
1, 13:33:00-000, 335, 174, 161, 125, 1347.79, 161, 1346.48, 52
1, 13:34:00-000, 536, 358, 178, 237, 1348.89, 178, 1348.45, 60
1, 13:35:00-000, 342, 179, 163, 160, 1346.33, 163, 1346.24, 82
1, 13:36:00-000, 631, 387, 244, 312, 1347.70, 244, 1346.91, 61
1, 13:37:00-000, 349, 212, 137, 148, 1348.31, 137, 1346.92, 47
1, 13:38:00-000, 532, 310, 222, 192, 1348.67, 222, 1348.77, 93
1, 13:39:00-000, 375, 209, 166, 134, 1347.58, 166, 1347.25, 77
1, 13:40:00-000, 664, 434, 230, 250, 1348.93, 228, 1348.51, 117
1, 13:41:00-000, 305, 167, 138, 156, 1348.07, 140, 1347.85, 108
1, 13:42:00-000, 629, 356, 273, 239, 1347.40, 273, 1346.88, 71
1, 13:43:00-000, 357, 206, 151, 156, 1346.97, 151, 1346.81, 84
1, 13:44:00-000, 670, 397, 273, 272, 1348.37, 273, 1347.84, 108
1, 13:45:00-000, 352, 211, 141, 142, 1348.20, 141, 1347.78, 79
1, 13:46:00-000, 550, 335, 215, 212, 1348.29, 215, 1348.06, 90
1, 13:47:00-000, 303, 167, 136, 145, 1347.96, 136, 1348.14, 86
1, 13:48:00-000, 629, 393, 236, 232, 1348.24, 236, 1347.97, 82
1, 13:49:00-000, 298, 156, 142, 124, 1347.03, 142, 1346.37, 93
1, 13:50:00-000, 630, 376, 254, 256, 1347.88, 254, 1346.85, 77
1, 13:51:00-000, 306, 165, 141, 150, 1347.99, 141, 1347.75, 82
1, 13:52:00-000, 624, 359, 265, 248, 1348.40, 265, 1348.08, 80
1, 13:53:00-000, 307, 187, 120, 94, 1348.60, 120, 1348.65, 69
1, 13:54:00-000, 594, 358, 236, 216, 1348.70, 236, 1348.52, 100
1, 13:55:00-000, 341, 203, 138, 166, 1348.45, 138, 1346.87, 114
1, 13:56:00-000, 569, 295, 274, 225, 1347.92, 274, 1346.44, 92
1, 13:57:00-000, 278, 149, 129, 112, 1348.34, 129, 1347.32, 33
1, 13:58:00-000, 609, 423, 186, 253, 1348.33, 186, 1347.67, 72
1, 13:59:00-000, 341, 187, 154, 148, 1347.72, 154, 1346.64, 142
1, 14:00:00-000, 574, 325, 249, 230, 1348.49, 249, 1347.85, 49
1, 14:01:00-000, 331, 203, 128, 118, 1348.59, 128, 1348.51, 79
1, 14:02:00-000, 567, 364, 203, 214, 1347.96, 203, 1348.27, 112
1, 14:03:00-000, 280, 143, 137, 115, 1348.79, 137, 1348.07, 90
1, 14:04:00-000, 589, 355, 234, 201, 1349.06, 234, 1348.22, 87
1, 14:05:00-000, 340, 199, 141, 156, 1347.50, 141, 1346.97, 112
1, 14:06:00-000, 669, 414, 255, 292, 1347.38, 255, 1346.78, 77
1, 14:07:00-000, 312, 177, 135, 153, 1347.11, 135, 1346.27, 94
1, 14:08:00-000, 606, 345, 261, 263, 1347.85, 261, 1347.12, 64
1, 14:09:00-000, 238, 151, 87, 116, 1348.03, 87, 1347.27, 61
1, 14:10:00-000, 592, 412, 180, 241, 1348.80, 180, 1348.04, 67
1, 14:11:00-000, 319, 188, 131, 139, 1348.28, 131, 1347.90, 118
1, 14:12:00-000, 688, 383, 305, 247, 1347.76, 304, 1347.50, 89
1, 14:13:00-000, 354, 183, 171, 148, 1348.44, 172, 1347.81, 97
1, 14:14:00-000, 748, 474, 274, 262, 1347.86, 274, 1348.20, 93
1, 14:15:00-000, 266, 167, 99, 110, 1349.35, 99, 1348.81, 173
1, 14:16:00-000, 599, 346, 253, 246, 1348.48, 253, 1347.25, 75
1, 14:17:00-000, 297, 162, 135, 99, 1349.31, 135, 1348.72, 80
1, 14:18:00-000, 647, 375, 272, 267, 1347.49, 272, 1347.66, 81
1, 14:19:00-000, 384, 226, 158, 173, 1347.18, 158, 1347.13, 91
1, 14:20:00-000, 463, 291, 172, 172, 1349.04, 172, 1348.72, 82
1, 14:21:00-000, 272, 156, 116, 90, 1347.92, 116, 1347.48, 74
1, 14:22:00-000, 566, 380, 186, 228, 1349.15, 186, 1347.24, 101
1, 14:23:00-000, 345, 185, 160, 151, 1347.53, 160, 1347.68, 109
1, 14:24:00-000, 676, 424, 252, 225, 1348.83, 252, 1348.29, 106
1, 14:25:00-000, 330, 201, 129, 136, 1348.21, 129, 1347.74, 131
1, 14:26:00-000, 622, 364, 258, 290, 1348.37, 258, 1347.30, 78
1, 14:27:00-000, 318, 227, 91, 144, 1349.63, 89, 1348.57, 77
1, 14:28:00-000, 604, 372, 232, 226, 1348.01, 234, 1347.27, 119
1, 14:29:00-000, 360, 212, 148, 147, 1348.99, 148, 1347.93, 96
1, 14:30:00-000, 589, 322, 267, 239, 1348.30, 267, 1347.48, 84
1, 14:31:00-000, 269, 149, 120, 104, 1348.31, 120, 1347.52, 73
1, 14:32:00-000, 618, 384, 234, 234, 1348.19, 234, 1348.40, 103
1, 14:33:00-000, 318, 198, 120, 131, 1348.85, 120, 1348.30, 98
1, 14:34:00-000, 556, 300, 256, 227, 1347.95, 256, 1347.03, 69
1, 14:35:00-000, 311, 162, 149, 144, 1347.41, 149, 1347.13, 48
1, 14:36:00-000, 619, 356, 263, 217, 1348.14, 263, 1348.00, 74
1, 14:37:00-000, 362, 214, 148, 151, 1348.36, 148, 1347.55, 96
1, 14:38:00-000, 503, 317, 186, 226, 1347.69, 186, 1346.83, 91
1, 14:39:00-000, 301, 156, 145, 141, 1347.76, 145, 1346.93, 52
1, 14:40:00-000, 590, 376, 214, 219, 1348.56, 214, 1347.81, 71
1, 14:41:00-000, 360, 226, 134, 117, 1348.96, 134, 1349.22, 118
1, 14:42:00-000, 593, 363, 230, 238, 1348.53, 230, 1348.24, 115
1, 14:43:00-000, 317, 180, 137, 117, 1347.84, 137, 1347.75, 104
1, 14:44:00-000, 593, 365, 228, 246, 1348.36, 228, 1347.67, 97
1, 14:45:00-000, 286, 177, 109, 143, 1348.84, 109, 1348.21, 88
1, 14:46:00-000, 684, 373, 311, 278, 1347.96, 311, 1347.04, 57
1, 14:47:00-000, 380, 261, 119, 148, 1348.72, 119, 1348.77, 93
1, 14:48:00-000, 514, 318, 196, 248, 1347.91, 196, 1347.16, 93
1, 14:49:00-000, 271, 167, 104, 133, 1348.64, 104, 1347.88, 75
1, 14:50:00-000, 559, 331, 228, 217, 1347.96, 228, 1347.71, 53
1, 14:51:00-000, 296, 151, 145, 136, 1347.87, 145, 1347.39, 73
1, 14:52:00-000, 636, 387, 249, 263, 1349.04, 249, 1348.49, 72
1, 14:53:00-000, 316, 202, 114, 161, 1347.82, 114, 1347.59, 86
1, 14:54:00-000, 663, 388, 275, 277, 1348.06, 275, 1347.46, 81
1, 14:55:00-000, 341, 187, 154, 158, 1347.14, 154, 1345.81, 63
1, 14:56:00-000, 583, 296, 287, 222, 1347.54, 287, 1346.53, 77
1, 14:57:00-000, 321, 195, 126, 103, 1348.61, 126, 1348.39, 53
1, 14:58:00-000, 580, 325, 255, 276, 1347.70, 255, 1347.08, 86
1, 14:59:00-000, 299, 172, 127, 136, 1349.13, 127, 1346.86, 51
1, 15:00:00-000, 609, 363, 246, 238, 1348.46, 246, 1347.99, 64
1, 15:01:00-000, 322, 207, 115, 127, 1348.24, 111, 1347.89, 87
1, 15:02:00-000, 687, 335, 352, 257, 1347.09, 354, 1346.70, 88
1, 15:03:00-000, 301, 182, 119, 131, 1347.74, 121, 1347.92, 73
1, 15:04:00-000, 630, 382, 248, 235, 1348.62, 248, 1349.05, 61
1, 15:05:00-000, 292, 202, 90, 139, 1348.23, 90, 1347.75, 96
1, 15:06:00-000, 543, 357, 186, 230, 1348.71, 186, 1347.99, 111
1, 15:07:00-000, 276, 158, 118, 137, 1347.65, 118, 1347.22, 94
1, 15:08:00-000, 766, 444, 322, 286, 1347.74, 322, 1347.86, 86
1, 15:09:00-000, 341, 169, 172, 132, 1346.94, 172, 1346.67, 99
1, 15:10:00-000, 572, 360, 212, 239, 1348.47, 212, 1347.59, 88
1, 15:11:00-000, 275, 160, 115, 120, 1348.44, 115, 1348.47, 86
1, 15:12:00-000, 604, 373, 231, 270, 1348.27, 231, 1348.02, 67
1, 15:13:00-000, 291, 144, 147, 130, 1347.48, 147, 1346.45, 53
1, 15:14:00-000, 630, 368, 262, 241, 1347.75, 262, 1346.78, 68
1, 15:15:00-000, 345, 215, 130, 156, 1347.90, 130, 1347.65, 84
1, 15:16:00-000, 606, 347, 259, 297, 1347.74, 259, 1346.76, 59
1, 15:17:00-000, 282, 172, 110, 119, 1348.37, 110, 1348.21, 66
1, 15:18:00-000, 610, 336, 274, 249, 1346.97, 274, 1346.88, 69
1, 15:19:00-000, 342, 218, 124, 148, 1347.97, 124, 1346.62, 54
1, 15:20:00-000, 742, 424, 318, 336, 1348.32, 318, 1346.46, 82
1, 15:21:00-000, 326, 221, 105, 113, 1349.13, 105, 1347.92, 99
1, 15:22:00-000, 545, 266, 279, 224, 1347.64, 279, 1347.61, 78
1, 15:23:00-000, 305, 185, 120, 127, 1347.31, 120, 1346.62, 54
1, 15:24:00-000, 646, 386, 260, 271, 1348.16, 260, 1347.55, 96
1, 15:25:00-000, 289, 144, 145, 106, 1348.09, 145, 1347.06, 83
1, 15:26:00-000, 624, 360, 264, 261, 1348.15, 264, 1346.83, 73
1, 15:27:00-000, 304, 168, 136, 148, 1347.32, 136, 1345.47, 68
1, 15:28:00-000, 723, 445, 278, 278, 1349.10, 278, 1348.18, 46
1, 15:29:00-000, 360, 207, 153, 154, 1347.77, 153, 1347.62, 105
1, 15:30:00-000, 573, 355, 218, 223, 1348.60, 218, 1348.01, 140
1, 15:31:00-000, 369, 223, 146, 154, 1348.21, 146, 1347.17, 72
1, 15:32:00-000, 597, 380, 217, 251, 1348.07, 217, 1347.34, 89
1, 15:33:00-000, 317, 176, 141, 160, 1348.03, 141, 1347.77, 100
1, 15:34:00-000, 622, 361, 261, 230, 1347.86, 261, 1347.57, 60
1, 15:35:00-000, 323, 193, 130, 144, 1348.04, 130, 1347.74, 97
1, 15:36:00-000, 639, 331, 308, 268, 1348.28, 308, 1346.73, 66
1, 15:37:00-000, 342, 194, 148, 142, 1347.70, 148, 1347.44, 53
1, 15:38:00-000, 565, 305, 260, 269, 1347.15, 257, 1346.44, 64
1, 15:39:00-000, 368, 211, 157, 181, 1347.26, 160, 1345.85, 22
1, 15:40:00-000, 615, 368, 247, 201, 1348.39, 247, 1347.54, 70
1, 15:41:00-000, 311, 158, 153, 112, 1348.01, 153, 1347.26, 108
1, 15:42:00-000, 670, 407, 263, 228, 1348.55, 263, 1347.12, 148
1, 15:43:00-000, 272, 170, 102, 120, 1348.55, 102, 1347.95, 107
1, 15:44:00-000, 614, 337, 277, 222, 1347.48, 277, 1347.29, 75
1, 15:45:00-000, 255, 145, 110, 122, 1348.17, 110, 1347.37, 86
1, 15:46:00-000, 631, 371, 260, 253, 1348.16, 260, 1346.94, 51
1, 15:47:00-000, 304, 166, 138, 127, 1348.43, 138, 1347.68, 81
1, 15:48:00-000, 602, 371, 231, 257, 1348.54, 231, 1347.33, 61
1, 15:49:00-000, 321, 229, 92, 109, 1349.01, 92, 1348.53, 95
1, 15:50:00-000, 553, 297, 256, 233, 1347.83, 256, 1346.59, 110
1, 15:51:00-000, 347, 198, 149, 137, 1347.93, 149, 1346.95, 91
1, 15:52:00-000, 606, 379, 227, 276, 1347.74, 227, 1346.75, 79
1, 15:53:00-000, 313, 192, 121, 129, 1347.93, 121, 1347.79, 71
1, 15:54:00-000, 527, 311, 216, 226, 1348.59, 216, 1348.55, 74
1, 15:55:00-000, 294, 189, 105, 127, 1348.01, 105, 1347.02, 48
1, 15:56:00-000, 668, 361, 307, 286, 1347.38, 307, 1347.00, 94
1, 15:57:00-000, 354, 184, 170, 137, 1347.83, 170, 1346.05, 75
1, 15:58:00-000, 523, 344, 179, 226, 1348.63, 179, 1347.02, 68
1, 15:59:00-000, 266, 160, 106, 113, 1347.47, 106, 1347.98, 81
1, 16:00:00-000, 654, 351, 303, 293, 1347.32, 303, 1346.64, 70
1, 16:01:00-000, 359, 219, 140, 113, 1347.88, 140, 1347.76, 55
1, 16:02:00-000, 559, 293, 266, 212, 1348.64, 266, 1348.07, 100
1, 16:03:00-000, 303, 205, 98, 122, 1348.69, 98, 1347.40, 74
1, 16:04:00-000, 679, 426, 253, 261, 1348.08, 253, 1347.79, 100
1, 16:05:00-000, 273, 174, 99, 145, 1348.02, 99, 1347.32, 111
1, 16:06:00-000, 581, 333, 248, 241, 1348.58, 248, 1347.13, 88
1, 16:07:00-000, 312, 200, 112, 146, 1348.53, 112, 1347.29, 75
1, 16:08:00-000, 679, 430, 249, 272, 1348.81, 249, 1348.41, 66
1, 16:09:00-000, 359, 192, 167, 147, 1347.99, 167, 1348.14, 107
1, 16:10:00-000, 569, 366, 203, 245, 1348.78, 203, 1348.22, 104
1, 16:11:00-000, 335, 191, 144, 152, 1347.66, 144, 1347.68, 91
1, 16:12:00-000, 707, 423, 284, 231, 1348.58, 280, 1348.14, 100
1, 16:13:00-000, 270, 171, 99, 102, 1349.36, 103, 1348.55, 140
1, 16:14:00-000, 679, 381, 298, 277, 1348.56, 298, 1347.98, 86
1, 16:15:00-000, 319, 205, 114, 123, 1347.48, 114, 1347.08, 92
1, 16:16:00-000, 630, 363, 267, 268, 1348.24, 267, 1347.18, 60
1, 16:17:00-000, 260, 132, 128, 113, 1347.45, 128, 1346.36, 95
1, 16:18:00-000, 587, 346, 241, 212, 1347.61, 241, 1347.26, 95
1, 16:19:00-000, 333, 232, 101, 151, 1348.85, 101, 1347.67, 75
1, 16:20:00-000, 689, 367, 322, 324, 1347.66, 322, 1347.17, 58
1, 16:21:00-000, 372, 204, 168, 144, 1348.52, 168, 1347.51, 77
1, 16:22:00-000, 597, 388, 209, 275, 1348.72, 209, 1347.45, 67
1, 16:23:00-000, 257, 153, 104, 81, 1348.17, 102, 1347.91, 82
1, 16:24:00-000, 592, 362, 230, 272, 1348.32, 232, 1347.60, 102
1, 16:25:00-000, 386, 239, 147, 184, 1347.98, 147, 1347.30, 53
1, 16:26:00-000, 650, 339, 311, 249, 1347.20, 311, 1347.44, 85
1, 16:27:00-000, 296, 200, 96, 128, 1347.88, 96, 1347.70, 81
1, 16:28:00-000, 635, 365, 270, 266, 1348.50, 270, 1347.74, 94
1, 16:29:00-000, 367, 172, 195, 124, 1347.51, 195, 1347.03, 85
2, 09:06:00-000, 3122, 0, 3122, 0, 0.00, 1135, 1348.74, 0
2, 09:07:00-000, 0, 0, 0, 0, 0.00, 0, 0.00, 1977
2, 09:08:00-000, 0, 0, 0, 0, 0.00, 0, 0.00, 10
2, 09:13:00-000, 3015, 1135, 1880, 1135, 1352.55, 1424, 1351.15, 0
2, 09:14:00-000, 13, 5, 8, 5, 1357.00, 7, 1350.00, 456
2, 09:15:00-000, 11, 1, 10, 1, 1357.00, 10, 1352.10, 1
2, 09:16:00-000, 142, 65, 77, 65, 1353.85, 77, 1352.49, 0
2, 09:17:00-000, 215, 111, 104, 111, 1357.51, 104, 1352.40, 0
2, 09:18:00-000, 583, 280, 303, 280, 1353.97, 287, 1352.32, 0
2, 09:19:00-000, 367, 164, 203, 164, 1354.02, 191, 1353.13, 1
2, 09:20:00-000, 721, 316, 405, 313, 1353.21, 395, 1352.48, 17
2, 09:21:00-000, 417, 229, 188, 232, 1356.58, 208, 1353.85, 0
2, 09:22:00-000, 554, 293, 261, 293, 1356.03, 261, 1353.10, 0
2, 09:23:00-000, 255, 119, 136, 119, 1353.42, 128, 1351.46, 0
2, 09:24:00-000, 479, 248, 231, 248, 1353.71, 238, 1352.63, 0
2, 09:25:00-000, 316, 144, 172, 144, 1354.08, 170, 1352.52, 0
2, 09:26:00-000, 593, 302, 291, 302, 1354.25, 229, 1352.37, 11
2, 09:27:00-000, 374, 196, 178, 196, 1353.33, 140, 1351.49, 47
2, 09:28:00-000, 612, 306, 306, 306, 1354.04, 267, 1351.51, 53
2, 09:29:00-000, 356, 163, 193, 163, 1353.43, 174, 1352.50, 17
2, 09:30:00-000, 644, 272, 372, 272, 1352.96, 352, 1351.61, 15
2, 09:31:00-000, 274, 130, 144, 130, 1353.48, 146, 1352.81, 15
2, 09:32:00-000, 620, 284, 336, 284, 1353.83, 336, 1352.55, 2
2, 09:33:00-000, 333, 146, 187, 146, 1353.10, 177, 1352.08, 5
2, 09:34:00-000, 649, 294, 355, 294, 1353.16, 323, 1351.74, 31
2, 09:35:00-000, 313, 179, 134, 179, 1354.09, 142, 1352.29, 9
2, 09:36:00-000, 582, 258, 324, 258, 1352.89, 260, 1351.44, 13
2, 09:37:00-000, 294, 138, 156, 138, 1352.87, 131, 1352.04, 50
2, 09:38:00-000, 700, 414, 286, 414, 1354.18, 272, 1352.27, 21
2, 09:39:00-000, 271, 138, 133, 138, 1353.55, 132, 1352.28, 15
2, 09:40:00-000, 645, 297, 348, 297, 1352.36, 252, 1351.37, 33
2, 09:41:00-000, 296, 139, 157, 139, 1353.41, 127, 1352.41, 58
2, 09:42:00-000, 664, 322, 342, 322, 1353.73, 305, 1351.87, 36
2, 09:43:00-000, 333, 122, 211, 122, 1351.92, 166, 1350.93, 45
2, 09:44:00-000, 596, 259, 337, 259, 1353.12, 320, 1351.46, 34
2, 09:45:00-000, 297, 113, 184, 113, 1351.97, 132, 1350.36, 32
2, 09:46:00-000, 607, 253, 354, 253, 1352.33, 281, 1351.40, 37
2, 09:47:00-000, 319, 156, 163, 156, 1352.73, 142, 1351.17, 68
2, 09:48:00-000, 497, 226, 271, 226, 1351.50, 218, 1350.75, 55
2, 09:49:00-000, 322, 144, 178, 144, 1353.43, 133, 1351.34, 38
2, 09:50:00-000, 704, 343, 361, 343, 1353.01, 306, 1351.86, 56
2, 09:51:00-000, 377, 183, 194, 183, 1352.86, 167, 1352.30, 38
2, 09:52:00-000, 507, 228, 279, 228, 1352.88, 247, 1351.16, 39
2, 09:53:00-000, 332, 144, 188, 144, 1352.11, 150, 1351.24, 25
2, 09:54:00-000, 580, 245, 335, 245, 1352.38, 194, 1350.74, 60
2, 09:55:00-000, 326, 162, 164, 162, 1352.84, 158, 1351.96, 82
2, 09:56:00-000, 586, 265, 321, 265, 1352.85, 268, 1351.60, 42
2, 09:57:00-000, 336, 145, 191, 145, 1351.77, 163, 1351.49, 33
2, 09:58:00-000, 725, 344, 381, 344, 1351.85, 315, 1351.35, 53
2, 09:59:00-000, 271, 124, 147, 124, 1353.46, 110, 1351.64, 56
2, 10:00:00-000, 580, 251, 329, 251, 1352.36, 224, 1351.54, 55
2, 10:01:00-000, 296, 115, 181, 115, 1352.40, 134, 1351.79, 72
2, 10:02:00-000, 610, 240, 370, 240, 1351.64, 232, 1350.81, 87
2, 10:03:00-000, 265, 122, 143, 121, 1351.81, 138, 1351.66, 83
2, 10:04:00-000, 588, 255, 333, 256, 1352.32, 258, 1351.23, 51
2, 10:05:00-000, 366, 144, 222, 144, 1352.61, 167, 1351.75, 47
2, 10:06:00-000, 592, 263, 329, 263, 1353.41, 297, 1351.53, 74
2, 10:07:00-000, 314, 130, 184, 130, 1352.22, 157, 1350.67, 32
2, 10:08:00-000, 654, 283, 371, 283, 1352.32, 272, 1351.15, 53
2, 10:09:00-000, 261, 114, 147, 114, 1352.36, 108, 1350.35, 60
2, 10:10:00-000, 594, 268, 326, 268, 1353.54, 229, 1351.30, 45
2, 10:11:00-000, 291, 150, 141, 150, 1352.87, 146, 1351.80, 64
2, 10:12:00-000, 644, 313, 331, 313, 1353.35, 305, 1351.40, 34
2, 10:13:00-000, 310, 113, 197, 113, 1352.75, 131, 1351.14, 20
2, 10:14:00-000, 647, 261, 386, 261, 1352.24, 308, 1351.63, 64
2, 10:15:00-000, 301, 116, 185, 116, 1352.05, 128, 1351.27, 76
2, 10:16:00-000, 605, 300, 305, 300, 1352.28, 273, 1351.47, 49
2, 10:17:00-000, 288, 124, 164, 124, 1351.84, 114, 1351.55, 52
2, 10:18:00-000, 565, 272, 293, 272, 1353.00, 257, 1351.67, 48
2, 10:19:00-000, 383, 173, 210, 173, 1353.38, 161, 1351.84, 35
2, 10:20:00-000, 576, 270, 306, 270, 1352.37, 275, 1351.20, 50
2, 10:21:00-000, 365, 144, 221, 144, 1351.51, 147, 1350.24, 29
2, 10:22:00-000, 627, 332, 295, 332, 1352.75, 267, 1351.75, 48
2, 10:23:00-000, 317, 143, 174, 143, 1353.75, 152, 1351.65, 50
2, 10:24:00-000, 625, 191, 434, 191, 1351.22, 267, 1350.47, 74
2, 10:25:00-000, 337, 125, 212, 125, 1351.81, 188, 1350.60, 86
2, 10:26:00-000, 603, 276, 327, 276, 1352.57, 248, 1351.56, 71
2, 10:27:00-000, 353, 137, 216, 137, 1352.82, 155, 1351.61, 67
2, 10:28:00-000, 586, 231, 355, 231, 1352.30, 269, 1350.73, 81
2, 10:29:00-000, 343, 183, 160, 183, 1352.91, 152, 1352.10, 43
2, 10:30:00-000, 663, 321, 342, 321, 1353.82, 284, 1352.33, 47
2, 10:31:00-000, 302, 133, 169, 133, 1353.84, 162, 1352.25, 27
2, 10:32:00-000, 703, 320, 383, 320, 1353.13, 327, 1351.13, 16
2, 10:33:00-000, 326, 129, 197, 129, 1351.76, 156, 1350.86, 55
2, 10:34:00-000, 645, 270, 375, 270, 1351.80, 257, 1350.67, 69
2, 10:35:00-000, 315, 161, 154, 161, 1351.71, 126, 1351.30, 73
2, 10:36:00-000, 601, 227, 374, 227, 1351.96, 270, 1350.57, 62
2, 10:37:00-000, 340, 168, 172, 168, 1353.76, 124, 1352.16, 83
2, 10:38:00-000, 704, 342, 362, 342, 1353.25, 311, 1352.49, 53
2, 10:39:00-000, 276, 116, 160, 116, 1352.26, 138, 1351.40, 36
2, 10:40:00-000, 629, 299, 330, 299, 1353.51, 299, 1352.23, 38
2, 10:41:00-000, 290, 126, 164, 126, 1352.42, 105, 1351.21, 34
2, 10:42:00-000, 559, 256, 303, 256, 1352.65, 225, 1352.17, 35
2, 10:43:00-000, 354, 147, 207, 147, 1351.82, 165, 1350.98, 101
2, 10:44:00-000, 618, 288, 330, 288, 1352.96, 276, 1352.09, 33
2, 10:45:00-000, 307, 137, 170, 137, 1352.58, 167, 1351.18, 57
2, 10:46:00-000, 625, 302, 323, 302, 1353.27, 247, 1351.21, 17
2, 10:47:00-000, 336, 160, 176, 160, 1351.98, 160, 1351.11, 51
2, 10:48:00-000, 580, 203, 377, 203, 1351.81, 282, 1351.12, 61
2, 10:49:00-000, 320, 122, 198, 122, 1351.85, 115, 1351.01, 61
2, 10:50:00-000, 654, 318, 336, 318, 1352.25, 286, 1351.28, 51
2, 10:51:00-000, 328, 140, 188, 140, 1352.52, 158, 1351.78, 70
2, 10:52:00-000, 551, 247, 304, 247, 1352.08, 258, 1350.98, 65
2, 10:53:00-000, 338, 178, 160, 178, 1353.35, 133, 1352.07, 23
2, 10:54:00-000, 578, 235, 343, 235, 1352.22, 272, 1351.17, 41
2, 10:55:00-000, 377, 151, 226, 151, 1352.55, 178, 1350.81, 57
2, 10:56:00-000, 659, 325, 334, 325, 1352.99, 289, 1351.63, 50
2, 10:57:00-000, 315, 135, 180, 135, 1352.40, 108, 1351.44, 53
2, 10:58:00-000, 601, 265, 336, 265, 1352.78, 261, 1351.82, 79
2, 10:59:00-000, 272, 138, 134, 138, 1353.31, 129, 1352.48, 55
2, 11:00:00-000, 621, 296, 325, 296, 1353.75, 293, 1352.01, 28
2, 11:01:00-000, 280, 148, 132, 148, 1353.56, 96, 1351.90, 22
2, 11:02:00-000, 635, 252, 383, 252, 1352.38, 262, 1351.26, 69
2, 11:03:00-000, 294, 151, 143, 151, 1352.68, 110, 1351.81, 71
2, 11:04:00-000, 659, 275, 384, 273, 1352.06, 305, 1351.05, 60
2, 11:05:00-000, 251, 112, 139, 114, 1352.47, 109, 1350.67, 69
2, 11:06:00-000, 597, 273, 324, 273, 1352.44, 246, 1351.84, 34
2, 11:07:00-000, 274, 125, 149, 125, 1353.46, 116, 1351.92, 56
2, 11:08:00-000, 610, 221, 389, 221, 1352.34, 269, 1351.04, 65
2, 11:09:00-000, 311, 108, 203, 108, 1352.19, 124, 1351.44, 78
2, 11:10:00-000, 672, 310, 362, 307, 1352.60, 290, 1351.30, 99
2, 11:11:00-000, 313, 145, 168, 148, 1351.90, 134, 1351.24, 75
2, 11:12:00-000, 612, 253, 359, 252, 1352.17, 289, 1351.34, 48
2, 11:13:00-000, 280, 109, 171, 110, 1351.65, 111, 1351.79, 50
2, 11:14:00-000, 583, 267, 316, 267, 1352.61, 252, 1351.59, 79
2, 11:15:00-000, 386, 158, 228, 158, 1351.81, 159, 1351.28, 55
2, 11:16:00-000, 674, 297, 377, 297, 1351.92, 319, 1350.94, 77
2, 11:17:00-000, 329, 138, 191, 138, 1351.46, 114, 1350.90, 47
2, 11:18:00-000, 534, 264, 270, 264, 1352.66, 218, 1351.22, 58
2, 11:19:00-000, 262, 71, 191, 71, 1351.38, 113, 1350.34, 48
2, 11:20:00-000, 574, 285, 289, 285, 1352.46, 276, 1351.40, 71
2, 11:21:00-000, 286, 119, 167, 119, 1353.41, 119, 1351.65, 40
2, 11:22:00-000, 672, 291, 381, 291, 1351.87, 325, 1350.98, 66
2, 11:23:00-000, 338, 168, 170, 164, 1352.45, 146, 1351.27, 34
2, 11:24:00-000, 572, 252, 320, 256, 1352.98, 224, 1351.77, 72
2, 11:25:00-000, 299, 78, 221, 78, 1351.95, 117, 1350.52, 60
2, 11:26:00-000, 657, 265, 392, 265, 1352.10, 295, 1351.60, 108
2, 11:27:00-000, 281, 133, 148, 133, 1352.64, 145, 1351.35, 80
2, 11:28:00-000, 592, 238, 354, 238, 1352.77, 285, 1351.56, 21
2, 11:29:00-000, 311, 145, 166, 145, 1353.41, 143, 1351.12, 58
2, 11:30:00-000, 671, 316, 355, 316, 1353.52, 275, 1351.21, 30
2, 11:31:00-000, 287, 152, 135, 152, 1354.16, 158, 1352.00, 33
2, 11:32:00-000, 658, 286, 372, 286, 1352.38, 281, 1351.90, 36
2, 11:33:00-000, 274, 113, 161, 113, 1352.32, 129, 1350.87, 63
2, 11:34:00-000, 552, 273, 279, 273, 1352.99, 223, 1352.25, 64
2, 11:35:00-000, 285, 142, 143, 142, 1353.39, 123, 1351.43, 33
2, 11:36:00-000, 635, 295, 340, 295, 1352.57, 271, 1351.42, 34
2, 11:37:00-000, 345, 159, 186, 159, 1353.02, 140, 1351.01, 50
2, 11:38:00-000, 626, 236, 390, 236, 1352.25, 288, 1351.00, 62
2, 11:39:00-000, 258, 100, 158, 100, 1350.53, 90, 1350.63, 76
2, 11:40:00-000, 628, 283, 345, 283, 1352.30, 325, 1351.00, 68
2, 11:41:00-000, 354, 164, 190, 164, 1351.17, 135, 1351.05, 40
2, 11:42:00-000, 544, 213, 331, 213, 1352.26, 248, 1351.30, 58
2, 11:43:00-000, 340, 201, 139, 201, 1353.98, 145, 1352.95, 43
2, 11:44:00-000, 534, 245, 289, 245, 1354.16, 240, 1351.17, 28
2, 11:45:00-000, 298, 130, 168, 130, 1352.08, 112, 1349.98, 49
2, 11:46:00-000, 616, 233, 383, 233, 1352.60, 309, 1351.48, 48
2, 11:47:00-000, 283, 141, 142, 141, 1352.53, 136, 1351.32, 59
2, 11:48:00-000, 629, 314, 315, 314, 1352.37, 244, 1351.55, 43
2, 11:49:00-000, 287, 139, 148, 139, 1353.46, 121, 1351.44, 30
2, 11:50:00-000, 555, 226, 329, 226, 1352.69, 256, 1351.36, 49
2, 11:51:00-000, 307, 102, 205, 102, 1351.72, 132, 1350.52, 69
2, 11:52:00-000, 653, 326, 327, 326, 1353.17, 315, 1352.24, 58
2, 11:53:00-000, 369, 161, 208, 161, 1352.07, 166, 1350.14, 34
2, 11:54:00-000, 550, 215, 335, 215, 1351.90, 232, 1351.18, 47
2, 11:55:00-000, 317, 136, 181, 136, 1352.77, 154, 1352.43, 82
2, 11:56:00-000, 652, 242, 410, 242, 1351.27, 266, 1350.16, 113
2, 11:57:00-000, 282, 121, 161, 121, 1352.52, 132, 1350.84, 56
2, 11:58:00-000, 682, 302, 380, 302, 1352.61, 282, 1351.34, 69
2, 11:59:00-000, 268, 109, 159, 109, 1352.52, 127, 1351.22, 57
2, 12:00:00-000, 641, 253, 388, 253, 1352.11, 301, 1350.77, 61
2, 12:01:00-000, 357, 209, 148, 209, 1353.30, 144, 1351.80, 59
2, 12:02:00-000, 647, 290, 357, 290, 1353.30, 296, 1351.24, 31
2, 12:03:00-000, 280, 130, 150, 130, 1352.35, 133, 1350.44, 45
2, 12:04:00-000, 560, 235, 325, 235, 1352.27, 247, 1351.33, 24
2, 12:05:00-000, 303, 161, 142, 161, 1352.32, 113, 1351.76, 67
2, 12:06:00-000, 698, 319, 379, 319, 1352.64, 314, 1351.50, 43
2, 12:07:00-000, 293, 127, 166, 127, 1351.88, 154, 1351.39, 51
2, 12:08:00-000, 639, 290, 349, 290, 1353.43, 280, 1351.82, 34
2, 12:09:00-000, 327, 160, 167, 160, 1353.20, 153, 1351.56, 46
2, 12:10:00-000, 599, 241, 358, 241, 1351.87, 247, 1351.08, 38
2, 12:11:00-000, 316, 152, 164, 152, 1352.97, 157, 1351.43, 72
2, 12:12:00-000, 586, 239, 347, 239, 1351.89, 262, 1350.78, 48
2, 12:13:00-000, 338, 151, 187, 151, 1352.01, 149, 1352.46, 48
2, 12:14:00-000, 598, 266, 332, 266, 1352.01, 251, 1350.90, 84
2, 12:15:00-000, 266, 91, 175, 91, 1352.40, 132, 1351.23, 45
2, 12:16:00-000, 601, 281, 320, 281, 1352.53, 272, 1351.67, 61
2, 12:17:00-000, 351, 189, 162, 189, 1353.18, 140, 1351.54, 43
2, 12:18:00-000, 655, 269, 386, 269, 1352.90, 308, 1351.45, 38
2, 12:19:00-000, 304, 156, 148, 156, 1352.67, 154, 1352.05, 49
2, 12:20:00-000, 603, 253, 350, 253, 1351.60, 184, 1350.53, 30
2, 12:21:00-000, 264, 104, 160, 104, 1351.71, 106, 1350.26, 137
2, 12:22:00-000, 646, 288, 358, 288, 1352.61, 186, 1350.25, 91
2, 12:23:00-000, 284, 131, 153, 131, 1352.45, 90, 1351.26, 122
2, 12:24:00-000, 520, 236, 284, 236, 1352.52, 205, 1351.10, 89
2, 12:25:00-000, 310, 142, 168, 142, 1352.37, 135, 1351.50, 56
2, 12:26:00-000, 707, 284, 423, 284, 1351.92, 283, 1350.45, 79
2, 12:27:00-000, 300, 118, 182, 118, 1351.88, 141, 1350.60, 99
2, 12:28:00-000, 595, 206, 389, 206, 1352.02, 264, 1351.01, 91
2, 12:29:00-000, 274, 113, 161, 113, 1353.47, 105, 1351.09, 79
2, 12:30:00-000, 674, 217, 457, 217, 1352.08, 323, 1350.61, 85
2, 12:31:00-000, 300, 128, 172, 128, 1352.26, 164, 1351.89, 65
2, 12:32:00-000, 659, 268, 391, 268, 1351.52, 301, 1350.88, 76
2, 12:33:00-000, 277, 120, 157, 120, 1353.07, 132, 1352.04, 48
2, 12:34:00-000, 570, 255, 315, 253, 1352.69, 223, 1351.66, 52
2, 12:35:00-000, 302, 143, 159, 145, 1353.03, 105, 1351.33, 84
2, 12:36:00-000, 576, 245, 331, 245, 1352.74, 242, 1351.25, 84
2, 12:37:00-000, 340, 147, 193, 147, 1352.63, 134, 1350.61, 61
2, 12:38:00-000, 640, 325, 315, 325, 1353.58, 279, 1352.07, 76
2, 12:39:00-000, 322, 134, 188, 134, 1354.14, 129, 1351.05, 24
2, 12:40:00-000, 599, 284, 315, 284, 1352.55, 279, 1351.61, 31
2, 12:41:00-000, 266, 111, 155, 111, 1352.10, 114, 1350.85, 39
2, 12:42:00-000, 530, 227, 303, 227, 1352.42, 241, 1351.31, 72
2, 12:43:00-000, 300, 113, 187, 113, 1352.60, 121, 1352.06, 38
2, 12:44:00-000, 675, 270, 405, 270, 1352.01, 275, 1350.97, 119
2, 12:45:00-000, 301, 127, 174, 127, 1351.96, 178, 1351.63, 67
2, 12:46:00-000, 608, 251, 357, 251, 1351.62, 289, 1350.63, 38
2, 12:47:00-000, 361, 170, 191, 170, 1352.19, 160, 1350.60, 49
2, 12:48:00-000, 602, 263, 339, 263, 1352.34, 268, 1350.65, 53
2, 12:49:00-000, 269, 118, 151, 118, 1352.33, 89, 1352.27, 53
2, 12:50:00-000, 583, 209, 374, 209, 1350.77, 241, 1350.12, 102
2, 12:51:00-000, 372, 201, 171, 201, 1353.09, 151, 1351.35, 63
2, 12:52:00-000, 719, 304, 415, 304, 1352.49, 336, 1351.14, 57
2, 12:53:00-000, 249, 130, 119, 130, 1352.11, 104, 1351.93, 60
2, 12:54:00-000, 608, 288, 320, 288, 1352.83, 258, 1351.36, 24
2, 12:55:00-000, 321, 138, 183, 138, 1352.17, 157, 1349.98, 52
2, 12:56:00-000, 657, 268, 389, 268, 1352.19, 286, 1351.39, 80
2, 12:57:00-000, 300, 129, 171, 129, 1351.70, 109, 1351.11, 47
2, 12:58:00-000, 697, 291, 406, 291, 1352.05, 293, 1351.00, 91
2, 12:59:00-000, 343, 151, 192, 151, 1352.87, 166, 1351.29, 66
2, 13:00:00-000, 609, 254, 355, 254, 1352.65, 262, 1351.94, 65
2, 13:01:00-000, 278, 111, 167, 111, 1352.83, 137, 1351.88, 44
2, 13:02:00-000, 658, 252, 406, 252, 1351.82, 281, 1350.36, 114
2, 13:03:00-000, 262, 101, 161, 101, 1352.08, 114, 1351.57, 64
2, 13:04:00-000, 654, 303, 351, 303, 1353.34, 285, 1352.10, 75
2, 13:05:00-000, 310, 150, 160, 150, 1354.12, 136, 1353.15, 48
2, 13:06:00-000, 606, 252, 354, 252, 1352.16, 254, 1351.69, 41
2, 13:07:00-000, 276, 145, 131, 145, 1352.26, 104, 1351.30, 76
2, 13:08:00-000, 738, 311, 427, 311, 1352.58, 354, 1352.13, 39
2, 13:09:00-000, 305, 133, 172, 133, 1352.31, 126, 1350.64, 73
2, 13:10:00-000, 619, 237, 382, 237, 1351.51, 255, 1350.86, 78
2, 13:11:00-000, 290, 133, 157, 133, 1351.52, 136, 1350.09, 72
2, 13:12:00-000, 696, 273, 423, 273, 1351.68, 293, 1350.16, 74
2, 13:13:00-000, 335, 197, 138, 197, 1352.99, 140, 1351.04, 62
2, 13:14:00-000, 694, 266, 428, 266, 1352.67, 303, 1351.64, 56
2, 13:15:00-000, 301, 149, 152, 149, 1352.86, 138, 1351.03, 90
2, 13:16:00-000, 536, 233, 303, 233, 1352.57, 226, 1351.12, 33
2, 13:17:00-000, 326, 159, 167, 159, 1352.61, 138, 1352.25, 52
2, 13:18:00-000, 659, 313, 346, 313, 1352.83, 274, 1351.66, 50
2, 13:19:00-000, 283, 124, 159, 124, 1352.96, 127, 1352.17, 66
2, 13:20:00-000, 658, 260, 398, 260, 1352.02, 273, 1351.05, 68
2, 13:21:00-000, 291, 112, 179, 112, 1351.87, 125, 1350.92, 83
2, 13:22:00-000, 606, 284, 322, 284, 1352.91, 259, 1351.54, 72
2, 13:23:00-000, 262, 158, 104, 158, 1354.08, 108, 1352.71, 41
2, 13:24:00-000, 657, 260, 397, 258, 1351.88, 295, 1350.53, 27
2, 13:25:00-000, 372, 136, 236, 138, 1352.09, 189, 1350.80, 72
2, 13:26:00-000, 524, 238, 286, 238, 1351.96, 246, 1351.30, 63
2, 13:27:00-000, 314, 146, 168, 146, 1353.07, 120, 1352.26, 41
2, 13:28:00-000, 577, 248, 329, 248, 1352.53, 271, 1351.45, 57
2, 13:29:00-000, 343, 141, 202, 141, 1352.72, 157, 1351.14, 39
2, 13:30:00-000, 639, 261, 378, 261, 1353.02, 305, 1351.58, 60
2, 13:31:00-000, 339, 170, 169, 170, 1352.62, 134, 1351.92, 62
2, 13:32:00-000, 556, 261, 295, 261, 1352.38, 219, 1351.25, 61
2, 13:33:00-000, 315, 116, 199, 116, 1351.11, 149, 1350.51, 33
2, 13:34:00-000, 630, 305, 325, 305, 1353.05, 254, 1351.34, 79
2, 13:35:00-000, 384, 117, 267, 117, 1350.77, 140, 1349.82, 69
2, 13:36:00-000, 642, 306, 336, 306, 1352.56, 331, 1351.36, 60
2, 13:37:00-000, 232, 118, 114, 118, 1351.84, 76, 1351.16, 71
2, 13:38:00-000, 530, 246, 284, 246, 1352.74, 240, 1351.65, 54
2, 13:39:00-000, 351, 149, 202, 149, 1352.07, 150, 1351.62, 23
2, 13:40:00-000, 628, 312, 316, 312, 1353.51, 304, 1352.32, 30
2, 13:41:00-000, 317, 127, 190, 127, 1352.58, 136, 1351.14, 39
2, 13:42:00-000, 609, 230, 379, 230, 1351.33, 258, 1350.76, 76
2, 13:43:00-000, 260, 102, 158, 102, 1352.08, 101, 1350.77, 94
2, 13:44:00-000, 689, 330, 359, 330, 1352.45, 307, 1351.08, 51
2, 13:45:00-000, 295, 126, 169, 126, 1352.00, 135, 1351.48, 47
2, 13:46:00-000, 612, 285, 327, 285, 1353.25, 285, 1352.17, 34
2, 13:47:00-000, 250, 111, 139, 111, 1353.95, 109, 1350.28, 52
2, 13:48:00-000, 639, 246, 393, 246, 1352.23, 274, 1351.46, 45
2, 13:49:00-000, 296, 123, 173, 123, 1350.93, 120, 1351.07, 91
2, 13:50:00-000, 610, 293, 317, 293, 1352.36, 271, 1351.01, 82
2, 13:51:00-000, 316, 138, 178, 138, 1353.07, 150, 1351.61, 28
2, 13:52:00-000, 630, 290, 340, 290, 1353.13, 284, 1351.94, 50
2, 13:53:00-000, 267, 127, 140, 127, 1352.30, 108, 1351.10, 40
2, 13:54:00-000, 620, 277, 343, 277, 1352.67, 280, 1351.22, 40
2, 13:55:00-000, 331, 129, 202, 129, 1352.09, 187, 1351.54, 43
2, 13:56:00-000, 657, 274, 383, 274, 1351.81, 291, 1351.07, 53
2, 13:57:00-000, 271, 129, 142, 129, 1352.39, 126, 1351.55, 47
2, 13:58:00-000, 653, 304, 349, 304, 1352.89, 282, 1351.15, 40
2, 13:59:00-000, 278, 99, 179, 99, 1351.40, 140, 1350.52, 65
2, 14:00:00-000, 611, 282, 329, 282, 1352.26, 229, 1351.10, 38
2, 14:01:00-000, 344, 144, 200, 144, 1352.86, 132, 1351.49, 102
2, 14:02:00-000, 667, 318, 349, 318, 1353.06, 283, 1351.69, 52
2, 14:03:00-000, 278, 134, 144, 134, 1352.38, 119, 1351.55, 57
2, 14:04:00-000, 559, 284, 275, 284, 1352.60, 244, 1351.55, 37
2, 14:05:00-000, 251, 108, 143, 108, 1351.88, 108, 1350.18, 43
2, 14:06:00-000, 669, 270, 399, 270, 1352.09, 330, 1350.70, 28
2, 14:07:00-000, 314, 131, 183, 131, 1352.44, 158, 1351.58, 58
2, 14:08:00-000, 617, 263, 354, 263, 1351.83, 257, 1350.50, 70
2, 14:09:00-000, 366, 163, 203, 163, 1352.24, 165, 1351.10, 42
2, 14:10:00-000, 598, 241, 357, 241, 1351.42, 261, 1350.95, 69
2, 14:11:00-000, 292, 131, 161, 131, 1352.24, 122, 1350.94, 84
2, 14:12:00-000, 617, 281, 336, 281, 1352.39, 293, 1351.56, 36
2, 14:13:00-000, 341, 124, 217, 124, 1351.71, 137, 1351.20, 56
2, 14:14:00-000, 689, 329, 360, 329, 1352.22, 293, 1351.61, 75
2, 14:15:00-000, 308, 129, 179, 129, 1352.54, 147, 1352.08, 67
2, 14:16:00-000, 615, 257, 358, 257, 1352.25, 269, 1351.14, 48
2, 14:17:00-000, 294, 147, 147, 145, 1352.88, 159, 1352.31, 44
2, 14:18:00-000, 653, 290, 363, 292, 1352.28, 278, 1350.89, 38
2, 14:19:00-000, 328, 150, 178, 150, 1352.78, 152, 1350.90, 56
2, 14:20:00-000, 648, 309, 339, 308, 1353.60, 293, 1352.20, 49
2, 14:21:00-000, 244, 96, 148, 97, 1352.40, 94, 1351.22, 35
2, 14:22:00-000, 608, 235, 373, 235, 1352.33, 259, 1351.91, 46
2, 14:23:00-000, 323, 149, 174, 149, 1352.31, 131, 1350.81, 104
2, 14:24:00-000, 627, 275, 352, 275, 1352.57, 305, 1351.93, 70
2, 14:25:00-000, 281, 122, 159, 122, 1352.06, 104, 1350.53, 29
2, 14:26:00-000, 646, 279, 367, 279, 1352.48, 279, 1350.64, 49
2, 14:27:00-000, 293, 113, 180, 113, 1352.71, 127, 1351.29, 95
2, 14:28:00-000, 611, 279, 332, 279, 1352.25, 268, 1350.95, 60
2, 14:29:00-000, 290, 135, 155, 135, 1352.48, 126, 1351.76, 56
2, 14:30:00-000, 650, 254, 396, 254, 1352.32, 305, 1351.46, 50
2, 14:31:00-000, 324, 176, 148, 176, 1353.19, 150, 1352.00, 40
2, 14:32:00-000, 650, 320, 330, 317, 1353.20, 261, 1351.51, 33
2, 14:33:00-000, 361, 134, 227, 137, 1352.77, 169, 1351.35, 65
2, 14:34:00-000, 519, 240, 279, 240, 1352.07, 227, 1351.34, 72
2, 14:35:00-000, 307, 176, 131, 176, 1354.14, 112, 1351.90, 35
2, 14:36:00-000, 579, 297, 282, 297, 1353.47, 279, 1351.70, 20
2, 14:37:00-000, 315, 116, 199, 116, 1352.22, 132, 1350.68, 13
2, 14:38:00-000, 588, 240, 348, 240, 1352.27, 275, 1351.49, 57
2, 14:39:00-000, 346, 138, 208, 138, 1352.48, 163, 1351.19, 66
2, 14:40:00-000, 634, 247, 387, 247, 1351.91, 277, 1351.19, 79
2, 14:41:00-000, 327, 174, 153, 174, 1353.44, 139, 1351.68, 71
2, 14:42:00-000, 600, 247, 353, 247, 1352.77, 272, 1351.74, 36
2, 14:43:00-000, 274, 129, 145, 129, 1352.54, 119, 1351.89, 54
2, 14:44:00-000, 607, 259, 348, 259, 1352.55, 274, 1351.47, 42
2, 14:45:00-000, 376, 197, 179, 197, 1353.71, 177, 1351.50, 56
2, 14:46:00-000, 552, 243, 309, 243, 1352.26, 255, 1351.04, 37
2, 14:47:00-000, 317, 164, 153, 164, 1354.16, 155, 1352.33, 29
2, 14:48:00-000, 600, 225, 375, 225, 1351.92, 270, 1350.65, 31
2, 14:49:00-000, 410, 186, 224, 186, 1352.35, 172, 1350.82, 71
2, 14:50:00-000, 605, 293, 312, 293, 1353.14, 273, 1350.86, 69
2, 14:51:00-000, 253, 132, 121, 132, 1353.60, 107, 1351.90, 31
2, 14:52:00-000, 605, 271, 334, 271, 1352.93, 279, 1351.86, 14
2, 14:53:00-000, 306, 128, 178, 128, 1353.13, 136, 1350.65, 59
2, 14:54:00-000, 681, 340, 341, 340, 1353.50, 307, 1351.49, 41
2, 14:55:00-000, 295, 112, 183, 112, 1351.60, 158, 1350.78, 22
2, 14:56:00-000, 646, 249, 397, 249, 1350.90, 245, 1350.47, 85
2, 14:57:00-000, 316, 172, 144, 172, 1353.42, 154, 1352.11, 66
2, 14:58:00-000, 691, 262, 429, 262, 1352.09, 291, 1351.06, 61
2, 14:59:00-000, 258, 132, 126, 132, 1352.75, 130, 1352.54, 86
2, 15:00:00-000, 554, 231, 323, 231, 1352.62, 260, 1351.36, 42
2, 15:01:00-000, 313, 157, 156, 157, 1352.42, 108, 1351.10, 43
2, 15:02:00-000, 693, 328, 365, 323, 1352.06, 283, 1351.08, 46
2, 15:03:00-000, 301, 130, 171, 135, 1352.39, 128, 1351.41, 78
2, 15:04:00-000, 654, 335, 319, 335, 1352.97, 275, 1352.13, 39
2, 15:05:00-000, 291, 101, 190, 101, 1351.81, 116, 1350.89, 49
2, 15:06:00-000, 642, 292, 350, 292, 1352.43, 266, 1351.07, 71
2, 15:07:00-000, 249, 101, 148, 101, 1352.23, 107, 1351.33, 82
2, 15:08:00-000, 683, 300, 383, 300, 1352.85, 310, 1351.42, 41
2, 15:09:00-000, 289, 114, 175, 114, 1352.21, 121, 1350.14, 75
2, 15:10:00-000, 656, 289, 367, 289, 1352.31, 289, 1351.20, 55
2, 15:11:00-000, 288, 117, 171, 117, 1352.58, 127, 1351.71, 70
2, 15:12:00-000, 569, 253, 316, 253, 1353.01, 269, 1351.25, 59
2, 15:13:00-000, 279, 101, 178, 101, 1351.10, 108, 1350.10, 48
2, 15:14:00-000, 739, 301, 438, 301, 1352.54, 327, 1351.64, 94
2, 15:15:00-000, 302, 122, 180, 122, 1352.11, 122, 1351.33, 72
2, 15:16:00-000, 634, 259, 375, 259, 1351.25, 261, 1350.58, 83
2, 15:17:00-000, 308, 132, 176, 132, 1352.04, 146, 1351.75, 66
2, 15:18:00-000, 612, 280, 332, 280, 1351.83, 245, 1350.03, 74
2, 15:19:00-000, 249, 119, 130, 119, 1352.08, 104, 1351.58, 66
2, 15:20:00-000, 683, 330, 353, 330, 1352.27, 304, 1351.41, 16
2, 15:21:00-000, 244, 106, 138, 106, 1352.30, 138, 1352.54, 50
2, 15:22:00-000, 627, 269, 358, 269, 1351.90, 260, 1350.59, 34
2, 15:23:00-000, 347, 146, 201, 146, 1351.30, 181, 1350.15, 72
2, 15:24:00-000, 639, 247, 392, 247, 1351.91, 265, 1351.00, 52
2, 15:25:00-000, 317, 133, 184, 133, 1352.33, 136, 1352.09, 78
2, 15:26:00-000, 645, 257, 388, 257, 1351.67, 240, 1350.72, 95
2, 15:27:00-000, 322, 140, 182, 140, 1351.62, 178, 1350.81, 88
2, 15:28:00-000, 543, 250, 293, 250, 1352.73, 227, 1351.96, 57
2, 15:29:00-000, 339, 152, 187, 152, 1352.28, 132, 1350.84, 59
2, 15:30:00-000, 595, 233, 362, 233, 1352.55, 249, 1351.25, 48
2, 15:31:00-000, 372, 150, 222, 150, 1352.91, 184, 1351.00, 83
2, 15:32:00-000, 615, 304, 311, 304, 1352.20, 255, 1351.53, 85
2, 15:33:00-000, 299, 129, 170, 129, 1352.85, 118, 1351.53, 27
2, 15:34:00-000, 601, 230, 371, 230, 1351.95, 256, 1350.70, 74
2, 15:35:00-000, 375, 160, 215, 160, 1353.21, 179, 1351.18, 82
2, 15:36:00-000, 603, 268, 335, 268, 1352.07, 267, 1351.77, 82
2, 15:37:00-000, 276, 118, 158, 118, 1352.18, 106, 1349.80, 51
2, 15:38:00-000, 692, 278, 414, 278, 1351.70, 319, 1350.76, 58
2, 15:39:00-000, 306, 137, 169, 137, 1352.14, 142, 1351.19, 60
2, 15:40:00-000, 612, 279, 333, 279, 1351.84, 159, 1350.21, 104
2, 15:41:00-000, 317, 138, 179, 138, 1351.85, 86, 1349.36, 122
2, 15:42:00-000, 666, 307, 359, 307, 1351.86, 233, 1350.92, 72
2, 15:43:00-000, 301, 122, 179, 122, 1352.00, 127, 1350.87, 132
2, 15:44:00-000, 645, 262, 383, 262, 1351.67, 246, 1350.03, 85
2, 15:45:00-000, 287, 84, 203, 84, 1351.38, 106, 1350.59, 111
2, 15:46:00-000, 588, 231, 357, 231, 1352.03, 257, 1350.28, 109
2, 15:47:00-000, 300, 112, 188, 112, 1351.46, 122, 1350.96, 75
2, 15:48:00-000, 728, 249, 479, 249, 1351.83, 323, 1350.55, 113
2, 15:49:00-000, 332, 186, 146, 186, 1352.87, 120, 1351.43, 111
2, 15:50:00-000, 602, 210, 392, 210, 1351.41, 259, 1350.83, 71
2, 15:51:00-000, 307, 120, 187, 120, 1351.91, 121, 1350.78, 94
2, 15:52:00-000, 731, 267, 464, 267, 1351.59, 340, 1350.46, 108
2, 15:53:00-000, 298, 122, 176, 122, 1352.50, 152, 1351.54, 61
2, 15:54:00-000, 575, 248, 327, 248, 1352.99, 199, 1350.69, 82
2, 15:55:00-000, 295, 122, 173, 122, 1351.61, 180, 1350.80, 54
2, 15:56:00-000, 637, 294, 343, 294, 1352.86, 258, 1351.21, 51
2, 15:57:00-000, 380, 163, 217, 163, 1350.56, 160, 1350.10, 79
2, 15:58:00-000, 642, 256, 386, 256, 1351.85, 290, 1350.71, 67
2, 15:59:00-000, 335, 131, 204, 131, 1351.55, 152, 1350.58, 89
2, 16:00:00-000, 633, 261, 372, 261, 1352.15, 304, 1350.91, 44
2, 16:01:00-000, 300, 146, 154, 146, 1352.84, 107, 1352.16, 58
2, 16:02:00-000, 627, 297, 330, 297, 1351.94, 225, 1351.71, 80
2, 16:03:00-000, 290, 131, 159, 131, 1352.84, 116, 1351.80, 69
2, 16:04:00-000, 679, 322, 357, 322, 1352.65, 274, 1350.95, 84
2, 16:05:00-000, 337, 122, 215, 122, 1351.49, 126, 1350.16, 42
2, 16:06:00-000, 663, 283, 380, 283, 1351.73, 286, 1350.87, 92
2, 16:07:00-000, 309, 121, 188, 121, 1351.94, 155, 1351.66, 48
2, 16:08:00-000, 552, 247, 305, 247, 1352.80, 235, 1351.44, 99
2, 16:09:00-000, 263, 118, 145, 118, 1351.53, 120, 1351.35, 61
2, 16:10:00-000, 660, 269, 391, 269, 1352.27, 287, 1350.49, 56
2, 16:11:00-000, 291, 122, 169, 122, 1352.84, 125, 1350.48, 63
2, 16:12:00-000, 559, 245, 314, 245, 1352.75, 232, 1351.32, 60
2, 16:13:00-000, 310, 155, 155, 155, 1352.76, 122, 1352.00, 62
2, 16:14:00-000, 632, 282, 350, 282, 1352.66, 285, 1351.32, 49
2, 16:15:00-000, 313, 112, 201, 112, 1351.16, 135, 1350.37, 49
2, 16:16:00-000, 623, 258, 365, 258, 1351.93, 270, 1350.90, 87
2, 16:17:00-000, 260, 102, 158, 102, 1350.49, 96, 1349.73, 76
2, 16:18:00-000, 610, 255, 355, 255, 1351.02, 240, 1350.39, 73
2, 16:19:00-000, 301, 116, 185, 116, 1351.69, 164, 1351.10, 82
2, 16:20:00-000, 590, 294, 296, 294, 1353.78, 225, 1351.30, 65
2, 16:21:00-000, 333, 149, 184, 149, 1351.13, 126, 1350.67, 53
2, 16:22:00-000, 611, 247, 364, 247, 1352.52, 287, 1351.35, 61
2, 16:23:00-000, 285, 124, 161, 124, 1351.79, 107, 1351.62, 82
2, 16:24:00-000, 610, 215, 395, 215, 1351.32, 214, 1350.90, 97
2, 16:25:00-000, 239, 103, 136, 103, 1352.66, 159, 1351.90, 67
2, 16:26:00-000, 709, 304, 405, 304, 1352.38, 292, 1350.58, 63
2, 16:27:00-000, 320, 105, 215, 105, 1351.67, 144, 1350.37, 77
2, 16:28:00-000, 580, 223, 357, 223, 1351.80, 265, 1351.61, 91
2, 16:29:00-000, 293, 140, 153, 140, 1352.50, 116, 1351.32, 79
3, 09:00:00-000, 174, 167, 7, 4, 1350.00, 4, 1350.00, 158
3, 09:01:00-000, 199, 199, 0, 0, 0.00, 0, 0.00, 205
3, 09:02:00-000, 189, 189, 0, 0, 0.00, 0, 0.00, 187
3, 09:03:00-000, 175, 175, 0, 0, 0.00, 0, 0.00, 179
3, 09:04:00-000, 229, 229, 0, 0, 0.00, 0, 0.00, 229
3, 09:05:00-000, 221, 221, 0, 0, 0.00, 0, 0.00, 219
3, 09:06:00-000, 202, 202, 0, 2, 1349.50, 0, 0.00, 194
3, 09:07:00-000, 200, 200, 0, 0, 0.00, 0, 0.00, 203
3, 09:08:00-000, 170, 170, 0, 0, 0.00, 0, 0.00, 169
3, 09:09:00-000, 199, 199, 0, 0, 0.00, 0, 0.00, 205
3, 09:10:00-000, 177, 177, 0, 0, 0.00, 0, 0.00, 177
3, 09:11:00-000, 217, 217, 0, 0, 0.00, 0, 0.00, 213
3, 09:12:00-000, 232, 232, 0, 0, 0.00, 0, 0.00, 231
3, 09:13:00-000, 193, 188, 5, 10, 1469.10, 5, 1354.20, 182
3, 09:14:00-000, 195, 190, 5, 1, 1353.00, 0, 0.00, 187
3, 09:15:00-000, 185, 167, 18, 6, 1354.00, 3, 1355.67, 182
3, 09:16:00-000, 184, 168, 16, 16, 1351.93, 11, 1354.36, 156
3, 09:17:00-000, 200, 200, 0, 2, 1359.50, 0, 0.00, 196
3, 09:18:00-000, 172, 148, 24, 7, 1358.57, 1, 1350.00, 167
3, 09:19:00-000, 184, 152, 32, 0, 0.00, 0, 0.00, 182
3, 09:20:00-000, 204, 164, 40, 9, 1350.22, 12, 1354.33, 180
3, 09:21:00-000, 218, 204, 14, 11, 1357.36, 7, 1358.86, 203
3, 09:22:00-000, 208, 186, 22, 8, 1354.87, 8, 1352.87, 196
3, 09:23:00-000, 194, 153, 41, 4, 1349.00, 0, 0.00, 185
3, 09:24:00-000, 188, 172, 16, 3, 1348.33, 2, 1350.00, 175
3, 09:25:00-000, 191, 174, 17, 4, 1350.00, 7, 1355.28, 190
3, 09:26:00-000, 195, 168, 27, 11, 1352.73, 5, 1351.40, 175
3, 09:27:00-000, 193, 187, 6, 1, 1349.00, 1, 1350.00, 195
3, 09:28:00-000, 179, 173, 6, 6, 1350.17, 0, 0.00, 171
3, 09:29:00-000, 219, 206, 13, 1, 1347.00, 2, 1351.00, 214
3, 09:30:00-000, 218, 197, 21, 17, 1350.00, 9, 1351.67, 195
3, 09:31:00-000, 196, 145, 51, 3, 1347.00, 5, 1352.40, 190
3, 09:32:00-000, 212, 163, 49, 4, 1349.75, 4, 1352.50, 198
3, 09:33:00-000, 208, 182, 26, 1, 1351.00, 3, 1351.00, 206
3, 09:34:00-000, 195, 121, 74, 10, 1349.00, 0, 0.00, 178
3, 09:35:00-000, 220, 193, 27, 1, 1356.00, 12, 1353.92, 216
3, 09:36:00-000, 241, 235, 6, 10, 1347.30, 2, 1355.00, 233
3, 09:37:00-000, 191, 164, 27, 3, 1348.67, 4, 1350.75, 179
3, 09:38:00-000, 171, 130, 41, 7, 1349.29, 15, 1352.60, 151
3, 09:39:00-000, 213, 190, 23, 8, 1352.25, 13, 1353.54, 194
3, 09:40:00-000, 197, 170, 27, 9, 1347.78, 1, 1352.00, 186
3, 09:41:00-000, 190, 169, 21, 6, 1351.67, 10, 1352.90, 171
3, 09:42:00-000, 203, 178, 25, 17, 1350.82, 13, 1352.46, 166
3, 09:43:00-000, 201, 152, 49, 9, 1349.56, 4, 1350.00, 200
3, 09:44:00-000, 205, 176, 29, 5, 1347.80, 5, 1351.00, 190
3, 09:45:00-000, 182, 137, 45, 9, 1349.00, 7, 1351.00, 162
3, 09:46:00-000, 211, 103, 108, 22, 1347.95, 9, 1350.00, 187
3, 09:47:00-000, 187, 93, 94, 1, 1347.00, 5, 1351.20, 179
3, 09:48:00-000, 166, 99, 67, 1, 1345.00, 13, 1350.69, 154
3, 09:49:00-000, 200, 117, 83, 3, 1348.33, 3, 1352.00, 189
3, 09:50:00-000, 193, 121, 72, 9, 1346.22, 4, 1350.75, 185
3, 09:51:00-000, 175, 87, 88, 6, 1348.33, 4, 1350.50, 163
3, 09:52:00-000, 227, 148, 79, 4, 1345.75, 19, 1352.42, 204
3, 09:53:00-000, 193, 174, 19, 2, 1347.00, 4, 1351.25, 180
3, 09:54:00-000, 224, 167, 57, 19, 1349.79, 11, 1351.36, 194
3, 09:55:00-000, 196, 132, 64, 1, 1348.00, 7, 1352.00, 195
3, 09:56:00-000, 194, 170, 24, 8, 1348.50, 7, 1354.14, 179
3, 09:57:00-000, 207, 181, 26, 2, 1347.00, 7, 1351.57, 201
3, 09:58:00-000, 189, 146, 43, 16, 1348.06, 7, 1351.14, 160
3, 09:59:00-000, 196, 159, 37, 7, 1352.00, 14, 1351.85, 171
3, 10:00:00-000, 207, 143, 64, 9, 1346.55, 2, 1351.00, 193
3, 10:01:00-000, 181, 124, 57, 4, 1349.00, 8, 1351.25, 175
3, 10:02:00-000, 205, 154, 51, 4, 1348.75, 10, 1350.70, 193
3, 10:03:00-000, 172, 125, 47, 2, 1349.00, 8, 1351.87, 168
3, 10:04:00-000, 184, 142, 42, 4, 1348.25, 6, 1351.50, 172
3, 10:05:00-000, 210, 188, 22, 4, 1349.75, 8, 1351.62, 197
3, 10:06:00-000, 196, 171, 25, 13, 1351.07, 14, 1351.28, 170
3, 10:07:00-000, 229, 218, 11, 2, 1352.00, 9, 1352.67, 208
3, 10:08:00-000, 198, 171, 27, 15, 1351.46, 3, 1351.00, 186
3, 10:09:00-000, 222, 209, 13, 8, 1349.37, 6, 1351.67, 210
3, 10:10:00-000, 174, 173, 1, 4, 1349.75, 1, 1351.00, 170
3, 10:11:00-000, 194, 190, 4, 3, 1347.00, 1, 1350.00, 185
3, 10:12:00-000, 181, 130, 51, 14, 1348.50, 5, 1350.80, 170
3, 10:13:00-000, 207, 122, 85, 2, 1346.50, 7, 1350.00, 198
3, 10:14:00-000, 233, 158, 75, 9, 1346.89, 16, 1350.19, 205
3, 10:15:00-000, 248, 206, 42, 5, 1349.60, 3, 1352.00, 241
3, 10:16:00-000, 184, 149, 35, 15, 1349.73, 4, 1351.00, 160
3, 10:17:00-000, 182, 160, 22, 5, 1351.80, 7, 1351.29, 177
3, 10:18:00-000, 217, 176, 41, 12, 1348.83, 10, 1351.80, 187
3, 10:19:00-000, 215, 175, 40, 2, 1350.00, 4, 1350.00, 213
3, 10:20:00-000, 204, 136, 68, 8, 1348.50, 9, 1352.00, 182
3, 10:21:00-000, 228, 151, 77, 17, 1347.76, 6, 1350.33, 210
3, 10:22:00-000, 202, 147, 55, 0, 0.00, 5, 1350.80, 197
3, 10:23:00-000, 183, 124, 59, 2, 1350.00, 9, 1350.00, 171
3, 10:24:00-000, 221, 203, 18, 7, 1347.86, 11, 1350.73, 201
3, 10:25:00-000, 218, 189, 29, 3, 1346.00, 2, 1352.00, 208
3, 10:26:00-000, 169, 123, 46, 7, 1347.43, 4, 1350.75, 168
3, 10:27:00-000, 182, 156, 26, 15, 1351.60, 7, 1353.43, 162
3, 10:28:00-000, 213, 177, 36, 10, 1348.30, 12, 1351.58, 181
3, 10:29:00-000, 210, 175, 35, 2, 1350.50, 9, 1352.22, 203
3, 10:30:00-000, 231, 203, 28, 18, 1347.83, 5, 1353.20, 206
3, 10:31:00-000, 190, 113, 77, 13, 1349.69, 13, 1351.31, 172
3, 10:32:00-000, 203, 138, 65, 2, 1349.00, 2, 1351.50, 193
3, 10:33:00-000, 208, 149, 59, 7, 1347.14, 6, 1352.67, 195
3, 10:34:00-000, 179, 87, 92, 12, 1346.58, 18, 1351.00, 149
3, 10:35:00-000, 182, 148, 34, 7, 1348.86, 6, 1350.67, 175
3, 10:36:00-000, 203, 166, 37, 8, 1346.38, 12, 1350.50, 177
3, 10:37:00-000, 188, 154, 34, 9, 1349.33, 9, 1350.67, 168
3, 10:38:00-000, 214, 160, 54, 17, 1348.64, 14, 1352.00, 191
3, 10:39:00-000, 191, 137, 54, 0, 0.00, 6, 1351.67, 176
3, 10:40:00-000, 209, 147, 62, 20, 1350.40, 10, 1352.10, 183
3, 10:41:00-000, 180, 121, 59, 7, 1347.14, 4, 1350.00, 167
3, 10:42:00-000, 212, 157, 55, 11, 1347.36, 15, 1350.47, 190
3, 10:43:00-000, 215, 192, 23, 6, 1348.17, 8, 1351.25, 195
3, 10:44:00-000, 195, 179, 16, 12, 1350.67, 11, 1352.09, 172
3, 10:45:00-000, 170, 146, 24, 7, 1351.57, 6, 1350.50, 163
3, 10:46:00-000, 202, 152, 50, 12, 1348.25, 9, 1351.67, 182
3, 10:47:00-000, 181, 135, 46, 2, 1348.50, 10, 1349.30, 169
3, 10:48:00-000, 208, 158, 50, 15, 1349.20, 12, 1351.33, 174
3, 10:49:00-000, 174, 134, 40, 5, 1349.20, 3, 1350.67, 172
3, 10:50:00-000, 182, 142, 40, 10, 1348.10, 15, 1350.93, 146
3, 10:51:00-000, 241, 199, 42, 0, 0.00, 4, 1352.00, 233
3, 10:52:00-000, 228, 130, 98, 26, 1350.50, 12, 1351.50, 199
3, 10:53:00-000, 178, 105, 73, 3, 1348.67, 5, 1351.80, 174
3, 10:54:00-000, 206, 154, 52, 8, 1349.50, 16, 1352.18, 181
3, 10:55:00-000, 196, 161, 35, 3, 1347.00, 7, 1351.86, 188
3, 10:56:00-000, 228, 159, 69, 19, 1350.21, 15, 1353.33, 188
3, 10:57:00-000, 200, 153, 47, 12, 1347.92, 10, 1351.30, 188
3, 10:58:00-000, 218, 180, 38, 10, 1350.00, 26, 1352.65, 181
3, 10:59:00-000, 253, 217, 36, 8, 1352.12, 6, 1352.67, 236
3, 11:00:00-000, 207, 173, 34, 15, 1351.20, 14, 1354.64, 172
3, 11:01:00-000, 226, 162, 64, 9, 1349.55, 8, 1351.00, 205
3, 11:02:00-000, 221, 188, 33, 7, 1347.86, 3, 1353.00, 216
3, 11:03:00-000, 208, 189, 19, 5, 1348.80, 4, 1351.00, 189
3, 11:04:00-000, 208, 173, 35, 11, 1347.82, 9, 1352.00, 205
3, 11:05:00-000, 181, 167, 14, 9, 1347.11, 3, 1351.33, 162
3, 11:06:00-000, 197, 169, 28, 6, 1348.50, 4, 1350.50, 194
3, 11:07:00-000, 198, 166, 32, 4, 1350.25, 6, 1350.50, 188
3, 11:08:00-000, 192, 149, 43, 12, 1350.08, 14, 1351.71, 161
3, 11:09:00-000, 197, 159, 38, 8, 1349.12, 8, 1350.37, 180
3, 11:10:00-000, 198, 158, 40, 3, 1347.00, 9, 1352.44, 193
3, 11:11:00-000, 210, 190, 20, 9, 1348.22, 3, 1352.67, 192
3, 11:12:00-000, 210, 146, 64, 19, 1349.94, 12, 1350.25, 180
3, 11:13:00-000, 199, 138, 61, 10, 1350.50, 26, 1351.42, 157
3, 11:14:00-000, 191, 134, 57, 8, 1348.25, 7, 1353.28, 187
3, 11:15:00-000, 201, 180, 21, 4, 1349.75, 9, 1351.00, 183
3, 11:16:00-000, 219, 189, 30, 16, 1350.44, 9, 1350.55, 196
3, 11:17:00-000, 192, 153, 39, 4, 1347.75, 2, 1351.00, 185
3, 11:18:00-000, 227, 184, 43, 4, 1347.75, 7, 1350.86, 212
3, 11:19:00-000, 208, 148, 60, 2, 1347.00, 1, 1350.00, 199
3, 11:20:00-000, 193, 111, 82, 12, 1348.75, 6, 1351.00, 189
3, 11:21:00-000, 215, 158, 57, 10, 1348.30, 15, 1350.93, 188
3, 11:22:00-000, 208, 160, 48, 24, 1347.71, 13, 1351.38, 161
3, 11:23:00-000, 181, 140, 41, 1, 1350.00, 12, 1351.00, 179
3, 11:24:00-000, 182, 147, 35, 16, 1350.75, 16, 1352.00, 138
3, 11:25:00-000, 227, 179, 48, 6, 1347.00, 7, 1349.71, 223
3, 11:26:00-000, 202, 177, 25, 12, 1347.58, 12, 1351.25, 182
3, 11:27:00-000, 194, 166, 28, 4, 1349.75, 12, 1350.50, 176
3, 11:28:00-000, 197, 180, 17, 10, 1350.50, 4, 1351.50, 184
3, 11:29:00-000, 208, 192, 16, 6, 1351.67, 11, 1352.91, 191
3, 11:30:00-000, 195, 150, 45, 13, 1349.15, 10, 1352.50, 169
3, 11:31:00-000, 195, 177, 18, 1, 1350.00, 4, 1352.00, 183
3, 11:32:00-000, 180, 161, 19, 11, 1351.00, 8, 1352.37, 168
3, 11:33:00-000, 221, 194, 27, 9, 1349.00, 14, 1351.43, 198
3, 11:34:00-000, 197, 160, 37, 14, 1348.71, 2, 1351.50, 183
3, 11:35:00-000, 216, 145, 71, 5, 1346.00, 7, 1354.43, 200
3, 11:36:00-000, 203, 167, 36, 10, 1348.80, 12, 1352.25, 184
3, 11:37:00-000, 196, 142, 54, 5, 1347.40, 0, 0.00, 195
3, 11:38:00-000, 216, 142, 74, 19, 1346.89, 9, 1350.33, 176
3, 11:39:00-000, 216, 142, 74, 14, 1349.50, 10, 1350.50, 200
3, 11:40:00-000, 204, 140, 64, 5, 1347.00, 15, 1350.40, 182
3, 11:41:00-000, 188, 133, 55, 7, 1346.28, 4, 1352.00, 180
3, 11:42:00-000, 204, 131, 73, 7, 1346.86, 8, 1352.37, 186
3, 11:43:00-000, 208, 163, 45, 6, 1353.17, 17, 1352.47, 186
3, 11:44:00-000, 171, 154, 17, 18, 1352.55, 5, 1352.80, 152
3, 11:45:00-000, 189, 124, 65, 5, 1346.00, 12, 1348.67, 163
3, 11:46:00-000, 212, 175, 37, 14, 1346.93, 3, 1350.00, 200
3, 11:47:00-000, 221, 117, 104, 12, 1349.67, 13, 1351.62, 187
3, 11:48:00-000, 214, 108, 106, 25, 1347.56, 24, 1351.83, 171
3, 11:49:00-000, 217, 140, 77, 4, 1348.75, 13, 1350.38, 205
3, 11:50:00-000, 164, 123, 41, 9, 1348.55, 2, 1351.50, 154
3, 11:51:00-000, 221, 152, 69, 3, 1346.67, 9, 1350.89, 195
3, 11:52:00-000, 194, 124, 70, 19, 1349.58, 16, 1352.12, 168
3, 11:53:00-000, 191, 132, 59, 5, 1349.80, 21, 1351.43, 169
3, 11:54:00-000, 181, 125, 56, 14, 1347.93, 7, 1351.00, 155
3, 11:55:00-000, 210, 166, 44, 7, 1349.57, 5, 1351.60, 205
3, 11:56:00-000, 213, 157, 56, 10, 1346.40, 14, 1350.93, 183
3, 11:57:00-000, 206, 164, 42, 9, 1349.33, 8, 1351.37, 196
3, 11:58:00-000, 214, 190, 24, 6, 1347.33, 8, 1350.87, 199
3, 11:59:00-000, 173, 145, 28, 4, 1350.25, 5, 1350.00, 159
3, 12:00:00-000, 201, 169, 32, 9, 1346.11, 5, 1350.80, 186
3, 12:01:00-000, 186, 145, 41, 10, 1349.30, 11, 1352.64, 163
3, 12:02:00-000, 188, 121, 67, 12, 1348.42, 4, 1351.00, 176
3, 12:03:00-000, 195, 133, 62, 1, 1347.00, 3, 1348.33, 190
3, 12:04:00-000, 205, 155, 50, 16, 1348.25, 9, 1351.33, 186
3, 12:05:00-000, 225, 182, 43, 5, 1345.40, 8, 1351.50, 203
3, 12:06:00-000, 183, 147, 36, 31, 1348.03, 19, 1352.00, 137
3, 12:07:00-000, 181, 127, 54, 3, 1348.00, 14, 1351.43, 167
3, 12:08:00-000, 214, 150, 64, 18, 1349.72, 16, 1352.18, 178
3, 12:09:00-000, 197, 139, 58, 12, 1350.92, 6, 1350.50, 179
3, 12:10:00-000, 190, 138, 52, 14, 1350.07, 19, 1352.05, 152
3, 12:11:00-000, 182, 123, 59, 11, 1346.91, 15, 1350.27, 163
3, 12:12:00-000, 192, 139, 53, 7, 1348.29, 16, 1350.87, 161
3, 12:13:00-000, 245, 202, 43, 4, 1347.75, 2, 1350.50, 245
3, 12:14:00-000, 202, 156, 46, 17, 1349.12, 17, 1351.06, 171
3, 12:15:00-000, 208, 153, 55, 6, 1350.67, 13, 1350.92, 183
3, 12:16:00-000, 195, 140, 55, 8, 1346.62, 10, 1350.30, 177
3, 12:17:00-000, 186, 149, 37, 18, 1351.05, 16, 1353.12, 159
3, 12:18:00-000, 167, 114, 53, 14, 1351.07, 16, 1351.19, 132
3, 12:19:00-000, 223, 169, 54, 6, 1353.50, 3, 1354.67, 215
3, 12:20:00-000, 228, 163, 65, 11, 1348.18, 5, 1350.60, 202
3, 12:21:00-000, 188, 163, 25, 0, 0.00, 4, 1350.75, 187
3, 12:22:00-000, 201, 158, 43, 6, 1349.00, 2, 1351.00, 197
3, 12:23:00-000, 211, 160, 51, 7, 1349.00, 3, 1350.00, 205
3, 12:24:00-000, 199, 150, 49, 23, 1351.61, 7, 1352.71, 172
3, 12:25:00-000, 171, 94, 77, 7, 1347.57, 13, 1351.15, 139
3, 12:26:00-000, 202, 106, 96, 8, 1349.87, 14, 1351.86, 189
3, 12:27:00-000, 214, 137, 77, 3, 1351.33, 12, 1351.50, 195
3, 12:28:00-000, 203, 145, 58, 23, 1347.17, 15, 1351.86, 162
3, 12:29:00-000, 202, 138, 64, 9, 1349.11, 13, 1350.85, 183
3, 12:30:00-000, 202, 135, 67, 8, 1347.12, 6, 1350.33, 193
3, 12:31:00-000, 188, 135, 53, 0, 0.00, 7, 1352.00, 179
3, 12:32:00-000, 181, 135, 46, 8, 1349.75, 2, 1350.00, 169
3, 12:33:00-000, 163, 101, 62, 6, 1347.33, 3, 1351.33, 160
3, 12:34:00-000, 229, 140, 89, 12, 1350.17, 14, 1351.71, 201
3, 12:35:00-000, 203, 136, 67, 4, 1352.75, 20, 1352.90, 181
3, 12:36:00-000, 162, 127, 35, 14, 1347.14, 13, 1351.92, 132
3, 12:37:00-000, 225, 191, 34, 5, 1348.40, 3, 1351.00, 213
3, 12:38:00-000, 230, 166, 64, 12, 1349.83, 9, 1351.22, 203
3, 12:39:00-000, 197, 151, 46, 9, 1349.33, 5, 1350.00, 194
3, 12:40:00-000, 206, 166, 40, 7, 1351.43, 10, 1352.50, 187
3, 12:41:00-000, 208, 182, 26, 1, 1355.00, 0, 0.00, 207
3, 12:42:00-000, 210, 168, 42, 18, 1348.39, 6, 1350.67, 186
3, 12:43:00-000, 221, 121, 100, 7, 1347.14, 1, 1350.00, 205
3, 12:44:00-000, 223, 130, 93, 2, 1348.00, 9, 1351.00, 222
3, 12:45:00-000, 192, 143, 49, 5, 1347.40, 14, 1351.21, 168
3, 12:46:00-000, 189, 113, 76, 19, 1347.89, 18, 1352.00, 155
3, 12:47:00-000, 214, 158, 56, 3, 1347.00, 7, 1352.00, 203
3, 12:48:00-000, 197, 179, 18, 7, 1346.29, 5, 1352.20, 188
3, 12:49:00-000, 187, 146, 41, 16, 1346.69, 0, 0.00, 168
3, 12:50:00-000, 192, 136, 56, 9, 1347.44, 12, 1350.42, 173
3, 12:51:00-000, 206, 151, 55, 1, 1349.00, 3, 1351.00, 200
3, 12:52:00-000, 208, 161, 47, 7, 1350.86, 25, 1351.96, 170
3, 12:53:00-000, 216, 181, 35, 18, 1351.16, 21, 1352.47, 184
3, 12:54:00-000, 203, 163, 40, 26, 1349.11, 9, 1350.33, 170
3, 12:55:00-000, 173, 118, 55, 12, 1346.50, 4, 1352.00, 158
3, 12:56:00-000, 187, 140, 47, 4, 1349.25, 7, 1351.29, 175
3, 12:57:00-000, 194, 154, 40, 7, 1351.00, 3, 1350.67, 186
3, 12:58:00-000, 213, 148, 65, 8, 1347.12, 9, 1350.33, 189
3, 12:59:00-000, 204, 129, 75, 4, 1348.50, 13, 1351.92, 193
3, 13:00:00-000, 199, 119, 80, 11, 1347.36, 9, 1350.33, 172
3, 13:01:00-000, 193, 150, 43, 13, 1348.15, 18, 1352.28, 169
3, 13:02:00-000, 215, 154, 61, 18, 1347.22, 9, 1351.44, 184
3, 13:03:00-000, 247, 198, 49, 2, 1352.00, 12, 1351.42, 227
3, 13:04:00-000, 222, 180, 42, 14, 1351.07, 6, 1352.33, 212
3, 13:05:00-000, 189, 135, 54, 8, 1350.87, 15, 1353.53, 164
3, 13:06:00-000, 207, 174, 33, 21, 1348.00, 6, 1351.50, 181
3, 13:07:00-000, 209, 158, 51, 1, 1353.00, 9, 1353.11, 187
3, 13:08:00-000, 194, 141, 53, 16, 1350.44, 13, 1351.46, 178
3, 13:09:00-000, 217, 151, 66, 8, 1346.63, 18, 1351.00, 185
3, 13:10:00-000, 198, 133, 65, 21, 1348.28, 13, 1351.15, 166
3, 13:11:00-000, 190, 113, 77, 4, 1346.75, 8, 1351.12, 174
3, 13:12:00-000, 213, 157, 56, 2, 1349.00, 3, 1351.67, 216
3, 13:13:00-000, 236, 178, 58, 4, 1347.50, 4, 1350.25, 218
3, 13:14:00-000, 226, 189, 37, 11, 1348.18, 9, 1350.22, 216
3, 13:15:00-000, 192, 142, 50, 4, 1352.75, 11, 1354.09, 171
3, 13:16:00-000, 202, 128, 74, 16, 1348.18, 17, 1352.17, 168
3, 13:17:00-000, 228, 184, 44, 12, 1348.67, 10, 1351.50, 208
3, 13:18:00-000, 207, 149, 58, 20, 1348.55, 15, 1353.66, 163
3, 13:19:00-000, 212, 154, 58, 2, 1346.00, 5, 1351.00, 215
3, 13:20:00-000, 210, 148, 62, 12, 1347.25, 4, 1350.00, 196
3, 13:21:00-000, 217, 149, 68, 4, 1349.00, 18, 1350.50, 193
3, 13:22:00-000, 197, 155, 42, 5, 1349.40, 1, 1353.00, 189
3, 13:23:00-000, 188, 152, 36, 7, 1349.86, 11, 1353.09, 173
3, 13:24:00-000, 215, 180, 35, 6, 1349.00, 0, 0.00, 211
3, 13:25:00-000, 167, 139, 28, 8, 1346.62, 3, 1352.33, 156
3, 13:26:00-000, 188, 135, 53, 9, 1348.00, 20, 1352.00, 161
3, 13:27:00-000, 188, 138, 50, 11, 1349.73, 11, 1351.82, 166
3, 13:28:00-000, 204, 184, 20, 5, 1349.20, 8, 1352.12, 190
3, 13:29:00-000, 197, 187, 10, 2, 1351.50, 1, 1352.00, 187
3, 13:30:00-000, 221, 190, 31, 24, 1349.04, 15, 1350.86, 186
3, 13:31:00-000, 228, 180, 48, 10, 1353.00, 10, 1353.60, 204
3, 13:32:00-000, 206, 153, 53, 12, 1346.50, 4, 1351.25, 192
3, 13:33:00-000, 200, 122, 78, 5, 1346.60, 12, 1351.00, 185
3, 13:34:00-000, 239, 162, 77, 21, 1347.62, 9, 1350.33, 205
3, 13:35:00-000, 204, 108, 96, 5, 1346.40, 6, 1350.17, 193
3, 13:36:00-000, 191, 103, 88, 5, 1351.60, 31, 1352.32, 162
3, 13:37:00-000, 203, 145, 58, 15, 1349.33, 30, 1351.66, 159
3, 13:38:00-000, 201, 172, 29, 27, 1351.29, 17, 1351.82, 156
3, 13:39:00-000, 207, 183, 24, 9, 1347.89, 8, 1350.37, 182
3, 13:40:00-000, 211, 170, 41, 10, 1352.00, 8, 1353.12, 194
3, 13:41:00-000, 178, 163, 15, 13, 1349.08, 2, 1350.00, 169
3, 13:42:00-000, 218, 181, 37, 22, 1347.91, 13, 1351.84, 180
3, 13:43:00-000, 218, 129, 89, 1, 1350.00, 12, 1351.50, 207
3, 13:44:00-000, 179, 122, 57, 14, 1347.71, 3, 1350.00, 163
3, 13:45:00-000, 193, 122, 71, 3, 1347.33, 17, 1350.70, 170
3, 13:46:00-000, 195, 143, 52, 10, 1349.50, 10, 1352.70, 172
3, 13:47:00-000, 159, 131, 28, 4, 1351.50, 3, 1351.00, 157
3, 13:48:00-000, 243, 195, 48, 7, 1349.28, 18, 1350.33, 217
3, 13:49:00-000, 214, 161, 53, 15, 1347.80, 7, 1350.86, 189
3, 13:50:00-000, 198, 157, 41, 7, 1348.00, 11, 1350.36, 180
3, 13:51:00-000, 184, 159, 25, 19, 1349.89, 9, 1351.33, 162
3, 13:52:00-000, 173, 132, 41, 8, 1350.50, 1, 1350.00, 161
3, 13:53:00-000, 196, 127, 69, 15, 1348.33, 8, 1350.87, 175
3, 13:54:00-000, 217, 156, 61, 4, 1348.00, 27, 1352.48, 187
3, 13:55:00-000, 217, 186, 31, 6, 1350.33, 2, 1351.00, 207
3, 13:56:00-000, 194, 163, 31, 9, 1347.33, 7, 1350.86, 180
3, 13:57:00-000, 202, 172, 30, 11, 1347.73, 4, 1350.75, 176
3, 13:58:00-000, 209, 184, 25, 19, 1348.63, 9, 1351.55, 187
3, 13:59:00-000, 208, 141, 67, 7, 1347.29, 6, 1351.00, 200
3, 14:00:00-000, 196, 129, 67, 6, 1349.00, 15, 1350.60, 176
3, 14:01:00-000, 173, 137, 36, 5, 1348.40, 15, 1351.33, 152
3, 14:02:00-000, 223, 201, 22, 8, 1351.12, 9, 1351.56, 206
3, 14:03:00-000, 190, 152, 38, 14, 1348.93, 2, 1351.50, 173
3, 14:04:00-000, 173, 113, 60, 17, 1349.00, 15, 1351.60, 142
3, 14:05:00-000, 192, 124, 68, 7, 1348.14, 10, 1350.40, 163
3, 14:06:00-000, 213, 146, 67, 13, 1347.69, 5, 1351.80, 205
3, 14:07:00-000, 231, 169, 62, 5, 1349.00, 27, 1351.00, 194
3, 14:08:00-000, 243, 150, 93, 24, 1348.20, 10, 1350.80, 213
3, 14:09:00-000, 204, 144, 60, 10, 1347.90, 14, 1351.28, 176
3, 14:10:00-000, 191, 142, 49, 16, 1350.00, 17, 1351.41, 162
3, 14:11:00-000, 209, 178, 31, 3, 1350.67, 7, 1351.28, 195
3, 14:12:00-000, 223, 172, 51, 25, 1348.84, 18, 1351.78, 187
3, 14:13:00-000, 221, 170, 51, 13, 1350.38, 10, 1352.10, 188
3, 14:14:00-000, 198, 125, 73, 7, 1350.00, 24, 1351.58, 177
3, 14:15:00-000, 198, 163, 35, 7, 1350.57, 1, 1353.00, 185
3, 14:16:00-000, 178, 152, 26, 8, 1349.75, 10, 1351.60, 163
3, 14:17:00-000, 178, 155, 23, 12, 1349.00, 8, 1353.00, 161
3, 14:18:00-000, 219, 181, 38, 19, 1348.21, 10, 1351.90, 181
3, 14:19:00-000, 203, 156, 47, 2, 1350.00, 5, 1352.40, 200
3, 14:20:00-000, 169, 143, 26, 12, 1350.67, 19, 1352.79, 143
3, 14:21:00-000, 229, 206, 23, 9, 1348.78, 4, 1351.00, 209
3, 14:22:00-000, 215, 159, 56, 7, 1347.43, 15, 1349.87, 197
3, 14:23:00-000, 203, 181, 22, 1, 1348.00, 4, 1350.50, 199
3, 14:24:00-000, 239, 203, 36, 21, 1351.09, 16, 1353.25, 202
3, 14:25:00-000, 249, 185, 64, 6, 1349.50, 6, 1350.50, 236
3, 14:26:00-000, 176, 148, 28, 9, 1349.67, 7, 1352.57, 160
3, 14:27:00-000, 222, 199, 23, 4, 1348.00, 11, 1352.09, 209
3, 14:28:00-000, 239, 204, 35, 13, 1346.46, 8, 1354.00, 204
3, 14:29:00-000, 203, 171, 32, 2, 1351.00, 5, 1351.00, 200
3, 14:30:00-000, 201, 188, 13, 10, 1349.20, 4, 1353.25, 196
3, 14:31:00-000, 192, 155, 37, 4, 1349.50, 8, 1350.87, 181
3, 14:32:00-000, 227, 200, 27, 12, 1349.91, 16, 1353.94, 200
3, 14:33:00-000, 221, 202, 19, 10, 1347.50, 3, 1351.67, 202
3, 14:34:00-000, 158, 111, 47, 18, 1347.89, 12, 1351.08, 129
3, 14:35:00-000, 218, 152, 66, 4, 1348.50, 9, 1350.67, 197
3, 14:36:00-000, 185, 146, 39, 17, 1349.70, 23, 1353.52, 154
3, 14:37:00-000, 179, 154, 25, 8, 1349.37, 9, 1352.78, 162
3, 14:38:00-000, 216, 182, 34, 15, 1347.33, 12, 1350.33, 188
3, 14:39:00-000, 222, 182, 40, 2, 1352.50, 6, 1350.17, 211
3, 14:40:00-000, 195, 155, 40, 17, 1348.41, 10, 1352.00, 175
3, 14:41:00-000, 182, 145, 37, 9, 1347.44, 9, 1351.55, 165
3, 14:42:00-000, 214, 171, 43, 10, 1349.10, 10, 1350.60, 185
3, 14:43:00-000, 163, 122, 41, 9, 1349.67, 7, 1351.29, 152
3, 14:44:00-000, 233, 186, 47, 12, 1346.75, 11, 1352.18, 205
3, 14:45:00-000, 173, 140, 33, 6, 1347.17, 10, 1352.00, 156
3, 14:46:00-000, 192, 156, 36, 3, 1348.67, 5, 1351.80, 192
3, 14:47:00-000, 212, 177, 35, 10, 1351.50, 11, 1353.00, 182
3, 14:48:00-000, 226, 165, 61, 7, 1348.14, 20, 1352.10, 202
3, 14:49:00-000, 182, 155, 27, 12, 1348.00, 5, 1351.20, 172
3, 14:50:00-000, 207, 168, 39, 9, 1349.33, 6, 1351.83, 190
3, 14:51:00-000, 208, 183, 25, 12, 1348.75, 9, 1351.78, 175
3, 14:52:00-000, 190, 163, 27, 8, 1348.75, 8, 1351.00, 187
3, 14:53:00-000, 191, 140, 51, 13, 1348.38, 2, 1351.50, 175
3, 14:54:00-000, 207, 135, 72, 9, 1350.00, 22, 1351.27, 176
3, 14:55:00-000, 204, 165, 39, 10, 1347.30, 13, 1351.31, 183
3, 14:56:00-000, 170, 100, 70, 19, 1348.79, 4, 1348.75, 145
3, 14:57:00-000, 152, 107, 45, 3, 1349.67, 15, 1351.26, 135
3, 14:58:00-000, 206, 167, 39, 10, 1346.40, 4, 1352.50, 190
3, 14:59:00-000, 185, 156, 29, 3, 1352.00, 6, 1352.17, 178
3, 15:00:00-000, 184, 138, 46, 22, 1349.36, 13, 1351.00, 146
3, 15:01:00-000, 210, 174, 36, 9, 1351.33, 6, 1351.00, 192
3, 15:02:00-000, 202, 136, 66, 16, 1348.19, 16, 1351.06, 164
3, 15:03:00-000, 198, 117, 81, 14, 1348.64, 18, 1350.89, 179
3, 15:04:00-000, 220, 170, 50, 11, 1350.00, 18, 1351.39, 190
3, 15:05:00-000, 171, 121, 50, 16, 1348.56, 10, 1350.70, 147
3, 15:06:00-000, 176, 137, 39, 8, 1349.87, 20, 1351.80, 140
3, 15:07:00-000, 201, 180, 21, 4, 1349.50, 3, 1350.00, 201
3, 15:08:00-000, 226, 146, 80, 28, 1348.14, 7, 1351.00, 177
3, 15:09:00-000, 179, 114, 65, 1, 1347.00, 6, 1352.83, 173
3, 15:10:00-000, 219, 181, 38, 10, 1348.70, 19, 1351.37, 195
3, 15:11:00-000, 171, 132, 39, 15, 1350.33, 3, 1351.67, 155
3, 15:12:00-000, 180, 108, 72, 19, 1350.26, 22, 1351.36, 140
3, 15:13:00-000, 218, 146, 72, 0, 0.00, 16, 1350.75, 202
3, 15:14:00-000, 188, 170, 18, 14, 1348.07, 7, 1351.57, 162
3, 15:15:00-000, 190, 143, 47, 1, 1349.00, 9, 1350.89, 172
3, 15:16:00-000, 229, 191, 38, 16, 1346.87, 5, 1350.80, 224
3, 15:17:00-000, 187, 150, 37, 9, 1348.00, 7, 1350.43, 167
3, 15:18:00-000, 222, 154, 68, 17, 1347.00, 12, 1348.92, 197
3, 15:19:00-000, 185, 121, 64, 3, 1351.33, 11, 1351.27, 170
3, 15:20:00-000, 211, 140, 71, 26, 1346.19, 16, 1352.12, 159
3, 15:21:00-000, 196, 128, 68, 11, 1347.45, 13, 1351.46, 177
3, 15:22:00-000, 189, 132, 57, 16, 1347.81, 14, 1350.93, 164
3, 15:23:00-000, 234, 141, 93, 12, 1347.92, 15, 1349.26, 201
3, 15:24:00-000, 210, 152, 58, 4, 1349.00, 23, 1350.65, 184
3, 15:25:00-000, 203, 178, 25, 9, 1348.11, 1, 1353.00, 190
3, 15:26:00-000, 202, 153, 49, 14, 1347.85, 7, 1350.43, 187
3, 15:27:00-000, 212, 159, 53, 7, 1349.57, 8, 1351.62, 196
3, 15:28:00-000, 208, 161, 47, 17, 1348.58, 21, 1351.52, 177
3, 15:29:00-000, 184, 147, 37, 11, 1348.91, 3, 1350.67, 161
3, 15:30:00-000, 189, 138, 51, 18, 1348.16, 15, 1352.13, 162
3, 15:31:00-000, 195, 148, 47, 4, 1349.25, 10, 1351.40, 181
3, 15:32:00-000, 180, 104, 76, 14, 1347.64, 5, 1350.40, 163
3, 15:33:00-000, 243, 109, 134, 8, 1348.50, 13, 1351.15, 221
3, 15:34:00-000, 175, 107, 68, 20, 1348.10, 14, 1351.71, 139
3, 15:35:00-000, 196, 159, 37, 8, 1350.75, 9, 1351.00, 178
3, 15:36:00-000, 224, 162, 62, 16, 1349.50, 19, 1352.68, 185
3, 15:37:00-000, 213, 145, 68, 6, 1348.00, 8, 1351.50, 196
3, 15:38:00-000, 227, 132, 95, 13, 1347.77, 8, 1351.12, 216
3, 15:39:00-000, 211, 108, 103, 3, 1345.33, 5, 1349.60, 198
3, 15:40:00-000, 199, 129, 70, 10, 1350.60, 12, 1351.42, 184
3, 15:41:00-000, 204, 140, 64, 11, 1347.91, 4, 1351.25, 184
3, 15:42:00-000, 204, 154, 50, 10, 1349.60, 22, 1351.36, 173
3, 15:43:00-000, 210, 178, 32, 4, 1348.25, 2, 1352.00, 207
3, 15:44:00-000, 236, 185, 51, 2, 1349.50, 4, 1350.25, 214
3, 15:45:00-000, 193, 135, 58, 9, 1347.55, 12, 1350.92, 184
3, 15:46:00-000, 211, 148, 63, 18, 1347.50, 8, 1351.87, 186
3, 15:47:00-000, 201, 134, 67, 7, 1349.00, 15, 1350.60, 183
3, 15:48:00-000, 198, 128, 70, 16, 1350.81, 30, 1352.09, 152
3, 15:49:00-000, 210, 189, 21, 11, 1349.18, 3, 1350.67, 183
3, 15:50:00-000, 224, 175, 49, 5, 1348.60, 13, 1351.15, 214
3, 15:51:00-000, 216, 146, 70, 12, 1346.92, 2, 1351.00, 202
3, 15:52:00-000, 186, 121, 65, 12, 1347.83, 19, 1351.16, 154
3, 15:53:00-000, 208, 178, 30, 13, 1348.46, 13, 1351.15, 171
3, 15:54:00-000, 207, 142, 65, 23, 1349.95, 15, 1352.66, 182
3, 15:55:00-000, 203, 140, 63, 1, 1348.00, 10, 1350.10, 193
3, 15:56:00-000, 197, 130, 67, 13, 1347.46, 5, 1350.60, 179
3, 15:57:00-000, 207, 123, 84, 12, 1348.08, 4, 1351.25, 190
3, 15:58:00-000, 206, 133, 73, 12, 1350.00, 16, 1350.43, 176
3, 15:59:00-000, 217, 153, 64, 8, 1348.00, 1, 1352.00, 207
3, 16:00:00-000, 192, 131, 61, 9, 1349.00, 11, 1352.09, 178
3, 16:01:00-000, 209, 152, 57, 7, 1348.86, 7, 1351.71, 186
3, 16:02:00-000, 205, 132, 73, 26, 1348.57, 13, 1350.61, 172
3, 16:03:00-000, 220, 145, 75, 2, 1347.50, 9, 1351.33, 212
3, 16:04:00-000, 185, 118, 67, 7, 1350.28, 10, 1351.60, 169
3, 16:05:00-000, 219, 161, 58, 9, 1350.44, 24, 1351.70, 182
3, 16:06:00-000, 188, 150, 38, 13, 1348.38, 9, 1351.44, 162
3, 16:07:00-000, 195, 140, 55, 10, 1348.10, 6, 1350.00, 180
3, 16:08:00-000, 210, 143, 67, 17, 1348.35, 8, 1350.88, 190
3, 16:09:00-000, 204, 130, 74, 6, 1348.50, 1, 1351.00, 198
3, 16:10:00-000, 216, 128, 88, 14, 1348.50, 29, 1351.37, 174
3, 16:11:00-000, 188, 155, 33, 8, 1350.12, 9, 1350.56, 164
3, 16:12:00-000, 193, 135, 58, 7, 1349.00, 9, 1351.89, 183
3, 16:13:00-000, 200, 117, 83, 15, 1347.33, 11, 1350.09, 172
3, 16:14:00-000, 206, 149, 57, 29, 1349.55, 22, 1352.32, 157
3, 16:15:00-000, 223, 149, 74, 9, 1347.22, 7, 1350.14, 202
3, 16:16:00-000, 177, 85, 92, 12, 1348.67, 4, 1351.00, 165
3, 16:17:00-000, 184, 92, 92, 5, 1346.00, 10, 1349.80, 159
3, 16:18:00-000, 209, 107, 102, 7, 1346.28, 12, 1350.92, 200
3, 16:19:00-000, 178, 110, 68, 6, 1349.33, 7, 1351.14, 153
3, 16:20:00-000, 228, 133, 95, 14, 1346.85, 23, 1351.13, 197
3, 16:21:00-000, 195, 145, 50, 7, 1346.71, 12, 1351.17, 179
3, 16:22:00-000, 165, 141, 24, 14, 1349.64, 5, 1351.00, 150
3, 16:23:00-000, 219, 150, 69, 15, 1348.93, 12, 1350.50, 186
3, 16:24:00-000, 192, 130, 62, 4, 1348.50, 17, 1350.88, 171
3, 16:25:00-000, 220, 165, 55, 8, 1348.62, 4, 1351.25, 211
3, 16:26:00-000, 208, 126, 82, 19, 1348.15, 6, 1350.00, 186
3, 16:27:00-000, 220, 145, 75, 5, 1347.80, 22, 1350.72, 187
3, 16:28:00-000, 224, 174, 50, 24, 1348.71, 17, 1351.00, 188
3, 16:29:00-000, 196, 125, 71, 5, 1348.20, 11, 1350.91, 177
4, 09:03:00-000, 281, 281, 0, 0, 0.00, 0, 0.00, 280
4, 09:04:00-000, 0, 0, 0, 0, 0.00, 0, 0.00, 1
4, 09:06:00-000, 292, 292, 0, 291, 1351.00, 0, 0.00, 0
4, 09:07:00-000, 1, 1, 0, 0, 0.00, 0, 0.00, 1
4, 09:08:00-000, 20, 18, 2, 2, 1353.50, 2, 1353.50, 9
4, 09:09:00-000, 51, 42, 9, 8, 1355.37, 8, 1355.37, 32
4, 09:10:00-000, 132, 92, 40, 41, 1384.21, 41, 1384.21, 50
4, 09:11:00-000, 69, 52, 17, 17, 1423.53, 17, 1423.53, 27
4, 09:12:00-000, 63, 58, 5, 5, 1460.00, 5, 1460.00, 50
4, 09:13:00-000, 85, 74, 11, 65, 1403.19, 11, 1406.54, 27
4, 09:14:00-000, 79, 67, 12, 56, 1356.53, 11, 1354.82, 7
4, 09:15:00-000, 61, 52, 9, 45, 1356.50, 7, 1354.28, 9
4, 09:16:00-000, 89, 61, 28, 50, 1353.33, 27, 1352.70, 8
4, 09:17:00-000, 95, 69, 26, 36, 1357.02, 26, 1357.07, 29
4, 09:18:00-000, 87, 31, 56, 48, 1354.60, 41, 1351.11, 7
4, 09:19:00-000, 81, 32, 49, 31, 1350.22, 38, 1350.02, 5
4, 09:20:00-000, 93, 47, 46, 47, 1353.82, 50, 1352.87, 7
4, 09:21:00-000, 78, 55, 23, 48, 1358.32, 27, 1357.96, 0
4, 09:22:00-000, 87, 53, 34, 52, 1353.18, 34, 1352.05, 7
4, 09:23:00-000, 74, 25, 49, 26, 1350.15, 36, 1349.96, 6
4, 09:24:00-000, 114, 28, 86, 27, 1351.03, 56, 1350.72, 17
4, 09:25:00-000, 51, 29, 22, 21, 1354.14, 23, 1353.00, 22
4, 09:26:00-000, 78, 38, 40, 37, 1353.10, 30, 1353.26, 11
4, 09:27:00-000, 94, 28, 66, 27, 1350.25, 49, 1350.91, 12
4, 09:28:00-000, 48, 27, 21, 26, 1351.38, 24, 1350.08, 8
4, 09:29:00-000, 75, 30, 45, 30, 1351.06, 37, 1351.18, 4
4, 09:30:00-000, 92, 52, 40, 49, 1350.83, 42, 1351.16, 0
4, 09:31:00-000, 97, 52, 45, 39, 1352.48, 42, 1352.61, 12
4, 09:32:00-000, 72, 36, 36, 40, 1350.92, 37, 1351.64, 1
4, 09:33:00-000, 94, 39, 55, 38, 1350.73, 47, 1350.09, 4
4, 09:34:00-000, 61, 26, 35, 28, 1346.32, 35, 1347.73, 4
4, 09:35:00-000, 100, 66, 34, 61, 1354.61, 36, 1355.33, 5
4, 09:36:00-000, 90, 52, 38, 45, 1353.50, 29, 1352.38, 6
4, 09:37:00-000, 85, 38, 47, 36, 1351.13, 40, 1351.27, 14
4, 09:38:00-000, 116, 66, 50, 57, 1352.96, 49, 1352.46, 6
4, 09:39:00-000, 62, 25, 37, 28, 1354.57, 27, 1354.85, 10
4, 09:40:00-000, 70, 31, 39, 32, 1350.43, 38, 1350.81, 3
4, 09:41:00-000, 79, 42, 37, 40, 1353.72, 35, 1351.94, 2
4, 09:42:00-000, 70, 32, 38, 30, 1352.39, 26, 1352.88, 11
4, 09:43:00-000, 71, 42, 29, 42, 1350.42, 34, 1350.38, 2
4, 09:44:00-000, 81, 38, 43, 37, 1351.21, 38, 1351.49, 1
4, 09:45:00-000, 66, 29, 37, 26, 1351.07, 33, 1348.96, 9
4, 09:46:00-000, 89, 48, 41, 51, 1350.62, 30, 1350.40, 9
4, 09:47:00-000, 99, 35, 64, 28, 1348.31, 44, 1347.99, 18
4, 09:48:00-000, 77, 24, 53, 26, 1349.42, 48, 1348.72, 15
4, 09:49:00-000, 94, 38, 56, 35, 1349.40, 34, 1350.73, 8
4, 09:50:00-000, 81, 27, 54, 30, 1349.40, 62, 1349.18, 1
4, 09:51:00-000, 99, 41, 58, 41, 1349.70, 49, 1349.50, 5
4, 09:52:00-000, 77, 44, 33, 41, 1352.97, 32, 1350.62, 2
4, 09:53:00-000, 77, 36, 41, 36, 1351.49, 35, 1351.45, 6
4, 09:54:00-000, 95, 42, 53, 39, 1349.81, 60, 1349.94, 2
4, 09:55:00-000, 89, 45, 44, 43, 1351.52, 45, 1351.26, 3
4, 09:56:00-000, 77, 48, 29, 38, 1353.41, 21, 1352.00, 18
4, 09:57:00-000, 83, 49, 34, 44, 1351.47, 34, 1350.61, 6
4, 09:58:00-000, 64, 30, 34, 30, 1349.89, 27, 1349.96, 7
4, 09:59:00-000, 95, 49, 46, 47, 1351.84, 34, 1351.97, 4
4, 10:00:00-000, 92, 38, 54, 35, 1349.74, 65, 1350.48, 1
4, 10:01:00-000, 86, 46, 40, 44, 1350.49, 33, 1350.75, 3
4, 10:02:00-000, 84, 44, 40, 44, 1350.83, 42, 1351.75, 3
4, 10:03:00-000, 74, 35, 39, 37, 1352.64, 28, 1352.07, 9
4, 10:04:00-000, 65, 30, 35, 28, 1348.99, 36, 1349.85, 0
4, 10:05:00-000, 104, 64, 40, 56, 1352.47, 44, 1351.97, 6
4, 10:06:00-000, 77, 41, 36, 43, 1352.23, 27, 1352.48, 7
4, 10:07:00-000, 86, 55, 31, 46, 1352.60, 28, 1352.85, 12
4, 10:08:00-000, 82, 43, 39, 40, 1351.24, 34, 1351.55, 0
4, 10:09:00-000, 84, 41, 43, 43, 1351.55, 41, 1351.38, 9
4, 10:10:00-000, 73, 25, 48, 25, 1350.99, 45, 1351.79, 0
4, 10:11:00-000, 71, 32, 39, 25, 1349.64, 32, 1349.49, 11
4, 10:12:00-000, 106, 57, 49, 55, 1349.93, 46, 1350.56, 7
4, 10:13:00-000, 53, 25, 28, 25, 1350.72, 29, 1350.82, 2
4, 10:14:00-000, 83, 42, 41, 38, 1349.07, 36, 1349.80, 2
4, 10:15:00-000, 85, 51, 34, 46, 1350.90, 40, 1350.92, 6
4, 10:16:00-000, 90, 41, 49, 37, 1349.64, 34, 1349.55, 12
4, 10:17:00-000, 80, 43, 37, 42, 1351.66, 39, 1351.97, 5
4, 10:18:00-000, 97, 38, 59, 36, 1350.72, 54, 1350.30, 5
4, 10:19:00-000, 82, 31, 51, 34, 1350.85, 37, 1350.72, 10
4, 10:20:00-000, 62, 31, 31, 30, 1351.66, 39, 1350.56, 1
4, 10:21:00-000, 100, 38, 62, 39, 1350.71, 48, 1350.53, 4
4, 10:22:00-000, 57, 21, 36, 19, 1350.05, 38, 1350.34, 2
4, 10:23:00-000, 81, 33, 48, 35, 1350.34, 37, 1350.07, 11
4, 10:24:00-000, 79, 35, 44, 34, 1349.58, 40, 1348.92, 3
4, 10:25:00-000, 95, 45, 50, 41, 1349.55, 45, 1349.68, 4
4, 10:26:00-000, 78, 31, 47, 35, 1349.25, 49, 1349.40, 7
4, 10:27:00-000, 64, 32, 32, 32, 1353.02, 21, 1352.19, 1
4, 10:28:00-000, 98, 57, 41, 57, 1351.24, 43, 1350.69, 0
4, 10:29:00-000, 98, 64, 34, 53, 1351.95, 35, 1351.45, 6
4, 10:30:00-000, 81, 43, 38, 36, 1353.63, 37, 1353.88, 13
4, 10:31:00-000, 78, 39, 39, 34, 1351.26, 28, 1352.21, 16
4, 10:32:00-000, 71, 35, 36, 34, 1351.14, 34, 1351.34, 2
4, 10:33:00-000, 96, 52, 44, 51, 1351.40, 38, 1350.78, 8
4, 10:34:00-000, 68, 30, 38, 30, 1348.90, 42, 1349.97, 3
4, 10:35:00-000, 91, 38, 53, 38, 1349.26, 46, 1349.62, 0
4, 10:36:00-000, 72, 42, 30, 31, 1351.03, 31, 1350.74, 7
4, 10:37:00-000, 58, 31, 27, 36, 1350.88, 25, 1350.99, 4
4, 10:38:00-000, 96, 60, 36, 54, 1352.77, 35, 1352.39, 6
4, 10:39:00-000, 70, 43, 27, 43, 1351.53, 26, 1351.57, 1
4, 10:40:00-000, 102, 37, 65, 37, 1352.83, 64, 1351.25, 2
4, 10:41:00-000, 87, 22, 65, 23, 1348.43, 53, 1349.71, 7
4, 10:42:00-000, 74, 39, 35, 39, 1351.97, 31, 1351.25, 1
4, 10:43:00-000, 74, 31, 43, 31, 1351.38, 41, 1351.77, 9
4, 10:44:00-000, 105, 55, 50, 46, 1353.32, 41, 1353.87, 1
4, 10:45:00-000, 73, 30, 43, 31, 1350.45, 34, 1350.90, 17
4, 10:46:00-000, 72, 33, 39, 31, 1351.90, 33, 1352.45, 8
4, 10:47:00-000, 100, 47, 53, 39, 1349.43, 43, 1349.18, 18
4, 10:48:00-000, 82, 46, 36, 40, 1351.57, 45, 1351.35, 5
4, 10:49:00-000, 70, 32, 38, 30, 1350.93, 23, 1350.91, 9
4, 10:50:00-000, 87, 38, 49, 35, 1350.68, 40, 1350.72, 1
4, 10:51:00-000, 81, 39, 42, 39, 1350.09, 36, 1349.91, 13
4, 10:52:00-000, 85, 46, 39, 45, 1350.57, 37, 1351.70, 1
4, 10:53:00-000, 79, 47, 32, 46, 1350.88, 41, 1350.68, 3
4, 10:54:00-000, 100, 55, 45, 56, 1351.94, 43, 1351.81, 2
4, 10:55:00-000, 78, 35, 43, 34, 1350.55, 35, 1350.05, 4
4, 10:56:00-000, 70, 25, 45, 26, 1352.27, 50, 1350.57, 2
4, 10:57:00-000, 91, 46, 45, 43, 1351.20, 36, 1351.66, 6
4, 10:58:00-000, 93, 64, 29, 51, 1352.74, 34, 1352.32, 7
4, 10:59:00-000, 81, 40, 41, 33, 1352.96, 39, 1353.76, 7
4, 11:00:00-000, 80, 49, 31, 57, 1353.32, 27, 1353.33, 1
4, 11:01:00-000, 86, 47, 39, 45, 1351.84, 36, 1351.85, 9
4, 11:02:00-000, 84, 43, 41, 43, 1349.80, 43, 1349.74, 0
4, 11:03:00-000, 97, 21, 76, 21, 1350.62, 59, 1350.01, 6
4, 11:04:00-000, 85, 37, 48, 37, 1351.62, 53, 1350.31, 3
4, 11:05:00-000, 85, 44, 41, 43, 1351.41, 38, 1352.02, 4
4, 11:06:00-000, 89, 42, 47, 35, 1350.28, 46, 1350.49, 0
4, 11:07:00-000, 75, 45, 30, 36, 1350.74, 30, 1350.66, 13
4, 11:08:00-000, 82, 53, 29, 56, 1351.22, 30, 1350.60, 0
4, 11:09:00-000, 96, 37, 59, 31, 1350.44, 50, 1350.71, 9
4, 11:10:00-000, 54, 31, 23, 31, 1352.15, 25, 1351.92, 2
4, 11:11:00-000, 97, 51, 46, 50, 1351.25, 46, 1351.43, 1
4, 11:12:00-000, 87, 45, 42, 45, 1350.13, 43, 1350.57, 3
4, 11:13:00-000, 67, 39, 28, 38, 1351.94, 20, 1351.60, 3
4, 11:14:00-000, 63, 34, 29, 35, 1352.11, 30, 1350.96, 2
4, 11:15:00-000, 91, 48, 43, 44, 1350.69, 42, 1351.11, 3
4, 11:16:00-000, 72, 33, 39, 36, 1350.55, 33, 1350.60, 5
4, 11:17:00-000, 67, 21, 46, 21, 1347.71, 33, 1348.05, 8
4, 11:18:00-000, 75, 29, 46, 29, 1351.27, 52, 1350.30, 2
4, 11:19:00-000, 71, 25, 46, 24, 1349.75, 32, 1349.27, 1
4, 11:20:00-000, 70, 25, 45, 25, 1349.76, 47, 1349.86, 10
4, 11:21:00-000, 85, 47, 38, 45, 1351.32, 38, 1351.70, 2
4, 11:22:00-000, 76, 35, 41, 33, 1349.66, 42, 1349.47, 1
4, 11:23:00-000, 89, 52, 37, 42, 1352.04, 36, 1352.46, 4
4, 11:24:00-000, 96, 60, 36, 67, 1352.14, 34, 1351.85, 2
4, 11:25:00-000, 87, 44, 43, 32, 1350.90, 26, 1350.65, 15
4, 11:26:00-000, 61, 31, 30, 30, 1350.86, 40, 1351.62, 1
4, 11:27:00-000, 97, 56, 41, 44, 1352.74, 28, 1352.49, 11
4, 11:28:00-000, 87, 54, 33, 56, 1351.19, 35, 1351.76, 9
4, 11:29:00-000, 77, 34, 43, 28, 1352.85, 40, 1352.72, 5
4, 11:30:00-000, 82, 38, 44, 45, 1350.54, 41, 1351.31, 0
4, 11:31:00-000, 54, 25, 29, 18, 1350.72, 20, 1350.75, 8
4, 11:32:00-000, 95, 50, 45, 46, 1351.38, 39, 1351.25, 11
4, 11:33:00-000, 93, 45, 48, 44, 1350.58, 50, 1350.41, 8
4, 11:34:00-000, 70, 31, 39, 36, 1350.52, 28, 1350.14, 3
4, 11:35:00-000, 69, 31, 38, 26, 1350.61, 26, 1351.11, 12
4, 11:36:00-000, 108, 57, 51, 58, 1351.70, 50, 1351.89, 2
4, 11:37:00-000, 70, 24, 46, 24, 1350.29, 34, 1349.88, 19
4, 11:38:00-000, 68, 29, 39, 26, 1350.23, 40, 1349.54, 0
4, 11:39:00-000, 86, 36, 50, 37, 1351.10, 49, 1350.50, 5
4, 11:40:00-000, 92, 45, 47, 37, 1348.80, 36, 1349.24, 6
4, 11:41:00-000, 62, 26, 36, 24, 1349.99, 26, 1348.53, 11
4, 11:42:00-000, 91, 53, 38, 50, 1349.09, 41, 1350.21, 10
4, 11:43:00-000, 88, 43, 45, 46, 1353.58, 26, 1353.76, 13
4, 11:44:00-000, 93, 46, 47, 41, 1352.65, 48, 1353.26, 4
4, 11:45:00-000, 88, 26, 62, 30, 1348.36, 53, 1349.06, 5
4, 11:46:00-000, 90, 46, 44, 37, 1349.86, 50, 1349.55, 3
4, 11:47:00-000, 92, 35, 57, 27, 1349.81, 42, 1349.75, 16
4, 11:48:00-000, 85, 39, 46, 48, 1348.66, 33, 1349.30, 6
4, 11:49:00-000, 77, 41, 36, 41, 1349.48, 39, 1350.12, 4
4, 11:50:00-000, 98, 52, 46, 52, 1349.53, 46, 1350.38, 2
4, 11:51:00-000, 73, 34, 39, 34, 1350.32, 33, 1350.30, 5
4, 11:52:00-000, 94, 46, 48, 45, 1353.26, 43, 1352.50, 2
4, 11:53:00-000, 87, 39, 48, 39, 1351.04, 35, 1351.42, 15
4, 11:54:00-000, 91, 43, 48, 43, 1349.06, 42, 1349.97, 7
4, 11:55:00-000, 90, 46, 44, 45, 1351.61, 29, 1350.96, 1
4, 11:56:00-000, 56, 18, 38, 17, 1349.64, 52, 1350.17, 7
4, 11:57:00-000, 84, 41, 43, 40, 1352.27, 29, 1351.37, 0
4, 11:58:00-000, 90, 52, 38, 46, 1351.47, 53, 1352.09, 6
4, 11:59:00-000, 93, 50, 43, 50, 1352.29, 31, 1352.38, 1
4, 12:00:00-000, 65, 30, 35, 30, 1350.46, 37, 1351.02, 9
4, 12:01:00-000, 70, 31, 39, 31, 1352.93, 27, 1353.37, 10
4, 12:02:00-000, 97, 39, 58, 39, 1350.56, 50, 1350.49, 3
4, 12:03:00-000, 73, 23, 50, 23, 1345.65, 42, 1346.35, 6
4, 12:04:00-000, 72, 45, 27, 41, 1350.60, 36, 1349.72, 5
4, 12:05:00-000, 74, 34, 40, 31, 1349.80, 35, 1350.82, 3
4, 12:06:00-000, 93, 36, 57, 35, 1351.99, 39, 1352.20, 10
4, 12:07:00-000, 62, 33, 29, 30, 1351.09, 21, 1350.81, 14
4, 12:08:00-000, 89, 60, 29, 63, 1351.49, 30, 1351.59, 1
4, 12:09:00-000, 99, 39, 60, 39, 1350.51, 56, 1350.22, 6
4, 12:10:00-000, 60, 42, 18, 35, 1352.11, 20, 1351.60, 1
4, 12:11:00-000, 82, 39, 43, 42, 1349.90, 35, 1351.05, 5
4, 12:12:00-000, 106, 46, 60, 45, 1350.06, 54, 1349.62, 14
4, 12:13:00-000, 73, 29, 44, 26, 1349.76, 41, 1350.63, 0
4, 12:14:00-000, 92, 44, 48, 48, 1351.03, 45, 1351.74, 0
4, 12:15:00-000, 87, 54, 33, 51, 1350.97, 36, 1351.55, 3
4, 12:16:00-000, 67, 33, 34, 32, 1349.12, 31, 1349.09, 2
4, 12:17:00-000, 75, 35, 40, 36, 1353.32, 39, 1353.07, 4
4, 12:18:00-000, 67, 40, 27, 37, 1351.91, 20, 1353.20, 6
4, 12:19:00-000, 82, 35, 47, 30, 1353.56, 42, 1353.14, 8
4, 12:20:00-000, 66, 32, 34, 28, 1350.14, 24, 1349.25, 11
4, 12:21:00-000, 81, 31, 50, 35, 1350.71, 45, 1350.93, 4
4, 12:22:00-000, 77, 31, 46, 30, 1349.76, 42, 1349.71, 8
4, 12:23:00-000, 96, 38, 58, 36, 1349.91, 49, 1349.89, 9
4, 12:24:00-000, 96, 48, 48, 46, 1352.38, 40, 1351.84, 10
4, 12:25:00-000, 72, 32, 40, 34, 1350.46, 36, 1351.22, 3
4, 12:26:00-000, 78, 41, 37, 41, 1351.33, 31, 1350.83, 1
4, 12:27:00-000, 76, 40, 36, 40, 1350.44, 29, 1350.27, 13
4, 12:28:00-000, 79, 47, 32, 42, 1352.02, 33, 1352.24, 2
4, 12:29:00-000, 86, 25, 61, 29, 1350.65, 35, 1350.51, 8
4, 12:30:00-000, 76, 34, 42, 34, 1348.52, 58, 1349.16, 2
4, 12:31:00-000, 96, 49, 47, 40, 1350.79, 48, 1350.49, 2
4, 12:32:00-000, 65, 34, 31, 36, 1350.85, 30, 1350.46, 0
4, 12:33:00-000, 72, 35, 37, 29, 1350.51, 24, 1350.49, 11
4, 12:34:00-000, 87, 45, 42, 44, 1352.33, 44, 1352.38, 12
4, 12:35:00-000, 94, 64, 30, 47, 1353.93, 21, 1353.57, 6
4, 12:36:00-000, 72, 33, 39, 44, 1350.06, 41, 1351.82, 4
4, 12:37:00-000, 67, 29, 38, 25, 1350.75, 20, 1350.85, 15
4, 12:38:00-000, 100, 46, 54, 45, 1351.66, 48, 1352.30, 8
4, 12:39:00-000, 86, 33, 53, 32, 1349.65, 52, 1349.80, 12
4, 12:40:00-000, 74, 41, 33, 31, 1352.06, 30, 1352.33, 2
4, 12:41:00-000, 96, 38, 58, 39, 1349.56, 40, 1349.34, 5
4, 12:42:00-000, 96, 28, 68, 34, 1349.79, 64, 1350.69, 2
4, 12:43:00-000, 86, 47, 39, 37, 1349.16, 38, 1349.60, 18
4, 12:44:00-000, 72, 36, 36, 42, 1349.37, 40, 1349.42, 1
4, 12:45:00-000, 92, 40, 52, 38, 1350.81, 44, 1350.06, 4
4, 12:46:00-000, 88, 47, 41, 48, 1351.26, 43, 1350.76, 5
4, 12:47:00-000, 98, 46, 52, 46, 1350.80, 51, 1350.75, 0
4, 12:48:00-000, 90, 47, 43, 39, 1350.40, 35, 1350.48, 8
4, 12:49:00-000, 62, 34, 28, 34, 1350.05, 29, 1350.20, 3
4, 12:50:00-000, 67, 33, 34, 29, 1349.44, 35, 1349.77, 2
4, 12:51:00-000, 93, 47, 46, 43, 1349.97, 37, 1349.97, 10
4, 12:52:00-000, 88, 53, 35, 46, 1353.34, 38, 1352.78, 1
4, 12:53:00-000, 79, 51, 28, 54, 1353.27, 27, 1353.03, 6
4, 12:54:00-000, 101, 48, 53, 52, 1349.82, 47, 1349.71, 2
4, 12:55:00-000, 82, 41, 41, 38, 1348.97, 35, 1349.16, 2
4, 12:56:00-000, 85, 36, 49, 39, 1351.30, 49, 1351.10, 0
4, 12:57:00-000, 107, 48, 59, 38, 1350.65, 56, 1350.72, 11
4, 12:58:00-000, 61, 31, 30, 26, 1348.42, 25, 1349.79, 13
4, 12:59:00-000, 91, 50, 41, 50, 1350.83, 24, 1350.49, 7
4, 13:00:00-000, 98, 37, 61, 37, 1350.02, 66, 1350.46, 5
4, 13:01:00-000, 105, 71, 34, 71, 1351.82, 35, 1351.28, 0
4, 13:02:00-000, 61, 24, 37, 20, 1349.80, 32, 1350.96, 12
4, 13:03:00-000, 98, 52, 46, 43, 1350.87, 42, 1351.16, 7
4, 13:04:00-000, 84, 34, 50, 30, 1350.63, 43, 1351.20, 4
4, 13:05:00-000, 81, 48, 33, 48, 1353.37, 29, 1351.55, 16
4, 13:06:00-000, 101, 50, 51, 51, 1351.11, 48, 1352.18, 2
4, 13:07:00-000, 80, 36, 44, 35, 1351.19, 35, 1350.48, 6
4, 13:08:00-000, 101, 55, 46, 56, 1352.01, 46, 1352.19, 7
4, 13:09:00-000, 77, 26, 51, 25, 1350.28, 42, 1350.56, 0
4, 13:10:00-000, 99, 50, 49, 50, 1350.13, 42, 1350.47, 2
4, 13:11:00-000, 81, 32, 49, 33, 1350.09, 51, 1350.26, 8
4, 13:12:00-000, 80, 46, 34, 38, 1350.18, 33, 1350.69, 0
4, 13:13:00-000, 108, 50, 58, 46, 1350.03, 38, 1350.78, 17
4, 13:14:00-000, 82, 41, 41, 45, 1349.59, 44, 1349.93, 7
4, 13:15:00-000, 81, 38, 43, 36, 1352.77, 38, 1350.73, 5
4, 13:16:00-000, 87, 45, 42, 48, 1351.62, 27, 1351.70, 6
4, 13:17:00-000, 86, 48, 38, 44, 1350.35, 42, 1351.44, 13
4, 13:18:00-000, 110, 66, 44, 59, 1353.09, 39, 1352.30, 9
4, 13:19:00-000, 63, 30, 33, 29, 1350.86, 21, 1350.90, 6
4, 13:20:00-000, 90, 33, 57, 33, 1348.23, 56, 1348.79, 7
4, 13:21:00-000, 81, 35, 46, 28, 1348.96, 39, 1350.09, 9
4, 13:22:00-000, 84, 45, 39, 34, 1348.82, 40, 1349.94, 5
4, 13:23:00-000, 75, 48, 27, 41, 1352.97, 29, 1352.06, 14
4, 13:24:00-000, 69, 22, 47, 22, 1350.91, 34, 1349.91, 10
4, 13:25:00-000, 80, 40, 40, 43, 1350.39, 34, 1350.43, 2
4, 13:26:00-000, 70, 40, 30, 40, 1351.49, 39, 1352.22, 1
4, 13:27:00-000, 104, 51, 53, 50, 1352.05, 27, 1351.81, 18
4, 13:28:00-000, 92, 37, 55, 36, 1350.63, 51, 1350.77, 8
4, 13:29:00-000, 70, 18, 52, 16, 1349.87, 38, 1349.02, 13
4, 13:30:00-000, 88, 45, 43, 40, 1350.89, 37, 1350.88, 1
4, 13:31:00-000, 81, 29, 52, 34, 1352.11, 35, 1350.74, 12
4, 13:32:00-000, 79, 32, 47, 30, 1348.29, 46, 1349.21, 13
4, 13:33:00-000, 81, 46, 35, 44, 1349.90, 31, 1349.70, 4
4, 13:34:00-000, 61, 26, 35, 29, 1349.62, 40, 1350.19, 1
4, 13:35:00-000, 94, 47, 47, 36, 1349.16, 28, 1349.57, 8
4, 13:36:00-000, 87, 57, 30, 42, 1351.85, 46, 1352.38, 8
4, 13:37:00-000, 82, 48, 34, 52, 1352.01, 28, 1351.92, 8
4, 13:38:00-000, 72, 40, 32, 44, 1353.56, 26, 1354.07, 2
4, 13:39:00-000, 105, 45, 60, 42, 1350.77, 45, 1350.95, 9
4, 13:40:00-000, 56, 21, 35, 25, 1353.15, 40, 1351.02, 6
4, 13:41:00-000, 82, 33, 49, 29, 1349.41, 40, 1349.44, 5
4, 13:42:00-000, 82, 41, 41, 41, 1350.60, 36, 1351.58, 4
4, 13:43:00-000, 72, 38, 34, 37, 1349.91, 31, 1350.54, 4
4, 13:44:00-000, 58, 22, 36, 22, 1350.45, 45, 1349.61, 0
4, 13:45:00-000, 116, 71, 45, 61, 1350.56, 42, 1350.78, 4
4, 13:46:00-000, 84, 32, 52, 38, 1350.65, 41, 1348.75, 3
4, 13:47:00-000, 67, 33, 34, 36, 1351.63, 33, 1352.72, 6
4, 13:48:00-000, 77, 40, 37, 36, 1350.86, 33, 1350.96, 5
4, 13:49:00-000, 94, 46, 48, 40, 1350.74, 52, 1351.34, 2
4, 13:50:00-000, 96, 51, 45, 48, 1350.01, 44, 1350.06, 11
4, 13:51:00-000, 103, 53, 50, 52, 1353.07, 32, 1352.62, 1
4, 13:52:00-000, 57, 24, 33, 22, 1348.86, 45, 1350.24, 4
4, 13:53:00-000, 94, 30, 64, 33, 1349.75, 48, 1350.14, 4
4, 13:54:00-000, 78, 47, 31, 44, 1351.20, 39, 1350.81, 1
4, 13:55:00-000, 53, 17, 36, 20, 1350.70, 33, 1350.78, 4
4, 13:56:00-000, 95, 44, 51, 43, 1350.97, 49, 1350.99, 1
4, 13:57:00-000, 86, 46, 40, 39, 1350.45, 39, 1350.48, 12
4, 13:58:00-000, 77, 25, 52, 25, 1349.72, 43, 1349.73, 8
4, 13:59:00-000, 86, 45, 41, 45, 1349.21, 33, 1349.33, 8
4, 14:00:00-000, 78, 47, 31, 44, 1349.99, 32, 1350.09, 0
4, 14:01:00-000, 110, 67, 43, 65, 1351.30, 40, 1351.42, 0
4, 14:02:00-000, 89, 37, 52, 42, 1350.59, 44, 1350.86, 0
4, 14:03:00-000, 74, 28, 46, 26, 1351.50, 42, 1351.01, 9
4, 14:04:00-000, 95, 42, 53, 42, 1349.99, 52, 1350.41, 3
4, 14:05:00-000, 83, 36, 47, 36, 1350.24, 35, 1350.28, 12
4, 14:06:00-000, 75, 33, 42, 32, 1350.56, 48, 1351.07, 0
4, 14:07:00-000, 82, 42, 40, 41, 1350.33, 39, 1350.84, 1
4, 14:08:00-000, 93, 47, 46, 40, 1350.04, 38, 1350.60, 5
4, 14:09:00-000, 77, 29, 48, 34, 1349.73, 42, 1350.33, 3
4, 14:10:00-000, 103, 44, 59, 43, 1351.20, 67, 1350.85, 3
4, 14:11:00-000, 75, 27, 48, 28, 1351.14, 45, 1351.50, 2
4, 14:12:00-000, 73, 40, 33, 37, 1351.48, 33, 1351.63, 0
4, 14:13:00-000, 95, 49, 46, 44, 1351.22, 41, 1351.77, 12
4, 14:14:00-000, 55, 28, 27, 28, 1350.53, 23, 1349.78, 4
4, 14:15:00-000, 95, 47, 48, 44, 1350.54, 44, 1349.95, 1
4, 14:16:00-000, 86, 44, 42, 47, 1351.27, 44, 1351.20, 1
4, 14:17:00-000, 78, 43, 35, 41, 1352.65, 33, 1353.08, 1
4, 14:18:00-000, 72, 40, 32, 36, 1350.57, 30, 1349.79, 2
4, 14:19:00-000, 93, 44, 49, 44, 1351.97, 38, 1352.55, 7
4, 14:20:00-000, 92, 46, 46, 52, 1351.99, 43, 1351.71, 0
4, 14:21:00-000, 65, 30, 35, 30, 1350.93, 31, 1350.93, 11
4, 14:22:00-000, 109, 35, 74, 25, 1348.20, 65, 1349.33, 8
4, 14:23:00-000, 76, 33, 43, 32, 1350.02, 29, 1349.61, 16
4, 14:24:00-000, 62, 38, 24, 42, 1351.95, 29, 1352.10, 4
4, 14:25:00-000, 101, 53, 48, 53, 1351.52, 40, 1350.24, 1
4, 14:26:00-000, 79, 41, 38, 35, 1352.05, 41, 1351.72, 10
4, 14:27:00-000, 68, 32, 36, 31, 1349.90, 28, 1349.46, 4
4, 14:28:00-000, 69, 33, 36, 34, 1350.79, 40, 1351.12, 1
4, 14:29:00-000, 84, 41, 43, 41, 1350.21, 41, 1350.26, 1
4, 14:30:00-000, 85, 50, 35, 41, 1352.46, 31, 1352.45, 9
4, 14:31:00-000, 81, 43, 38, 37, 1350.72, 35, 1351.42, 5
4, 14:32:00-000, 78, 48, 30, 48, 1354.18, 25, 1354.00, 11
4, 14:33:00-000, 71, 26, 45, 25, 1351.67, 29, 1351.20, 5
4, 14:34:00-000, 102, 46, 56, 47, 1351.58, 59, 1351.73, 2
4, 14:35:00-000, 54, 28, 26, 19, 1349.68, 27, 1349.85, 10
4, 14:36:00-000, 89, 53, 36, 47, 1353.35, 24, 1354.00, 5
4, 14:37:00-000, 87, 40, 47, 46, 1352.97, 38, 1352.73, 4
4, 14:38:00-000, 75, 33, 42, 31, 1348.74, 56, 1349.90, 5
4, 14:39:00-000, 81, 51, 30, 51, 1351.48, 25, 1351.40, 2
4, 14:40:00-000, 92, 54, 38, 49, 1351.38, 39, 1351.74, 1
4, 14:41:00-000, 103, 54, 49, 55, 1351.28, 52, 1351.30, 2
4, 14:42:00-000, 89, 35, 54, 36, 1349.85, 44, 1349.97, 4
4, 14:43:00-000, 99, 47, 52, 47, 1351.10, 34, 1351.20, 0
4, 14:44:00-000, 78, 34, 44, 34, 1349.05, 53, 1350.35, 9
4, 14:45:00-000, 61, 29, 32, 26, 1349.61, 33, 1349.84, 4
4, 14:46:00-000, 83, 52, 31, 46, 1351.82, 33, 1351.12, 1
4, 14:47:00-000, 70, 35, 35, 38, 1353.04, 32, 1352.80, 2
4, 14:48:00-000, 78, 33, 45, 36, 1350.00, 37, 1349.99, 6
4, 14:49:00-000, 98, 50, 48, 42, 1351.54, 34, 1351.79, 4
4, 14:50:00-000, 78, 39, 39, 40, 1350.82, 54, 1352.53, 4
4, 14:51:00-000, 74, 36, 38, 32, 1351.84, 32, 1352.18, 1
4, 14:52:00-000, 103, 45, 58, 46, 1350.32, 56, 1350.33, 6
4, 14:53:00-000, 75, 39, 36, 32, 1350.46, 30, 1351.09, 2
4, 14:54:00-000, 78, 29, 49, 36, 1349.22, 49, 1350.50, 0
4, 14:55:00-000, 108, 59, 49, 41, 1351.04, 39, 1350.89, 11
4, 14:56:00-000, 60, 34, 26, 46, 1349.49, 32, 1350.93, 6
4, 14:57:00-000, 92, 57, 35, 56, 1350.83, 34, 1350.82, 5
4, 14:58:00-000, 86, 22, 64, 22, 1349.31, 50, 1350.09, 8
4, 14:59:00-000, 96, 43, 53, 37, 1350.75, 44, 1350.65, 13
4, 15:00:00-000, 78, 47, 31, 53, 1351.43, 27, 1351.77, 6
4, 15:01:00-000, 89, 47, 42, 37, 1351.21, 24, 1351.12, 11
4, 15:02:00-000, 94, 39, 55, 41, 1348.90, 54, 1349.06, 12
4, 15:03:00-000, 97, 37, 60, 30, 1349.69, 46, 1349.45, 13
4, 15:04:00-000, 77, 46, 31, 46, 1350.73, 36, 1350.77, 0
4, 15:05:00-000, 76, 36, 40, 42, 1350.73, 33, 1350.63, 5
4, 15:06:00-000, 64, 38, 26, 36, 1351.72, 28, 1351.53, 1
4, 15:07:00-000, 100, 44, 56, 39, 1350.43, 48, 1350.41, 2
4, 15:08:00-000, 77, 32, 45, 40, 1349.57, 45, 1349.21, 1
4, 15:09:00-000, 88, 29, 59, 26, 1349.15, 33, 1349.72, 9
4, 15:10:00-000, 88, 45, 43, 41, 1352.16, 59, 1352.31, 5
4, 15:11:00-000, 79, 45, 34, 44, 1350.65, 37, 1350.48, 3
4, 15:12:00-000, 93, 46, 47, 43, 1351.74, 32, 1352.21, 2
4, 15:13:00-000, 87, 52, 35, 56, 1350.69, 43, 1350.88, 4
4, 15:14:00-000, 74, 37, 37, 37, 1349.89, 34, 1350.35, 3
4, 15:15:00-000, 89, 38, 51, 38, 1350.36, 46, 1350.45, 6
4, 15:16:00-000, 84, 37, 47, 31, 1350.96, 39, 1350.53, 7
4, 15:17:00-000, 72, 27, 45, 28, 1349.92, 39, 1349.74, 8
4, 15:18:00-000, 67, 30, 37, 29, 1348.20, 40, 1349.14, 2
4, 15:19:00-000, 107, 57, 50, 55, 1350.48, 49, 1350.46, 2
4, 15:20:00-000, 80, 46, 34, 41, 1351.67, 27, 1351.77, 6
4, 15:21:00-000, 59, 35, 24, 31, 1350.61, 19, 1350.15, 9
4, 15:22:00-000, 101, 46, 55, 46, 1348.79, 49, 1349.89, 6
4, 15:23:00-000, 82, 49, 33, 48, 1349.93, 32, 1350.09, 10
4, 15:24:00-000, 82, 34, 48, 35, 1350.31, 42, 1350.18, 1
4, 15:25:00-000, 70, 28, 42, 21, 1349.00, 28, 1349.60, 6
4, 15:26:00-000, 90, 29, 61, 33, 1348.30, 69, 1350.48, 6
4, 15:27:00-000, 88, 39, 49, 37, 1350.18, 34, 1350.26, 3
4, 15:28:00-000, 90, 49, 41, 46, 1352.15, 49, 1352.03, 2
4, 15:29:00-000, 83, 38, 45, 39, 1350.22, 25, 1350.60, 16
4, 15:30:00-000, 77, 42, 35, 43, 1351.20, 44, 1351.51, 1
4, 15:31:00-000, 80, 42, 38, 41, 1350.78, 34, 1350.53, 1
4, 15:32:00-000, 70, 37, 33, 33, 1350.54, 34, 1350.73, 5
4, 15:33:00-000, 93, 36, 57, 37, 1349.99, 42, 1349.97, 2
4, 15:34:00-000, 65, 30, 35, 32, 1352.02, 37, 1349.45, 10
4, 15:35:00-000, 135, 70, 65, 64, 1350.44, 52, 1351.13, 5
4, 15:36:00-000, 86, 44, 42, 49, 1351.42, 45, 1352.37, 0
4, 15:37:00-000, 76, 40, 36, 30, 1350.46, 24, 1350.12, 14
4, 15:38:00-000, 85, 24, 61, 31, 1346.99, 48, 1346.89, 7
4, 15:39:00-000, 80, 36, 44, 34, 1348.02, 42, 1347.21, 8
4, 15:40:00-000, 92, 55, 37, 54, 1351.71, 28, 1350.99, 16
4, 15:41:00-000, 58, 27, 31, 17, 1349.29, 22, 1350.00, 4
4, 15:42:00-000, 80, 47, 33, 58, 1349.77, 41, 1350.02, 0
4, 15:43:00-000, 107, 39, 68, 38, 1349.73, 57, 1349.71, 1
4, 15:44:00-000, 70, 34, 36, 31, 1350.41, 30, 1349.79, 13
4, 15:45:00-000, 75, 30, 45, 31, 1348.90, 31, 1349.58, 2
4, 15:46:00-000, 83, 40, 43, 38, 1348.81, 53, 1349.20, 6
4, 15:47:00-000, 76, 43, 33, 47, 1350.54, 28, 1350.64, 0
4, 15:48:00-000, 92, 52, 40, 51, 1352.56, 37, 1352.05, 2
4, 15:49:00-000, 75, 39, 36, 32, 1350.55, 31, 1350.70, 4
4, 15:50:00-000, 89, 30, 59, 35, 1349.33, 54, 1350.23, 2
4, 15:51:00-000, 82, 27, 55, 30, 1348.46, 53, 1348.42, 8
4, 15:52:00-000, 97, 63, 34, 59, 1350.74, 37, 1350.83, 2
4, 15:53:00-000, 81, 42, 39, 42, 1351.59, 37, 1351.62, 1
4, 15:54:00-000, 82, 41, 41, 43, 1350.83, 37, 1350.80, 6
4, 15:55:00-000, 88, 47, 41, 43, 1350.64, 29, 1350.48, 1
4, 15:56:00-000, 73, 30, 43, 35, 1349.31, 46, 1350.06, 0
4, 15:57:00-000, 110, 55, 55, 52, 1348.74, 49, 1348.60, 1
4, 15:58:00-000, 76, 39, 37, 40, 1350.64, 41, 1350.63, 5
4, 15:59:00-000, 81, 44, 37, 40, 1350.32, 34, 1350.40, 2
4, 16:00:00-000, 83, 45, 38, 44, 1349.90, 41, 1350.33, 6
4, 16:01:00-000, 107, 56, 51, 57, 1351.97, 44, 1352.13, 0
4, 16:02:00-000, 77, 39, 38, 38, 1349.83, 43, 1350.67, 4
4, 16:03:00-000, 75, 28, 47, 27, 1350.03, 33, 1350.36, 2
4, 16:04:00-000, 83, 31, 52, 29, 1349.93, 57, 1350.73, 4
4, 16:05:00-000, 82, 42, 40, 42, 1350.97, 36, 1349.91, 7
4, 16:06:00-000, 76, 38, 38, 37, 1349.18, 37, 1350.13, 3
4, 16:07:00-000, 75, 35, 40, 32, 1350.62, 30, 1351.26, 3
4, 16:08:00-000, 86, 39, 47, 42, 1349.97, 57, 1350.23, 0
4, 16:09:00-000, 92, 45, 47, 38, 1350.07, 45, 1350.08, 4
4, 16:10:00-000, 65, 36, 29, 39, 1351.25, 27, 1352.03, 0
4, 16:11:00-000, 88, 35, 53, 34, 1350.41, 25, 1350.76, 11
4, 16:12:00-000, 93, 49, 44, 41, 1350.94, 48, 1351.66, 3
4, 16:13:00-000, 71, 39, 32, 35, 1349.51, 43, 1349.39, 7
4, 16:14:00-000, 82, 38, 44, 40, 1351.97, 34, 1353.35, 4
4, 16:15:00-000, 81, 46, 35, 41, 1350.75, 40, 1350.79, 5
4, 16:16:00-000, 72, 27, 45, 32, 1349.15, 37, 1349.24, 0
4, 16:17:00-000, 68, 25, 43, 26, 1348.65, 29, 1349.34, 6
4, 16:18:00-000, 92, 42, 50, 37, 1348.78, 59, 1349.36, 7
4, 16:19:00-000, 97, 46, 51, 43, 1351.11, 39, 1350.63, 9
4, 16:20:00-000, 71, 34, 37, 33, 1350.48, 47, 1351.61, 0
4, 16:21:00-000, 78, 37, 41, 34, 1350.52, 33, 1350.93, 6
4, 16:22:00-000, 105, 55, 50, 57, 1350.06, 49, 1350.30, 5
4, 16:23:00-000, 84, 48, 36, 48, 1350.93, 36, 1351.30, 0
4, 16:24:00-000, 81, 33, 48, 36, 1348.69, 43, 1349.32, 0
4, 16:25:00-000, 66, 37, 29, 36, 1350.74, 28, 1350.82, 5
4, 16:26:00-000, 105, 49, 56, 50, 1348.97, 56, 1349.44, 0
4, 16:27:00-000, 86, 50, 36, 47, 1350.74, 28, 1351.50, 2
4, 16:28:00-000, 113, 58, 55, 54, 1350.56, 60, 1350.69, 7
4, 16:29:00-000, 89, 47, 42, 40, 1349.37, 37, 1349.99, 2
5, 09:13:00-000, 10331, 5648, 4683, 3915, 1348.25, 3894, 1349.53, 0
5, 09:14:00-000, 0, 0, 0, 0, 0.00, 49, 1357.00, 567
5, 09:15:00-000, 0, 0, 0, 0, 0.00, 36, 1357.00, 1865
5, 09:16:00-000, 0, 0, 0, 0, 0.00, 0, 0.00, 5
5, 09:26:00-000, 10428, 5708, 4720, 3700, 1348.42, 3726, 1348.58, 0
5, 09:27:00-000, 0, 0, 0, 53, 1348.00, 61, 1356.00, 0
5, 09:28:00-000, 12, 4, 8, 71, 1347.98, 115, 1356.63, 2058
5, 09:29:00-000, 35, 20, 15, 15, 1351.00, 13, 1352.69, 655
5, 09:30:00-000, 62, 30, 32, 24, 1350.04, 26, 1352.19, 3
5, 09:31:00-000, 0, 0, 0, 0, 0.00, 3, 1358.00, 2
5, 09:32:00-000, 159, 110, 49, 71, 1350.10, 53, 1351.05, 3
5, 09:33:00-000, 328, 187, 141, 128, 1349.21, 117, 1349.79, 40
5, 09:34:00-000, 550, 289, 261, 244, 1348.44, 235, 1349.83, 13
5, 09:35:00-000, 0, 0, 0, 0, 0.00, 40, 1358.74, 26
5, 09:36:00-000, 1007, 597, 410, 412, 1349.50, 379, 1350.46, 60
5, 09:37:00-000, 1201, 576, 625, 462, 1348.44, 500, 1348.85, 110
5, 09:38:00-000, 1375, 745, 630, 503, 1348.32, 633, 1350.37, 137
5, 09:39:00-000, 2, 0, 2, 23, 1347.00, 26, 1357.23, 142
5, 09:40:00-000, 1384, 745, 639, 525, 1348.72, 548, 1349.57, 195
5, 09:41:00-000, 1306, 666, 640, 489, 1348.36, 493, 1349.21, 224
5, 09:42:00-000, 1111, 602, 509, 383, 1349.59, 456, 1350.82, 212
5, 09:43:00-000, 0, 0, 0, 26, 1346.85, 0, 0.00, 225
5, 09:44:00-000, 1016, 523, 493, 439, 1348.59, 415, 1349.79, 187
5, 09:45:00-000, 972, 490, 482, 401, 1348.18, 395, 1348.89, 123
5, 09:46:00-000, 878, 391, 487, 282, 1348.26, 349, 1348.65, 183
5, 09:47:00-000, 0, 0, 0, 30, 1345.30, 37, 1355.27, 123
5, 09:48:00-000, 899, 468, 431, 387, 1347.95, 345, 1348.52, 132
5, 09:49:00-000, 988, 532, 456, 362, 1348.55, 399, 1349.43, 138
5, 09:50:00-000, 1115, 585, 530, 491, 1349.03, 470, 1350.25, 127
5, 09:51:00-000, 0, 0, 0, 2, 1345.00, 19, 1357.00, 139
5, 09:52:00-000, 1001, 533, 468, 408, 1348.30, 400, 1349.52, 142
5, 09:53:00-000, 1125, 596, 529, 411, 1348.56, 402, 1349.04, 151
5, 09:54:00-000, 1038, 519, 519, 427, 1348.41, 436, 1349.80, 171
5, 09:55:00-000, 0, 0, 0, 17, 1345.00, 40, 1355.32, 156
5, 09:56:00-000, 1054, 570, 484, 437, 1349.03, 434, 1349.81, 127
5, 09:57:00-000, 1049, 576, 473, 397, 1349.31, 388, 1349.39, 153
5, 09:58:00-000, 1007, 500, 507, 416, 1348.19, 391, 1349.13, 164
5, 09:59:00-000, 0, 0, 0, 3, 1345.00, 31, 1356.00, 141
5, 10:00:00-000, 992, 508, 484, 402, 1348.57, 372, 1350.05, 153
5, 10:01:00-000, 938, 500, 438, 391, 1349.29, 336, 1349.81, 160
5, 10:02:00-000, 1003, 483, 520, 368, 1348.70, 402, 1349.09, 162
5, 10:03:00-000, 0, 0, 0, 0, 0.00, 7, 1354.71, 154
5, 10:04:00-000, 1035, 525, 510, 395, 1349.29, 408, 1350.00, 164
5, 10:05:00-000, 1017, 502, 515, 376, 1348.55, 399, 1348.99, 184
5, 10:06:00-000, 937, 530, 407, 388, 1349.82, 385, 1350.86, 180
5, 10:07:00-000, 0, 0, 0, 47, 1345.63, 16, 1357.00, 125
5, 10:08:00-000, 1041, 475, 566, 409, 1347.96, 459, 1349.55, 117
5, 10:09:00-000, 1104, 569, 535, 407, 1349.10, 418, 1349.70, 144
5, 10:10:00-000, 1078, 596, 482, 434, 1348.31, 449, 1350.02, 153
5, 10:11:00-000, 0, 0, 0, 15, 1345.00, 20, 1357.00, 130
5, 10:12:00-000, 982, 493, 489, 422, 1348.33, 450, 1349.93, 151
5, 10:13:00-000, 1085, 605, 480, 437, 1349.52, 361, 1349.94, 128
5, 10:14:00-000, 1033, 575, 458, 399, 1348.27, 344, 1349.03, 139
5, 10:15:00-000, 0, 0, 0, 12, 1347.00, 8, 1355.50, 165
5, 10:16:00-000, 1114, 562, 552, 481, 1348.48, 457, 1349.88, 203
5, 10:17:00-000, 968, 501, 467, 371, 1349.53, 363, 1349.96, 178
5, 10:18:00-000, 992, 521, 471, 396, 1348.81, 423, 1349.51, 152
5, 10:19:00-000, 1, 0, 1, 0, 0.00, 32, 1356.15, 151
5, 10:20:00-000, 1005, 549, 456, 402, 1348.52, 397, 1349.34, 147
5, 10:21:00-000, 1062, 588, 474, 392, 1349.79, 359, 1350.14, 141
5, 10:22:00-000, 1011, 519, 492, 423, 1348.72, 415, 1350.08, 169
5, 10:23:00-000, 0, 0, 0, 3, 1348.00, 31, 1357.00, 164
5, 10:24:00-000, 1055, 542, 513, 418, 1348.89, 408, 1349.01, 161
5, 10:25:00-000, 1037, 536, 501, 464, 1348.22, 386, 1348.53, 156
5, 10:26:00-000, 1006, 495, 511, 389, 1347.92, 419, 1349.04, 145
5, 10:27:00-000, 2, 2, 0, 2, 1349.00, 35, 1356.00, 136
5, 10:28:00-000, 981, 512, 469, 401, 1348.45, 382, 1349.34, 137
5, 10:29:00-000, 1071, 563, 508, 424, 1348.86, 442, 1349.50, 148
5, 10:30:00-000, 1014, 541, 473, 380, 1349.20, 448, 1350.38, 135
5, 10:31:00-000, 0, 0, 0, 5, 1346.00, 15, 1357.00, 156
5, 10:32:00-000, 977, 533, 444, 436, 1349.47, 395, 1351.36, 146
5, 10:33:00-000, 1135, 595, 540, 442, 1348.78, 365, 1349.29, 118
5, 10:34:00-000, 1092, 547, 545, 439, 1348.41, 415, 1349.36, 135
5, 10:35:00-000, 0, 0, 0, 0, 0.00, 36, 1354.41, 216
5, 10:36:00-000, 929, 498, 431, 383, 1348.68, 347, 1349.39, 182
5, 10:37:00-000, 1022, 521, 501, 374, 1348.62, 420, 1349.70, 169
5, 10:38:00-000, 986, 535, 451, 394, 1349.40, 414, 1350.58, 120
5, 10:39:00-000, 0, 0, 0, 0, 0.00, 0, 0.00, 167
5, 10:40:00-000, 1095, 648, 447, 429, 1349.68, 421, 1350.45, 160
5, 10:41:00-000, 1027, 533, 494, 414, 1348.70, 390, 1349.27, 168
5, 10:42:00-000, 1104, 526, 578, 421, 1348.68, 491, 1349.32, 142
5, 10:43:00-000, 0, 0, 0, 9, 1346.00, 12, 1356.00, 172
5, 10:44:00-000, 1054, 563, 491, 420, 1349.35, 404, 1350.34, 160
5, 10:45:00-000, 1067, 579, 488, 414, 1349.30, 408, 1349.34, 161
5, 10:46:00-000, 1007, 531, 476, 423, 1348.61, 448, 1350.44, 143
5, 10:47:00-000, 0, 0, 0, 21, 1346.00, 10, 1356.00, 149
5, 10:48:00-000, 1115, 619, 496, 491, 1349.35, 378, 1349.91, 133
5, 10:49:00-000, 961, 529, 432, 362, 1349.48, 348, 1350.03, 166
5, 10:50:00-000, 1143, 549, 594, 456, 1348.00, 487, 1348.80, 182
5, 10:51:00-000, 0, 0, 0, 0, 0.00, 29, 1355.34, 165
5, 10:52:00-000, 1046, 558, 488, 393, 1349.18, 414, 1350.11, 158
5, 10:53:00-000, 1127, 586, 541, 421, 1349.66, 457, 1350.57, 173
5, 10:54:00-000, 986, 492, 494, 417, 1349.15, 392, 1350.06, 147
5, 10:55:00-000, 0, 0, 0, 20, 1344.35, 22, 1356.00, 164
5, 10:56:00-000, 1076, 576, 500, 433, 1349.51, 462, 1350.96, 129
5, 10:57:00-000, 985, 493, 492, 351, 1348.41, 369, 1349.10, 156
5, 10:58:00-000, 1064, 549, 515, 409, 1349.01, 433, 1350.22, 142
5, 10:59:00-000, 0, 0, 0, 1, 1346.00, 14, 1356.21, 167
5, 11:00:00-000, 1001, 549, 452, 399, 1349.45, 436, 1351.01, 156
5, 11:01:00-000, 995, 540, 455, 327, 1349.35, 367, 1350.20, 134
5, 11:02:00-000, 974, 487, 487, 439, 1348.47, 372, 1349.70, 162
5, 11:03:00-000, 0, 0, 0, 6, 1346.00, 34, 1355.58, 182
5, 11:04:00-000, 1126, 604, 522, 485, 1348.82, 430, 1349.78, 126
5, 11:05:00-000, 1129, 568, 561, 432, 1348.37, 458, 1349.02, 179
5, 11:06:00-000, 1090, 566, 524, 439, 1349.33, 451, 1349.89, 165
5, 11:07:00-000, 0, 0, 0, 3, 1347.00, 42, 1357.00, 116
5, 11:08:00-000, 1042, 575, 467, 421, 1348.82, 385, 1349.88, 161
5, 11:09:00-000, 1007, 455, 552, 390, 1348.33, 386, 1348.57, 167
5, 11:10:00-000, 938, 546, 392, 394, 1349.28, 373, 1350.68, 140
5, 11:11:00-000, 1, 0, 1, 0, 0.00, 13, 1356.69, 142
5, 11:12:00-000, 1040, 561, 479, 415, 1349.08, 416, 1349.71, 178
5, 11:13:00-000, 1048, 535, 513, 394, 1349.27, 358, 1349.76, 150
5, 11:14:00-000, 1062, 573, 489, 410, 1349.34, 403, 1350.35, 162
5, 11:15:00-000, 0, 0, 0, 27, 1347.00, 1, 1356.00, 194
5, 11:16:00-000, 1022, 503, 519, 413, 1348.34, 395, 1349.13, 181
5, 11:17:00-000, 1056, 486, 570, 382, 1347.87, 381, 1348.46, 149
5, 11:18:00-000, 953, 515, 438, 351, 1348.94, 394, 1350.17, 203
5, 11:19:00-000, 0, 0, 0, 25, 1346.00, 0, 0.00, 204
5, 11:20:00-000, 1093, 589, 504, 426, 1348.82, 429, 1349.78, 147
5, 11:21:00-000, 1065, 577, 488, 402, 1349.36, 391, 1349.98, 211
5, 11:22:00-000, 974, 514, 460, 432, 1348.66, 350, 1349.22, 170
5, 11:23:00-000, 0, 0, 0, 31, 1345.00, 54, 1356.59, 159
5, 11:24:00-000, 983, 488, 495, 359, 1348.98, 426, 1350.20, 128
5, 11:25:00-000, 991, 453, 538, 361, 1348.76, 340, 1349.16, 155
5, 11:26:00-000, 1002, 531, 471, 415, 1348.70, 389, 1349.05, 144
5, 11:27:00-000, 0, 0, 0, 43, 1345.32, 30, 1355.23, 151
5, 11:28:00-000, 1078, 573, 505, 450, 1349.36, 438, 1350.11, 134
5, 11:29:00-000, 1009, 527, 482, 362, 1348.77, 389, 1349.53, 144
5, 11:30:00-000, 1118, 563, 555, 425, 1348.65, 512, 1350.11, 143
5, 11:31:00-000, 0, 0, 0, 14, 1346.00, 32, 1357.00, 152
5, 11:32:00-000, 926, 466, 460, 356, 1348.84, 364, 1350.27, 161
5, 11:33:00-000, 1007, 533, 474, 386, 1349.02, 369, 1349.64, 169
5, 11:34:00-000, 984, 529, 455, 347, 1349.56, 431, 1350.41, 128
5, 11:35:00-000, 0, 0, 0, 40, 1346.00, 25, 1357.16, 140
5, 11:36:00-000, 1097, 555, 542, 414, 1348.81, 447, 1350.02, 170
5, 11:37:00-000, 1072, 541, 531, 395, 1349.29, 441, 1350.00, 160
5, 11:38:00-000, 958, 535, 423, 432, 1348.72, 354, 1349.40, 162
5, 11:39:00-000, 0, 0, 0, 39, 1345.02, 0, 0.00, 140
5, 11:40:00-000, 1095, 559, 536, 452, 1348.59, 417, 1349.67, 126
5, 11:41:00-000, 1057, 541, 516, 423, 1347.68, 430, 1348.38, 169
5, 11:42:00-000, 1050, 556, 494, 426, 1349.08, 401, 1349.43, 138
5, 11:43:00-000, 0, 0, 0, 10, 1347.00, 67, 1356.29, 150
5, 11:44:00-000, 981, 520, 461, 348, 1349.59, 443, 1350.90, 112
5, 11:45:00-000, 1061, 512, 549, 431, 1348.57, 418, 1349.37, 127
5, 11:46:00-000, 972, 549, 423, 387, 1349.72, 314, 1350.43, 162
5, 11:47:00-000, 0, 0, 0, 53, 1346.24, 12, 1356.00, 151
5, 11:48:00-000, 1015, 518, 497, 431, 1348.77, 439, 1350.44, 138
5, 11:49:00-000, 976, 520, 456, 393, 1349.31, 366, 1350.40, 156
5, 11:50:00-000, 1086, 578, 508, 397, 1348.64, 380, 1349.32, 144
5, 11:51:00-000, 0, 0, 0, 30, 1345.36, 7, 1355.00, 142
5, 11:52:00-000, 1055, 534, 521, 409, 1348.34, 465, 1349.73, 209
5, 11:53:00-000, 1051, 539, 512, 417, 1348.41, 423, 1349.03, 153
5, 11:54:00-000, 1066, 552, 514, 422, 1349.00, 428, 1349.36, 147
5, 11:55:00-000, 1, 0, 1, 0, 0.00, 16, 1355.87, 155
5, 11:56:00-000, 1036, 507, 529, 440, 1348.07, 390, 1348.68, 143
5, 11:57:00-000, 1009, 532, 477, 373, 1349.51, 408, 1349.90, 140
5, 11:58:00-000, 1038, 520, 518, 415, 1348.01, 446, 1349.07, 134
5, 11:59:00-000, 0, 0, 0, 33, 1344.15, 18, 1355.00, 171
5, 12:00:00-000, 1024, 539, 485, 450, 1349.10, 398, 1349.85, 116
5, 12:01:00-000, 1045, 539, 506, 389, 1349.40, 473, 1350.61, 154
5, 12:02:00-000, 991, 502, 489, 395, 1348.59, 418, 1350.46, 112
5, 12:03:00-000, 0, 0, 0, 72, 1344.90, 17, 1356.00, 85
5, 12:04:00-000, 1035, 536, 499, 413, 1348.43, 407, 1349.51, 132
5, 12:05:00-000, 1025, 508, 517, 378, 1348.50, 391, 1349.02, 134
5, 12:06:00-000, 1107, 577, 530, 402, 1348.89, 449, 1350.31, 191
5, 12:07:00-000, 0, 0, 0, 54, 1345.31, 3, 1356.00, 162
5, 12:08:00-000, 969, 532, 437, 381, 1349.28, 388, 1350.53, 168
5, 12:09:00-000, 1058, 568, 490, 423, 1348.88, 409, 1349.83, 155
5, 12:10:00-000, 1098, 551, 547, 455, 1348.39, 422, 1349.28, 131
5, 12:11:00-000, 0, 0, 0, 29, 1345.03, 28, 1355.18, 163
5, 12:12:00-000, 1006, 531, 475, 414, 1348.77, 385, 1349.70, 139
5, 12:13:00-000, 955, 488, 467, 380, 1349.08, 351, 1348.96, 149
5, 12:14:00-000, 1014, 540, 474, 419, 1348.68, 390, 1349.96, 141
5, 12:15:00-000, 0, 0, 0, 36, 1346.10, 0, 0.00, 139
5, 12:16:00-000, 1061, 534, 527, 425, 1348.63, 435, 1349.35, 177
5, 12:17:00-000, 943, 503, 440, 359, 1349.16, 405, 1350.02, 119
5, 12:18:00-000, 1063, 531, 532, 364, 1348.91, 436, 1349.82, 161
5, 12:19:00-000, 0, 0, 0, 38, 1346.00, 8, 1357.00, 127
5, 12:20:00-000, 1070, 548, 522, 338, 1349.46, 339, 1348.46, 171
5, 12:21:00-000, 1008, 478, 530, 366, 1349.06, 397, 1348.77, 240
5, 12:22:00-000, 1027, 538, 489, 373, 1348.64, 405, 1349.13, 228
5, 12:23:00-000, 0, 0, 0, 0, 0.00, 0, 0.00, 194
5, 12:24:00-000, 1082, 586, 496, 434, 1349.54, 395, 1349.62, 219
5, 12:25:00-000, 934, 491, 443, 367, 1349.88, 308, 1349.38, 186
5, 12:26:00-000, 1123, 595, 528, 398, 1349.78, 414, 1350.33, 196
5, 12:27:00-000, 0, 0, 0, 31, 1346.00, 29, 1355.00, 168
5, 12:28:00-000, 976, 485, 491, 354, 1349.12, 368, 1349.73, 224
5, 12:29:00-000, 1000, 487, 513, 378, 1348.97, 394, 1348.94, 191
5, 12:30:00-000, 1049, 578, 471, 407, 1349.53, 373, 1349.38, 180
5, 12:31:00-000, 0, 0, 0, 22, 1347.18, 0, 0.00, 174
5, 12:32:00-000, 994, 530, 464, 396, 1348.84, 392, 1349.67, 162
5, 12:33:00-000, 1023, 526, 497, 384, 1348.68, 368, 1349.07, 202
5, 12:34:00-000, 1121, 562, 559, 442, 1348.77, 429, 1349.16, 150
5, 12:35:00-000, 0, 0, 0, 12, 1346.00, 0, 0.00, 194
5, 12:36:00-000, 1017, 540, 477, 394, 1348.86, 391, 1349.66, 179
5, 12:37:00-000, 1019, 526, 493, 357, 1349.22, 389, 1349.68, 189
5, 12:38:00-000, 1038, 613, 425, 416, 1349.30, 356, 1349.89, 185
5, 12:39:00-000, 2, 2, 0, 34, 1347.14, 0, 0.00, 174
5, 12:40:00-000, 1059, 533, 526, 384, 1348.84, 421, 1349.29, 190
5, 12:41:00-000, 1028, 514, 514, 421, 1349.08, 395, 1349.62, 190
5, 12:42:00-000, 1076, 567, 509, 428, 1349.48, 413, 1349.90, 190
5, 12:43:00-000, 0, 0, 0, 0, 0.00, 11, 1356.00, 131
5, 12:44:00-000, 958, 472, 486, 337, 1348.70, 391, 1349.73, 206
5, 12:45:00-000, 1038, 581, 457, 423, 1349.35, 355, 1349.37, 167
5, 12:46:00-000, 1026, 489, 537, 396, 1348.42, 412, 1349.51, 163
5, 12:47:00-000, 0, 0, 0, 17, 1345.00, 27, 1356.00, 152
5, 12:48:00-000, 1067, 532, 535, 415, 1348.29, 450, 1349.30, 161
5, 12:49:00-000, 1076, 525, 551, 393, 1349.25, 420, 1350.26, 166
5, 12:50:00-000, 985, 483, 502, 352, 1348.34, 324, 1348.55, 164
5, 12:51:00-000, 0, 0, 0, 28, 1345.00, 83, 1354.66, 193
5, 12:52:00-000, 1004, 491, 513, 411, 1348.68, 423, 1349.38, 152
5, 12:53:00-000, 999, 543, 456, 380, 1349.58, 365, 1350.39, 149
5, 12:54:00-000, 1009, 512, 497, 401, 1348.47, 379, 1349.75, 122
5, 12:55:00-000, 0, 0, 0, 22, 1345.91, 31, 1354.38, 142
5, 12:56:00-000, 1066, 562, 504, 408, 1349.45, 403, 1350.03, 198
5, 12:57:00-000, 1061, 519, 542, 374, 1348.38, 348, 1348.85, 145
5, 12:58:00-000, 1079, 585, 494, 471, 1348.37, 418, 1349.74, 156
5, 12:59:00-000, 1, 1, 0, 38, 1345.18, 29, 1355.00, 215
5, 13:00:00-000, 1036, 570, 466, 428, 1348.91, 371, 1349.70, 143
5, 13:01:00-000, 1015, 546, 469, 416, 1349.01, 398, 1349.79, 205
5, 13:02:00-000, 997, 529, 468, 398, 1348.97, 387, 1349.73, 162
5, 13:03:00-000, 0, 0, 0, 0, 0.00, 2, 1356.00, 142
5, 13:04:00-000, 953, 507, 446, 374, 1348.48, 401, 1349.51, 151
5, 13:05:00-000, 973, 518, 455, 385, 1349.57, 405, 1350.60, 154
5, 13:06:00-000, 995, 419, 576, 338, 1348.38, 393, 1348.57, 142
5, 13:07:00-000, 0, 0, 0, 19, 1344.95, 51, 1354.47, 128
5, 13:08:00-000, 949, 495, 454, 346, 1349.70, 374, 1350.31, 153
5, 13:09:00-000, 1088, 536, 552, 408, 1348.53, 426, 1349.08, 147
5, 13:10:00-000, 961, 500, 461, 416, 1347.98, 366, 1349.18, 197
5, 13:11:00-000, 2, 0, 2, 48, 1344.83, 18, 1354.28, 160
5, 13:12:00-000, 1045, 520, 525, 414, 1348.29, 403, 1349.00, 122
5, 13:13:00-000, 967, 473, 494, 373, 1348.44, 427, 1349.78, 128
5, 13:14:00-000, 1042, 512, 530, 391, 1348.54, 409, 1349.32, 158
5, 13:15:00-000, 1, 0, 1, 23, 1345.00, 34, 1355.82, 128
5, 13:16:00-000, 1080, 513, 567, 386, 1348.77, 441, 1349.72, 172
5, 13:17:00-000, 959, 489, 470, 345, 1348.76, 368, 1349.38, 167
5, 13:18:00-000, 973, 483, 490, 457, 1347.81, 426, 1349.80, 154
5, 13:19:00-000, 0, 0, 0, 0, 0.00, 21, 1356.00, 116
5, 13:20:00-000, 1024, 537, 487, 441, 1348.40, 389, 1349.48, 139
5, 13:21:00-000, 1016, 559, 457, 439, 1348.53, 338, 1349.01, 137
5, 13:22:00-000, 1027, 543, 484, 401, 1348.69, 417, 1349.94, 124
5, 13:23:00-000, 2, 0, 2, 0, 0.00, 55, 1356.50, 129
5, 13:24:00-000, 1000, 522, 478, 408, 1348.93, 379, 1349.93, 171
5, 13:25:00-000, 1033, 491, 542, 400, 1347.78, 410, 1348.43, 128
5, 13:26:00-000, 1109, 570, 539, 449, 1349.11, 407, 1350.04, 166
5, 13:27:00-000, 0, 0, 0, 0, 0.00, 37, 1356.00, 154
5, 13:28:00-000, 1087, 614, 473, 434, 1348.88, 398, 1349.86, 205
5, 13:29:00-000, 979, 483, 496, 356, 1348.70, 376, 1349.10, 157
5, 13:30:00-000, 991, 547, 444, 400, 1349.04, 390, 1349.86, 184
5, 13:31:00-000, 0, 0, 0, 20, 1346.00, 30, 1356.86, 174
5, 13:32:00-000, 928, 462, 466, 393, 1347.98, 377, 1349.63, 125
5, 13:33:00-000, 1005, 517, 488, 430, 1348.57, 365, 1349.20, 147
5, 13:34:00-000, 1060, 488, 572, 340, 1349.38, 466, 1350.53, 113
5, 13:35:00-000, 8, 1, 7, 39, 1345.10, 7, 1345.00, 127
5, 13:36:00-000, 1047, 491, 556, 421, 1348.09, 434, 1348.79, 183
5, 13:37:00-000, 1057, 505, 552, 358, 1348.11, 420, 1349.15, 169
5, 13:38:00-000, 937, 535, 402, 365, 1350.03, 369, 1350.97, 175
5, 13:39:00-000, 3, 2, 1, 40, 1346.69, 5, 1356.00, 163
5, 13:40:00-000, 1065, 557, 508, 451, 1349.02, 468, 1350.10, 139
5, 13:41:00-000, 993, 526, 467, 397, 1349.04, 404, 1349.47, 132
5, 13:42:00-000, 1021, 500, 521, 414, 1348.82, 366, 1349.21, 123
5, 13:43:00-000, 6, 6, 0, 12, 1346.58, 13, 1355.00, 136
5, 13:44:00-000, 1086, 592, 494, 437, 1348.79, 447, 1350.11, 141
5, 13:45:00-000, 1037, 528, 509, 393, 1348.87, 390, 1349.09, 180
5, 13:46:00-000, 966, 522, 444, 421, 1349.46, 415, 1350.44, 190
5, 13:47:00-000, 5, 1, 4, 21, 1345.95, 36, 1356.77, 111
5, 13:48:00-000, 1024, 542, 482, 413, 1349.75, 376, 1350.29, 113
5, 13:49:00-000, 963, 473, 490, 363, 1348.60, 341, 1348.63, 132
5, 13:50:00-000, 1137, 573, 564, 447, 1348.23, 472, 1349.64, 174
5, 13:51:00-000, 4, 0, 4, 14, 1346.00, 40, 1355.00, 145
5, 13:52:00-000, 1079, 587, 492, 433, 1349.17, 405, 1350.19, 175
5, 13:53:00-000, 993, 537, 456, 366, 1349.25, 352, 1349.69, 167
5, 13:54:00-000, 991, 542, 449, 422, 1349.84, 381, 1350.90, 218
5, 13:55:00-000, 4, 4, 0, 39, 1346.35, 0, 0.00, 150
5, 13:56:00-000, 1004, 517, 487, 448, 1348.30, 378, 1349.71, 144
5, 13:57:00-000, 1063, 535, 528, 408, 1349.22, 401, 1349.81, 160
5, 13:58:00-000, 1026, 490, 536, 356, 1348.64, 440, 1349.98, 124
5, 13:59:00-000, 0, 0, 0, 42, 1345.47, 5, 1355.00, 160
5, 14:00:00-000, 1080, 533, 547, 403, 1348.47, 440, 1349.83, 162
5, 14:01:00-000, 996, 516, 480, 362, 1349.47, 379, 1350.28, 159
5, 14:02:00-000, 1013, 548, 465, 335, 1349.81, 378, 1350.86, 175
5, 14:03:00-000, 2, 0, 2, 35, 1347.34, 24, 1356.00, 190
5, 14:04:00-000, 1040, 532, 508, 404, 1348.59, 413, 1349.65, 178
5, 14:05:00-000, 1122, 573, 549, 410, 1348.36, 413, 1348.96, 197
5, 14:06:00-000, 1102, 604, 498, 457, 1348.58, 398, 1348.98, 173
5, 14:07:00-000, 2, 2, 0, 18, 1345.33, 17, 1356.00, 199
5, 14:08:00-000, 989, 467, 522, 385, 1348.16, 409, 1349.41, 179
5, 14:09:00-000, 1048, 548, 500, 376, 1348.54, 391, 1348.87, 177
5, 14:10:00-000, 1005, 521, 484, 330, 1349.15, 346, 1349.59, 177
5, 14:11:00-000, 0, 0, 0, 24, 1346.92, 20, 1355.00, 206
5, 14:12:00-000, 1126, 593, 533, 491, 1348.63, 433, 1349.28, 196
5, 14:13:00-000, 1022, 548, 474, 385, 1349.41, 354, 1349.80, 160
5, 14:14:00-000, 1010, 560, 450, 391, 1349.45, 403, 1349.92, 189
5, 14:15:00-000, 0, 0, 0, 10, 1346.00, 9, 1356.00, 202
5, 14:16:00-000, 895, 458, 437, 385, 1348.32, 360, 1349.69, 151
5, 14:17:00-000, 1007, 558, 449, 423, 1349.57, 392, 1350.27, 140
5, 14:18:00-000, 1046, 506, 540, 406, 1348.26, 430, 1349.18, 109
5, 14:19:00-000, 2, 0, 2, 13, 1344.77, 29, 1355.58, 127
5, 14:20:00-000, 1060, 570, 490, 414, 1348.69, 431, 1350.26, 156
5, 14:21:00-000, 1023, 534, 489, 400, 1349.18, 381, 1349.69, 167
5, 14:22:00-000, 1004, 515, 489, 402, 1348.37, 372, 1349.10, 137
5, 14:23:00-000, 7, 7, 0, 24, 1348.04, 33, 1356.00, 169
5, 14:24:00-000, 1064, 584, 480, 432, 1349.60, 393, 1350.30, 163
5, 14:25:00-000, 1027, 521, 506, 356, 1348.51, 394, 1349.43, 175
5, 14:26:00-000, 1025, 483, 542, 398, 1348.37, 426, 1350.17, 161
5, 14:27:00-000, 2, 1, 1, 1, 1353.00, 39, 1355.15, 148
5, 14:28:00-000, 1121, 572, 549, 462, 1348.84, 463, 1349.96, 166
5, 14:29:00-000, 971, 518, 453, 349, 1349.49, 354, 1350.27, 165
5, 14:30:00-000, 1055, 588, 467, 428, 1348.42, 365, 1349.29, 174
5, 14:31:00-000, 7, 7, 0, 29, 1345.00, 37, 1355.62, 169
5, 14:32:00-000, 979, 473, 506, 363, 1349.33, 438, 1350.85, 178
5, 14:33:00-000, 1055, 586, 469, 415, 1349.77, 397, 1350.23, 144
5, 14:34:00-000, 1004, 504, 500, 429, 1348.54, 407, 1349.47, 166
5, 14:35:00-000, 0, 0, 0, 19, 1345.00, 65, 1357.14, 125
5, 14:36:00-000, 1088, 558, 530, 466, 1348.62, 455, 1350.03, 107
5, 14:37:00-000, 969, 512, 457, 371, 1349.92, 365, 1350.70, 104
5, 14:38:00-000, 1090, 523, 567, 397, 1348.59, 379, 1348.88, 142
5, 14:39:00-000, 0, 0, 0, 35, 1344.97, 29, 1355.00, 157
5, 14:40:00-000, 1010, 506, 504, 385, 1348.87, 377, 1349.54, 216
5, 14:41:00-000, 1021, 559, 462, 402, 1349.62, 423, 1350.38, 154
5, 14:42:00-000, 985, 563, 422, 385, 1349.48, 360, 1350.14, 164
5, 14:43:00-000, 6, 1, 5, 14, 1347.00, 19, 1356.00, 170
5, 14:44:00-000, 961, 467, 494, 384, 1348.82, 369, 1349.61, 144
5, 14:45:00-000, 1106, 590, 516, 421, 1349.08, 464, 1350.17, 178
5, 14:46:00-000, 998, 519, 479, 431, 1348.26, 397, 1349.80, 133
5, 14:47:00-000, 2, 1, 1, 0, 0.00, 43, 1356.69, 139
5, 14:48:00-000, 1062, 539, 523, 425, 1349.04, 418, 1349.60, 141
5, 14:49:00-000, 1004, 465, 539, 331, 1349.24, 389, 1350.10, 140
5, 14:50:00-000, 1129, 623, 506, 461, 1348.97, 463, 1350.26, 163
5, 14:51:00-000, 2, 2, 0, 21, 1346.38, 36, 1356.80, 150
5, 14:52:00-000, 1053, 528, 525, 446, 1348.85, 442, 1349.70, 188
5, 14:53:00-000, 1001, 495, 506, 379, 1349.10, 431, 1349.76, 131
5, 14:54:00-000, 1014, 527, 487, 450, 1349.11, 459, 1350.75, 130
5, 14:55:00-000, 4, 3, 1, 44, 1344.72, 1, 1346.00, 82
5, 14:56:00-000, 1053, 516, 537, 433, 1348.18, 399, 1349.27, 119
5, 14:57:00-000, 978, 512, 466, 393, 1349.85, 400, 1350.67, 137
5, 14:58:00-000, 981, 505, 476, 393, 1348.32, 363, 1348.97, 126
5, 14:59:00-000, 1, 1, 0, 29, 1344.69, 30, 1355.10, 114
5, 15:00:00-000, 1070, 579, 491, 416, 1349.65, 419, 1350.54, 159
5, 15:01:00-000, 1118, 523, 595, 409, 1348.76, 485, 1349.58, 170
5, 15:02:00-000, 1035, 563, 472, 491, 1348.25, 403, 1349.59, 140
5, 15:03:00-000, 0, 0, 0, 0, 0.00, 15, 1356.40, 136
5, 15:04:00-000, 931, 483, 448, 352, 1349.39, 402, 1350.22, 159
5, 15:05:00-000, 1092, 517, 575, 355, 1349.16, 404, 1349.28, 122
5, 15:06:00-000, 1133, 596, 537, 430, 1348.44, 494, 1349.60, 163
5, 15:07:00-000, 1, 0, 1, 6, 1346.00, 12, 1355.50, 185
5, 15:08:00-000, 987, 523, 464, 408, 1349.05, 379, 1350.08, 192
5, 15:09:00-000, 1005, 528, 477, 441, 1348.89, 382, 1349.70, 147
5, 15:10:00-000, 1072, 540, 532, 448, 1348.62, 448, 1349.58, 148
5, 15:11:00-000, 1, 0, 1, 0, 0.00, 14, 1356.00, 137
5, 15:12:00-000, 1050, 554, 496, 391, 1348.70, 422, 1349.69, 145
5, 15:13:00-000, 981, 494, 487, 394, 1348.31, 368, 1348.97, 149
5, 15:14:00-000, 1063, 538, 525, 491, 1348.40, 453, 1349.31, 146
5, 15:15:00-000, 1, 0, 1, 0, 0.00, 10, 1355.80, 157
5, 15:16:00-000, 904, 419, 485, 368, 1347.59, 405, 1348.48, 112
5, 15:17:00-000, 1052, 532, 520, 392, 1348.19, 380, 1348.13, 121
5, 15:18:00-000, 1106, 526, 580, 421, 1348.21, 425, 1349.59, 132
5, 15:19:00-000, 0, 0, 0, 9, 1344.33, 46, 1354.28, 174
5, 15:20:00-000, 968, 455, 513, 387, 1347.50, 455, 1349.60, 149
5, 15:21:00-000, 1113, 585, 528, 424, 1349.60, 410, 1349.77, 131
5, 15:22:00-000, 1018, 519, 499, 424, 1348.68, 377, 1349.61, 129
5, 15:23:00-000, 2, 1, 1, 28, 1344.82, 13, 1354.69, 173
5, 15:24:00-000, 962, 487, 475, 367, 1348.49, 334, 1349.33, 172
5, 15:25:00-000, 920, 484, 436, 368, 1349.17, 327, 1349.74, 171
5, 15:26:00-000, 944, 453, 491, 408, 1347.90, 393, 1349.10, 175
5, 15:27:00-000, 1, 0, 1, 37, 1343.81, 13, 1354.15, 140
5, 15:28:00-000, 1074, 560, 514, 409, 1348.91, 425, 1349.93, 111
5, 15:29:00-000, 985, 479, 506, 355, 1349.02, 398, 1349.68, 160
5, 15:30:00-000, 1127, 595, 532, 448, 1349.03, 439, 1349.75, 186
5, 15:31:00-000, 3, 1, 2, 52, 1345.37, 28, 1355.07, 140
5, 15:32:00-000, 1056, 502, 554, 356, 1348.63, 445, 1349.64, 145
5, 15:33:00-000, 1060, 565, 495, 383, 1348.80, 404, 1349.19, 170
5, 15:34:00-000, 1137, 611, 526, 493, 1349.20, 437, 1350.11, 176
5, 15:35:00-000, 0, 0, 0, 21, 1346.38, 27, 1356.00, 157
5, 15:36:00-000, 1010, 493, 517, 454, 1348.78, 416, 1349.97, 140
5, 15:37:00-000, 1017, 509, 508, 370, 1348.79, 379, 1349.66, 157
5, 15:38:00-000, 902, 419, 483, 396, 1348.02, 356, 1348.94, 127
5, 15:39:00-000, 2, 1, 1, 30, 1343.43, 36, 1353.69, 138
5, 15:40:00-000, 1065, 461, 604, 308, 1348.92, 393, 1348.80, 132
5, 15:41:00-000, 986, 486, 500, 339, 1348.99, 364, 1349.03, 192
5, 15:42:00-000, 998, 500, 498, 392, 1349.67, 340, 1349.17, 244
5, 15:43:00-000, 3, 1, 2, 1, 1352.00, 2, 1351.00, 226
5, 15:44:00-000, 1075, 553, 522, 437, 1349.81, 410, 1349.99, 169
5, 15:45:00-000, 937, 448, 489, 336, 1348.55, 323, 1348.65, 211
5, 15:46:00-000, 1027, 546, 481, 409, 1349.04, 405, 1349.25, 209
5, 15:47:00-000, 0, 0, 0, 3, 1349.00, 0, 0.00, 189
5, 15:48:00-000, 1085, 582, 503, 435, 1348.69, 385, 1349.01, 161
5, 15:49:00-000, 1040, 518, 522, 352, 1349.00, 385, 1349.31, 186
5, 15:50:00-000, 985, 507, 478, 391, 1348.33, 346, 1348.47, 213
5, 15:51:00-000, 5, 5, 0, 3, 1348.00, 0, 0.00, 226
5, 15:52:00-000, 1097, 558, 539, 420, 1348.74, 392, 1348.66, 189
5, 15:53:00-000, 1100, 627, 473, 426, 1350.20, 356, 1349.65, 188
5, 15:54:00-000, 937, 489, 448, 343, 1349.65, 338, 1349.95, 219
5, 15:55:00-000, 1, 0, 1, 31, 1346.00, 0, 0.00, 263
5, 15:56:00-000, 941, 463, 478, 385, 1348.64, 364, 1349.09, 195
5, 15:57:00-000, 1080, 548, 532, 433, 1349.08, 434, 1349.42, 129
5, 15:58:00-000, 978, 518, 460, 361, 1349.73, 353, 1350.04, 140
5, 15:59:00-000, 1, 0, 1, 4, 1346.00, 1, 1345.00, 162
5, 16:00:00-000, 1101, 541, 560, 484, 1349.00, 449, 1349.29, 173
5, 16:01:00-000, 1014, 525, 489, 378, 1349.63, 396, 1350.18, 148
5, 16:02:00-000, 1061, 502, 559, 356, 1348.99, 382, 1349.91, 140
5, 16:03:00-000, 2, 0, 2, 12, 1346.00, 39, 1354.66, 168
5, 16:04:00-000, 903, 463, 440, 351, 1348.87, 375, 1350.51, 220
5, 16:05:00-000, 1001, 463, 538, 346, 1348.61, 379, 1348.97, 165
5, 16:06:00-000, 1062, 554, 508, 461, 1348.78, 455, 1349.93, 168
5, 16:07:00-000, 0, 0, 0, 0, 0.00, 6, 1354.33, 145
5, 16:08:00-000, 1065, 527, 538, 403, 1349.51, 434, 1350.39, 171
5, 16:09:00-000, 1038, 540, 498, 388, 1349.93, 362, 1350.01, 176
5, 16:10:00-000, 985, 517, 468, 384, 1348.34, 405, 1349.59, 131
5, 16:11:00-000, 9, 2, 7, 20, 1345.30, 33, 1354.94, 204
5, 16:12:00-000, 1014, 552, 462, 423, 1348.71, 378, 1349.89, 140
5, 16:13:00-000, 1050, 536, 514, 381, 1349.28, 409, 1349.72, 182
5, 16:14:00-000, 1048, 560, 488, 410, 1349.12, 398, 1350.18, 133
5, 16:15:00-000, 3, 0, 3, 14, 1345.00, 3, 1352.00, 151
5, 16:16:00-000, 1050, 506, 544, 415, 1348.48, 407, 1349.75, 193
5, 16:17:00-000, 1036, 494, 542, 401, 1348.25, 401, 1348.55, 205
5, 16:18:00-000, 1137, 547, 590, 467, 1348.48, 426, 1348.78, 151
5, 16:19:00-000, 7, 7, 0, 6, 1351.17, 11, 1354.00, 142
5, 16:20:00-000, 970, 517, 453, 428, 1348.96, 474, 1350.80, 202
5, 16:21:00-000, 998, 494, 504, 357, 1348.61, 352, 1349.18, 89
5, 16:22:00-000, 954, 461, 493, 380, 1348.80, 424, 1349.82, 139
5, 16:23:00-000, 0, 0, 0, 4, 1346.00, 14, 1354.93, 164
5, 16:24:00-000, 991, 484, 507, 374, 1349.27, 395, 1349.66, 148
5, 16:25:00-000, 1069, 546, 523, 439, 1349.51, 432, 1349.48, 107
5, 16:26:00-000, 1034, 552, 482, 455, 1349.13, 412, 1350.46, 150
5, 16:27:00-000, 6, 1, 5, 7, 1345.86, 2, 1354.00, 145
5, 16:28:00-000, 1078, 569, 509, 433, 1349.38, 388, 1349.59, 173
5, 16:29:00-000, 975, 485, 490, 407, 1348.87, 355, 1349.98, 157
6, 12:20:00-000, 6948, 3566, 3382, 1584, 1347.89, 1609, 1348.52, 0
6, 12:21:00-000, 0, 0, 0, 106, 1347.00, 34, 1353.00, 0
6, 12:22:00-000, 0, 0, 0, 115, 1346.00, 151, 1354.00, 0
6, 12:23:00-000, 0, 0, 0, 0, 0.00, 72, 1354.00, 0
6, 12:24:00-000, 0, 0, 0, 13, 1346.00, 114, 1354.91, 0
6, 12:25:00-000, 0, 0, 0, 35, 1346.00, 56, 1355.00, 0
6, 12:26:00-000, 0, 0, 0, 89, 1346.00, 59, 1355.00, 0
6, 12:27:00-000, 0, 0, 0, 3, 1345.00, 0, 0.00, 0
6, 12:28:00-000, 0, 0, 0, 36, 1345.00, 0, 0.00, 0
6, 12:29:00-000, 0, 0, 0, 13, 1345.00, 28, 1356.00, 0
6, 12:30:00-000, 0, 0, 0, 126, 1345.00, 31, 1356.00, 0
6, 12:33:00-000, 0, 0, 0, 0, 0.00, 2, 1356.00, 0
6, 12:34:00-000, 0, 0, 0, 0, 0.00, 62, 1356.00, 0
6, 12:35:00-000, 0, 0, 0, 0, 0.00, 49, 1356.00, 0
6, 12:36:00-000, 0, 0, 0, 0, 0.00, 17, 1356.00, 0
6, 12:37:00-000, 0, 0, 0, 0, 0.00, 12, 1356.00, 0
6, 12:38:00-000, 0, 0, 0, 0, 0.00, 66, 1356.19, 0
6, 12:39:00-000, 0, 0, 0, 0, 0.00, 55, 1357.00, 0
6, 12:40:00-000, 0, 0, 0, 0, 0.00, 6, 1357.00, 105
6, 12:41:00-000, 0, 0, 0, 0, 0.00, 0, 0.00, 102
6, 12:42:00-000, 0, 0, 0, 65, 1345.00, 0, 0.00, 90
6, 12:43:00-000, 0, 0, 0, 0, 0.00, 0, 0.00, 132
6, 12:44:00-000, 0, 0, 0, 3, 1345.00, 0, 0.00, 130
6, 12:45:00-000, 0, 0, 0, 0, 0.00, 0, 0.00, 113
6, 12:46:00-000, 0, 0, 0, 0, 0.00, 0, 0.00, 131
6, 12:47:00-000, 0, 0, 0, 0, 0.00, 0, 0.00, 122
6, 12:48:00-000, 0, 0, 0, 29, 1344.00, 0, 0.00, 114
6, 12:49:00-000, 0, 0, 0, 0, 0.00, 0, 0.00, 124
6, 12:50:00-000, 0, 0, 0, 40, 1344.00, 0, 0.00, 113
6, 12:51:00-000, 0, 0, 0, 1, 1344.00, 0, 0.00, 115
6, 12:52:00-000, 0, 0, 0, 35, 1344.00, 0, 0.00, 112
6, 12:53:00-000, 0, 0, 0, 0, 0.00, 0, 0.00, 97
6, 12:54:00-000, 0, 0, 0, 0, 0.00, 33, 1357.03, 97
6, 12:55:00-000, 0, 0, 0, 0, 0.00, 0, 0.00, 87
6, 12:56:00-000, 0, 0, 0, 0, 0.00, 0, 0.00, 98
6, 12:57:00-000, 0, 0, 0, 0, 0.00, 0, 0.00, 98
6, 12:58:00-000, 0, 0, 0, 0, 0.00, 0, 0.00, 109
6, 12:59:00-000, 0, 0, 0, 0, 0.00, 0, 0.00, 110
6, 15:40:00-000, 6968, 3449, 3519, 1653, 1347.62, 1666, 1348.27, 0
6, 15:41:00-000, 0, 0, 0, 79, 1346.50, 67, 1353.00, 0
6, 15:42:00-000, 0, 0, 0, 64, 1346.00, 161, 1354.00, 0
6, 15:43:00-000, 0, 0, 0, 24, 1346.00, 18, 1354.00, 0
6, 15:44:00-000, 1, 0, 1, 75, 1346.00, 62, 1354.09, 0
6, 15:46:00-000, 0, 0, 0, 74, 1345.00, 40, 1355.00, 0
6, 15:47:00-000, 0, 0, 0, 19, 1345.00, 12, 1355.00, 0
6, 15:48:00-000, 0, 0, 0, 34, 1345.00, 36, 1355.00, 0
6, 15:49:00-000, 0, 0, 0, 0, 0.00, 59, 1355.00, 0
6, 15:50:00-000, 0, 0, 0, 53, 1345.00, 0, 0.00, 0
6, 15:51:00-000, 0, 0, 0, 43, 1345.00, 18, 1355.00, 0
6, 15:52:00-000, 0, 0, 0, 24, 1345.00, 44, 1355.00, 0
6, 15:53:00-000, 0, 0, 0, 0, 0.00, 53, 1355.00, 0
6, 15:54:00-000, 0, 0, 0, 0, 0.00, 78, 1356.00, 0
6, 15:56:00-000, 0, 0, 0, 23, 1345.00, 56, 1356.00, 0
6, 15:57:00-000, 0, 0, 0, 33, 1344.00, 13, 1356.00, 0
6, 15:58:00-000, 0, 0, 0, 29, 1344.00, 45, 1356.00, 0
6, 15:59:00-000, 0, 0, 0, 0, 0.00, 2, 1356.00, 0
6, 16:00:00-000, 0, 0, 0, 34, 1344.00, 17, 1356.00, 124
6, 16:01:00-000, 0, 0, 0, 0, 0.00, 7, 1356.00, 115
6, 16:02:00-000, 0, 0, 0, 0, 0.00, 0, 0.00, 132
6, 16:03:00-000, 0, 0, 0, 0, 0.00, 0, 0.00, 133
6, 16:04:00-000, 0, 0, 0, 0, 0.00, 0, 0.00, 107
6, 16:05:00-000, 0, 0, 0, 0, 0.00, 0, 0.00, 107
6, 16:06:00-000, 0, 0, 0, 0, 0.00, 0, 0.00, 111
6, 16:07:00-000, 0, 0, 0, 0, 0.00, 0, 0.00, 103
6, 16:08:00-000, 0, 0, 0, 0, 0.00, 0, 0.00, 110
6, 16:09:00-000, 0, 0, 0, 0, 0.00, 0, 0.00, 115
6, 16:10:00-000, 0, 0, 0, 0, 0.00, 0, 0.00, 114
6, 16:11:00-000, 0, 0, 0, 0, 0.00, 0, 0.00, 116
6, 16:12:00-000, 0, 0, 0, 0, 0.00, 0, 0.00, 119
6, 16:13:00-000, 0, 0, 0, 0, 0.00, 0, 0.00, 112
6, 16:14:00-000, 0, 0, 0, 0, 0.00, 1, 1357.00, 87
6, 16:15:00-000, 0, 0, 0, 0, 0.00, 0, 0.00, 98
6, 16:16:00-000, 0, 0, 0, 0, 0.00, 0, 0.00, 116
6, 16:17:00-000, 0, 0, 0, 17, 1344.00, 0, 0.00, 112
6, 16:18:00-000, 1, 1, 0, 0, 0.00, 0, 0.00, 106
6, 16:19:00-000, 0, 0, 0, 0, 0.00, 0, 0.00, 99
6, 16:20:00-000, 17, 7, 10, 7, 1346.43, 9, 1350.78, 0
7, 09:07:00-000, 6218, 4087, 2131, 0, 0.00, 0, 0.00, 5372
7, 09:08:00-000, 1, 1, 0, 1, 1352.00, 1, 1352.00, 845
7, 09:20:00-000, 8842, 4196, 4646, 3, 1353.00, 3, 1351.00, 8836
7, 09:23:00-000, 1043, 13, 1030, 0, 0.00, 0, 0.00, 1043
7, 09:29:00-000, 991, 660, 331, 0, 0.00, 0, 0.00, 991
7, 09:31:00-000, 3594, 2733, 861, 0, 0.00, 0, 0.00, 3594
7, 09:33:00-000, 915, 15, 900, 15, 1349.07, 15, 1353.00, 885
7, 09:37:00-000, 3853, 1039, 2814, 0, 0.00, 0, 0.00, 3853
7, 09:44:00-000, 6123, 3372, 2751, 1, 1349.00, 1, 1349.00, 6121
7, 09:45:00-000, 5955, 3005, 2950, 0, 0.00, 0, 0.00, 5955
7, 09:46:00-000, 14786, 10286, 4500, 15, 1347.60, 15, 1350.60, 14756
7, 09:48:00-000, 501, 500, 1, 0, 0.00, 0, 0.00, 501
7, 09:49:00-000, 1293, 727, 566, 7, 1349.00, 7, 1349.00, 550
7, 09:50:00-000, 5501, 4254, 1247, 15, 1349.06, 15, 1349.80, 6200
7, 09:51:00-000, 8409, 5181, 3228, 6, 1348.00, 6, 1347.83, 8397
7, 09:52:00-000, 5261, 3581, 1680, 0, 0.00, 0, 0.00, 3803
7, 09:53:00-000, 13688, 7780, 5908, 0, 0.00, 0, 0.00, 15146
7, 09:54:00-000, 3031, 1305, 1726, 1, 1347.00, 6, 1352.00, 3024
7, 09:55:00-000, 2066, 776, 1290, 5, 1349.00, 0, 0.00, 2061
7, 09:58:00-000, 3429, 2046, 1383, 0, 0.00, 0, 0.00, 3422
7, 09:59:00-000, 5569, 2357, 3212, 0, 0.00, 0, 0.00, 5576
7, 10:00:00-000, 10911, 6925, 3986, 4, 1351.25, 4, 1351.50, 10886
7, 10:01:00-000, 17556, 7865, 9691, 6, 1349.00, 6, 1349.33, 17561
7, 10:02:00-000, 6974, 3732, 3242, 4, 1351.00, 0, 0.00, 6970
7, 10:03:00-000, 7582, 3955, 3627, 2, 1350.00, 6, 1349.67, 7574
7, 10:04:00-000, 8914, 2312, 6602, 0, 0.00, 0, 0.00, 7564
7, 10:05:00-000, 4100, 4090, 10, 0, 0.00, 0, 0.00, 5450
7, 10:08:00-000, 7284, 2340, 4944, 2, 1352.00, 2, 1352.00, 7280
7, 10:09:00-000, 1010, 1002, 8, 2, 1352.00, 2, 1352.00, 1006
7, 10:10:00-000, 378, 28, 350, 23, 1351.43, 23, 1352.00, 332
7, 10:11:00-000, 6315, 4326, 1989, 0, 0.00, 0, 0.00, 6315
7, 10:12:00-000, 16669, 5183, 11486, 8, 1350.50, 5, 1350.80, 16656
7, 10:13:00-000, 6149, 3578, 2571, 10, 1350.30, 13, 1351.31, 6126
7, 10:14:00-000, 5663, 3478, 2185, 3, 1353.00, 3, 1352.00, 5657
7, 10:15:00-000, 1014, 14, 1000, 0, 0.00, 0, 0.00, 0
7, 10:16:00-000, 2452, 2410, 42, 16, 1350.25, 16, 1348.37, 3434
7, 10:17:00-000, 9893, 6204, 3689, 2, 1353.00, 2, 1353.00, 9881
7, 10:18:00-000, 4088, 1002, 3086, 9, 1352.00, 9, 1351.67, 4078
7, 10:19:00-000, 11555, 7841, 3714, 0, 0.00, 0, 0.00, 11555
7, 10:20:00-000, 7150, 4346, 2804, 9, 1346.00, 9, 1351.56, 7132
7, 10:22:00-000, 3077, 2010, 1067, 0, 0.00, 0, 0.00, 3077
7, 10:24:00-000, 7206, 4330, 2876, 0, 0.00, 0, 0.00, 7206
7, 10:25:00-000, 19821, 7629, 12192, 7, 1348.57, 7, 1349.43, 19807
7, 10:26:00-000, 11756, 4945, 6811, 12, 1350.91, 23, 1351.61, 11721
7, 10:27:00-000, 1672, 12, 1660, 11, 1356.00, 0, 0.00, 1661
7, 10:28:00-000, 7819, 3130, 4689, 4, 1352.00, 4, 1351.25, 7808
7, 10:29:00-000, 1058, 8, 1050, 0, 0.00, 0, 0.00, 1061
7, 10:32:00-000, 1276, 1261, 15, 1, 1353.00, 1, 1352.00, 1274
7, 10:33:00-000, 17050, 9064, 7986, 0, 0.00, 0, 0.00, 17050
7, 10:34:00-000, 4130, 2228, 1902, 0, 0.00, 0, 0.00, 4130
7, 10:35:00-000, 13299, 4404, 8895, 84, 1349.30, 84, 1349.66, 13131
7, 10:36:00-000, 12009, 8658, 3351, 3, 1351.00, 3, 1351.67, 11163
7, 10:37:00-000, 14756, 5732, 9024, 16, 1349.81, 16, 1350.44, 15269
7, 10:38:00-000, 2217, 687, 1530, 1, 1351.00, 1, 1352.00, 2510
7, 10:42:00-000, 6913, 1909, 5004, 2, 1352.00, 2, 1351.50, 6909
7, 10:43:00-000, 9954, 4071, 5883, 0, 0.00, 0, 0.00, 9135
7, 10:44:00-000, 4, 4, 0, 8, 1352.00, 8, 1352.00, 807
7, 10:45:00-000, 1454, 39, 1415, 23, 1351.82, 23, 1353.09, 1408
7, 10:47:00-000, 3568, 2723, 845, 0, 0.00, 0, 0.00, 3568
7, 10:48:00-000, 14568, 6703, 7865, 19, 1349.84, 19, 1352.00, 14530
7, 10:49:00-000, 3165, 1189, 1976, 10, 1350.00, 10, 1347.00, 3145
7, 10:50:00-000, 1706, 1690, 16, 0, 0.00, 0, 0.00, 1706
7, 10:51:00-000, 2149, 2131, 18, 1, 1354.00, 1, 1351.00, 2147
7, 10:52:00-000, 16410, 9828, 6582, 0, 0.00, 0, 0.00, 16410
7, 10:53:00-000, 4427, 2823, 1604, 1, 1349.00, 1, 1350.00, 4425
7, 10:54:00-000, 6628, 3168, 3460, 33, 1350.00, 34, 1349.00, 6561
7, 10:55:00-000, 863, 2, 861, 2, 1352.00, 1, 1352.00, 860
7, 10:56:00-000, 289, 279, 10, 6, 1350.17, 6, 1351.00, 277
7, 11:02:00-000, 6597, 3590, 3007, 10, 1350.30, 6, 1350.17, 6581
7, 11:03:00-000, 18229, 8809, 9420, 0, 0.00, 4, 1349.00, 17428
7, 11:04:00-000, 2512, 1820, 692, 6, 1349.50, 6, 1349.17, 3297
7, 11:05:00-000, 12359, 5343, 7016, 2, 1351.00, 10, 1351.00, 12347
7, 11:06:00-000, 10111, 6567, 3544, 11, 1351.54, 3, 1351.00, 9335
7, 11:07:00-000, 16104, 9354, 6750, 1, 1352.00, 1, 1352.00, 16864
7, 11:08:00-000, 995, 15, 980, 0, 0.00, 0, 0.00, 995
7, 11:09:00-000, 15865, 7985, 7880, 3, 1349.00, 3, 1350.00, 15859
7, 11:10:00-000, 2995, 920, 2075, 10, 1349.80, 10, 1344.80, 2975
7, 11:11:00-000, 2535, 2417, 118, 0, 0.00, 0, 0.00, 2535
7, 11:15:00-000, 4955, 2639, 2316, 0, 0.00, 0, 0.00, 4955
7, 11:16:00-000, 5402, 3842, 1560, 31, 1346.32, 31, 1350.32, 5340
7, 11:17:00-000, 17983, 10155, 7828, 67, 1347.54, 67, 1346.86, 17849
7, 11:18:00-000, 5874, 3556, 2318, 20, 1347.45, 26, 1351.81, 5828
7, 11:19:00-000, 9412, 3287, 6125, 6, 1354.00, 0, 0.00, 7770
7, 11:20:00-000, 1164, 2, 1162, 16, 1348.69, 16, 1348.62, 2768
7, 11:21:00-000, 4981, 2853, 2128, 0, 0.00, 0, 0.00, 4981
7, 11:22:00-000, 6257, 2590, 3667, 95, 1353.48, 142, 1351.99, 6020
7, 11:23:00-000, 1150, 60, 1090, 47, 1356.34, 0, 0.00, 1103
7, 11:24:00-000, 2092, 92, 2000, 27, 1352.55, 27, 1352.00, 2038
7, 11:25:00-000, 4865, 2123, 2742, 16, 1349.87, 16, 1351.13, 4833
7, 11:27:00-000, 4998, 1732, 3266, 0, 0.00, 0, 0.00, 4229
7, 11:28:00-000, 0, 0, 0, 0, 0.00, 0, 0.00, 769
7, 11:32:00-000, 1213, 1202, 11, 2, 1354.00, 2, 1349.00, 1209
7, 11:33:00-000, 1245, 1237, 8, 7, 1353.86, 7, 1352.00, 1231
7, 11:34:00-000, 3623, 1057, 2566, 6, 1343.83, 6, 1350.33, 3611
7, 11:35:00-000, 1082, 896, 186, 0, 0.00, 0, 0.00, 1082
7, 11:36:00-000, 2494, 1031, 1463, 0, 0.00, 0, 0.00, 2494
7, 11:37:00-000, 4291, 2770, 1521, 0, 0.00, 0, 0.00, 3568
7, 11:38:00-000, 7054, 5488, 1566, 3, 1349.33, 3, 1349.00, 6072
7, 11:39:00-000, 10802, 8163, 2639, 4, 1350.50, 4, 1351.50, 11012
7, 11:40:00-000, 10932, 7552, 3380, 4, 1350.25, 4, 1350.00, 12405
7, 11:41:00-000, 17207, 9205, 8002, 12, 1348.00, 12, 1347.42, 17181
7, 11:42:00-000, 9467, 5768, 3699, 18, 1345.94, 22, 1350.13, 9429
7, 11:43:00-000, 4, 4, 0, 4, 1356.00, 0, 0.00, 0
7, 11:46:00-000, 7398, 3413, 3985, 1, 1352.00, 1, 1352.00, 7396
7, 11:47:00-000, 9818, 6818, 3000, 9, 1348.00, 9, 1346.11, 8831
7, 11:48:00-000, 10843, 4170, 6673, 39, 1348.31, 39, 1348.43, 11734
7, 11:49:00-000, 9350, 6163, 3187, 1, 1350.00, 1, 1350.00, 9348
7, 11:50:00-000, 11474, 5535, 5939, 19, 1348.31, 19, 1350.26, 11436
7, 11:51:00-000, 10437, 6553, 3884, 1, 1350.00, 1, 1352.00, 10435
7, 11:52:00-000, 2782, 1322, 1460, 22, 1354.72, 22, 1351.82, 2738
7, 11:53:00-000, 10926, 2681, 8245, 0, 0.00, 0, 0.00, 10926
7, 11:54:00-000, 9314, 2966, 6348, 10, 1349.40, 10, 1349.10, 8474
7, 11:55:00-000, 2582, 1166, 1416, 0, 0.00, 0, 0.00, 3402
7, 11:56:00-000, 13583, 8816, 4767, 20, 1351.00, 32, 1351.00, 13531
7, 11:57:00-000, 1512, 1449, 63, 19, 1350.47, 7, 1350.57, 1486
7, 11:58:00-000, 6118, 4571, 1547, 11, 1352.91, 11, 1351.45, 6096
7, 11:59:00-000, 13625, 5590, 8035, 0, 0.00, 0, 0.00, 13625
7, 12:00:00-000, 24419, 12870, 11549, 0, 0.00, 3, 1351.00, 23614
7, 12:01:00-000, 1362, 32, 1330, 32, 1355.84, 29, 1353.00, 2103
7, 12:02:00-000, 1002, 1000, 2, 1, 1349.00, 1, 1346.00, 1000
7, 12:03:00-000, 1010, 1000, 10, 2, 1348.00, 2, 1347.00, 1006
7, 12:04:00-000, 3312, 1830, 1482, 26, 1347.42, 19, 1349.00, 3267
7, 12:05:00-000, 10158, 5843, 4315, 4, 1347.00, 11, 1346.73, 10143
7, 12:06:00-000, 8268, 3724, 4544, 8, 1353.62, 16, 1352.00, 8244
7, 12:07:00-000, 5939, 3061, 2878, 9, 1355.56, 1, 1351.00, 5429
7, 12:08:00-000, 845, 45, 800, 14, 1352.00, 14, 1352.00, 1317
7, 12:09:00-000, 116, 16, 100, 0, 0.00, 0, 0.00, 116
7, 12:10:00-000, 2664, 2645, 19, 5, 1356.00, 5, 1352.00, 2654
7, 12:11:00-000, 7447, 3205, 4242, 71, 1347.20, 70, 1346.65, 7306
7, 12:12:00-000, 9793, 2320, 7473, 3, 1353.67, 5, 1351.20, 9785
7, 12:13:00-000, 13962, 6005, 7957, 6, 1351.17, 5, 1346.00, 12783
7, 12:14:00-000, 7689, 4349, 3340, 4, 1353.25, 4, 1351.00, 7410
7, 12:15:00-000, 14374, 8297, 6077, 1, 1352.00, 1, 1351.00, 14948
7, 12:16:00-000, 2272, 816, 1456, 13, 1350.15, 10, 1354.20, 3112
7, 12:17:00-000, 3, 0, 3, 0, 0.00, 3, 1350.00, 0
7, 12:20:00-000, 2344, 2330, 14, 0, 0.00, 0, 0.00, 2344
7, 12:21:00-000, 6610, 4276, 2334, 4, 1350.00, 4, 1348.75, 6602
7, 12:22:00-000, 7567, 4617, 2950, 1, 1350.00, 1, 1348.00, 7565
7, 12:23:00-000, 4085, 2927, 1158, 0, 0.00, 0, 0.00, 4085
7, 12:24:00-000, 6800, 3952, 2848, 1, 1355.00, 1, 1352.00, 6783
7, 12:25:00-000, 2454, 14, 2440, 0, 0.00, 0, 0.00, 2469
7, 12:27:00-000, 1934, 1920, 14, 0, 0.00, 0, 0.00, 1934
7, 12:30:00-000, 357, 352, 5, 2, 1351.00, 2, 1351.00, 353
7, 12:32:00-000, 6880, 2125, 4755, 1, 1350.00, 1, 1349.00, 6878
7, 12:33:00-000, 6676, 5770, 906, 0, 0.00, 0, 0.00, 6676
7, 12:37:00-000, 1578, 1570, 8, 0, 0.00, 0, 0.00, 1578
7, 12:42:00-000, 1872, 497, 1375, 14, 1349.43, 14, 1350.00, 1844
7, 12:44:00-000, 838, 18, 820, 0, 0.00, 0, 0.00, 838
7, 12:45:00-000, 7079, 2997, 4082, 0, 0.00, 0, 0.00, 7079
7, 12:46:00-000, 6401, 5559, 842, 0, 0.00, 0, 0.00, 6401
7, 12:47:00-000, 10958, 3026, 7932, 5, 1350.00, 4, 1350.75, 10949
7, 12:48:00-000, 10125, 5313, 4812, 0, 0.00, 1, 1346.00, 10124
7, 12:50:00-000, 6273, 2409, 3864, 1, 1352.00, 1, 1351.00, 6271
7, 12:52:00-000, 4464, 885, 3579, 8, 1351.75, 8, 1351.25, 4448
7, 12:54:00-000, 5606, 1207, 4399, 0, 0.00, 0, 0.00, 5606
7, 12:55:00-000, 4815, 3810, 1005, 0, 0.00, 0, 0.00, 3681
7, 12:56:00-000, 4324, 1047, 3277, 0, 0.00, 0, 0.00, 5458
7, 12:57:00-000, 15575, 10758, 4817, 0, 0.00, 1, 1352.00, 14820
7, 12:58:00-000, 5384, 1223, 4161, 6, 1349.50, 5, 1347.40, 6127
7, 12:59:00-000, 14084, 6077, 8007, 0, 0.00, 0, 0.00, 12604
7, 13:00:00-000, 4311, 997, 3314, 9, 1350.33, 9, 1349.33, 5773
7, 13:01:00-000, 3963, 2590, 1373, 14, 1355.00, 14, 1353.14, 3935
7, 13:02:00-000, 13926, 3051, 10875, 27, 1347.03, 27, 1348.89, 13872
7, 13:03:00-000, 6772, 4375, 2397, 13, 1350.69, 13, 1352.23, 6746
7, 13:04:00-000, 7534, 1949, 5585, 5, 1349.60, 5, 1351.00, 7524
7, 13:05:00-000, 5266, 2662, 2604, 15, 1356.47, 15, 1351.00, 5236
7, 13:07:00-000, 5130, 3143, 1987, 2, 1355.00, 2, 1350.00, 3614
7, 13:08:00-000, 3414, 3294, 120, 43, 1350.26, 43, 1349.48, 4840
7, 13:09:00-000, 11405, 5611, 5794, 0, 0.00, 0, 0.00, 11405
7, 13:10:00-000, 8637, 4136, 4501, 34, 1351.94, 34, 1351.15, 8569
7, 13:11:00-000, 2134, 2123, 11, 3, 1354.33, 3, 1350.00, 1365
7, 13:12:00-000, 3544, 32, 3512, 22, 1349.00, 22, 1346.00, 4263
7, 13:13:00-000, 11358, 5600, 5758, 6, 1348.17, 6, 1349.50, 11346
7, 13:14:00-000, 17596, 10168, 7428, 2, 1349.00, 2, 1351.00, 16881
7, 13:15:00-000, 1229, 7, 1222, 2, 1347.00, 2, 1346.00, 1936
7, 13:16:00-000, 2689, 2323, 366, 5, 1351.40, 5, 1349.20, 2679
7, 13:17:00-000, 708, 704, 4, 4, 1355.00, 4, 1352.00, 700
7, 13:18:00-000, 3249, 1059, 2190, 0, 0.00, 0, 0.00, 3249
7, 13:19:00-000, 22032, 11055, 10977, 12, 1348.67, 12, 1349.75, 22008
7, 13:20:00-000, 7735, 5284, 2451, 3, 1349.00, 9, 1353.00, 7709
7, 13:21:00-000, 16014, 7777, 8237, 19, 1350.52, 13, 1349.46, 15996
7, 13:22:00-000, 10593, 2449, 8144, 0, 0.00, 0, 0.00, 10593
7, 13:23:00-000, 5338, 1637, 3701, 0, 0.00, 0, 0.00, 5338
7, 13:25:00-000, 4582, 2996, 1586, 8, 1352.00, 8, 1345.88, 4566
7, 13:26:00-000, 1995, 1973, 22, 3, 1356.00, 3, 1351.00, 1989
7, 13:27:00-000, 9785, 6795, 2990, 0, 0.00, 0, 0.00, 9785
7, 13:28:00-000, 1239, 69, 1170, 48, 1353.37, 48, 1352.00, 1143
7, 13:30:00-000, 3352, 1610, 1742, 10, 1352.80, 10, 1352.00, 3332
7, 13:31:00-000, 6219, 2961, 3258, 0, 0.00, 0, 0.00, 6219
7, 13:32:00-000, 3914, 3139, 775, 20, 1348.50, 20, 1351.10, 3874
7, 13:33:00-000, 21325, 6856, 14469, 5, 1348.60, 7, 1348.71, 21307
7, 13:34:00-000, 13998, 8316, 5682, 60, 1347.52, 45, 1348.06, 13899
7, 13:35:00-000, 7976, 2556, 5420, 0, 0.00, 13, 1346.00, 7289
7, 13:36:00-000, 583, 573, 10, 3, 1352.00, 3, 1350.00, 1251
7, 13:37:00-000, 2637, 1285, 1352, 2, 1354.00, 2, 1349.00, 2633
7, 13:39:00-000, 1468, 1450, 18, 0, 0.00, 0, 0.00, 1468
7, 13:40:00-000, 108, 97, 11, 11, 1351.64, 11, 1352.00, 86
7, 13:41:00-000, 5599, 1457, 4142, 0, 0.00, 0, 0.00, 5599
7, 13:42:00-000, 4930, 2961, 1969, 19, 1351.31, 19, 1351.84, 4892
7, 13:43:00-000, 4047, 3990, 57, 0, 0.00, 0, 0.00, 4047
7, 13:44:00-000, 4256, 4233, 23, 9, 1348.89, 9, 1351.67, 4238
7, 13:45:00-000, 2450, 30, 2420, 0, 0.00, 0, 0.00, 2450
7, 13:47:00-000, 10248, 7540, 2708, 4, 1348.75, 4, 1350.75, 10240
7, 13:48:00-000, 4771, 1029, 3742, 3, 1350.00, 0, 0.00, 4768
7, 13:49:00-000, 12160, 5098, 7062, 24, 1350.29, 27, 1350.77, 12109
7, 13:50:00-000, 17264, 8888, 8376, 0, 0.00, 0, 0.00, 17264
7, 13:51:00-000, 6255, 2306, 3949, 5, 1352.00, 5, 1352.00, 6245
7, 13:52:00-000, 3435, 3400, 35, 7, 1348.00, 8, 1348.12, 3420
7, 13:53:00-000, 8242, 4377, 3865, 4, 1350.25, 3, 1349.33, 8235
7, 13:55:00-000, 4939, 3894, 1045, 0, 0.00, 0, 0.00, 4178
7, 13:56:00-000, 21899, 8665, 13234, 5, 1352.60, 5, 1352.00, 22650
7, 13:57:00-000, 11718, 8440, 3278, 1, 1352.00, 1, 1351.00, 11716
7, 13:58:00-000, 12013, 3429, 8584, 28, 1349.35, 25, 1351.08, 11960
7, 13:59:00-000, 7950, 3149, 4801, 1, 1350.00, 4, 1347.75, 7945
7, 14:00:00-000, 12445, 3924, 8521, 0, 0.00, 0, 0.00, 12445
7, 14:01:00-000, 6931, 4445, 2486, 21, 1354.09, 21, 1351.43, 6889
7, 14:03:00-000, 1628, 702, 926, 0, 0.00, 0, 0.00, 1628
7, 14:04:00-000, 2272, 789, 1483, 12, 1345.75, 12, 1351.08, 2248
7, 14:05:00-000, 5397, 1925, 3472, 0, 0.00, 0, 0.00, 5397
7, 14:06:00-000, 18121, 9796, 8325, 36, 1350.53, 64, 1351.54, 18021
7, 14:07:00-000, 8490, 4864, 3626, 30, 1353.53, 2, 1351.00, 8442
7, 14:08:00-000, 18082, 6133, 11949, 8, 1349.87, 8, 1350.00, 17629
7, 14:09:00-000, 13559, 5773, 7786, 41, 1348.19, 41, 1348.75, 13930
7, 14:10:00-000, 7874, 5908, 1966, 5, 1353.80, 5, 1352.20, 7864
7, 14:11:00-000, 7230, 5870, 1360, 0, 0.00, 0, 0.00, 7230
7, 14:12:00-000, 7816, 3779, 4037, 0, 0.00, 0, 0.00, 7816
7, 14:13:00-000, 7319, 5761, 1558, 1, 1353.00, 1, 1352.00, 5827
7, 14:14:00-000, 1788, 1085, 703, 6, 1349.00, 6, 1348.00, 3266
7, 14:16:00-000, 14546, 5043, 9503, 18, 1350.06, 25, 1352.08, 14503
7, 14:17:00-000, 9693, 3698, 5995, 11, 1350.09, 4, 1351.75, 9678
7, 14:19:00-000, 13340, 8242, 5098, 2, 1353.00, 2, 1351.00, 12355
7, 14:20:00-000, 5511, 4397, 1114, 9, 1351.11, 9, 1349.89, 6474
7, 14:21:00-000, 5983, 5931, 52, 1, 1351.00, 1, 1351.00, 5981
7, 14:22:00-000, 10161, 6325, 3836, 7, 1348.71, 7, 1348.71, 9096
7, 14:23:00-000, 8726, 5003, 3723, 12, 1350.83, 12, 1351.00, 9736
7, 14:24:00-000, 4276, 2084, 2192, 64, 1353.01, 64, 1352.87, 4165
7, 14:25:00-000, 928, 7, 921, 1, 1350.00, 1, 1347.00, 926
7, 14:26:00-000, 7907, 5912, 1995, 4, 1348.00, 4, 1349.00, 7899
7, 14:27:00-000, 15437, 8461, 6976, 1, 1349.00, 0, 0.00, 15436
7, 14:28:00-000, 8308, 4832, 3476, 1, 1349.00, 2, 1348.00, 8305
7, 14:29:00-000, 8404, 4164, 4240, 5, 1351.20, 5, 1350.00, 8394
7, 14:30:00-000, 2149, 19, 2130, 0, 0.00, 0, 0.00, 2149
7, 14:31:00-000, 3534, 2130, 1404, 3, 1352.33, 3, 1350.33, 3528
7, 14:32:00-000, 1351, 21, 1330, 4, 1357.00, 4, 1352.00, 1343
7, 14:34:00-000, 14566, 5152, 9414, 0, 0.00, 0, 0.00, 14566
7, 14:35:00-000, 9324, 5143, 4181, 1, 1351.00, 1, 1350.00, 9322
7, 14:38:00-000, 7046, 154, 6892, 14, 1350.78, 15, 1350.13, 7017
7, 14:39:00-000, 9588, 4623, 4965, 1, 1350.00, 0, 0.00, 9587
7, 14:40:00-000, 6467, 2989, 3478, 13, 1351.69, 13, 1350.38, 6441
7, 14:41:00-000, 8396, 2458, 5938, 0, 0.00, 0, 0.00, 8396
7, 14:43:00-000, 3317, 1061, 2256, 0, 0.00, 0, 0.00, 3317
7, 14:44:00-000, 7868, 3426, 4442, 23, 1348.13, 23, 1346.47, 6749
7, 14:45:00-000, 15769, 9271, 6498, 20, 1348.15, 20, 1347.75, 16032
7, 14:46:00-000, 2165, 2150, 15, 0, 0.00, 0, 0.00, 2935
7, 14:48:00-000, 2386, 1315, 1071, 0, 0.00, 0, 0.00, 2386
7, 14:49:00-000, 9174, 7112, 2062, 2, 1351.00, 2, 1351.50, 9170
7, 14:50:00-000, 8723, 3571, 5152, 15, 1348.20, 11, 1352.00, 8697
7, 14:51:00-000, 4, 0, 4, 0, 0.00, 4, 1349.50, 0
7, 14:52:00-000, 1090, 1070, 20, 3, 1348.00, 3, 1349.00, 1084
7, 14:53:00-000, 5923, 2537, 3386, 12, 1350.67, 12, 1349.58, 4291
7, 14:54:00-000, 7334, 4495, 2839, 30, 1348.73, 30, 1351.00, 8882
7, 14:55:00-000, 12055, 5662, 6393, 21, 1352.47, 21, 1351.71, 12013
7, 14:56:00-000, 13215, 9002, 4213, 17, 1349.18, 19, 1348.47, 13179
7, 14:57:00-000, 2, 2, 0, 2, 1353.00, 0, 0.00, 0
7, 14:58:00-000, 3307, 2457, 850, 15, 1350.87, 15, 1350.47, 3277
7, 14:59:00-000, 12310, 6578, 5732, 4, 1349.50, 4, 1349.25, 12302
7, 15:00:00-000, 15724, 7542, 8182, 5, 1351.40, 5, 1352.00, 15714
7, 15:01:00-000, 2576, 408, 2168, 8, 1350.87, 8, 1350.75, 2560
7, 15:02:00-000, 8942, 4774, 4168, 0, 0.00, 18, 1351.44, 8419
7, 15:03:00-000, 10859, 3152, 7707, 24, 1351.21, 6, 1352.00, 11334
7, 15:04:00-000, 5867, 4378, 1489, 0, 0.00, 0, 0.00, 5867
7, 15:05:00-000, 5848, 3675, 2173, 0, 0.00, 0, 0.00, 5585
7, 15:06:00-000, 6668, 4586, 2082, 55, 1351.23, 57, 1351.40, 6819
7, 15:07:00-000, 15800, 4055, 11745, 12, 1351.17, 11, 1350.91, 15777
7, 15:08:00-000, 1, 1, 0, 1, 1352.00, 0, 0.00, 0
7, 15:09:00-000, 12691, 5392, 7299, 2, 1351.00, 2, 1351.50, 12687
7, 15:10:00-000, 4088, 2860, 1228, 26, 1353.27, 26, 1351.46, 4036
7, 15:11:00-000, 17028, 8811, 8217, 0, 0.00, 0, 0.00, 16172
7, 15:12:00-000, 7695, 4664, 3031, 4, 1349.00, 4, 1352.75, 8543
7, 15:13:00-000, 4838, 2506, 2332, 2, 1350.50, 1, 1349.00, 4835
7, 15:14:00-000, 18357, 4819, 13538, 6, 1349.00, 7, 1349.86, 18344
7, 15:15:00-000, 20583, 8358, 12225, 2, 1351.50, 2, 1351.50, 19299
7, 15:16:00-000, 6666, 5429, 1237, 2, 1352.00, 2, 1351.00, 7942
7, 15:17:00-000, 13174, 8430, 4744, 2, 1349.00, 2, 1348.50, 13170
7, 15:18:00-000, 7145, 2539, 4606, 18, 1348.22, 18, 1348.00, 7109
7, 15:19:00-000, 970, 20, 950, 17, 1355.00, 17, 1352.00, 936
7, 15:20:00-000, 2347, 1393, 954, 1, 1355.00, 1, 1351.00, 2345
7, 15:21:00-000, 5539, 1057, 4482, 22, 1356.00, 22, 1352.00, 5495
7, 15:22:00-000, 5873, 2570, 3303, 12, 1349.00, 12, 1346.83, 5849
7, 15:23:00-000, 2951, 1105, 1846, 0, 0.00, 0, 0.00, 2951
7, 15:24:00-000, 9620, 870, 8750, 5, 1350.60, 5, 1349.60, 9610
7, 15:25:00-000, 9340, 4487, 4853, 4, 1351.00, 4, 1350.50, 9332
7, 15:26:00-000, 9961, 7197, 2764, 23, 1347.22, 23, 1347.00, 9915
7, 15:27:00-000, 5881, 4431, 1450, 0, 0.00, 0, 0.00, 5881
7, 15:28:00-000, 5983, 2666, 3317, 5, 1348.40, 5, 1353.00, 5973
7, 15:29:00-000, 3426, 791, 2635, 24, 1346.00, 24, 1346.58, 3378
7, 15:30:00-000, 13942, 5408, 8534, 4, 1352.50, 4, 1351.50, 13934
7, 15:31:00-000, 8791, 2928, 5863, 3, 1349.00, 2, 1351.00, 8786
7, 15:32:00-000, 10488, 5247, 5241, 2, 1350.00, 4, 1349.50, 10482
7, 15:33:00-000, 12205, 6286, 5919, 11, 1348.45, 10, 1350.50, 12184
7, 15:34:00-000, 3650, 2870, 780, 28, 1346.71, 28, 1346.78, 3594
7, 15:35:00-000, 1505, 288, 1217, 15, 1346.73, 15, 1349.66, 1475
7, 15:37:00-000, 6227, 5128, 1099, 0, 0.00, 1, 1351.00, 6226
7, 15:38:00-000, 3410, 3361, 49, 26, 1347.61, 25, 1347.60, 3359
7, 15:39:00-000, 3337, 2293, 1044, 0, 0.00, 0, 0.00, 3337
7, 15:40:00-000, 1052, 6, 1046, 6, 1348.00, 6, 1347.00, 1040
7, 15:42:00-000, 2732, 38, 2694, 5, 1349.00, 4, 1349.00, 2723
7, 15:43:00-000, 1005, 1002, 3, 2, 1353.00, 3, 1350.33, 1000
7, 15:45:00-000, 2132, 22, 2110, 15, 1350.80, 15, 1352.00, 2102
7, 15:47:00-000, 1323, 1310, 13, 0, 0.00, 0, 0.00, 1323
7, 15:48:00-000, 2267, 879, 1388, 8, 1353.25, 8, 1351.00, 2251
7, 15:50:00-000, 847, 840, 7, 1, 1346.00, 0, 0.00, 846
7, 15:51:00-000, 6639, 5569, 1070, 6, 1351.00, 8, 1349.88, 6625
7, 15:52:00-000, 6234, 57, 6177, 30, 1350.93, 29, 1351.20, 6175
7, 15:54:00-000, 2329, 2311, 18, 1, 1350.00, 1, 1350.00, 2327
7, 15:55:00-000, 2060, 1158, 902, 0, 0.00, 0, 0.00, 2060
7, 15:56:00-000, 1198, 1190, 8, 0, 0.00, 0, 0.00, 1198
7, 15:58:00-000, 869, 9, 860, 0, 0.00, 0, 0.00, 869
7, 15:59:00-000, 3724, 14, 3710, 0, 0.00, 0, 0.00, 3724
7, 16:00:00-000, 1192, 22, 1170, 0, 0.00, 0, 0.00, 1192
7, 16:01:00-000, 964, 69, 895, 0, 0.00, 0, 0.00, 964
7, 16:02:00-000, 9926, 4879, 5047, 10, 1350.60, 10, 1351.50, 9906
7, 16:03:00-000, 6096, 1419, 4677, 1, 1349.00, 0, 0.00, 4698
7, 16:04:00-000, 5028, 2607, 2421, 0, 0.00, 1, 1349.00, 6424
7, 16:05:00-000, 3635, 2179, 1456, 16, 1348.00, 16, 1351.56, 3603
7, 16:06:00-000, 2947, 744, 2203, 21, 1346.86, 21, 1347.43, 2905
7, 16:07:00-000, 1183, 13, 1170, 0, 0.00, 0, 0.00, 1183
7, 16:08:00-000, 3642, 1913, 1729, 3, 1348.00, 1, 1349.00, 3638
7, 16:09:00-000, 66, 62, 4, 2, 1351.00, 4, 1349.50, 60
7, 16:10:00-000, 6307, 2679, 3628, 10, 1352.50, 10, 1351.70, 5121
7, 16:11:00-000, 15014, 6610, 8404, 0, 0.00, 0, 0.00, 16180
7, 16:12:00-000, 6419, 3861, 2558, 13, 1353.31, 13, 1352.54, 6393
7, 16:13:00-000, 10053, 2949, 7104, 22, 1348.86, 22, 1352.00, 10009
7, 16:14:00-000, 1344, 781, 563, 13, 1350.31, 13, 1352.77, 1318
7, 16:15:00-000, 3619, 1546, 2073, 1, 1352.00, 1, 1352.00, 3617
7, 16:16:00-000, 2100, 26, 2074, 4, 1350.00, 4, 1348.00, 2092
7, 16:17:00-000, 7191, 6538, 653, 4, 1348.00, 4, 1346.25, 7183
7, 16:18:00-000, 5471, 2357, 3114, 26, 1348.54, 26, 1351.96, 5419
7, 16:19:00-000, 12700, 5300, 7400, 37, 1348.70, 37, 1350.13, 12626
7, 16:20:00-000, 17128, 10381, 6747, 12, 1353.25, 12, 1351.83, 17084
7, 16:21:00-000, 15901, 7440, 8461, 13, 1349.38, 13, 1352.00, 15895
7, 16:22:00-000, 17780, 11197, 6583, 14, 1351.07, 13, 1351.15, 17753
7, 16:23:00-000, 9622, 6069, 3553, 11, 1349.36, 12, 1349.83, 9599
7, 16:24:00-000, 14030, 3572, 10458, 25, 1349.40, 25, 1348.64, 13980
7, 16:25:00-000, 5747, 2343, 3404, 1, 1355.00, 1, 1351.00, 5745
7, 16:26:00-000, 18016, 6558, 11458, 47, 1348.53, 47, 1348.76, 17922
7, 16:27:00-000, 6945, 4817, 2128, 0, 0.00, 0, 0.00, 6945
7, 16:28:00-000, 8713, 1932, 6781, 17, 1350.53, 17, 1351.18, 8679
7, 16:29:00-000, 13901, 6556, 7345, 27, 1350.22, 29, 1349.31, 13845
9, 09:07:00-000, 4080, 3080, 1000, 0, 0.00, 0, 0.00, 4080
9, 09:20:00-000, 1790, 920, 870, 0, 0.00, 0, 0.00, 1790
9, 09:30:00-000, 1360, 0, 1360, 0, 0.00, 0, 0.00, 1360
9, 09:31:00-000, 2208, 1378, 830, 8, 1353.25, 8, 1352.00, 2192
9, 09:44:00-000, 1360, 0, 1360, 0, 0.00, 0, 0.00, 1360
9, 09:45:00-000, 3240, 2540, 700, 0, 0.00, 0, 0.00, 3240
9, 09:46:00-000, 10130, 5720, 4410, 0, 0.00, 0, 0.00, 10130
9, 09:47:00-000, 770, 770, 0, 0, 0.00, 0, 0.00, 770
9, 09:49:00-000, 975, 970, 5, 5, 1348.00, 5, 1346.00, 965
9, 09:50:00-000, 4360, 1990, 2370, 0, 0.00, 0, 0.00, 3420
9, 09:51:00-000, 5630, 1490, 4140, 0, 0.00, 0, 0.00, 6570
9, 09:53:00-000, 1230, 0, 1230, 0, 0.00, 0, 0.00, 1230
9, 09:54:00-000, 1380, 0, 1380, 0, 0.00, 0, 0.00, 1380
9, 09:55:00-000, 2850, 770, 2080, 0, 0.00, 0, 0.00, 2850
9, 09:58:00-000, 1080, 0, 1080, 0, 0.00, 0, 0.00, 1080
9, 09:59:00-000, 8050, 810, 7240, 0, 0.00, 0, 0.00, 8050
9, 10:00:00-000, 5730, 2490, 3240, 0, 0.00, 0, 0.00, 5730
9, 10:01:00-000, 8820, 5420, 3400, 0, 0.00, 0, 0.00, 7090
9, 10:02:00-000, 2788, 2780, 8, 8, 1348.00, 8, 1348.62, 4502
9, 10:03:00-000, 4330, 1530, 2800, 0, 0.00, 0, 0.00, 4330
9, 10:04:00-000, 3870, 670, 3200, 0, 0.00, 0, 0.00, 3870
9, 10:05:00-000, 3032, 12, 3020, 7, 1353.57, 7, 1353.00, 3018
9, 10:08:00-000, 12370, 5890, 6480, 0, 0.00, 0, 0.00, 12370
9, 10:11:00-000, 3480, 1200, 2280, 0, 0.00, 0, 0.00, 3480
9, 10:12:00-000, 5040, 2360, 2680, 0, 0.00, 0, 0.00, 5040
9, 10:13:00-000, 5510, 4090, 1420, 0, 0.00, 0, 0.00, 5510
9, 10:15:00-000, 2630, 0, 2630, 0, 0.00, 0, 0.00, 2630
9, 10:16:00-000, 840, 840, 0, 0, 0.00, 0, 0.00, 840
9, 10:17:00-000, 2610, 1210, 1400, 0, 0.00, 0, 0.00, 2610
9, 10:18:00-000, 2250, 0, 2250, 0, 0.00, 0, 0.00, 2250
9, 10:19:00-000, 7130, 1680, 5450, 0, 0.00, 0, 0.00, 6270
9, 10:20:00-000, 4070, 2740, 1330, 0, 0.00, 0, 0.00, 4930
9, 10:22:00-000, 2310, 2310, 0, 0, 0.00, 0, 0.00, 2310
9, 10:24:00-000, 2230, 0, 2230, 0, 0.00, 0, 0.00, 2230
9, 10:25:00-000, 9261, 4900, 4361, 1, 1348.00, 1, 1350.00, 8399
9, 10:26:00-000, 6790, 4300, 2490, 0, 0.00, 0, 0.00, 7650
9, 10:27:00-000, 740, 0, 740, 0, 0.00, 0, 0.00, 740
9, 10:28:00-000, 9030, 6770, 2260, 0, 0.00, 0, 0.00, 9030
9, 10:29:00-000, 1380, 1380, 0, 0, 0.00, 0, 0.00, 1380
9, 10:33:00-000, 9370, 3050, 6320, 0, 0.00, 0, 0.00, 9150
9, 10:34:00-000, 3168, 2379, 789, 14, 1348.28, 14, 1350.21, 3360
9, 10:35:00-000, 5640, 3690, 1950, 0, 0.00, 0, 0.00, 5640
9, 10:36:00-000, 9680, 6260, 3420, 0, 0.00, 0, 0.00, 9680
9, 10:37:00-000, 7242, 1922, 5320, 2, 1351.50, 2, 1354.00, 7238
9, 10:42:00-000, 5790, 3450, 2340, 0, 0.00, 0, 0.00, 5790
9, 10:43:00-000, 4280, 860, 3420, 0, 0.00, 0, 0.00, 4280
9, 10:47:00-000, 6720, 3220, 3500, 0, 0.00, 0, 0.00, 6720
9, 10:48:00-000, 7390, 2020, 5370, 0, 0.00, 0, 0.00, 7390
9, 10:49:00-000, 5008, 3230, 1778, 18, 1348.00, 18, 1349.44, 4972
9, 10:50:00-000, 1200, 1200, 0, 0, 0.00, 0, 0.00, 1200
9, 10:51:00-000, 5200, 1120, 4080, 0, 0.00, 0, 0.00, 5200
9, 10:52:00-000, 9300, 3510, 5790, 0, 0.00, 0, 0.00, 9300
9, 10:53:00-000, 1940, 1170, 770, 0, 0.00, 0, 0.00, 1940
9, 10:54:00-000, 2290, 1080, 1210, 0, 0.00, 0, 0.00, 2290
9, 10:56:00-000, 1440, 1440, 0, 0, 0.00, 0, 0.00, 1440
9, 10:58:00-000, 1000, 0, 1000, 0, 0.00, 0, 0.00, 1000
9, 11:03:00-000, 8750, 2080, 6670, 0, 0.00, 0, 0.00, 7260
9, 11:04:00-000, 780, 0, 780, 0, 0.00, 0, 0.00, 2270
9, 11:05:00-000, 4110, 710, 3400, 0, 0.00, 0, 0.00, 4110
9, 11:06:00-000, 6790, 2050, 4740, 0, 0.00, 0, 0.00, 6790
9, 11:07:00-000, 7970, 2590, 5380, 0, 0.00, 0, 0.00, 7290
9, 11:08:00-000, 2130, 1320, 810, 0, 0.00, 0, 0.00, 2810
9, 11:09:00-000, 7110, 4300, 2810, 0, 0.00, 0, 0.00, 7110
9, 11:10:00-000, 1459, 1430, 29, 17, 1347.23, 17, 1350.12, 1425
9, 11:11:00-000, 4570, 3420, 1150, 0, 0.00, 0, 0.00, 4570
9, 11:13:00-000, 850, 0, 850, 0, 0.00, 0, 0.00, 850
9, 11:15:00-000, 1160, 0, 1160, 0, 0.00, 0, 0.00, 1160
9, 11:16:00-000, 9150, 4500, 4650, 0, 0.00, 0, 0.00, 9150
9, 11:17:00-000, 6380, 5270, 1110, 0, 0.00, 0, 0.00, 6380
9, 11:18:00-000, 2010, 0, 2010, 0, 0.00, 0, 0.00, 2010
9, 11:19:00-000, 4550, 830, 3720, 0, 0.00, 0, 0.00, 4550
9, 11:22:00-000, 2445, 1462, 983, 55, 1351.65, 55, 1352.72, 2335
9, 11:24:00-000, 2106, 2080, 26, 26, 1347.00, 19, 1351.68, 2061
9, 11:25:00-000, 2837, 1190, 1647, 10, 1352.60, 17, 1349.00, 2810
9, 11:26:00-000, 2763, 1393, 1370, 30, 1352.20, 33, 1352.00, 2700
9, 11:27:00-000, 793, 793, 0, 3, 1355.00, 0, 0.00, 790
9, 11:28:00-000, 3135, 2415, 720, 3, 1350.67, 3, 1351.00, 3129
9, 11:29:00-000, 1374, 14, 1360, 8, 1354.50, 8, 1352.00, 1358
9, 11:31:00-000, 1470, 1470, 0, 0, 0.00, 0, 0.00, 1470
9, 11:33:00-000, 650, 650, 0, 0, 0.00, 0, 0.00, 650
9, 11:34:00-000, 790, 0, 790, 0, 0.00, 0, 0.00, 790
9, 11:38:00-000, 5638, 3970, 1668, 8, 1347.00, 8, 1349.63, 5622
9, 11:39:00-000, 4300, 3300, 1000, 0, 0.00, 0, 0.00, 4300
9, 11:40:00-000, 7870, 5160, 2710, 0, 0.00, 0, 0.00, 7870
9, 11:41:00-000, 7811, 4561, 3250, 11, 1354.64, 11, 1349.00, 7789
9, 11:42:00-000, 2154, 894, 1260, 4, 1356.00, 4, 1353.00, 2146
9, 11:46:00-000, 6280, 1500, 4780, 0, 0.00, 0, 0.00, 6280
9, 11:47:00-000, 4205, 745, 3460, 5, 1349.00, 5, 1354.00, 4195
9, 11:48:00-000, 9670, 5850, 3820, 0, 0.00, 0, 0.00, 9670
9, 11:49:00-000, 5210, 0, 5210, 0, 0.00, 0, 0.00, 5210
9, 11:50:00-000, 4370, 1130, 3240, 0, 0.00, 0, 0.00, 4370
9, 11:51:00-000, 2060, 1120, 940, 0, 0.00, 0, 0.00, 2060
9, 11:53:00-000, 3800, 3800, 0, 0, 0.00, 0, 0.00, 2610
9, 11:54:00-000, 5320, 1000, 4320, 0, 0.00, 0, 0.00, 6510
9, 11:55:00-000, 2063, 1153, 910, 3, 1355.00, 3, 1353.00, 2057
9, 11:56:00-000, 5442, 3132, 2310, 33, 1350.21, 33, 1352.00, 5376
9, 11:57:00-000, 2260, 0, 2260, 0, 0.00, 0, 0.00, 2260
9, 11:58:00-000, 940, 940, 0, 0, 0.00, 0, 0.00, 940
9, 11:59:00-000, 5270, 3820, 1450, 0, 0.00, 0, 0.00, 5270
9, 12:00:00-000, 12241, 4770, 7471, 1, 1347.00, 1, 1349.00, 12049
9, 12:01:00-000, 2490, 2490, 0, 0, 0.00, 0, 0.00, 2680
9, 12:04:00-000, 3675, 55, 3620, 26, 1352.96, 29, 1352.65, 3620
9, 12:05:00-000, 3851, 1481, 2370, 11, 1350.63, 8, 1353.00, 3832
9, 12:06:00-000, 3735, 2535, 1200, 25, 1356.00, 25, 1353.00, 3685
9, 12:09:00-000, 2460, 0, 2460, 0, 0.00, 0, 0.00, 2460
9, 12:11:00-000, 3220, 900, 2320, 0, 0.00, 0, 0.00, 3220
9, 12:12:00-000, 5822, 2732, 3090, 2, 1352.00, 2, 1354.00, 5818
9, 12:13:00-000, 3815, 2254, 1561, 19, 1352.89, 19, 1351.84, 3777
9, 12:14:00-000, 3590, 1430, 2160, 0, 0.00, 0, 0.00, 3590
9, 12:15:00-000, 6940, 3620, 3320, 0, 0.00, 0, 0.00, 6940
9, 12:16:00-000, 760, 760, 0, 0, 0.00, 0, 0.00, 760
9, 12:17:00-000, 990, 990, 0, 0, 0.00, 0, 0.00, 990
9, 12:20:00-000, 910, 910, 0, 0, 0.00, 0, 0.00, 910
9, 12:21:00-000, 3880, 0, 3880, 0, 0.00, 0, 0.00, 3880
9, 12:22:00-000, 4220, 3280, 940, 0, 0.00, 0, 0.00, 4220
9, 12:23:00-000, 4860, 2030, 2830, 0, 0.00, 0, 0.00, 4860
9, 12:25:00-000, 970, 0, 970, 0, 0.00, 0, 0.00, 970
9, 12:27:00-000, 900, 900, 0, 0, 0.00, 0, 0.00, 900
9, 12:28:00-000, 1041, 1, 1040, 1, 1354.00, 1, 1352.00, 1039
9, 12:32:00-000, 7060, 4440, 2620, 0, 0.00, 0, 0.00, 7060
9, 12:33:00-000, 2160, 0, 2160, 0, 0.00, 0, 0.00, 2160
9, 12:36:00-000, 1380, 0, 1380, 0, 0.00, 0, 0.00, 1380
9, 12:37:00-000, 1240, 0, 1240, 0, 0.00, 0, 0.00, 1240
9, 12:38:00-000, 1861, 1080, 781, 11, 1346.27, 11, 1349.18, 1839
9, 12:41:00-000, 1960, 850, 1110, 0, 0.00, 0, 0.00, 1960
9, 12:45:00-000, 1940, 0, 1940, 0, 0.00, 0, 0.00, 1340
9, 12:46:00-000, 2322, 1162, 1160, 32, 1355.40, 32, 1352.00, 2858
9, 12:47:00-000, 2560, 1290, 1270, 0, 0.00, 0, 0.00, 2560
9, 12:48:00-000, 4580, 3280, 1300, 0, 0.00, 0, 0.00, 4580
9, 12:49:00-000, 1203, 1090, 113, 61, 1349.42, 61, 1345.76, 1081
9, 12:50:00-000, 3253, 3250, 3, 3, 1345.00, 3, 1350.00, 3247
9, 12:52:00-000, 2720, 2720, 0, 0, 0.00, 0, 0.00, 2720
9, 12:54:00-000, 2220, 2220, 0, 0, 0.00, 0, 0.00, 2220
9, 12:55:00-000, 6120, 5320, 800, 0, 0.00, 0, 0.00, 6120
9, 12:56:00-000, 10380, 7960, 2420, 0, 0.00, 0, 0.00, 10380
9, 12:57:00-000, 8240, 5970, 2270, 0, 0.00, 0, 0.00, 8240
9, 12:58:00-000, 3500, 0, 3500, 0, 0.00, 0, 0.00, 3500
9, 12:59:00-000, 10700, 5220, 5480, 0, 0.00, 0, 0.00, 10700
9, 13:00:00-000, 2633, 1170, 1463, 3, 1349.00, 3, 1349.33, 2627
9, 13:01:00-000, 4071, 2829, 1242, 35, 1352.85, 35, 1351.54, 4001
9, 13:02:00-000, 10520, 7340, 3180, 0, 0.00, 0, 0.00, 10520
9, 13:04:00-000, 3440, 2750, 690, 0, 0.00, 0, 0.00, 3440
9, 13:05:00-000, 1180, 0, 1180, 0, 0.00, 0, 0.00, 1180
9, 13:06:00-000, 3597, 1398, 2199, 21, 1348.76, 21, 1349.90, 3555
9, 13:07:00-000, 2180, 0, 2180, 0, 0.00, 0, 0.00, 2180
9, 13:09:00-000, 9306, 3446, 5860, 18, 1353.22, 18, 1351.00, 9270
9, 13:10:00-000, 6042, 1632, 4410, 2, 1349.00, 2, 1352.00, 6038
9, 13:11:00-000, 930, 930, 0, 0, 0.00, 0, 0.00, 930
9, 13:12:00-000, 3264, 2070, 1194, 34, 1345.26, 34, 1348.56, 3196
9, 13:13:00-000, 1203, 1200, 3, 3, 1348.00, 3, 1344.00, 1197
9, 13:14:00-000, 7180, 950, 6230, 3, 1347.00, 0, 0.00, 7177
9, 13:15:00-000, 3, 0, 3, 0, 0.00, 3, 1347.33, 0
9, 13:16:00-000, 2750, 1440, 1310, 0, 0.00, 0, 0.00, 2750
9, 13:18:00-000, 1990, 880, 1110, 0, 0.00, 0, 0.00, 1990
9, 13:19:00-000, 12580, 2230, 10350, 0, 0.00, 0, 0.00, 12580
9, 13:20:00-000, 2991, 1440, 1551, 21, 1349.00, 21, 1346.33, 2949
9, 13:21:00-000, 8936, 5136, 3800, 11, 1350.91, 11, 1350.00, 7504
9, 13:22:00-000, 6507, 5190, 1317, 7, 1348.00, 7, 1345.29, 7903
9, 13:23:00-000, 4910, 2760, 2150, 0, 0.00, 0, 0.00, 4910
9, 13:24:00-000, 1110, 0, 1110, 0, 0.00, 0, 0.00, 1110
9, 13:25:00-000, 5937, 2340, 3597, 21, 1348.00, 21, 1346.00, 5895
9, 13:26:00-000, 2150, 760, 1390, 17, 1353.35, 20, 1352.00, 2113
9, 13:27:00-000, 6453, 3733, 2720, 3, 1356.00, 0, 0.00, 6450
9, 13:28:00-000, 1777, 955, 822, 27, 1354.63, 27, 1353.00, 1723
9, 13:29:00-000, 1111, 1, 1110, 1, 1354.00, 1, 1353.00, 1109
9, 13:31:00-000, 4740, 1510, 3230, 0, 0.00, 0, 0.00, 4740
9, 13:32:00-000, 4074, 2781, 1293, 14, 1350.50, 14, 1348.79, 4046
9, 13:33:00-000, 5540, 2090, 3450, 0, 0.00, 0, 0.00, 5540
9, 13:34:00-000, 9598, 4798, 4800, 8, 1351.38, 8, 1352.50, 9582
9, 13:35:00-000, 7390, 3660, 3730, 0, 0.00, 0, 0.00, 7390
9, 13:37:00-000, 911, 21, 890, 17, 1353.23, 17, 1352.00, 877
9, 13:41:00-000, 6030, 2350, 3680, 0, 0.00, 0, 0.00, 5230
9, 13:42:00-000, 5676, 3300, 2376, 16, 1345.00, 16, 1347.06, 6444
9, 13:43:00-000, 6660, 3860, 2800, 0, 0.00, 0, 0.00, 6660
9, 13:44:00-000, 2374, 1464, 910, 14, 1350.57, 14, 1352.00, 2346
9, 13:47:00-000, 3660, 2450, 1210, 0, 0.00, 0, 0.00, 3660
9, 13:48:00-000, 3030, 1410, 1620, 0, 0.00, 0, 0.00, 3030
9, 13:49:00-000, 790, 0, 790, 0, 0.00, 0, 0.00, 790
9, 13:50:00-000, 10326, 3070, 7256, 6, 1346.00, 5, 1351.60, 10315
9, 13:51:00-000, 6511, 5090, 1421, 0, 0.00, 1, 1351.00, 5160
9, 13:52:00-000, 1440, 1440, 0, 0, 0.00, 0, 0.00, 2790
9, 13:55:00-000, 2980, 1870, 1110, 0, 0.00, 0, 0.00, 2980
9, 13:56:00-000, 10119, 1959, 8160, 6, 1350.00, 6, 1351.00, 10107
9, 13:57:00-000, 10682, 1892, 8790, 2, 1352.00, 2, 1352.00, 10678
9, 13:58:00-000, 4734, 1320, 3414, 4, 1348.00, 4, 1347.00, 4726
9, 13:59:00-000, 6500, 5100, 1400, 0, 0.00, 0, 0.00, 6500
9, 14:00:00-000, 8668, 3798, 4870, 8, 1350.50, 8, 1351.63, 8652
9, 14:01:00-000, 1880, 1880, 0, 0, 0.00, 0, 0.00, 1880
9, 14:03:00-000, 1890, 1890, 0, 0, 0.00, 0, 0.00, 1890
9, 14:04:00-000, 3906, 3870, 36, 21, 1348.00, 11, 1349.64, 3874
9, 14:05:00-000, 4284, 2060, 2224, 4, 1350.00, 14, 1347.00, 4266
9, 14:06:00-000, 10978, 4678, 6300, 8, 1352.50, 8, 1353.00, 10962
9, 14:07:00-000, 3163, 3, 3160, 3, 1352.00, 3, 1351.00, 2397
9, 14:08:00-000, 8470, 3870, 4600, 0, 0.00, 0, 0.00, 9230
9, 14:09:00-000, 3450, 0, 3450, 0, 0.00, 0, 0.00, 3450
9, 14:10:00-000, 4020, 2630, 1390, 0, 0.00, 0, 0.00, 4020
9, 14:11:00-000, 7570, 6210, 1360, 0, 0.00, 0, 0.00, 7570
9, 14:12:00-000, 4850, 2450, 2400, 0, 0.00, 0, 0.00, 4850
9, 14:13:00-000, 2322, 2, 2320, 2, 1351.00, 2, 1353.00, 2318
9, 14:14:00-000, 2161, 700, 1461, 1, 1349.00, 1, 1349.00, 2159
9, 14:16:00-000, 6560, 2750, 3810, 0, 0.00, 0, 0.00, 6560
9, 14:17:00-000, 3104, 54, 3050, 38, 1356.23, 38, 1352.00, 3028
9, 14:19:00-000, 10151, 3250, 6901, 1, 1352.00, 1, 1351.00, 10149
9, 14:20:00-000, 4056, 1586, 2470, 39, 1354.66, 39, 1351.00, 3978
9, 14:22:00-000, 5627, 1627, 4000, 11, 1349.36, 11, 1353.00, 5605
9, 14:23:00-000, 8521, 5650, 2871, 1, 1348.00, 1, 1346.00, 6959
9, 14:24:00-000, 1310, 1310, 0, 0, 0.00, 0, 0.00, 2870
9, 14:26:00-000, 5820, 3100, 2720, 10, 1352.80, 10, 1352.00, 5800
9, 14:27:00-000, 5650, 980, 4670, 0, 0.00, 0, 0.00, 4620
9, 14:28:00-000, 5596, 3145, 2451, 40, 1352.34, 40, 1351.03, 6546
9, 14:29:00-000, 3040, 3040, 0, 0, 0.00, 0, 0.00, 3040
9, 14:30:00-000, 960, 960, 0, 0, 0.00, 0, 0.00, 960
9, 14:31:00-000, 2376, 6, 2370, 6, 1352.17, 6, 1352.67, 2364
9, 14:34:00-000, 3170, 1230, 1940, 0, 0.00, 0, 0.00, 3170
9, 14:35:00-000, 3680, 2480, 1200, 0, 0.00, 0, 0.00, 3680
9, 14:38:00-000, 3570, 990, 2580, 0, 0.00, 0, 0.00, 3570
9, 14:39:00-000, 1870, 1870, 0, 0, 0.00, 0, 0.00, 1870
9, 14:40:00-000, 3040, 780, 2260, 0, 0.00, 0, 0.00, 3040
9, 14:41:00-000, 2910, 2910, 0, 0, 0.00, 0, 0.00, 2910
9, 14:43:00-000, 3250, 2310, 940, 0, 0.00, 0, 0.00, 3250
9, 14:44:00-000, 1570, 0, 1570, 0, 0.00, 0, 0.00, 1570
9, 14:45:00-000, 7466, 6360, 1106, 6, 1348.00, 6, 1346.67, 7454
9, 14:46:00-000, 4430, 2440, 1990, 0, 0.00, 0, 0.00, 4430
9, 14:48:00-000, 1530, 0, 1530, 0, 0.00, 0, 0.00, 1530
9, 14:49:00-000, 4103, 1610, 2493, 3, 1348.00, 3, 1352.00, 4097
9, 14:50:00-000, 2260, 890, 1370, 0, 0.00, 0, 0.00, 2260
9, 14:52:00-000, 2460, 0, 2460, 0, 0.00, 0, 0.00, 2460
9, 14:53:00-000, 6620, 3503, 3117, 70, 1348.14, 70, 1347.61, 6480
9, 14:54:00-000, 7430, 3780, 3650, 0, 0.00, 0, 0.00, 7430
9, 14:55:00-000, 7774, 3844, 3930, 4, 1352.25, 4, 1352.00, 7766
9, 14:56:00-000, 9083, 4480, 4603, 28, 1349.96, 28, 1350.32, 9027
9, 14:57:00-000, 710, 710, 0, 0, 0.00, 0, 0.00, 710
9, 14:58:00-000, 1110, 0, 1110, 0, 0.00, 0, 0.00, 1110
9, 14:59:00-000, 950, 0, 950, 0, 0.00, 0, 0.00, 950
9, 15:00:00-000, 4508, 3610, 898, 8, 1349.00, 3, 1349.00, 4497
9, 15:01:00-000, 886, 1, 885, 1, 1349.00, 6, 1347.00, 879
9, 15:02:00-000, 5534, 2274, 3260, 24, 1351.00, 24, 1352.00, 5486
9, 15:03:00-000, 9110, 7670, 1440, 0, 0.00, 0, 0.00, 7670
9, 15:04:00-000, 2396, 1186, 1210, 6, 1352.00, 6, 1352.00, 3824
9, 15:05:00-000, 1430, 0, 1430, 0, 0.00, 0, 0.00, 1430
9, 15:06:00-000, 2460, 2460, 0, 0, 0.00, 0, 0.00, 2460
9, 15:07:00-000, 4400, 2220, 2180, 0, 0.00, 0, 0.00, 4400
9, 15:09:00-000, 7340, 4700, 2640, 0, 0.00, 0, 0.00, 7340
9, 15:11:00-000, 1990, 0, 1990, 0, 0.00, 0, 0.00, 1990
9, 15:12:00-000, 810, 0, 810, 0, 0.00, 0, 0.00, 810
9, 15:13:00-000, 4700, 1100, 3600, 0, 0.00, 0, 0.00, 4700
9, 15:14:00-000, 6213, 3510, 2703, 3, 1348.00, 3, 1348.33, 6207
9, 15:15:00-000, 8570, 4510, 4060, 0, 0.00, 0, 0.00, 8570
9, 15:16:00-000, 4354, 1044, 3310, 2, 1345.00, 4, 1353.00, 4348
9, 15:17:00-000, 10589, 5882, 4707, 9, 1348.33, 7, 1348.86, 10573
9, 15:18:00-000, 6125, 4070, 2055, 15, 1347.60, 15, 1345.66, 6095
9, 15:20:00-000, 2409, 1539, 870, 9, 1354.00, 9, 1352.00, 2391
9, 15:21:00-000, 5520, 3810, 1710, 0, 0.00, 0, 0.00, 5520
9, 15:22:00-000, 1613, 913, 700, 3, 1348.00, 3, 1352.00, 1607
9, 15:23:00-000, 2120, 790, 1330, 0, 0.00, 0, 0.00, 2120
9, 15:24:00-000, 4419, 2609, 1810, 9, 1351.22, 9, 1352.00, 4401
9, 15:25:00-000, 10103, 5780, 4323, 3, 1347.00, 3, 1349.00, 8627
9, 15:26:00-000, 4193, 2093, 2100, 18, 1351.11, 18, 1351.00, 5627
9, 15:27:00-000, 790, 790, 0, 0, 0.00, 0, 0.00, 790
9, 15:28:00-000, 2690, 0, 2690, 0, 0.00, 0, 0.00, 2690
9, 15:29:00-000, 835, 830, 5, 5, 1350.00, 5, 1350.00, 825
9, 15:30:00-000, 9069, 3629, 5440, 9, 1352.44, 9, 1353.00, 9051
9, 15:31:00-000, 6041, 1411, 4630, 1, 1353.00, 1, 1352.00, 6039
9, 15:32:00-000, 7880, 3370, 4510, 0, 0.00, 0, 0.00, 7880
9, 15:33:00-000, 6442, 872, 5570, 2, 1350.00, 2, 1352.00, 5448
9, 15:34:00-000, 1310, 0, 1310, 0, 0.00, 0, 0.00, 2300
9, 15:36:00-000, 2223, 869, 1354, 13, 1352.38, 13, 1351.69, 2197
9, 15:37:00-000, 2340, 0, 2340, 0, 0.00, 0, 0.00, 2340
9, 15:38:00-000, 1089, 1080, 9, 6, 1348.00, 6, 1346.00, 1077
9, 15:39:00-000, 3460, 1290, 2170, 0, 0.00, 0, 0.00, 2600
9, 15:40:00-000, 34, 34, 0, 34, 1353.00, 34, 1350.00, 826
9, 15:41:00-000, 2250, 2250, 0, 0, 0.00, 0, 0.00, 2250
9, 15:42:00-000, 2380, 2380, 0, 0, 0.00, 0, 0.00, 2380
9, 15:43:00-000, 1380, 0, 1380, 0, 0.00, 0, 0.00, 1380
9, 15:47:00-000, 4080, 1290, 2790, 0, 0.00, 0, 0.00, 4080
9, 15:48:00-000, 2222, 1061, 1161, 9, 1352.55, 9, 1353.00, 2204
9, 15:49:00-000, 1970, 1970, 0, 0, 0.00, 0, 0.00, 1970
9, 15:50:00-000, 1060, 1060, 0, 0, 0.00, 0, 0.00, 1060
9, 15:51:00-000, 3600, 2370, 1230, 0, 0.00, 0, 0.00, 3600
9, 15:52:00-000, 2070, 2070, 0, 0, 0.00, 0, 0.00, 2070
9, 15:54:00-000, 1050, 1050, 0, 0, 0.00, 0, 0.00, 1050
9, 15:55:00-000, 3680, 2310, 1370, 0, 0.00, 0, 0.00, 3680
9, 15:56:00-000, 2654, 1260, 1394, 4, 1348.00, 4, 1348.00, 2646
9, 15:58:00-000, 1607, 17, 1590, 17, 1356.00, 17, 1352.00, 1573
9, 15:59:00-000, 5000, 3070, 1930, 0, 0.00, 0, 0.00, 5000
9, 16:00:00-000, 950, 0, 950, 0, 0.00, 0, 0.00, 950
9, 16:01:00-000, 1070, 0, 1070, 0, 0.00, 0, 0.00, 1070
9, 16:02:00-000, 3970, 980, 2990, 0, 0.00, 0, 0.00, 3970
9, 16:03:00-000, 2420, 0, 2420, 0, 0.00, 0, 0.00, 2420
9, 16:04:00-000, 6808, 8, 6800, 8, 1351.00, 8, 1352.00, 6792
9, 16:05:00-000, 1110, 1110, 0, 0, 0.00, 0, 0.00, 1110
9, 16:07:00-000, 2304, 2300, 4, 4, 1348.00, 4, 1349.00, 2296
9, 16:08:00-000, 4290, 3490, 800, 0, 0.00, 0, 0.00, 4290
9, 16:10:00-000, 6550, 4170, 2380, 0, 0.00, 0, 0.00, 6550
9, 16:11:00-000, 7890, 7890, 0, 0, 0.00, 0, 0.00, 7890
9, 16:12:00-000, 4532, 2460, 2072, 2, 1348.00, 2, 1349.00, 4528
9, 16:13:00-000, 10080, 6200, 3880, 0, 0.00, 0, 0.00, 10080
9, 16:14:00-000, 920, 0, 920, 0, 0.00, 0, 0.00, 920
9, 16:15:00-000, 1340, 0, 1340, 0, 0.00, 0, 0.00, 1340
9, 16:17:00-000, 7275, 4050, 3225, 5, 1348.00, 5, 1348.00, 7265
9, 16:19:00-000, 11451, 4531, 6920, 1, 1353.00, 1, 1352.00, 10129
9, 16:20:00-000, 6502, 2442, 4060, 2, 1351.00, 2, 1351.00, 7818
9, 16:21:00-000, 10580, 3450, 7130, 0, 0.00, 0, 0.00, 10580
9, 16:22:00-000, 11462, 2586, 8876, 12, 1350.75, 12, 1351.75, 11438
9, 16:23:00-000, 8920, 3600, 5320, 0, 0.00, 0, 0.00, 7440
9, 16:24:00-000, 3989, 789, 3200, 15, 1350.33, 15, 1352.00, 5439
9, 16:25:00-000, 2050, 0, 2050, 0, 0.00, 0, 0.00, 2050
9, 16:26:00-000, 6621, 1091, 5530, 1, 1351.00, 1, 1352.00, 6619
9, 16:28:00-000, 5277, 2137, 3140, 17, 1351.00, 17, 1352.00, 5243
9, 16:29:00-000, 3572, 890, 2682, 2, 1348.00, 2, 1349.00, 3568
