TraderType,Time,EnterQty,BuyEnterQty,SellEnterQty,BuyExecutedQty,BuyExecutedPx,SellExecutedQty,SellExecutedPx,CanceledQty
1, 09:06:00-000, 3177, 3177, 0, 932, 1348.12, 0, 0.00, 0
1, 09:07:00-000, 0, 0, 0, 0, 0.00, 0, 0.00, 2230
1, 09:08:00-000, 0, 0, 0, 0, 0.00, 0, 0.00, 15
1, 09:13:00-000, 3104, 2172, 932, 1120, 1347.71, 932, 1347.43, 0
1, 09:14:00-000, 10, 10, 0, 0, 0.00, 0, 0.00, 1052
1, 09:15:00-000, 43, 33, 10, 6, 1352.00, 10, 1355.10, 10
1, 09:16:00-000, 167, 111, 56, 32, 1350.28, 56, 1352.30, 38
1, 09:17:00-000, 206, 144, 62, 66, 1349.64, 62, 1349.93, 47
1, 09:18:00-000, 641, 451, 190, 238, 1348.70, 190, 1349.68, 125
1, 09:19:00-000, 385, 274, 111, 125, 1349.50, 111, 1353.45, 156
1, 09:20:00-000, 779, 451, 328, 272, 1348.00, 328, 1350.94, 209
1, 09:21:00-000, 356, 253, 103, 60, 1348.06, 103, 1357.28, 135
1, 09:22:00-000, 544, 317, 227, 222, 1349.18, 225, 1351.19, 211
1, 09:23:00-000, 281, 155, 126, 115, 1348.56, 126, 1348.87, 71
1, 09:24:00-000, 596, 366, 230, 153, 1349.03, 228, 1356.13, 72
1, 09:25:00-000, 376, 243, 133, 131, 1349.23, 135, 1355.88, 153
1, 09:26:00-000, 634, 466, 168, 258, 1348.37, 168, 1349.42, 168
1, 09:27:00-000, 365, 241, 124, 112, 1348.72, 124, 1348.65, 178
1, 09:28:00-000, 627, 403, 224, 230, 1348.37, 224, 1348.26, 175
1, 09:29:00-000, 307, 189, 118, 137, 1347.70, 118, 1347.61, 123
1, 09:30:00-000, 690, 436, 254, 207, 1348.90, 254, 1351.23, 91
1, 09:31:00-000, 231, 149, 82, 130, 1348.91, 82, 1349.12, 156
1, 09:32:00-000, 635, 452, 183, 285, 1348.19, 183, 1347.79, 94
1, 09:33:00-000, 315, 218, 97, 103, 1348.39, 97, 1349.58, 138
1, 09:34:00-000, 606, 387, 219, 280, 1348.16, 219, 1347.67, 147
1, 09:35:00-000, 362, 224, 138, 130, 1347.84, 138, 1347.87, 90
1, 09:36:00-000, 556, 291, 265, 233, 1348.29, 265, 1348.32, 90
1, 09:37:00-000, 270, 158, 112, 117, 1348.47, 112, 1348.81, 57
1, 09:38:00-000, 645, 401, 244, 229, 1348.62, 244, 1348.12, 76
1, 09:39:00-000, 299, 175, 124, 96, 1347.70, 124, 1347.49, 110
1, 09:40:00-000, 601, 364, 237, 228, 1348.33, 237, 1348.21, 122
1, 09:41:00-000, 274, 168, 106, 112, 1347.81, 106, 1347.97, 96
1, 09:42:00-000, 654, 386, 268, 257, 1347.67, 268, 1347.82, 95
1, 09:43:00-000, 339, 194, 145, 133, 1348.56, 145, 1347.53, 96
1, 09:44:00-000, 626, 367, 259, 256, 1348.28, 254, 1347.81, 81
1, 09:45:00-000, 242, 165, 77, 79, 1347.91, 82, 1348.14, 111
1, 09:46:00-000, 607, 417, 190, 257, 1348.19, 190, 1347.60, 114
1, 09:47:00-000, 287, 176, 111, 116, 1348.00, 111, 1347.87, 130
1, 09:48:00-000, 605, 398, 207, 199, 1348.37, 207, 1349.36, 116
1, 09:49:00-000, 308, 180, 128, 165, 1347.56, 128, 1347.00, 90
1, 09:50:00-000, 626, 366, 260, 246, 1347.37, 260, 1347.48, 82
1, 09:51:00-000, 274, 170, 104, 140, 1348.48, 104, 1346.84, 105
1, 09:52:00-000, 615, 373, 242, 219, 1347.60, 242, 1347.31, 75
1, 09:53:00-000, 377, 211, 166, 156, 1348.14, 166, 1347.81, 87
1, 09:54:00-000, 647, 405, 242, 281, 1348.06, 242, 1347.36, 99
1, 09:55:00-000, 315, 188, 127, 132, 1348.08, 127, 1348.24, 103
1, 09:56:00-000, 555, 331, 224, 191, 1348.99, 224, 1349.32, 94
1, 09:57:00-000, 313, 193, 120, 110, 1349.30, 120, 1349.10, 87
1, 09:58:00-000, 692, 419, 273, 284, 1348.13, 273, 1348.21, 106
1, 09:59:00-000, 274, 135, 139, 126, 1347.50, 139, 1347.52, 104
1, 10:00:00-000, 599, 346, 253, 231, 1348.22, 253, 1348.38, 69
1, 10:01:00-000, 327, 190, 137, 114, 1348.98, 137, 1348.31, 73
1, 10:02:00-000, 614, 347, 267, 247, 1347.87, 267, 1346.94, 81
1, 10:03:00-000, 343, 212, 131, 148, 1348.20, 131, 1347.44, 87
1, 10:04:00-000, 595, 380, 215, 252, 1347.62, 215, 1347.02, 86
1, 10:05:00-000, 304, 156, 148, 105, 1347.74, 148, 1348.37, 103
1, 10:06:00-000, 611, 398, 213, 216, 1348.02, 213, 1347.95, 119
1, 10:07:00-000, 321, 211, 110, 173, 1348.74, 110, 1348.22, 93
1, 10:08:00-000, 612, 390, 222, 232, 1348.71, 222, 1348.27, 107
1, 10:09:00-000, 303, 161, 142, 113, 1347.09, 142, 1347.18, 113
1, 10:10:00-000, 659, 391, 268, 263, 1347.12, 268, 1346.84, 72
1, 10:11:00-000, 280, 172, 108, 138, 1347.76, 108, 1347.97, 95
1, 10:12:00-000, 561, 323, 238, 223, 1348.43, 238, 1348.05, 90
1, 10:13:00-000, 300, 202, 98, 113, 1348.10, 98, 1347.78, 66
1, 10:14:00-000, 670, 385, 285, 249, 1347.93, 285, 1347.46, 116
1, 10:15:00-000, 300, 181, 119, 102, 1348.59, 119, 1348.64, 95
1, 10:16:00-000, 616, 364, 252, 249, 1347.51, 252, 1347.22, 140
1, 10:17:00-000, 368, 231, 137, 162, 1349.38, 137, 1349.15, 62
1, 10:18:00-000, 654, 407, 247, 293, 1346.49, 247, 1346.33, 59
1, 10:19:00-000, 314, 176, 138, 145, 1347.07, 138, 1347.18, 102
1, 10:20:00-000, 598, 381, 217, 269, 1346.62, 217, 1346.29, 77
1, 10:21:00-000, 295, 192, 103, 103, 1348.72, 103, 1347.85, 94
1, 10:22:00-000, 636, 369, 267, 227, 1348.65, 264, 1348.94, 117
1, 10:23:00-000, 308, 191, 117, 135, 1348.06, 120, 1347.85, 92
1, 10:24:00-000, 607, 353, 254, 263, 1348.26, 254, 1347.96, 93
1, 10:25:00-000, 298, 160, 138, 112, 1348.11, 138, 1347.80, 67
1, 10:26:00-000, 575, 276, 299, 242, 1346.70, 299, 1346.06, 67
1, 10:27:00-000, 345, 236, 109, 146, 1348.28, 109, 1347.53, 30
1, 10:28:00-000, 624, 355, 269, 295, 1348.09, 269, 1347.16, 66
1, 10:29:00-000, 296, 167, 129, 103, 1348.15, 129, 1348.31, 66
1, 10:30:00-000, 619, 437, 182, 239, 1349.31, 182, 1349.63, 107
1, 10:31:00-000, 294, 182, 112, 123, 1349.52, 112, 1348.93, 135
1, 10:32:00-000, 628, 376, 252, 268, 1347.62, 252, 1347.33, 88
1, 10:33:00-000, 302, 177, 125, 143, 1347.32, 125, 1347.43, 79
1, 10:34:00-000, 658, 353, 305, 266, 1347.38, 303, 1346.94, 64
1, 10:35:00-000, 338, 186, 152, 155, 1347.24, 154, 1347.16, 72
1, 10:36:00-000, 611, 302, 309, 264, 1347.12, 309, 1346.60, 25
1, 10:37:00-000, 252, 153, 99, 96, 1347.35, 99, 1347.25, 65
1, 10:38:00-000, 677, 391, 286, 245, 1347.89, 286, 1347.34, 76
1, 10:39:00-000, 302, 187, 115, 121, 1347.80, 111, 1348.27, 102
1, 10:40:00-000, 693, 462, 231, 295, 1348.21, 235, 1347.81, 132
1, 10:41:00-000, 328, 189, 139, 158, 1346.97, 139, 1347.26, 104
1, 10:42:00-000, 515, 318, 197, 192, 1347.58, 197, 1347.08, 51
1, 10:43:00-000, 333, 200, 133, 133, 1348.14, 133, 1347.38, 88
1, 10:44:00-000, 574, 327, 247, 233, 1348.42, 247, 1347.35, 96
1, 10:45:00-000, 341, 186, 155, 137, 1347.49, 155, 1347.32, 77
1, 10:46:00-000, 602, 335, 267, 232, 1348.43, 267, 1347.88, 82
1, 10:47:00-000, 309, 166, 143, 139, 1347.59, 143, 1346.82, 69
1, 10:48:00-000, 629, 375, 254, 225, 1348.39, 254, 1347.61, 84
1, 10:49:00-000, 309, 178, 131, 149, 1347.64, 126, 1347.66, 80
1, 10:50:00-000, 664, 387, 277, 311, 1347.82, 279, 1346.94, 61
1, 10:51:00-000, 298, 172, 126, 123, 1347.76, 129, 1347.15, 68
1, 10:52:00-000, 629, 371, 258, 266, 1346.78, 258, 1346.59, 77
1, 10:53:00-000, 279, 180, 99, 135, 1349.01, 99, 1349.24, 88
1, 10:54:00-000, 623, 350, 273, 232, 1347.36, 273, 1347.32, 73
1, 10:55:00-000, 320, 212, 108, 140, 1348.35, 108, 1346.85, 98
1, 10:56:00-000, 678, 421, 257, 281, 1348.03, 257, 1347.59, 89
1, 10:57:00-000, 292, 153, 139, 150, 1347.92, 139, 1347.21, 82
1, 10:58:00-000, 561, 318, 243, 217, 1347.68, 243, 1347.37, 53
1, 10:59:00-000, 328, 216, 112, 114, 1347.44, 112, 1347.16, 84
1, 11:00:00-000, 646, 390, 256, 314, 1347.48, 256, 1346.74, 94
1, 11:01:00-000, 353, 218, 135, 123, 1348.11, 135, 1347.29, 93
1, 11:02:00-000, 602, 315, 287, 246, 1347.06, 287, 1346.80, 101
1, 11:03:00-000, 340, 212, 128, 117, 1347.63, 128, 1347.29, 62
1, 11:04:00-000, 600, 344, 256, 289, 1347.55, 253, 1346.78, 75
1, 11:05:00-000, 268, 161, 107, 90, 1346.86, 110, 1347.12, 75
1, 11:06:00-000, 679, 382, 297, 280, 1347.77, 297, 1347.59, 98
1, 11:07:00-000, 294, 154, 140, 133, 1347.52, 140, 1347.60, 63
1, 11:08:00-000, 576, 300, 276, 244, 1347.04, 276, 1346.60, 41
1, 11:09:00-000, 314, 183, 131, 121, 1348.46, 131, 1346.71, 45
1, 11:10:00-000, 606, 336, 270, 214, 1348.01, 269, 1347.42, 71
1, 11:11:00-000, 406, 248, 158, 152, 1347.82, 159, 1347.10, 94
1, 11:12:00-000, 561, 348, 213, 260, 1348.00, 213, 1347.55, 107
1, 11:13:00-000, 257, 150, 107, 95, 1346.91, 107, 1347.18, 74
1, 11:14:00-000, 656, 428, 228, 293, 1348.49, 228, 1348.18, 92
1, 11:15:00-000, 364, 210, 154, 145, 1347.27, 154, 1346.37, 95
1, 11:16:00-000, 626, 348, 278, 270, 1347.58, 276, 1347.15, 88
1, 11:17:00-000, 298, 166, 132, 112, 1347.43, 134, 1347.68, 73
1, 11:18:00-000, 560, 316, 244, 238, 1347.68, 244, 1347.40, 70
1, 11:19:00-000, 294, 191, 103, 92, 1348.16, 103, 1347.85, 62
1, 11:20:00-000, 648, 386, 262, 310, 1348.22, 262, 1347.98, 74
1, 11:21:00-000, 330, 210, 120, 103, 1348.77, 120, 1348.54, 93
1, 11:22:00-000, 622, 376, 246, 216, 1348.46, 246, 1348.81, 139
1, 11:23:00-000, 289, 134, 155, 141, 1347.99, 155, 1346.82, 112
1, 11:24:00-000, 574, 330, 244, 242, 1348.04, 244, 1346.38, 38
1, 11:25:00-000, 346, 195, 151, 129, 1348.67, 151, 1347.91, 77
1, 11:26:00-000, 652, 409, 243, 234, 1348.35, 243, 1347.11, 72
1, 11:27:00-000, 292, 165, 127, 140, 1347.98, 127, 1347.40, 116
1, 11:28:00-000, 624, 379, 245, 247, 1348.10, 245, 1347.37, 114
1, 11:29:00-000, 344, 195, 149, 167, 1347.98, 149, 1348.04, 63
1, 11:30:00-000, 521, 316, 205, 190, 1347.39, 205, 1346.99, 71
1, 11:31:00-000, 377, 249, 128, 169, 1348.48, 128, 1347.34, 89
1, 11:32:00-000, 656, 393, 263, 269, 1347.77, 260, 1346.72, 124
1, 11:33:00-000, 355, 189, 166, 100, 1347.79, 169, 1348.49, 106
1, 11:34:00-000, 627, 425, 202, 269, 1347.79, 202, 1347.22, 116
1, 11:35:00-000, 304, 195, 109, 118, 1348.13, 109, 1347.39, 110
1, 11:36:00-000, 607, 361, 246, 251, 1347.90, 246, 1347.86, 98
1, 11:37:00-000, 283, 175, 108, 122, 1348.07, 108, 1347.75, 92
1, 11:38:00-000, 633, 394, 239, 231, 1348.58, 239, 1347.60, 83
1, 11:39:00-000, 284, 159, 125, 153, 1348.13, 125, 1347.83, 122
1, 11:40:00-000, 612, 285, 327, 245, 1346.99, 327, 1346.40, 22
1, 11:41:00-000, 327, 187, 140, 103, 1347.05, 140, 1347.27, 51
1, 11:42:00-000, 576, 354, 222, 244, 1347.98, 222, 1347.51, 84
1, 11:43:00-000, 272, 166, 106, 116, 1348.66, 106, 1348.16, 74
1, 11:44:00-000, 638, 357, 281, 264, 1348.28, 281, 1347.47, 66
1, 11:45:00-000, 263, 172, 91, 116, 1349.64, 91, 1349.34, 86
1, 11:46:00-000, 585, 359, 226, 263, 1348.50, 226, 1347.95, 87
1, 11:47:00-000, 354, 211, 143, 158, 1348.90, 143, 1349.17, 71
1, 11:48:00-000, 636, 360, 276, 231, 1347.98, 276, 1347.67, 86
1, 11:49:00-000, 350, 219, 131, 163, 1347.63, 131, 1347.14, 87
1, 11:50:00-000, 618, 351, 267, 245, 1347.97, 267, 1346.88, 106
1, 11:51:00-000, 266, 162, 104, 118, 1347.80, 104, 1348.03, 78
1, 11:52:00-000, 625, 342, 283, 281, 1347.43, 283, 1346.37, 61
1, 11:53:00-000, 317, 160, 157, 111, 1347.70, 157, 1347.01, 43
1, 11:54:00-000, 598, 379, 219, 241, 1347.98, 219, 1347.81, 60
1, 11:55:00-000, 305, 185, 120, 147, 1348.38, 120, 1347.41, 121
1, 11:56:00-000, 560, 368, 192, 218, 1348.46, 190, 1347.95, 94
1, 11:57:00-000, 351, 196, 155, 129, 1347.99, 157, 1346.45, 80
1, 11:58:00-000, 628, 344, 284, 300, 1347.33, 284, 1346.80, 70
1, 11:59:00-000, 287, 193, 94, 115, 1348.27, 94, 1347.09, 57
1, 12:00:00-000, 661, 381, 280, 291, 1347.91, 280, 1347.41, 68
1, 12:01:00-000, 266, 145, 121, 141, 1347.64, 121, 1346.88, 85
1, 12:02:00-000, 620, 362, 258, 254, 1347.69, 258, 1346.71, 55
1, 12:03:00-000, 266, 146, 120, 114, 1346.32, 120, 1345.35, 67
1, 12:04:00-000, 624, 365, 259, 257, 1347.59, 259, 1346.59, 74
1, 12:05:00-000, 357, 223, 134, 165, 1348.07, 134, 1347.34, 77
1, 12:06:00-000, 549, 270, 279, 247, 1347.33, 279, 1346.65, 56
1, 12:07:00-000, 342, 216, 126, 184, 1346.38, 126, 1345.70, 27
1, 12:08:00-000, 633, 333, 300, 218, 1347.56, 300, 1347.54, 63
1, 12:09:00-000, 299, 147, 152, 129, 1346.74, 152, 1346.04, 77
1, 12:10:00-000, 653, 410, 243, 257, 1348.51, 243, 1347.59, 55
1, 12:11:00-000, 287, 165, 122, 129, 1347.94, 122, 1347.41, 100
1, 12:12:00-000, 610, 359, 251, 248, 1349.03, 251, 1348.20, 76
1, 12:13:00-000, 353, 203, 150, 135, 1347.49, 150, 1346.62, 90
1, 12:14:00-000, 675, 361, 314, 266, 1347.64, 314, 1346.85, 98
1, 12:15:00-000, 353, 212, 141, 159, 1347.26, 141, 1346.24, 66
1, 12:16:00-000, 494, 304, 190, 191, 1348.56, 190, 1348.56, 78
1, 12:17:00-000, 237, 135, 102, 95, 1347.57, 102, 1346.81, 76
1, 12:18:00-000, 682, 431, 251, 257, 1348.47, 251, 1348.06, 106
1, 12:19:00-000, 338, 214, 124, 159, 1348.29, 124, 1347.43, 93
1, 12:20:00-000, 663, 409, 254, 231, 1349.04, 254, 1347.36, 133
1, 12:21:00-000, 321, 203, 118, 99, 1349.49, 118, 1347.90, 132
1, 12:22:00-000, 677, 353, 324, 222, 1348.49, 324, 1346.82, 104
1, 12:23:00-000, 282, 175, 107, 91, 1347.26, 107, 1347.07, 132
1, 12:24:00-000, 534, 307, 227, 195, 1347.61, 227, 1347.10, 103
1, 12:25:00-000, 297, 182, 115, 104, 1347.40, 115, 1346.64, 79
1, 12:26:00-000, 588, 361, 227, 264, 1347.50, 227, 1346.95, 82
1, 12:27:00-000, 394, 259, 135, 168, 1348.11, 135, 1347.41, 93
1, 12:28:00-000, 635, 448, 187, 271, 1348.44, 187, 1347.58, 120
1, 12:29:00-000, 306, 198, 108, 128, 1347.93, 108, 1347.92, 128
1, 12:30:00-000, 644, 382, 262, 284, 1348.31, 262, 1347.47, 113
1, 12:31:00-000, 268, 180, 88, 104, 1349.33, 88, 1348.42, 91
1, 12:32:00-000, 626, 388, 238, 274, 1348.17, 238, 1347.55, 81
1, 12:33:00-000, 308, 178, 130, 116, 1347.97, 130, 1347.22, 61
1, 12:34:00-000, 648, 379, 269, 241, 1348.02, 269, 1348.01, 122
1, 12:35:00-000, 330, 150, 180, 97, 1348.33, 180, 1347.00, 104
1, 12:36:00-000, 608, 349, 259, 251, 1348.40, 259, 1347.79, 86
1, 12:37:00-000, 339, 202, 137, 147, 1348.01, 137, 1346.98, 77
1, 12:38:00-000, 668, 410, 258, 280, 1347.79, 258, 1346.80, 76
1, 12:39:00-000, 326, 243, 83, 102, 1348.78, 83, 1348.85, 116
1, 12:40:00-000, 639, 402, 237, 291, 1348.10, 237, 1348.22, 137
1, 12:41:00-000, 372, 220, 152, 129, 1347.52, 152, 1347.21, 91
1, 12:42:00-000, 647, 379, 268, 274, 1348.03, 268, 1346.92, 102
1, 12:43:00-000, 364, 235, 129, 155, 1348.28, 129, 1348.24, 92
1, 12:44:00-000, 601, 357, 244, 234, 1348.26, 244, 1348.18, 109
1, 12:45:00-000, 268, 166, 102, 130, 1349.18, 102, 1347.63, 87
1, 12:46:00-000, 631, 373, 258, 255, 1348.15, 258, 1347.05, 91
1, 12:47:00-000, 278, 179, 99, 101, 1348.63, 99, 1348.72, 90
1, 12:48:00-000, 770, 400, 370, 315, 1347.89, 370, 1347.23, 92
1, 12:49:00-000, 341, 216, 125, 130, 1347.54, 125, 1346.93, 79
1, 12:50:00-000, 578, 339, 239, 269, 1347.71, 239, 1347.15, 74
1, 12:51:00-000, 283, 170, 113, 129, 1348.71, 113, 1348.20, 64
1, 12:52:00-000, 669, 413, 256, 295, 1348.10, 256, 1347.00, 75
1, 12:53:00-000, 339, 169, 170, 126, 1347.66, 170, 1346.69, 83
1, 12:54:00-000, 592, 296, 296, 251, 1347.41, 296, 1346.78, 55
1, 12:55:00-000, 276, 153, 123, 122, 1347.29, 123, 1346.78, 54
1, 12:56:00-000, 591, 394, 197, 227, 1347.93, 197, 1347.42, 51
1, 12:57:00-000, 342, 186, 156, 149, 1348.88, 156, 1348.62, 146
1, 12:58:00-000, 588, 313, 275, 215, 1347.52, 275, 1347.26, 36
1, 12:59:00-000, 404, 231, 173, 149, 1346.96, 173, 1346.40, 69
1, 13:00:00-000, 607, 337, 270, 274, 1347.89, 270, 1346.65, 102
1, 13:01:00-000, 247, 155, 92, 85, 1348.51, 92, 1348.05, 66
1, 13:02:00-000, 589, 302, 287, 239, 1347.26, 287, 1346.62, 70
1, 13:03:00-000, 270, 153, 117, 105, 1347.13, 117, 1346.56, 63
1, 13:04:00-000, 711, 435, 276, 284, 1348.04, 276, 1347.29, 72
1, 13:05:00-000, 273, 172, 101, 93, 1349.28, 101, 1348.16, 123
1, 13:06:00-000, 557, 355, 202, 247, 1349.08, 202, 1348.19, 93
1, 13:07:00-000, 279, 176, 103, 119, 1347.87, 103, 1347.46, 72
1, 13:08:00-000, 627, 395, 232, 237, 1348.56, 232, 1347.21, 112
1, 13:09:00-000, 358, 165, 193, 154, 1347.83, 193, 1346.16, 107
1, 13:10:00-000, 539, 318, 221, 223, 1348.18, 221, 1347.07, 46
1, 13:11:00-000, 313, 212, 101, 126, 1348.41, 101, 1347.61, 73
1, 13:12:00-000, 659, 409, 250, 249, 1348.43, 250, 1348.38, 126
1, 13:13:00-000, 237, 175, 62, 92, 1349.81, 62, 1349.39, 125
1, 13:14:00-000, 595, 374, 221, 207, 1349.23, 221, 1348.34, 112
1, 13:15:00-000, 375, 213, 162, 172, 1348.27, 162, 1347.33, 113
1, 13:16:00-000, 569, 320, 249, 242, 1347.88, 249, 1347.25, 86
1, 13:17:00-000, 274, 134, 140, 75, 1347.96, 140, 1347.83, 63
1, 13:18:00-000, 735, 438, 297, 252, 1348.02, 297, 1347.98, 72
1, 13:19:00-000, 260, 172, 88, 104, 1349.46, 88, 1349.29, 147
1, 13:20:00-000, 604, 352, 252, 223, 1348.67, 252, 1348.72, 111
1, 13:21:00-000, 309, 174, 135, 169, 1347.44, 135, 1346.39, 79
1, 13:22:00-000, 757, 525, 232, 325, 1348.65, 232, 1347.70, 70
1, 13:23:00-000, 251, 153, 98, 96, 1347.98, 98, 1347.76, 137
1, 13:24:00-000, 495, 318, 177, 192, 1348.20, 177, 1348.04, 84
1, 13:25:00-000, 336, 238, 98, 134, 1348.56, 98, 1347.61, 119
1, 13:26:00-000, 564, 312, 252, 257, 1348.06, 252, 1347.41, 91
1, 13:27:00-000, 310, 160, 150, 101, 1348.14, 150, 1347.72, 84
1, 13:28:00-000, 675, 367, 308, 267, 1347.68, 308, 1346.97, 61
1, 13:29:00-000, 279, 192, 87, 63, 1348.93, 87, 1348.94, 92
1, 13:30:00-000, 675, 394, 281, 349, 1347.77, 281, 1347.13, 97
1, 13:31:00-000, 356, 193, 163, 159, 1347.52, 163, 1347.05, 73
1, 13:32:00-000, 532, 359, 173, 203, 1347.95, 173, 1349.24, 81
1, 13:33:00-000, 248, 164, 84, 82, 1348.85, 84, 1349.09, 109
1, 13:34:00-000, 600, 358, 242, 226, 1348.53, 242, 1348.63, 104
1, 13:35:00-000, 374, 197, 177, 153, 1347.88, 177, 1346.55, 81
1, 13:36:00-000, 660, 327, 333, 279, 1347.22, 333, 1346.02, 68
1, 13:37:00-000, 286, 159, 127, 113, 1348.53, 127, 1348.24, 60
1, 13:38:00-000, 579, 369, 210, 248, 1348.05, 210, 1347.73, 65
1, 13:39:00-000, 264, 172, 92, 157, 1348.17, 92, 1346.27, 82
1, 13:40:00-000, 564, 341, 223, 242, 1348.64, 223, 1347.68, 59
1, 13:41:00-000, 298, 194, 104, 146, 1349.34, 104, 1348.02, 67
1, 13:42:00-000, 621, 364, 257, 234, 1348.26, 257, 1347.90, 99
1, 13:43:00-000, 337, 193, 144, 153, 1347.41, 144, 1346.46, 60
1, 13:44:00-000, 610, 279, 331, 227, 1347.57, 331, 1347.04, 88
1, 13:45:00-000, 287, 183, 104, 103, 1347.94, 102, 1347.82, 37
1, 13:46:00-000, 607, 332, 275, 234, 1347.50, 277, 1346.96, 98
1, 13:47:00-000, 267, 161, 106, 126, 1347.66, 106, 1347.08, 55
1, 13:48:00-000, 603, 335, 268, 263, 1348.40, 268, 1347.69, 72
1, 13:49:00-000, 272, 171, 101, 111, 1348.42, 101, 1348.41, 54
1, 13:50:00-000, 547, 333, 214, 238, 1348.28, 214, 1348.06, 61
1, 13:51:00-000, 321, 164, 157, 113, 1348.10, 157, 1346.47, 77
1, 13:52:00-000, 583, 349, 234, 230, 1347.70, 234, 1346.82, 93
1, 13:53:00-000, 308, 188, 120, 124, 1347.94, 120, 1347.00, 83
1, 13:54:00-000, 609, 379, 230, 226, 1348.19, 230, 1347.45, 83
1, 13:55:00-000, 260, 157, 103, 130, 1347.71, 103, 1347.43, 117
1, 13:56:00-000, 553, 344, 209, 209, 1348.54, 209, 1347.50, 101
1, 13:57:00-000, 298, 196, 102, 127, 1347.78, 102, 1347.68, 68
1, 13:58:00-000, 560, 316, 244, 226, 1347.34, 244, 1346.83, 101
1, 13:59:00-000, 368, 254, 114, 169, 1348.02, 114, 1347.06, 75
1, 14:00:00-000, 567, 329, 238, 184, 1348.62, 238, 1347.78, 108
1, 14:01:00-000, 311, 182, 129, 104, 1349.27, 129, 1347.93, 111
1, 14:02:00-000, 632, 347, 285, 243, 1348.55, 285, 1348.24, 93
1, 14:03:00-000, 269, 170, 99, 105, 1348.78, 99, 1348.32, 102
1, 14:04:00-000, 610, 365, 245, 216, 1348.09, 245, 1347.69, 82
1, 14:05:00-000, 352, 211, 141, 129, 1348.13, 141, 1347.52, 125
1, 14:06:00-000, 692, 429, 263, 297, 1347.92, 263, 1347.47, 112
1, 14:07:00-000, 324, 245, 79, 124, 1348.89, 79, 1348.60, 107
1, 14:08:00-000, 591, 419, 172, 252, 1348.72, 172, 1347.76, 139
1, 14:09:00-000, 322, 211, 111, 134, 1348.30, 111, 1347.80, 128
1, 14:10:00-000, 612, 355, 257, 241, 1347.82, 257, 1347.39, 93
1, 14:11:00-000, 365, 188, 177, 127, 1347.75, 177, 1347.41, 88
1, 14:12:00-000, 597, 346, 251, 236, 1347.29, 251, 1347.51, 108
1, 14:13:00-000, 294, 186, 108, 101, 1348.48, 108, 1348.12, 89
1, 14:14:00-000, 652, 393, 259, 238, 1348.36, 259, 1347.58, 102
1, 14:15:00-000, 313, 194, 119, 130, 1348.17, 119, 1347.32, 123
1, 14:16:00-000, 695, 445, 250, 266, 1348.66, 250, 1348.61, 126
1, 14:17:00-000, 285, 176, 109, 88, 1348.82, 109, 1347.89, 133
1, 14:18:00-000, 631, 401, 230, 233, 1348.18, 230, 1347.34, 122
1, 14:19:00-000, 290, 177, 113, 115, 1348.40, 113, 1347.76, 138
1, 14:20:00-000, 634, 402, 232, 238, 1348.36, 232, 1348.44, 105
1, 14:21:00-000, 349, 181, 168, 110, 1348.19, 168, 1348.08, 105
1, 14:22:00-000, 610, 401, 209, 251, 1347.90, 209, 1347.67, 108
1, 14:23:00-000, 305, 170, 135, 144, 1347.55, 135, 1347.12, 94
1, 14:24:00-000, 609, 382, 227, 308, 1347.39, 227, 1346.82, 54
1, 14:25:00-000, 280, 176, 104, 123, 1348.68, 104, 1347.53, 87
1, 14:26:00-000, 545, 349, 196, 242, 1348.65, 196, 1347.87, 64
1, 14:27:00-000, 366, 234, 132, 168, 1348.84, 132, 1348.76, 69
1, 14:28:00-000, 631, 328, 303, 234, 1347.81, 303, 1347.58, 96
1, 14:29:00-000, 332, 193, 139, 124, 1347.94, 139, 1347.79, 83
1, 14:30:00-000, 624, 339, 285, 252, 1348.76, 285, 1347.73, 80
1, 14:31:00-000, 304, 200, 104, 120, 1349.34, 104, 1349.10, 81
1, 14:32:00-000, 613, 377, 236, 263, 1348.16, 236, 1347.60, 83
1, 14:33:00-000, 338, 182, 156, 162, 1347.87, 156, 1347.81, 97
1, 14:34:00-000, 563, 303, 260, 196, 1347.84, 260, 1347.20, 52
1, 14:35:00-000, 352, 219, 133, 149, 1347.95, 133, 1346.96, 78
1, 14:36:00-000, 604, 381, 223, 257, 1348.60, 223, 1347.87, 106
1, 14:37:00-000, 310, 168, 142, 113, 1347.90, 142, 1347.81, 86
1, 14:38:00-000, 691, 428, 263, 293, 1348.84, 263, 1347.71, 90
1, 14:39:00-000, 340, 202, 138, 135, 1349.35, 138, 1348.10, 91
1, 14:40:00-000, 572, 340, 232, 204, 1348.85, 232, 1348.52, 126
1, 14:41:00-000, 330, 205, 125, 111, 1347.96, 125, 1347.98, 84
1, 14:42:00-000, 581, 340, 241, 236, 1348.20, 241, 1347.31, 87
1, 14:43:00-000, 293, 166, 127, 142, 1347.60, 127, 1347.37, 105
1, 14:44:00-000, 692, 397, 295, 296, 1347.56, 295, 1347.02, 42
1, 14:45:00-000, 372, 245, 127, 158, 1348.55, 127, 1347.80, 96
1, 14:46:00-000, 581, 372, 209, 213, 1348.73, 209, 1348.32, 121
1, 14:47:00-000, 322, 184, 138, 120, 1348.21, 138, 1347.69, 95
1, 14:48:00-000, 661, 390, 271, 261, 1348.38, 271, 1348.05, 114
1, 14:49:00-000, 280, 183, 97, 124, 1347.91, 97, 1347.35, 92
1, 14:50:00-000, 576, 349, 227, 238, 1348.00, 227, 1347.36, 115
1, 14:51:00-000, 340, 170, 170, 138, 1347.95, 170, 1346.59, 73
1, 14:52:00-000, 612, 348, 264, 275, 1347.16, 264, 1346.65, 48
1, 14:53:00-000, 282, 179, 103, 107, 1349.09, 103, 1348.28, 60
1, 14:54:00-000, 626, 390, 236, 285, 1348.68, 236, 1347.67, 77
1, 14:55:00-000, 340, 203, 137, 158, 1347.97, 137, 1347.92, 91
1, 14:56:00-000, 611, 358, 253, 235, 1347.45, 253, 1347.01, 65
1, 14:57:00-000, 258, 157, 101, 137, 1348.60, 101, 1347.98, 91
1, 14:58:00-000, 543, 285, 258, 205, 1347.59, 258, 1347.19, 57
1, 14:59:00-000, 323, 189, 134, 143, 1348.39, 134, 1347.40, 64
1, 15:00:00-000, 610, 368, 242, 242, 1347.24, 242, 1346.54, 75
1, 15:01:00-000, 357, 218, 139, 182, 1347.59, 138, 1347.00, 79
1, 15:02:00-000, 608, 324, 284, 223, 1348.07, 285, 1347.27, 77
1, 15:03:00-000, 284, 191, 93, 100, 1349.20, 93, 1348.11, 89
1, 15:04:00-000, 638, 375, 263, 292, 1347.71, 263, 1347.67, 82
1, 15:05:00-000, 326, 199, 127, 95, 1349.27, 127, 1347.54, 88
1, 15:06:00-000, 745, 449, 296, 312, 1347.62, 296, 1346.85, 111
1, 15:07:00-000, 320, 207, 113, 146, 1348.22, 113, 1347.72, 102
1, 15:08:00-000, 656, 410, 246, 256, 1348.63, 246, 1348.48, 85
1, 15:09:00-000, 267, 161, 106, 129, 1348.36, 106, 1347.26, 114
1, 15:10:00-000, 682, 335, 347, 243, 1347.18, 347, 1346.83, 69
1, 15:11:00-000, 310, 203, 107, 102, 1347.72, 107, 1347.25, 81
1, 15:12:00-000, 625, 327, 298, 322, 1347.84, 298, 1346.39, 68
1, 15:13:00-000, 310, 172, 138, 100, 1349.83, 138, 1348.11, 60
1, 15:14:00-000, 660, 395, 265, 277, 1348.01, 265, 1347.79, 65
1, 15:15:00-000, 346, 195, 151, 155, 1348.04, 151, 1347.36, 101
1, 15:16:00-000, 628, 355, 273, 248, 1348.50, 273, 1347.25, 61
1, 15:17:00-000, 281, 204, 77, 117, 1349.18, 77, 1347.79, 93
1, 15:18:00-000, 725, 425, 300, 315, 1348.17, 300, 1347.77, 84
1, 15:19:00-000, 257, 144, 113, 127, 1348.08, 113, 1347.16, 87
1, 15:20:00-000, 588, 357, 231, 240, 1348.00, 231, 1347.35, 78
1, 15:21:00-000, 318, 184, 134, 112, 1348.10, 134, 1347.75, 90
1, 15:22:00-000, 578, 326, 252, 275, 1347.95, 252, 1347.40, 63
1, 15:23:00-000, 327, 223, 104, 129, 1348.67, 104, 1347.02, 63
1, 15:24:00-000, 691, 407, 284, 289, 1348.43, 284, 1347.24, 117
1, 15:25:00-000, 284, 161, 123, 122, 1347.27, 123, 1346.99, 67
1, 15:26:00-000, 635, 357, 278, 254, 1347.56, 278, 1346.58, 63
1, 15:27:00-000, 289, 180, 109, 117, 1348.03, 109, 1347.56, 90
1, 15:28:00-000, 618, 355, 263, 236, 1347.70, 263, 1346.88, 88
1, 15:29:00-000, 313, 161, 152, 154, 1347.43, 152, 1346.28, 91
1, 15:30:00-000, 641, 339, 302, 256, 1347.07, 302, 1346.02, 40
1, 15:31:00-000, 340, 185, 155, 134, 1348.30, 155, 1347.11, 71
1, 15:32:00-000, 571, 319, 252, 232, 1348.01, 252, 1347.03, 61
1, 15:33:00-000, 344, 172, 172, 141, 1348.35, 172, 1346.41, 61
1, 15:34:00-000, 503, 318, 185, 211, 1348.41, 185, 1347.71, 56
1, 15:35:00-000, 287, 161, 126, 115, 1349.55, 126, 1349.80, 62
1, 15:36:00-000, 602, 347, 255, 236, 1348.67, 255, 1348.54, 96
1, 15:37:00-000, 338, 190, 148, 104, 1349.19, 148, 1348.11, 87
1, 15:38:00-000, 594, 363, 231, 252, 1347.96, 231, 1347.77, 110
1, 15:39:00-000, 277, 180, 97, 148, 1348.84, 97, 1347.85, 77
1, 15:40:00-000, 627, 405, 222, 221, 1348.81, 222, 1347.87, 98
1, 15:41:00-000, 343, 206, 137, 91, 1348.56, 137, 1347.58, 106
1, 15:42:00-000, 628, 376, 252, 203, 1348.27, 252, 1348.05, 189
1, 15:43:00-000, 301, 191, 110, 130, 1349.08, 110, 1347.73, 100
1, 15:44:00-000, 615, 392, 223, 260, 1348.39, 223, 1347.10, 119
1, 15:45:00-000, 313, 168, 145, 85, 1347.94, 145, 1346.63, 97
1, 15:46:00-000, 619, 426, 193, 249, 1349.06, 193, 1347.61, 95
1, 15:47:00-000, 331, 194, 137, 169, 1347.86, 137, 1347.35, 119
1, 15:48:00-000, 645, 420, 225, 261, 1348.21, 225, 1347.31, 123
1, 15:49:00-000, 293, 208, 85, 136, 1348.30, 85, 1347.67, 90
1, 15:50:00-000, 670, 423, 247, 314, 1348.29, 247, 1347.06, 114
1, 15:51:00-000, 303, 165, 138, 132, 1348.21, 137, 1347.53, 78
1, 15:52:00-000, 624, 373, 251, 273, 1348.35, 252, 1347.95, 57
1, 15:53:00-000, 335, 182, 153, 123, 1347.57, 153, 1347.01, 83
1, 15:54:00-000, 614, 348, 266, 217, 1347.81, 266, 1346.96, 95
1, 15:55:00-000, 353, 178, 175, 133, 1347.80, 175, 1346.15, 80
1, 15:56:00-000, 581, 326, 255, 225, 1348.32, 255, 1347.42, 90
1, 15:57:00-000, 317, 198, 119, 128, 1347.79, 119, 1347.01, 53
1, 15:58:00-000, 635, 365, 270, 280, 1348.58, 270, 1347.72, 85
1, 15:59:00-000, 305, 184, 121, 106, 1349.13, 121, 1348.58, 79
1, 16:00:00-000, 626, 398, 228, 243, 1349.10, 228, 1348.52, 135
1, 16:01:00-000, 281, 158, 123, 148, 1347.69, 123, 1346.80, 73
1, 16:02:00-000, 572, 340, 232, 241, 1348.05, 232, 1347.62, 60
1, 16:03:00-000, 345, 190, 155, 152, 1347.50, 155, 1347.28, 63
1, 16:04:00-000, 619, 379, 240, 244, 1348.34, 240, 1348.19, 87
1, 16:05:00-000, 343, 192, 151, 162, 1349.29, 151, 1347.92, 80
1, 16:06:00-000, 676, 411, 265, 283, 1348.19, 265, 1347.23, 78
1, 16:07:00-000, 287, 161, 126, 137, 1347.41, 126, 1347.24, 86
1, 16:08:00-000, 580, 339, 241, 252, 1348.55, 241, 1347.59, 60
1, 16:09:00-000, 343, 193, 150, 157, 1348.53, 150, 1347.53, 57
1, 16:10:00-000, 585, 354, 231, 260, 1348.63, 231, 1347.62, 53
1, 16:11:00-000, 312, 172, 140, 139, 1347.36, 138, 1347.50, 81
1, 16:12:00-000, 587, 318, 269, 236, 1348.35, 271, 1347.60, 67
1, 16:13:00-000, 281, 185, 96, 89, 1348.17, 96, 1348.74, 52
1, 16:14:00-000, 700, 366, 334, 304, 1347.89, 334, 1347.17, 65
1, 16:15:00-000, 311, 213, 98, 104, 1348.42, 98, 1348.23, 98
1, 16:16:00-000, 550, 299, 251, 271, 1347.43, 251, 1346.78, 63
1, 16:17:00-000, 338, 180, 158, 123, 1348.28, 158, 1347.14, 56
1, 16:18:00-000, 663, 384, 279, 270, 1347.75, 279, 1346.84, 105
1, 16:19:00-000, 303, 193, 110, 133, 1348.92, 110, 1347.90, 83
1, 16:20:00-000, 624, 368, 256, 283, 1347.97, 256, 1347.58, 74
1, 16:21:00-000, 245, 140, 105, 114, 1347.33, 105, 1347.38, 59
1, 16:22:00-000, 716, 403, 313, 278, 1347.30, 313, 1346.50, 62
1, 16:23:00-000, 307, 168, 139, 128, 1347.38, 139, 1346.96, 55
1, 16:24:00-000, 550, 310, 240, 247, 1347.43, 240, 1346.70, 107
1, 16:25:00-000, 340, 190, 150, 125, 1347.91, 150, 1347.45, 47
1, 16:26:00-000, 628, 327, 301, 268, 1347.95, 301, 1347.18, 67
1, 16:27:00-000, 257, 122, 135, 86, 1346.67, 135, 1345.64, 56
1, 16:28:00-000, 578, 362, 216, 247, 1348.17, 216, 1347.35, 59
1, 16:29:00-000, 305, 202, 103, 149, 1348.06, 103, 1347.81, 92
2, 09:06:00-000, 3253, 0, 3253, 0, 0.00, 1191, 1348.66, 0
2, 09:07:00-000, 0, 0, 0, 0, 0.00, 10, 1351.00, 2051
2, 09:08:00-000, 0, 0, 0, 0, 0.00, 0, 0.00, 1
2, 09:13:00-000, 3131, 1201, 1930, 1201, 1352.41, 1527, 1351.03, 0
2, 09:14:00-000, 19, 0, 19, 0, 0.00, 44, 1354.45, 373
2, 09:15:00-000, 20, 10, 10, 10, 1356.30, 10, 1351.60, 5
2, 09:16:00-000, 149, 73, 76, 73, 1354.30, 72, 1354.34, 0
2, 09:17:00-000, 217, 111, 106, 111, 1353.67, 110, 1353.73, 0
2, 09:18:00-000, 589, 257, 332, 257, 1354.10, 328, 1352.54, 0
2, 09:19:00-000, 423, 213, 210, 196, 1354.39, 214, 1351.94, 0
2, 09:20:00-000, 809, 423, 386, 432, 1355.05, 386, 1353.62, 0
2, 09:21:00-000, 347, 195, 152, 197, 1357.72, 152, 1354.10, 0
2, 09:22:00-000, 623, 274, 349, 280, 1353.83, 283, 1352.10, 1
2, 09:23:00-000, 323, 203, 120, 203, 1353.30, 172, 1353.57, 13
2, 09:24:00-000, 603, 331, 272, 331, 1356.23, 272, 1352.89, 0
2, 09:25:00-000, 302, 157, 145, 157, 1357.81, 130, 1352.53, 0
2, 09:26:00-000, 655, 286, 369, 286, 1353.18, 301, 1351.02, 13
2, 09:27:00-000, 299, 138, 161, 138, 1352.60, 124, 1351.48, 68
2, 09:28:00-000, 607, 290, 317, 290, 1353.17, 233, 1350.91, 53
2, 09:29:00-000, 346, 175, 171, 174, 1354.06, 206, 1353.70, 35
2, 09:30:00-000, 616, 320, 296, 321, 1352.85, 296, 1351.51, 0
2, 09:31:00-000, 330, 140, 190, 140, 1352.08, 167, 1351.42, 0
2, 09:32:00-000, 587, 226, 361, 226, 1352.18, 297, 1351.11, 29
2, 09:33:00-000, 319, 145, 174, 145, 1353.42, 172, 1352.27, 39
2, 09:34:00-000, 622, 277, 345, 277, 1352.92, 322, 1351.51, 8
2, 09:35:00-000, 312, 153, 159, 153, 1353.87, 134, 1353.06, 19
2, 09:36:00-000, 614, 355, 259, 355, 1354.05, 246, 1351.55, 39
2, 09:37:00-000, 330, 178, 152, 178, 1354.43, 134, 1351.98, 12
2, 09:38:00-000, 588, 300, 288, 300, 1353.49, 268, 1352.15, 11
2, 09:39:00-000, 316, 148, 168, 148, 1352.97, 155, 1352.06, 17
2, 09:40:00-000, 633, 314, 319, 314, 1353.26, 278, 1351.78, 41
2, 09:41:00-000, 337, 151, 186, 151, 1353.17, 148, 1351.45, 27
2, 09:42:00-000, 614, 249, 365, 249, 1353.29, 300, 1351.84, 34
2, 09:43:00-000, 341, 163, 178, 163, 1352.69, 172, 1351.99, 44
2, 09:44:00-000, 525, 196, 329, 196, 1351.63, 255, 1351.11, 61
2, 09:45:00-000, 307, 171, 136, 171, 1354.30, 129, 1351.66, 33
2, 09:46:00-000, 565, 243, 322, 243, 1353.62, 246, 1350.67, 32
2, 09:47:00-000, 349, 212, 137, 212, 1354.78, 159, 1352.73, 33
2, 09:48:00-000, 608, 317, 291, 317, 1354.55, 284, 1352.62, 6
2, 09:49:00-000, 298, 128, 170, 128, 1352.28, 109, 1350.88, 7
2, 09:50:00-000, 609, 239, 370, 239, 1351.80, 267, 1351.05, 73
2, 09:51:00-000, 312, 138, 174, 138, 1352.78, 150, 1351.74, 63
2, 09:52:00-000, 540, 243, 297, 243, 1352.78, 240, 1351.48, 49
2, 09:53:00-000, 315, 124, 191, 124, 1352.41, 144, 1350.80, 52
2, 09:54:00-000, 614, 263, 351, 263, 1352.84, 315, 1351.32, 34
2, 09:55:00-000, 347, 144, 203, 144, 1351.89, 157, 1351.07, 46
2, 09:56:00-000, 655, 280, 375, 280, 1353.30, 285, 1351.69, 34
2, 09:57:00-000, 303, 170, 133, 170, 1353.85, 175, 1352.92, 47
2, 09:58:00-000, 643, 281, 362, 281, 1353.37, 309, 1351.54, 35
2, 09:59:00-000, 271, 110, 161, 110, 1351.86, 106, 1351.22, 42
2, 10:00:00-000, 589, 299, 290, 299, 1353.41, 249, 1351.66, 51
2, 10:01:00-000, 313, 179, 134, 179, 1353.11, 124, 1351.41, 41
2, 10:02:00-000, 659, 277, 382, 277, 1352.12, 293, 1351.61, 26
2, 10:03:00-000, 356, 184, 172, 184, 1353.72, 170, 1352.26, 59
2, 10:04:00-000, 642, 297, 345, 297, 1353.39, 289, 1351.19, 27
2, 10:05:00-000, 293, 146, 147, 146, 1352.45, 111, 1351.48, 48
2, 10:06:00-000, 618, 258, 360, 258, 1352.48, 272, 1352.21, 47
2, 10:07:00-000, 259, 110, 149, 110, 1353.71, 147, 1351.10, 59
2, 10:08:00-000, 646, 257, 389, 257, 1351.99, 240, 1351.01, 52
2, 10:09:00-000, 343, 138, 205, 138, 1351.49, 157, 1350.43, 101
2, 10:10:00-000, 592, 283, 309, 283, 1353.34, 270, 1351.22, 44
2, 10:11:00-000, 267, 103, 164, 103, 1352.88, 130, 1350.87, 49
2, 10:12:00-000, 551, 291, 260, 291, 1352.78, 190, 1351.15, 39
2, 10:13:00-000, 314, 131, 183, 131, 1352.06, 107, 1350.53, 73
2, 10:14:00-000, 560, 244, 316, 244, 1352.71, 240, 1351.74, 73
2, 10:15:00-000, 329, 157, 172, 157, 1352.36, 124, 1350.93, 72
2, 10:16:00-000, 638, 266, 372, 266, 1352.73, 317, 1351.76, 40
2, 10:17:00-000, 290, 127, 163, 127, 1354.26, 160, 1352.66, 54
2, 10:18:00-000, 629, 296, 333, 296, 1352.13, 274, 1351.40, 29
2, 10:19:00-000, 287, 103, 184, 103, 1352.02, 130, 1350.79, 46
2, 10:20:00-000, 581, 228, 353, 228, 1352.12, 238, 1350.33, 80
2, 10:21:00-000, 309, 151, 158, 151, 1353.31, 142, 1352.41, 70
2, 10:22:00-000, 574, 290, 284, 290, 1353.63, 245, 1352.00, 34
2, 10:23:00-000, 328, 140, 188, 140, 1353.51, 169, 1352.18, 21
2, 10:24:00-000, 625, 270, 355, 270, 1353.63, 280, 1351.70, 35
2, 10:25:00-000, 255, 129, 126, 129, 1352.94, 112, 1352.01, 64
2, 10:26:00-000, 685, 245, 440, 245, 1351.47, 266, 1350.51, 58
2, 10:27:00-000, 337, 168, 169, 168, 1352.92, 171, 1352.30, 95
2, 10:28:00-000, 640, 283, 357, 283, 1352.32, 273, 1350.89, 57
2, 10:29:00-000, 309, 136, 173, 136, 1352.41, 160, 1351.58, 66
2, 10:30:00-000, 581, 294, 287, 294, 1354.48, 289, 1352.43, 4
2, 10:31:00-000, 291, 116, 175, 116, 1353.49, 121, 1352.27, 19
2, 10:32:00-000, 612, 266, 346, 266, 1352.37, 256, 1351.60, 61
2, 10:33:00-000, 295, 127, 168, 127, 1352.23, 115, 1350.63, 81
2, 10:34:00-000, 621, 286, 335, 286, 1352.79, 288, 1351.25, 53
2, 10:35:00-000, 268, 129, 139, 129, 1352.58, 131, 1351.26, 45
2, 10:36:00-000, 635, 254, 381, 254, 1350.94, 262, 1350.29, 38
2, 10:37:00-000, 352, 147, 205, 147, 1352.00, 142, 1351.49, 80
2, 10:38:00-000, 610, 280, 330, 280, 1351.93, 240, 1351.03, 94
2, 10:39:00-000, 257, 115, 142, 115, 1352.55, 105, 1350.71, 65
2, 10:40:00-000, 595, 239, 356, 239, 1352.28, 238, 1351.25, 73
2, 10:41:00-000, 334, 155, 179, 155, 1351.51, 116, 1350.24, 89
2, 10:42:00-000, 709, 291, 418, 291, 1352.38, 305, 1351.24, 71
2, 10:43:00-000, 298, 111, 187, 111, 1352.61, 133, 1351.38, 90
2, 10:44:00-000, 618, 233, 385, 233, 1352.29, 256, 1351.61, 101
2, 10:45:00-000, 257, 96, 161, 96, 1353.29, 155, 1350.61, 67
2, 10:46:00-000, 684, 282, 402, 282, 1352.67, 279, 1351.29, 51
2, 10:47:00-000, 351, 135, 216, 135, 1350.40, 157, 1350.61, 93
2, 10:48:00-000, 608, 290, 318, 290, 1352.40, 268, 1351.74, 61
2, 10:49:00-000, 393, 175, 218, 175, 1352.71, 161, 1351.80, 53
2, 10:50:00-000, 572, 257, 315, 257, 1352.71, 233, 1350.89, 77
2, 10:51:00-000, 282, 108, 174, 108, 1351.20, 124, 1350.26, 74
2, 10:52:00-000, 603, 270, 333, 270, 1351.65, 267, 1349.94, 63
2, 10:53:00-000, 361, 180, 181, 180, 1353.76, 156, 1351.67, 43
2, 10:54:00-000, 627, 268, 359, 268, 1352.11, 269, 1350.83, 38
2, 10:55:00-000, 311, 117, 194, 117, 1351.90, 160, 1351.55, 71
2, 10:56:00-000, 614, 259, 355, 254, 1352.71, 289, 1351.26, 32
2, 10:57:00-000, 301, 119, 182, 124, 1352.42, 137, 1350.83, 51
2, 10:58:00-000, 562, 246, 316, 245, 1352.36, 265, 1350.96, 65
2, 10:59:00-000, 376, 157, 219, 158, 1351.36, 165, 1350.82, 63
2, 11:00:00-000, 589, 247, 342, 247, 1352.41, 265, 1350.62, 47
2, 11:01:00-000, 294, 130, 164, 130, 1351.72, 121, 1350.99, 76
2, 11:02:00-000, 680, 361, 319, 361, 1352.91, 272, 1351.55, 37
2, 11:03:00-000, 316, 139, 177, 139, 1352.22, 160, 1351.16, 38
2, 11:04:00-000, 596, 267, 329, 267, 1352.93, 258, 1352.10, 37
2, 11:05:00-000, 336, 149, 187, 149, 1352.21, 142, 1351.03, 61
2, 11:06:00-000, 659, 288, 371, 288, 1352.30, 253, 1351.39, 61
2, 11:07:00-000, 301, 134, 167, 134, 1351.75, 143, 1351.81, 74
2, 11:08:00-000, 665, 263, 402, 263, 1351.52, 279, 1351.14, 79
2, 11:09:00-000, 280, 113, 167, 113, 1350.87, 147, 1350.48, 90
2, 11:10:00-000, 613, 297, 316, 297, 1352.48, 261, 1351.50, 41
2, 11:11:00-000, 351, 148, 203, 148, 1352.71, 180, 1351.31, 42
2, 11:12:00-000, 692, 274, 418, 274, 1352.42, 268, 1350.99, 76
2, 11:13:00-000, 331, 153, 178, 153, 1351.78, 131, 1350.61, 68
2, 11:14:00-000, 655, 261, 394, 261, 1352.57, 304, 1351.38, 81
2, 11:15:00-000, 282, 109, 173, 109, 1350.37, 109, 1349.89, 82
2, 11:16:00-000, 573, 268, 305, 268, 1352.26, 259, 1351.36, 71
2, 11:17:00-000, 334, 137, 197, 137, 1352.44, 150, 1350.69, 30
2, 11:18:00-000, 546, 241, 305, 241, 1351.64, 233, 1350.76, 76
2, 11:19:00-000, 282, 118, 164, 118, 1353.07, 138, 1352.34, 44
2, 11:20:00-000, 610, 286, 324, 286, 1352.58, 279, 1351.40, 51
2, 11:21:00-000, 356, 167, 189, 167, 1352.60, 156, 1351.47, 40
2, 11:22:00-000, 607, 325, 282, 325, 1353.04, 259, 1351.95, 36
2, 11:23:00-000, 373, 155, 218, 155, 1353.04, 180, 1351.53, 23
2, 11:24:00-000, 489, 231, 258, 231, 1351.99, 188, 1351.05, 46
2, 11:25:00-000, 266, 105, 161, 105, 1352.87, 119, 1351.48, 56
2, 11:26:00-000, 708, 307, 401, 307, 1352.20, 275, 1351.38, 57
2, 11:27:00-000, 283, 106, 177, 106, 1352.73, 127, 1352.14, 116
2, 11:28:00-000, 641, 257, 384, 257, 1352.16, 324, 1351.46, 41
2, 11:29:00-000, 339, 146, 193, 146, 1351.76, 134, 1350.12, 59
2, 11:30:00-000, 607, 282, 325, 282, 1352.47, 259, 1351.26, 60
2, 11:31:00-000, 301, 113, 188, 113, 1352.15, 148, 1351.43, 70
2, 11:32:00-000, 614, 279, 335, 279, 1352.15, 252, 1350.78, 56
2, 11:33:00-000, 348, 167, 181, 167, 1352.82, 159, 1351.51, 63
2, 11:34:00-000, 605, 228, 377, 228, 1352.14, 271, 1350.50, 54
2, 11:35:00-000, 304, 166, 138, 166, 1353.08, 133, 1351.90, 58
2, 11:36:00-000, 544, 282, 262, 282, 1353.08, 241, 1351.97, 18
2, 11:37:00-000, 368, 134, 234, 134, 1351.81, 171, 1350.36, 34
2, 11:38:00-000, 578, 291, 287, 291, 1352.83, 249, 1351.01, 60
2, 11:39:00-000, 328, 135, 193, 135, 1352.94, 170, 1351.06, 23
2, 11:40:00-000, 573, 229, 344, 229, 1351.97, 226, 1350.94, 61
2, 11:41:00-000, 331, 125, 206, 125, 1351.09, 165, 1350.50, 65
2, 11:42:00-000, 589, 304, 285, 304, 1353.43, 283, 1352.34, 44
2, 11:43:00-000, 249, 131, 118, 131, 1354.48, 102, 1351.73, 18
2, 11:44:00-000, 612, 245, 367, 245, 1352.10, 304, 1350.97, 38
2, 11:45:00-000, 301, 133, 168, 133, 1352.99, 117, 1351.35, 44
2, 11:46:00-000, 600, 270, 330, 270, 1352.03, 264, 1351.44, 79
2, 11:47:00-000, 341, 178, 163, 178, 1354.89, 136, 1351.84, 35
2, 11:48:00-000, 647, 292, 355, 292, 1351.90, 266, 1351.40, 48
2, 11:49:00-000, 319, 119, 200, 119, 1351.85, 136, 1350.54, 69
2, 11:50:00-000, 574, 267, 307, 267, 1351.83, 253, 1351.31, 68
2, 11:51:00-000, 286, 119, 167, 119, 1351.66, 122, 1350.02, 64
2, 11:52:00-000, 625, 254, 371, 254, 1351.55, 252, 1350.62, 71
2, 11:53:00-000, 335, 140, 195, 140, 1351.39, 133, 1351.03, 65
2, 11:54:00-000, 667, 334, 333, 334, 1353.14, 300, 1351.89, 65
2, 11:55:00-000, 312, 107, 205, 107, 1352.72, 160, 1350.61, 49
2, 11:56:00-000, 625, 253, 372, 253, 1352.35, 300, 1351.34, 56
2, 11:57:00-000, 320, 135, 185, 135, 1351.40, 115, 1351.10, 62
2, 11:58:00-000, 634, 271, 363, 271, 1352.78, 272, 1350.78, 49
2, 11:59:00-000, 259, 100, 159, 100, 1351.97, 107, 1351.16, 93
2, 12:00:00-000, 684, 303, 381, 303, 1352.03, 283, 1352.01, 74
2, 12:01:00-000, 294, 127, 167, 127, 1352.76, 110, 1349.66, 90
2, 12:02:00-000, 582, 242, 340, 242, 1351.83, 219, 1350.89, 96
2, 12:03:00-000, 310, 166, 144, 166, 1352.48, 138, 1351.43, 73
2, 12:04:00-000, 603, 249, 354, 249, 1352.82, 242, 1350.89, 38
2, 12:05:00-000, 306, 140, 166, 140, 1351.74, 139, 1351.02, 69
2, 12:06:00-000, 594, 246, 348, 246, 1352.40, 254, 1350.92, 74
2, 12:07:00-000, 310, 113, 197, 113, 1351.83, 127, 1349.95, 71
2, 12:08:00-000, 697, 290, 407, 290, 1351.57, 336, 1350.88, 54
2, 12:09:00-000, 322, 95, 227, 95, 1350.52, 132, 1350.70, 99
2, 12:10:00-000, 590, 268, 322, 268, 1351.93, 287, 1351.46, 57
2, 12:11:00-000, 362, 120, 242, 120, 1351.95, 170, 1350.77, 57
2, 12:12:00-000, 561, 304, 257, 304, 1352.81, 229, 1351.89, 77
2, 12:13:00-000, 322, 122, 200, 122, 1351.37, 141, 1350.28, 33
2, 12:14:00-000, 628, 270, 358, 270, 1351.00, 245, 1351.20, 72
2, 12:15:00-000, 301, 97, 204, 97, 1351.38, 152, 1350.65, 70
2, 12:16:00-000, 637, 310, 327, 310, 1352.82, 295, 1351.75, 66
2, 12:17:00-000, 331, 152, 179, 152, 1352.03, 139, 1351.41, 31
2, 12:18:00-000, 675, 315, 360, 315, 1352.36, 242, 1351.53, 80
2, 12:19:00-000, 324, 126, 198, 126, 1351.80, 161, 1350.89, 91
2, 12:20:00-000, 617, 262, 355, 262, 1351.79, 192, 1349.93, 71
2, 12:21:00-000, 351, 184, 167, 184, 1352.52, 134, 1350.95, 105
2, 12:22:00-000, 597, 276, 321, 274, 1352.19, 199, 1350.05, 83
2, 12:23:00-000, 250, 95, 155, 97, 1351.27, 94, 1350.26, 99
2, 12:24:00-000, 608, 242, 366, 242, 1351.64, 265, 1350.87, 83
2, 12:25:00-000, 312, 117, 195, 117, 1352.40, 142, 1350.97, 72
2, 12:26:00-000, 654, 216, 438, 216, 1352.04, 273, 1350.85, 100
2, 12:27:00-000, 346, 130, 216, 130, 1352.29, 159, 1350.66, 108
2, 12:28:00-000, 583, 227, 356, 227, 1352.01, 276, 1350.79, 90
2, 12:29:00-000, 325, 141, 184, 141, 1352.30, 133, 1350.98, 48
2, 12:30:00-000, 669, 244, 425, 244, 1351.90, 242, 1350.60, 97
2, 12:31:00-000, 317, 148, 169, 148, 1352.51, 161, 1352.06, 79
2, 12:32:00-000, 543, 238, 305, 238, 1351.81, 213, 1351.29, 83
2, 12:33:00-000, 267, 132, 135, 132, 1352.69, 94, 1351.59, 95
2, 12:34:00-000, 541, 216, 325, 216, 1353.07, 231, 1351.05, 67
2, 12:35:00-000, 314, 145, 169, 145, 1352.49, 114, 1352.00, 67
2, 12:36:00-000, 564, 244, 320, 244, 1352.18, 258, 1351.36, 69
2, 12:37:00-000, 375, 151, 224, 151, 1351.40, 177, 1350.41, 42
2, 12:38:00-000, 589, 241, 348, 241, 1352.31, 281, 1350.53, 46
2, 12:39:00-000, 361, 165, 196, 165, 1352.53, 145, 1351.46, 62
2, 12:40:00-000, 513, 223, 290, 223, 1352.77, 255, 1351.05, 54
2, 12:41:00-000, 375, 144, 231, 144, 1351.51, 171, 1350.58, 42
2, 12:42:00-000, 558, 221, 337, 221, 1351.95, 254, 1351.00, 81
2, 12:43:00-000, 317, 134, 183, 134, 1353.21, 147, 1350.52, 54
2, 12:44:00-000, 586, 277, 309, 277, 1352.46, 221, 1351.86, 66
2, 12:45:00-000, 296, 125, 171, 125, 1351.69, 103, 1350.53, 69
2, 12:46:00-000, 593, 245, 348, 245, 1352.24, 314, 1351.10, 41
2, 12:47:00-000, 287, 150, 137, 150, 1353.46, 127, 1352.40, 49
2, 12:48:00-000, 685, 308, 377, 308, 1352.50, 276, 1351.38, 38
2, 12:49:00-000, 300, 129, 171, 129, 1352.76, 134, 1351.68, 67
2, 12:50:00-000, 668, 319, 349, 319, 1352.93, 287, 1351.45, 40
2, 12:51:00-000, 288, 108, 180, 108, 1352.21, 112, 1351.58, 62
2, 12:52:00-000, 594, 250, 344, 250, 1352.00, 255, 1351.25, 94
2, 12:53:00-000, 314, 154, 160, 154, 1351.94, 110, 1351.47, 78
2, 12:54:00-000, 645, 278, 367, 278, 1351.55, 299, 1350.94, 55
2, 12:55:00-000, 323, 119, 204, 119, 1351.59, 141, 1351.09, 57
2, 12:56:00-000, 542, 225, 317, 225, 1352.45, 235, 1350.90, 71
2, 12:57:00-000, 316, 158, 158, 158, 1352.70, 141, 1351.86, 47
2, 12:58:00-000, 629, 269, 360, 269, 1351.61, 254, 1350.87, 64
2, 12:59:00-000, 281, 96, 185, 96, 1351.16, 111, 1350.78, 76
2, 13:00:00-000, 642, 272, 370, 272, 1352.01, 266, 1350.88, 84
2, 13:01:00-000, 337, 172, 165, 172, 1352.87, 167, 1351.48, 69
2, 13:02:00-000, 695, 278, 417, 278, 1351.76, 249, 1350.47, 43
2, 13:03:00-000, 271, 107, 164, 107, 1350.91, 114, 1350.04, 134
2, 13:04:00-000, 634, 252, 382, 252, 1352.15, 262, 1351.33, 97
2, 13:05:00-000, 299, 135, 164, 135, 1352.75, 135, 1351.37, 78
2, 13:06:00-000, 653, 262, 391, 262, 1352.61, 276, 1351.66, 65
2, 13:07:00-000, 328, 149, 179, 149, 1352.30, 158, 1351.56, 79
2, 13:08:00-000, 643, 266, 377, 266, 1352.01, 267, 1351.42, 68
2, 13:09:00-000, 301, 108, 193, 108, 1351.61, 128, 1351.39, 72
2, 13:10:00-000, 648, 244, 404, 244, 1351.63, 304, 1351.08, 90
2, 13:11:00-000, 317, 138, 179, 138, 1352.69, 151, 1352.36, 51
2, 13:12:00-000, 631, 286, 345, 286, 1352.54, 259, 1351.41, 88
2, 13:13:00-000, 273, 92, 181, 92, 1353.35, 149, 1351.98, 40
2, 13:14:00-000, 699, 314, 385, 314, 1353.24, 344, 1351.96, 35
2, 13:15:00-000, 365, 135, 230, 135, 1352.15, 172, 1351.71, 48
2, 13:16:00-000, 643, 300, 343, 300, 1352.88, 296, 1351.76, 68
2, 13:17:00-000, 318, 133, 185, 133, 1352.37, 122, 1351.81, 53
2, 13:18:00-000, 658, 329, 329, 329, 1353.22, 277, 1351.79, 49
2, 13:19:00-000, 301, 158, 143, 158, 1353.73, 124, 1352.12, 57
2, 13:20:00-000, 607, 283, 324, 283, 1353.05, 271, 1351.98, 27
2, 13:21:00-000, 273, 126, 147, 126, 1351.64, 128, 1350.42, 29
2, 13:22:00-000, 555, 262, 293, 262, 1352.49, 229, 1351.09, 53
2, 13:23:00-000, 374, 182, 192, 182, 1352.78, 160, 1351.26, 41
2, 13:24:00-000, 629, 254, 375, 254, 1352.26, 286, 1351.28, 40
2, 13:25:00-000, 372, 180, 192, 180, 1352.59, 178, 1351.59, 81
2, 13:26:00-000, 624, 227, 397, 227, 1352.00, 300, 1351.32, 45
2, 13:27:00-000, 352, 170, 182, 170, 1351.56, 135, 1350.92, 58
2, 13:28:00-000, 581, 272, 309, 272, 1352.46, 261, 1351.31, 56
2, 13:29:00-000, 350, 124, 226, 124, 1352.45, 127, 1350.72, 60
2, 13:30:00-000, 600, 251, 349, 251, 1352.19, 319, 1351.16, 93
2, 13:31:00-000, 298, 122, 176, 122, 1351.44, 133, 1351.30, 34
2, 13:32:00-000, 645, 359, 286, 359, 1353.61, 278, 1351.51, 35
2, 13:33:00-000, 294, 141, 153, 141, 1353.52, 109, 1352.32, 19
2, 13:34:00-000, 706, 307, 399, 307, 1352.91, 328, 1351.69, 41
2, 13:35:00-000, 311, 107, 204, 107, 1352.65, 139, 1351.40, 52
2, 13:36:00-000, 689, 320, 369, 320, 1351.66, 288, 1351.04, 99
2, 13:37:00-000, 310, 149, 161, 149, 1353.26, 126, 1351.98, 54
2, 13:38:00-000, 613, 248, 365, 248, 1352.01, 265, 1350.78, 52
2, 13:39:00-000, 315, 115, 200, 115, 1352.56, 151, 1350.77, 78
2, 13:40:00-000, 585, 253, 332, 253, 1352.09, 240, 1351.29, 63
2, 13:41:00-000, 316, 146, 170, 146, 1352.32, 141, 1352.16, 92
2, 13:42:00-000, 639, 303, 336, 303, 1352.84, 254, 1351.67, 38
2, 13:43:00-000, 321, 129, 192, 129, 1352.19, 172, 1350.43, 44
2, 13:44:00-000, 580, 270, 310, 270, 1352.30, 234, 1351.15, 56
2, 13:45:00-000, 405, 187, 218, 187, 1353.11, 158, 1351.97, 67
2, 13:46:00-000, 537, 227, 310, 227, 1351.91, 207, 1351.13, 100
2, 13:47:00-000, 320, 144, 176, 144, 1352.36, 141, 1351.30, 47
2, 13:48:00-000, 529, 232, 297, 232, 1352.92, 277, 1351.42, 49
2, 13:49:00-000, 264, 104, 160, 104, 1351.96, 104, 1351.32, 25
2, 13:50:00-000, 650, 288, 362, 288, 1352.79, 288, 1351.65, 53
2, 13:51:00-000, 324, 140, 184, 140, 1351.99, 147, 1352.28, 52
2, 13:52:00-000, 618, 266, 352, 266, 1352.02, 270, 1350.81, 88
2, 13:53:00-000, 281, 125, 156, 125, 1351.58, 118, 1351.03, 54
2, 13:54:00-000, 586, 232, 354, 232, 1352.66, 271, 1351.28, 53
2, 13:55:00-000, 322, 127, 195, 127, 1352.39, 144, 1350.49, 57
2, 13:56:00-000, 654, 310, 344, 310, 1352.99, 299, 1351.90, 65
2, 13:57:00-000, 363, 162, 201, 162, 1352.68, 155, 1351.30, 42
2, 13:58:00-000, 591, 242, 349, 242, 1352.11, 244, 1350.80, 55
2, 13:59:00-000, 328, 141, 187, 141, 1351.93, 142, 1350.74, 73
2, 14:00:00-000, 542, 245, 297, 245, 1352.13, 185, 1351.25, 105
2, 14:01:00-000, 336, 145, 191, 145, 1352.58, 203, 1352.26, 23
2, 14:02:00-000, 589, 310, 279, 310, 1353.13, 222, 1351.04, 45
2, 14:03:00-000, 322, 144, 178, 144, 1353.25, 167, 1352.26, 33
2, 14:04:00-000, 593, 253, 340, 253, 1352.79, 259, 1351.00, 33
2, 14:05:00-000, 382, 187, 195, 187, 1352.26, 139, 1351.18, 84
2, 14:06:00-000, 616, 228, 388, 228, 1351.59, 283, 1350.92, 69
2, 14:07:00-000, 255, 104, 151, 104, 1352.26, 132, 1351.11, 80
2, 14:08:00-000, 647, 251, 396, 251, 1352.49, 303, 1350.92, 36
2, 14:09:00-000, 282, 134, 148, 134, 1353.02, 122, 1351.67, 70
2, 14:10:00-000, 607, 267, 340, 267, 1352.47, 267, 1351.42, 56
2, 14:11:00-000, 371, 156, 215, 156, 1352.52, 137, 1351.08, 53
2, 14:12:00-000, 635, 292, 343, 292, 1352.42, 246, 1350.97, 87
2, 14:13:00-000, 347, 179, 168, 179, 1352.89, 164, 1351.47, 69
2, 14:14:00-000, 615, 263, 352, 263, 1352.34, 280, 1350.87, 41
2, 14:15:00-000, 302, 98, 204, 98, 1351.39, 124, 1350.53, 57
2, 14:16:00-000, 632, 266, 366, 266, 1353.12, 314, 1352.03, 53
2, 14:17:00-000, 294, 143, 151, 143, 1352.76, 129, 1352.04, 50
2, 14:18:00-000, 613, 266, 347, 266, 1352.25, 280, 1351.43, 52
2, 14:19:00-000, 344, 153, 191, 153, 1353.51, 159, 1352.33, 55
2, 14:20:00-000, 620, 284, 336, 284, 1352.53, 264, 1351.52, 45
2, 14:21:00-000, 258, 125, 133, 125, 1352.25, 144, 1352.39, 38
2, 14:22:00-000, 644, 272, 372, 272, 1351.82, 291, 1351.45, 34
2, 14:23:00-000, 313, 149, 164, 149, 1352.46, 143, 1350.58, 54
2, 14:24:00-000, 641, 285, 356, 285, 1352.51, 257, 1350.98, 62
2, 14:25:00-000, 382, 150, 232, 150, 1352.18, 177, 1350.99, 78
2, 14:26:00-000, 611, 249, 362, 246, 1352.43, 272, 1351.82, 69
2, 14:27:00-000, 317, 149, 168, 152, 1353.18, 152, 1351.53, 62
2, 14:28:00-000, 567, 273, 294, 273, 1351.95, 222, 1351.31, 46
2, 14:29:00-000, 292, 123, 169, 123, 1351.90, 114, 1351.41, 35
2, 14:30:00-000, 626, 281, 345, 281, 1352.54, 256, 1351.72, 84
2, 14:31:00-000, 359, 183, 176, 183, 1352.95, 163, 1351.66, 66
2, 14:32:00-000, 575, 254, 321, 254, 1352.30, 249, 1351.79, 45
2, 14:33:00-000, 280, 107, 173, 107, 1351.23, 137, 1351.34, 31
2, 14:34:00-000, 621, 272, 349, 272, 1351.55, 254, 1350.81, 66
2, 14:35:00-000, 361, 171, 190, 171, 1352.69, 148, 1351.12, 71
2, 14:36:00-000, 615, 272, 343, 272, 1353.18, 285, 1351.59, 71
2, 14:37:00-000, 332, 146, 186, 146, 1352.40, 164, 1351.33, 25
2, 14:38:00-000, 671, 278, 393, 278, 1353.46, 326, 1351.68, 32
2, 14:39:00-000, 282, 124, 158, 124, 1352.53, 141, 1352.10, 54
2, 14:40:00-000, 607, 302, 305, 302, 1353.32, 230, 1352.23, 48
2, 14:41:00-000, 319, 164, 155, 164, 1352.10, 130, 1350.87, 68
2, 14:42:00-000, 597, 251, 346, 251, 1351.48, 269, 1350.92, 26
2, 14:43:00-000, 355, 155, 200, 155, 1351.72, 145, 1350.24, 77
2, 14:44:00-000, 630, 292, 338, 292, 1353.11, 270, 1351.28, 65
2, 14:45:00-000, 290, 128, 162, 128, 1352.18, 142, 1351.24, 44
2, 14:46:00-000, 603, 272, 331, 272, 1353.02, 276, 1351.61, 36
2, 14:47:00-000, 283, 136, 147, 136, 1352.89, 121, 1352.87, 44
2, 14:48:00-000, 611, 266, 345, 266, 1353.26, 293, 1351.54, 30
2, 14:49:00-000, 329, 102, 227, 102, 1351.23, 137, 1349.92, 54
2, 14:50:00-000, 646, 268, 378, 268, 1351.42, 288, 1351.16, 71
2, 14:51:00-000, 323, 150, 173, 148, 1351.79, 144, 1350.48, 84
2, 14:52:00-000, 548, 242, 306, 244, 1352.25, 250, 1350.98, 50
2, 14:53:00-000, 372, 160, 212, 160, 1352.93, 146, 1351.10, 53
2, 14:54:00-000, 620, 261, 359, 261, 1352.99, 278, 1351.58, 70
2, 14:55:00-000, 300, 105, 195, 105, 1352.05, 132, 1351.21, 74
2, 14:56:00-000, 569, 259, 310, 259, 1351.82, 262, 1351.07, 76
2, 14:57:00-000, 334, 157, 177, 157, 1351.89, 129, 1351.24, 43
2, 14:58:00-000, 670, 316, 354, 316, 1352.87, 244, 1351.60, 79
2, 14:59:00-000, 393, 150, 243, 150, 1351.54, 173, 1350.86, 81
2, 15:00:00-000, 660, 256, 404, 256, 1352.16, 252, 1350.69, 85
2, 15:01:00-000, 342, 128, 214, 128, 1351.64, 134, 1349.68, 130
2, 15:02:00-000, 576, 261, 315, 261, 1351.78, 226, 1350.31, 94
2, 15:03:00-000, 282, 143, 139, 143, 1352.15, 135, 1352.72, 35
2, 15:04:00-000, 612, 249, 363, 249, 1352.27, 254, 1351.13, 51
2, 15:05:00-000, 270, 115, 155, 115, 1352.96, 130, 1351.17, 76
2, 15:06:00-000, 652, 259, 393, 259, 1351.99, 273, 1350.85, 75
2, 15:07:00-000, 342, 157, 185, 157, 1352.94, 170, 1351.78, 70
2, 15:08:00-000, 613, 258, 355, 258, 1352.43, 269, 1351.25, 51
2, 15:09:00-000, 278, 126, 152, 126, 1353.11, 124, 1351.64, 60
2, 15:10:00-000, 636, 259, 377, 259, 1351.84, 292, 1350.23, 47
2, 15:11:00-000, 266, 127, 139, 127, 1352.35, 115, 1351.62, 67
2, 15:12:00-000, 629, 226, 403, 226, 1351.27, 253, 1350.77, 63
2, 15:13:00-000, 295, 144, 151, 144, 1351.81, 144, 1352.11, 106
2, 15:14:00-000, 636, 338, 298, 338, 1352.92, 251, 1351.70, 34
2, 15:15:00-000, 289, 121, 168, 121, 1352.47, 124, 1351.94, 37
2, 15:16:00-000, 650, 313, 337, 313, 1352.36, 253, 1351.06, 53
2, 15:17:00-000, 342, 97, 245, 97, 1351.85, 122, 1350.73, 76
2, 15:18:00-000, 596, 271, 325, 271, 1352.51, 297, 1351.58, 107
2, 15:19:00-000, 351, 133, 218, 133, 1351.74, 144, 1351.33, 45
2, 15:20:00-000, 651, 288, 363, 288, 1352.17, 296, 1351.40, 76
2, 15:21:00-000, 257, 122, 135, 122, 1352.40, 96, 1351.96, 65
2, 15:22:00-000, 700, 284, 416, 284, 1352.06, 297, 1351.25, 57
2, 15:23:00-000, 330, 119, 211, 119, 1351.70, 150, 1350.86, 74
2, 15:24:00-000, 603, 288, 315, 288, 1352.38, 233, 1351.81, 96
2, 15:25:00-000, 266, 113, 153, 113, 1352.35, 112, 1350.62, 67
2, 15:26:00-000, 666, 289, 377, 289, 1351.97, 298, 1351.11, 49
2, 15:27:00-000, 267, 115, 152, 115, 1352.68, 122, 1351.65, 64
2, 15:28:00-000, 626, 245, 381, 245, 1351.89, 282, 1351.12, 68
2, 15:29:00-000, 325, 112, 213, 112, 1351.76, 159, 1350.70, 68
2, 15:30:00-000, 719, 276, 443, 276, 1351.08, 317, 1351.04, 73
2, 15:31:00-000, 327, 154, 173, 154, 1351.48, 131, 1351.12, 88
2, 15:32:00-000, 595, 250, 345, 250, 1351.66, 256, 1351.29, 94
2, 15:33:00-000, 310, 115, 195, 115, 1352.35, 150, 1351.28, 55
2, 15:34:00-000, 660, 293, 367, 293, 1352.21, 270, 1351.42, 55
2, 15:35:00-000, 297, 163, 134, 163, 1354.25, 114, 1353.13, 82
2, 15:36:00-000, 651, 312, 339, 312, 1352.76, 279, 1351.71, 56
2, 15:37:00-000, 281, 130, 151, 130, 1353.70, 123, 1351.87, 25
2, 15:38:00-000, 646, 271, 375, 271, 1352.51, 270, 1350.90, 56
2, 15:39:00-000, 374, 143, 231, 143, 1352.23, 179, 1351.34, 62
2, 15:40:00-000, 624, 287, 337, 287, 1352.20, 191, 1350.61, 107
2, 15:41:00-000, 282, 139, 143, 139, 1351.77, 138, 1350.68, 87
2, 15:42:00-000, 558, 248, 310, 248, 1352.41, 188, 1349.93, 51
2, 15:43:00-000, 344, 164, 180, 164, 1352.49, 117, 1350.75, 95
2, 15:44:00-000, 571, 224, 347, 224, 1352.15, 237, 1351.11, 88
2, 15:45:00-000, 333, 159, 174, 159, 1352.65, 118, 1351.30, 92
2, 15:46:00-000, 622, 251, 371, 251, 1352.78, 214, 1351.35, 102
2, 15:47:00-000, 286, 108, 178, 108, 1352.16, 126, 1350.98, 110
2, 15:48:00-000, 612, 199, 413, 199, 1351.88, 280, 1350.48, 83
2, 15:49:00-000, 326, 126, 200, 126, 1351.58, 153, 1350.87, 89
2, 15:50:00-000, 622, 198, 424, 198, 1351.95, 281, 1350.70, 88
2, 15:51:00-000, 264, 130, 134, 130, 1352.29, 115, 1351.13, 99
2, 15:52:00-000, 603, 238, 365, 238, 1352.22, 259, 1350.92, 54
2, 15:53:00-000, 245, 86, 159, 86, 1351.00, 119, 1350.02, 75
2, 15:54:00-000, 641, 289, 352, 289, 1351.54, 251, 1350.77, 64
2, 15:55:00-000, 283, 96, 187, 96, 1351.74, 141, 1349.77, 93
2, 15:56:00-000, 643, 278, 365, 278, 1352.36, 292, 1351.46, 53
2, 15:57:00-000, 278, 128, 150, 128, 1351.62, 114, 1351.35, 65
2, 15:58:00-000, 718, 329, 389, 329, 1352.88, 314, 1351.21, 52
2, 15:59:00-000, 268, 116, 152, 116, 1351.95, 101, 1351.60, 58
2, 16:00:00-000, 568, 227, 341, 227, 1352.49, 273, 1351.74, 76
2, 16:01:00-000, 338, 151, 187, 151, 1352.07, 154, 1350.81, 38
2, 16:02:00-000, 628, 248, 380, 248, 1351.94, 242, 1350.76, 67
2, 16:03:00-000, 324, 155, 169, 155, 1352.83, 121, 1350.77, 90
2, 16:04:00-000, 660, 295, 365, 295, 1352.44, 288, 1350.89, 97
2, 16:05:00-000, 333, 154, 179, 154, 1352.48, 117, 1351.11, 52
2, 16:06:00-000, 617, 254, 363, 254, 1352.58, 286, 1350.39, 84
2, 16:07:00-000, 289, 133, 156, 133, 1351.70, 125, 1350.96, 56
2, 16:08:00-000, 690, 287, 403, 287, 1352.23, 274, 1351.49, 48
2, 16:09:00-000, 321, 110, 211, 110, 1351.60, 144, 1351.20, 95
2, 16:10:00-000, 596, 284, 312, 284, 1352.42, 261, 1351.54, 64
2, 16:11:00-000, 232, 112, 120, 112, 1352.83, 96, 1350.32, 61
2, 16:12:00-000, 607, 269, 338, 269, 1352.49, 289, 1351.14, 36
2, 16:13:00-000, 335, 149, 186, 149, 1351.88, 145, 1351.66, 37
2, 16:14:00-000, 672, 253, 419, 253, 1351.97, 301, 1350.86, 58
2, 16:15:00-000, 291, 143, 148, 143, 1352.48, 161, 1351.96, 82
2, 16:16:00-000, 667, 272, 395, 272, 1351.75, 316, 1350.59, 25
2, 16:17:00-000, 280, 98, 182, 98, 1351.93, 125, 1351.33, 56
2, 16:18:00-000, 722, 326, 396, 326, 1351.81, 297, 1351.39, 81
2, 16:19:00-000, 228, 106, 122, 106, 1353.07, 114, 1352.52, 61
2, 16:20:00-000, 641, 293, 348, 293, 1353.12, 266, 1351.30, 58
2, 16:21:00-000, 295, 120, 175, 120, 1352.46, 127, 1350.81, 55
2, 16:22:00-000, 697, 336, 361, 336, 1352.64, 329, 1351.56, 60
2, 16:23:00-000, 288, 120, 168, 120, 1352.59, 124, 1350.86, 30
2, 16:24:00-000, 683, 288, 395, 288, 1352.38, 324, 1351.42, 50
2, 16:25:00-000, 348, 151, 197, 151, 1353.60, 173, 1352.05, 35
2, 16:26:00-000, 614, 309, 305, 309, 1352.81, 241, 1351.22, 56
2, 16:27:00-000, 281, 99, 182, 99, 1349.72, 97, 1350.06, 53
2, 16:28:00-000, 612, 297, 315, 297, 1351.97, 250, 1350.98, 91
2, 16:29:00-000, 340, 159, 181, 159, 1352.57, 142, 1350.94, 54
3, 09:00:00-000, 189, 186, 3, 1, 1350.00, 1, 1350.00, 175
3, 09:01:00-000, 204, 204, 0, 0, 0.00, 0, 0.00, 215
3, 09:02:00-000, 184, 184, 0, 0, 0.00, 0, 0.00, 182
3, 09:03:00-000, 214, 214, 0, 0, 0.00, 0, 0.00, 211
3, 09:04:00-000, 215, 215, 0, 0, 0.00, 0, 0.00, 213
3, 09:05:00-000, 182, 182, 0, 0, 0.00, 0, 0.00, 190
3, 09:06:00-000, 217, 217, 0, 0, 0.00, 0, 0.00, 211
3, 09:07:00-000, 216, 216, 0, 0, 0.00, 0, 0.00, 217
3, 09:08:00-000, 185, 185, 0, 0, 0.00, 0, 0.00, 183
3, 09:09:00-000, 206, 206, 0, 0, 0.00, 0, 0.00, 203
3, 09:10:00-000, 175, 175, 0, 0, 0.00, 0, 0.00, 176
3, 09:11:00-000, 232, 232, 0, 0, 0.00, 0, 0.00, 241
3, 09:12:00-000, 198, 198, 0, 0, 0.00, 0, 0.00, 195
3, 09:13:00-000, 211, 209, 2, 9, 1520.78, 1, 1354.00, 197
3, 09:14:00-000, 187, 181, 6, 0, 0.00, 6, 1350.67, 179
3, 09:15:00-000, 181, 179, 2, 7, 1354.57, 2, 1355.50, 179
3, 09:16:00-000, 210, 210, 0, 4, 1355.25, 0, 0.00, 200
3, 09:17:00-000, 207, 200, 7, 5, 1352.60, 4, 1351.75, 196
3, 09:18:00-000, 190, 177, 13, 13, 1353.15, 10, 1356.60, 176
3, 09:19:00-000, 176, 169, 7, 7, 1356.57, 7, 1358.00, 159
3, 09:20:00-000, 212, 212, 0, 4, 1357.00, 0, 0.00, 210
3, 09:21:00-000, 171, 167, 4, 10, 1375.20, 3, 1367.33, 153
3, 09:22:00-000, 203, 198, 5, 3, 1359.33, 1, 1351.00, 195
3, 09:23:00-000, 195, 193, 2, 10, 1349.40, 1, 1352.00, 194
3, 09:24:00-000, 185, 167, 18, 2, 1357.00, 5, 1349.00, 178
3, 09:25:00-000, 174, 158, 16, 6, 1352.33, 6, 1352.83, 162
3, 09:26:00-000, 205, 174, 31, 9, 1349.89, 1, 1351.00, 195
3, 09:27:00-000, 200, 149, 51, 11, 1350.91, 16, 1352.62, 165
3, 09:28:00-000, 177, 159, 18, 4, 1348.00, 12, 1350.50, 168
3, 09:29:00-000, 224, 221, 3, 6, 1347.17, 2, 1355.50, 204
3, 09:30:00-000, 185, 167, 18, 23, 1353.34, 2, 1356.00, 172
3, 09:31:00-000, 212, 178, 34, 0, 0.00, 3, 1351.00, 208
3, 09:32:00-000, 191, 164, 27, 21, 1350.76, 13, 1353.38, 151
3, 09:33:00-000, 165, 121, 44, 0, 0.00, 4, 1350.75, 169
3, 09:34:00-000, 174, 132, 42, 8, 1350.12, 9, 1350.89, 157
3, 09:35:00-000, 175, 115, 60, 7, 1349.29, 15, 1350.93, 151
3, 09:36:00-000, 189, 113, 76, 8, 1349.12, 10, 1351.90, 172
3, 09:37:00-000, 221, 146, 75, 7, 1348.14, 3, 1351.00, 206
3, 09:38:00-000, 207, 161, 46, 7, 1347.71, 11, 1350.18, 195
3, 09:39:00-000, 230, 193, 37, 11, 1353.27, 14, 1353.28, 197
3, 09:40:00-000, 204, 168, 36, 4, 1347.50, 3, 1349.33, 205
3, 09:41:00-000, 181, 162, 19, 0, 0.00, 7, 1350.71, 171
3, 09:42:00-000, 224, 218, 6, 5, 1351.80, 4, 1351.75, 208
3, 09:43:00-000, 180, 154, 26, 6, 1350.67, 1, 1350.00, 179
3, 09:44:00-000, 219, 147, 72, 8, 1347.50, 1, 1351.00, 213
3, 09:45:00-000, 210, 156, 54, 6, 1350.33, 12, 1350.92, 191
3, 09:46:00-000, 181, 161, 20, 12, 1350.25, 10, 1353.70, 155
3, 09:47:00-000, 212, 180, 32, 4, 1346.75, 12, 1355.58, 195
3, 09:48:00-000, 188, 140, 48, 13, 1347.38, 2, 1351.50, 181
3, 09:49:00-000, 227, 193, 34, 1, 1348.00, 4, 1350.75, 216
3, 09:50:00-000, 257, 189, 68, 8, 1348.00, 14, 1352.00, 241
3, 09:51:00-000, 183, 154, 29, 6, 1347.50, 8, 1350.37, 165
3, 09:52:00-000, 221, 166, 55, 13, 1349.61, 16, 1351.75, 188
3, 09:53:00-000, 203, 168, 35, 8, 1350.00, 7, 1350.43, 194
3, 09:54:00-000, 199, 140, 59, 17, 1348.47, 12, 1351.17, 164
3, 09:55:00-000, 226, 147, 79, 2, 1348.00, 6, 1351.00, 219
3, 09:56:00-000, 215, 178, 37, 15, 1350.27, 20, 1354.25, 182
3, 09:57:00-000, 196, 156, 40, 3, 1350.33, 12, 1351.58, 186
3, 09:58:00-000, 198, 193, 5, 2, 1350.00, 2, 1350.00, 190
3, 09:59:00-000, 206, 174, 32, 5, 1346.60, 0, 0.00, 198
3, 10:00:00-000, 192, 182, 10, 9, 1349.00, 7, 1350.71, 180
3, 10:01:00-000, 204, 176, 28, 5, 1347.80, 8, 1353.25, 192
3, 10:02:00-000, 232, 200, 32, 16, 1349.25, 18, 1352.00, 195
3, 10:03:00-000, 165, 156, 9, 3, 1351.00, 6, 1353.17, 161
3, 10:04:00-000, 210, 180, 30, 14, 1349.07, 3, 1352.33, 181
3, 10:05:00-000, 195, 157, 38, 11, 1347.82, 1, 1351.00, 195
3, 10:06:00-000, 234, 150, 84, 4, 1348.00, 3, 1350.33, 212
3, 10:07:00-000, 180, 134, 46, 5, 1349.00, 4, 1350.75, 184
3, 10:08:00-000, 174, 124, 50, 8, 1345.63, 5, 1351.20, 159
3, 10:09:00-000, 209, 171, 38, 11, 1347.82, 4, 1351.50, 196
3, 10:10:00-000, 193, 114, 79, 21, 1347.24, 5, 1350.80, 166
3, 10:11:00-000, 183, 108, 75, 6, 1349.50, 4, 1351.50, 169
3, 10:12:00-000, 170, 89, 81, 15, 1347.67, 20, 1351.40, 136
3, 10:13:00-000, 192, 118, 74, 5, 1350.20, 24, 1351.16, 166
3, 10:14:00-000, 191, 144, 47, 12, 1349.00, 23, 1351.30, 157
3, 10:15:00-000, 186, 144, 42, 7, 1349.57, 15, 1351.07, 162
3, 10:16:00-000, 198, 191, 7, 6, 1349.00, 6, 1351.67, 180
3, 10:17:00-000, 210, 187, 23, 21, 1351.38, 10, 1350.30, 183
3, 10:18:00-000, 202, 171, 31, 17, 1347.41, 7, 1351.29, 184
3, 10:19:00-000, 233, 174, 59, 4, 1346.00, 16, 1352.31, 208
3, 10:20:00-000, 190, 138, 52, 11, 1348.00, 6, 1350.50, 171
3, 10:21:00-000, 222, 157, 65, 0, 0.00, 12, 1350.83, 214
3, 10:22:00-000, 206, 179, 27, 14, 1351.28, 10, 1353.30, 178
3, 10:23:00-000, 176, 132, 44, 2, 1349.00, 5, 1350.40, 169
3, 10:24:00-000, 176, 129, 47, 24, 1348.83, 9, 1353.44, 149
3, 10:25:00-000, 237, 147, 90, 11, 1347.36, 6, 1350.50, 217
3, 10:26:00-000, 194, 105, 89, 23, 1347.04, 4, 1350.75, 161
3, 10:27:00-000, 202, 84, 118, 0, 0.00, 9, 1351.67, 200
3, 10:28:00-000, 235, 136, 99, 19, 1348.84, 35, 1352.20, 171
3, 10:29:00-000, 205, 151, 54, 5, 1353.00, 10, 1351.60, 199
3, 10:30:00-000, 192, 168, 24, 16, 1351.56, 19, 1353.26, 154
3, 10:31:00-000, 188, 159, 29, 8, 1350.12, 0, 0.00, 182
3, 10:32:00-000, 178, 129, 49, 7, 1348.00, 20, 1351.00, 154
3, 10:33:00-000, 234, 171, 63, 8, 1348.00, 12, 1351.67, 215
3, 10:34:00-000, 209, 151, 58, 13, 1347.69, 6, 1351.83, 190
3, 10:35:00-000, 189, 125, 64, 15, 1347.80, 7, 1351.00, 167
3, 10:36:00-000, 192, 135, 57, 12, 1349.50, 8, 1350.12, 162
3, 10:37:00-000, 201, 157, 44, 10, 1351.10, 17, 1352.00, 184
3, 10:38:00-000, 181, 147, 34, 9, 1348.22, 7, 1351.71, 165
3, 10:39:00-000, 189, 148, 41, 9, 1348.33, 11, 1350.00, 162
3, 10:40:00-000, 215, 111, 104, 8, 1347.87, 3, 1350.00, 204
3, 10:41:00-000, 163, 103, 60, 4, 1348.50, 4, 1351.75, 161
3, 10:42:00-000, 204, 127, 77, 0, 0.00, 15, 1350.40, 188
3, 10:43:00-000, 190, 180, 10, 4, 1351.00, 4, 1353.25, 179
3, 10:44:00-000, 242, 198, 44, 16, 1349.50, 3, 1352.33, 225
3, 10:45:00-000, 176, 140, 36, 9, 1349.55, 6, 1351.83, 161
3, 10:46:00-000, 199, 133, 66, 16, 1346.43, 11, 1351.09, 174
3, 10:47:00-000, 198, 142, 56, 8, 1350.00, 4, 1351.25, 179
3, 10:48:00-000, 227, 128, 99, 11, 1350.73, 8, 1352.12, 207
3, 10:49:00-000, 180, 92, 88, 13, 1348.46, 12, 1351.58, 160
3, 10:50:00-000, 221, 139, 82, 14, 1348.64, 18, 1350.39, 193
3, 10:51:00-000, 215, 126, 89, 3, 1349.33, 5, 1351.40, 202
3, 10:52:00-000, 187, 92, 95, 10, 1348.70, 17, 1350.53, 158
3, 10:53:00-000, 177, 129, 48, 5, 1347.00, 5, 1351.40, 173
3, 10:54:00-000, 184, 121, 63, 3, 1348.33, 3, 1352.67, 178
3, 10:55:00-000, 196, 168, 28, 3, 1348.33, 6, 1352.00, 177
3, 10:56:00-000, 201, 149, 52, 13, 1349.38, 5, 1351.20, 188
3, 10:57:00-000, 199, 166, 33, 2, 1348.50, 6, 1351.67, 193
3, 10:58:00-000, 188, 130, 58, 9, 1350.33, 7, 1353.14, 177
3, 10:59:00-000, 184, 169, 15, 6, 1353.00, 5, 1352.40, 170
3, 11:00:00-000, 162, 119, 43, 5, 1346.60, 6, 1351.17, 149
3, 11:01:00-000, 230, 191, 39, 11, 1348.18, 7, 1351.86, 205
3, 11:02:00-000, 218, 168, 50, 16, 1347.56, 18, 1351.44, 181
3, 11:03:00-000, 194, 138, 56, 6, 1347.83, 8, 1351.25, 191
3, 11:04:00-000, 197, 113, 84, 10, 1348.00, 9, 1350.33, 177
3, 11:05:00-000, 180, 129, 51, 10, 1348.60, 18, 1351.49, 144
3, 11:06:00-000, 202, 164, 38, 4, 1348.25, 14, 1352.43, 192
3, 11:07:00-000, 195, 139, 56, 8, 1348.87, 0, 0.00, 185
3, 11:08:00-000, 226, 161, 65, 8, 1348.87, 13, 1350.00, 200
3, 11:09:00-000, 193, 149, 44, 10, 1348.10, 7, 1351.86, 187
3, 11:10:00-000, 186, 135, 51, 20, 1349.00, 20, 1351.35, 141
3, 11:11:00-000, 216, 171, 45, 4, 1349.75, 4, 1351.00, 205
3, 11:12:00-000, 210, 185, 25, 10, 1346.60, 13, 1351.23, 192
3, 11:13:00-000, 170, 137, 33, 13, 1350.77, 10, 1351.80, 147
3, 11:14:00-000, 173, 135, 38, 1, 1346.00, 1, 1351.00, 166
3, 11:15:00-000, 212, 202, 10, 0, 0.00, 3, 1350.00, 217
3, 11:16:00-000, 181, 143, 38, 18, 1347.55, 1, 1351.00, 153
3, 11:17:00-000, 188, 126, 62, 8, 1347.12, 16, 1350.81, 168
3, 11:18:00-000, 174, 116, 58, 9, 1347.55, 13, 1351.08, 155
3, 11:19:00-000, 208, 189, 19, 5, 1350.20, 9, 1351.33, 197
3, 11:20:00-000, 178, 152, 26, 15, 1348.80, 13, 1352.31, 146
3, 11:21:00-000, 171, 150, 21, 13, 1348.77, 2, 1354.50, 158
3, 11:22:00-000, 225, 183, 42, 4, 1345.75, 9, 1350.89, 213
3, 11:23:00-000, 195, 149, 46, 15, 1348.80, 13, 1351.15, 166
3, 11:24:00-000, 197, 155, 42, 10, 1346.30, 1, 1351.00, 185
3, 11:25:00-000, 230, 143, 87, 10, 1347.70, 11, 1350.91, 209
3, 11:26:00-000, 221, 134, 87, 5, 1350.20, 24, 1351.95, 193
3, 11:27:00-000, 183, 174, 9, 2, 1351.50, 4, 1352.50, 170
3, 11:28:00-000, 201, 123, 78, 25, 1348.80, 13, 1350.69, 166
3, 11:29:00-000, 203, 151, 52, 6, 1348.67, 14, 1350.21, 184
3, 11:30:00-000, 236, 188, 48, 18, 1348.00, 8, 1351.63, 211
3, 11:31:00-000, 182, 115, 67, 5, 1350.00, 6, 1351.50, 172
3, 11:32:00-000, 181, 124, 57, 9, 1348.55, 3, 1352.00, 164
3, 11:33:00-000, 184, 108, 76, 2, 1348.50, 5, 1351.40, 182
3, 11:34:00-000, 186, 118, 68, 12, 1349.17, 13, 1351.30, 154
3, 11:35:00-000, 193, 143, 50, 2, 1349.00, 9, 1351.78, 183
3, 11:36:00-000, 190, 162, 28, 2, 1347.00, 3, 1351.67, 193
3, 11:37:00-000, 189, 162, 27, 3, 1353.33, 11, 1354.09, 173
3, 11:38:00-000, 221, 189, 32, 18, 1348.39, 6, 1352.00, 193
3, 11:39:00-000, 209, 162, 47, 14, 1349.00, 12, 1351.75, 190
3, 11:40:00-000, 232, 140, 92, 11, 1346.36, 2, 1350.50, 207
3, 11:41:00-000, 177, 126, 51, 1, 1346.00, 10, 1350.90, 173
3, 11:42:00-000, 198, 137, 61, 13, 1351.54, 15, 1352.40, 169
3, 11:43:00-000, 224, 190, 34, 0, 0.00, 5, 1354.20, 222
3, 11:44:00-000, 192, 173, 19, 7, 1350.43, 4, 1351.00, 183
3, 11:45:00-000, 193, 144, 49, 13, 1350.15, 8, 1352.50, 173
3, 11:46:00-000, 183, 160, 23, 6, 1352.17, 15, 1352.87, 157
3, 11:47:00-000, 220, 158, 62, 16, 1349.19, 5, 1351.00, 193
3, 11:48:00-000, 229, 156, 73, 19, 1349.79, 15, 1351.13, 192
3, 11:49:00-000, 198, 137, 61, 13, 1350.38, 5, 1351.20, 185
3, 11:50:00-000, 173, 101, 72, 2, 1346.50, 12, 1350.33, 168
3, 11:51:00-000, 211, 167, 44, 1, 1350.00, 9, 1351.67, 191
3, 11:52:00-000, 219, 174, 45, 12, 1348.50, 14, 1351.43, 199
3, 11:53:00-000, 183, 124, 59, 10, 1348.90, 2, 1352.50, 165
3, 11:54:00-000, 202, 159, 43, 3, 1350.33, 11, 1351.82, 193
3, 11:55:00-000, 210, 179, 31, 5, 1349.40, 1, 1353.00, 206
3, 11:56:00-000, 220, 195, 25, 5, 1348.00, 4, 1351.00, 214
3, 11:57:00-000, 198, 171, 27, 7, 1347.14, 3, 1351.00, 187
3, 11:58:00-000, 187, 165, 22, 10, 1347.60, 8, 1351.00, 166
3, 11:59:00-000, 190, 160, 30, 3, 1349.00, 9, 1352.22, 176
3, 12:00:00-000, 223, 157, 66, 14, 1350.43, 7, 1352.43, 195
3, 12:01:00-000, 197, 145, 52, 12, 1347.75, 2, 1351.00, 193
3, 12:02:00-000, 239, 165, 74, 8, 1351.00, 35, 1352.02, 196
3, 12:03:00-000, 195, 152, 43, 7, 1346.71, 1, 1349.00, 187
3, 12:04:00-000, 212, 172, 40, 14, 1349.43, 18, 1351.72, 181
3, 12:05:00-000, 195, 144, 51, 5, 1348.20, 11, 1352.27, 179
3, 12:06:00-000, 199, 111, 88, 29, 1346.96, 0, 0.00, 167
3, 12:07:00-000, 222, 99, 123, 3, 1344.00, 8, 1347.00, 193
3, 12:08:00-000, 169, 124, 45, 5, 1347.60, 11, 1350.54, 165
3, 12:09:00-000, 188, 110, 78, 9, 1346.33, 12, 1350.92, 177
3, 12:10:00-000, 215, 134, 81, 11, 1347.45, 20, 1351.25, 181
3, 12:11:00-000, 249, 184, 65, 6, 1351.17, 19, 1351.16, 221
3, 12:12:00-000, 205, 173, 32, 22, 1349.36, 0, 0.00, 189
3, 12:13:00-000, 212, 146, 66, 7, 1347.14, 8, 1350.50, 197
3, 12:14:00-000, 200, 137, 63, 20, 1347.45, 13, 1353.00, 165
3, 12:15:00-000, 167, 115, 52, 3, 1347.67, 16, 1351.43, 139
3, 12:16:00-000, 181, 150, 31, 7, 1349.43, 0, 0.00, 184
3, 12:17:00-000, 254, 198, 56, 15, 1349.26, 14, 1350.29, 222
3, 12:18:00-000, 211, 172, 39, 12, 1348.92, 10, 1351.80, 187
3, 12:19:00-000, 187, 146, 41, 1, 1347.00, 13, 1350.15, 174
3, 12:20:00-000, 204, 173, 31, 7, 1349.29, 8, 1352.25, 183
3, 12:21:00-000, 179, 129, 50, 5, 1348.20, 5, 1350.00, 179
3, 12:22:00-000, 181, 142, 39, 6, 1349.67, 13, 1350.61, 163
3, 12:23:00-000, 194, 189, 5, 4, 1351.25, 3, 1352.67, 187
3, 12:24:00-000, 196, 162, 34, 17, 1347.82, 14, 1350.29, 164
3, 12:25:00-000, 213, 171, 42, 10, 1349.30, 1, 1352.00, 202
3, 12:26:00-000, 219, 121, 98, 22, 1347.13, 11, 1350.27, 177
3, 12:27:00-000, 198, 98, 100, 2, 1349.00, 4, 1350.00, 196
3, 12:28:00-000, 174, 134, 40, 5, 1347.80, 15, 1351.13, 154
3, 12:29:00-000, 213, 153, 60, 5, 1350.60, 12, 1351.83, 201
3, 12:30:00-000, 218, 185, 33, 17, 1347.59, 11, 1352.91, 174
3, 12:31:00-000, 215, 198, 17, 2, 1349.00, 3, 1352.00, 228
3, 12:32:00-000, 235, 188, 47, 10, 1349.50, 11, 1352.45, 210
3, 12:33:00-000, 197, 168, 29, 3, 1350.33, 8, 1350.25, 179
3, 12:34:00-000, 186, 178, 8, 14, 1349.50, 6, 1351.33, 176
3, 12:35:00-000, 208, 183, 25, 6, 1349.17, 15, 1353.13, 187
3, 12:36:00-000, 197, 183, 14, 10, 1349.90, 5, 1351.20, 173
3, 12:37:00-000, 185, 153, 32, 7, 1348.43, 10, 1350.80, 170
3, 12:38:00-000, 192, 163, 29, 13, 1347.61, 4, 1351.25, 183
3, 12:39:00-000, 245, 195, 50, 6, 1348.83, 7, 1351.00, 223
3, 12:40:00-000, 182, 166, 16, 2, 1354.00, 3, 1350.33, 186
3, 12:41:00-000, 212, 164, 48, 10, 1351.10, 8, 1353.25, 181
3, 12:42:00-000, 197, 180, 17, 5, 1349.80, 8, 1352.00, 191
3, 12:43:00-000, 176, 150, 26, 5, 1352.80, 5, 1351.00, 169
3, 12:44:00-000, 202, 165, 37, 13, 1348.92, 12, 1350.33, 178
3, 12:45:00-000, 187, 169, 18, 9, 1346.55, 4, 1351.00, 176
3, 12:46:00-000, 218, 164, 54, 11, 1347.36, 3, 1350.67, 199
3, 12:47:00-000, 214, 132, 82, 9, 1351.11, 27, 1351.59, 175
3, 12:48:00-000, 208, 165, 43, 9, 1346.33, 8, 1351.13, 179
3, 12:49:00-000, 206, 151, 55, 8, 1347.87, 11, 1350.82, 202
3, 12:50:00-000, 241, 179, 62, 15, 1348.40, 11, 1351.36, 220
3, 12:51:00-000, 214, 185, 29, 7, 1348.00, 3, 1352.33, 195
3, 12:52:00-000, 182, 113, 69, 11, 1347.09, 13, 1350.54, 161
3, 12:53:00-000, 233, 158, 75, 14, 1346.43, 4, 1348.50, 218
3, 12:54:00-000, 186, 126, 60, 6, 1349.83, 12, 1351.50, 169
3, 12:55:00-000, 217, 178, 39, 12, 1351.33, 6, 1352.00, 200
3, 12:56:00-000, 174, 109, 65, 15, 1348.26, 9, 1350.78, 143
3, 12:57:00-000, 184, 129, 55, 5, 1348.60, 15, 1350.00, 169
3, 12:58:00-000, 230, 150, 80, 10, 1349.20, 12, 1350.33, 202
3, 12:59:00-000, 193, 149, 44, 0, 0.00, 7, 1350.14, 195
3, 13:00:00-000, 173, 148, 25, 13, 1348.38, 10, 1351.30, 149
3, 13:01:00-000, 186, 132, 54, 3, 1347.67, 2, 1349.00, 181
3, 13:02:00-000, 220, 164, 56, 3, 1346.67, 14, 1350.50, 197
3, 13:03:00-000, 216, 166, 50, 7, 1347.57, 5, 1350.60, 209
3, 13:04:00-000, 252, 201, 51, 16, 1349.06, 21, 1352.43, 209
3, 13:05:00-000, 193, 152, 41, 11, 1349.91, 6, 1350.33, 178
3, 13:06:00-000, 211, 159, 52, 9, 1347.78, 11, 1350.45, 196
3, 13:07:00-000, 185, 152, 33, 6, 1348.33, 7, 1350.71, 169
3, 13:08:00-000, 193, 161, 32, 9, 1349.67, 4, 1352.75, 180
3, 13:09:00-000, 200, 170, 30, 13, 1346.77, 1, 1352.00, 188
3, 13:10:00-000, 188, 124, 64, 5, 1348.60, 6, 1350.83, 175
3, 13:11:00-000, 248, 200, 48, 7, 1348.71, 8, 1350.75, 230
3, 13:12:00-000, 151, 115, 36, 12, 1348.83, 9, 1352.33, 130
3, 13:13:00-000, 180, 156, 24, 2, 1351.00, 4, 1351.00, 177
3, 13:14:00-000, 219, 197, 22, 5, 1348.80, 8, 1352.00, 204
3, 13:15:00-000, 211, 156, 55, 5, 1348.00, 6, 1351.50, 201
3, 13:16:00-000, 230, 161, 69, 11, 1349.18, 20, 1350.70, 200
3, 13:17:00-000, 193, 177, 16, 5, 1351.00, 2, 1354.50, 181
3, 13:18:00-000, 230, 204, 26, 12, 1349.58, 4, 1353.00, 216
3, 13:19:00-000, 200, 160, 40, 8, 1349.50, 13, 1351.08, 180
3, 13:20:00-000, 202, 152, 50, 19, 1349.52, 7, 1352.28, 180
3, 13:21:00-000, 217, 169, 48, 7, 1352.14, 21, 1352.19, 184
3, 13:22:00-000, 242, 233, 9, 6, 1347.67, 0, 0.00, 236
3, 13:23:00-000, 221, 187, 34, 4, 1351.25, 3, 1353.33, 219
3, 13:24:00-000, 154, 108, 46, 5, 1348.00, 13, 1351.15, 136
3, 13:25:00-000, 232, 179, 53, 18, 1348.39, 17, 1350.88, 194
3, 13:26:00-000, 240, 160, 80, 29, 1348.96, 22, 1351.18, 185
3, 13:27:00-000, 173, 129, 44, 5, 1348.80, 6, 1351.50, 160
3, 13:28:00-000, 172, 108, 64, 18, 1348.89, 20, 1351.45, 143
3, 13:29:00-000, 203, 122, 81, 8, 1348.37, 3, 1350.33, 191
3, 13:30:00-000, 186, 108, 78, 18, 1348.11, 16, 1351.06, 154
3, 13:31:00-000, 224, 124, 100, 9, 1351.00, 12, 1353.00, 202
3, 13:32:00-000, 187, 153, 34, 12, 1353.25, 18, 1353.33, 159
3, 13:33:00-000, 200, 179, 21, 5, 1350.20, 3, 1353.00, 182
3, 13:34:00-000, 221, 147, 74, 31, 1349.87, 12, 1351.50, 186
3, 13:35:00-000, 203, 132, 71, 6, 1346.67, 6, 1352.17, 176
3, 13:36:00-000, 170, 100, 70, 9, 1347.55, 14, 1351.64, 154
3, 13:37:00-000, 179, 111, 68, 11, 1349.00, 10, 1352.10, 167
3, 13:38:00-000, 215, 150, 65, 23, 1348.17, 16, 1351.69, 170
3, 13:39:00-000, 265, 148, 117, 4, 1345.50, 9, 1349.22, 248
3, 13:40:00-000, 189, 126, 63, 4, 1349.00, 12, 1351.00, 177
3, 13:41:00-000, 203, 141, 62, 3, 1347.67, 10, 1351.80, 188
3, 13:42:00-000, 193, 138, 55, 10, 1347.90, 5, 1350.20, 185
3, 13:43:00-000, 212, 125, 87, 5, 1348.20, 10, 1350.60, 198
3, 13:44:00-000, 188, 114, 74, 13, 1348.00, 13, 1350.92, 162
3, 13:45:00-000, 232, 143, 89, 10, 1347.70, 11, 1350.00, 205
3, 13:46:00-000, 218, 132, 86, 14, 1348.21, 15, 1349.46, 194
3, 13:47:00-000, 187, 109, 78, 2, 1347.00, 10, 1351.80, 174
3, 13:48:00-000, 217, 166, 51, 8, 1352.50, 14, 1353.00, 190
3, 13:49:00-000, 223, 206, 17, 5, 1350.60, 2, 1351.00, 220
3, 13:50:00-000, 207, 180, 27, 20, 1348.95, 5, 1351.00, 184
3, 13:51:00-000, 221, 165, 56, 8, 1350.87, 9, 1352.55, 202
3, 13:52:00-000, 195, 128, 67, 9, 1348.55, 6, 1351.17, 184
3, 13:53:00-000, 202, 172, 30, 7, 1346.71, 8, 1350.87, 186
3, 13:54:00-000, 221, 168, 53, 9, 1349.67, 12, 1350.67, 200
3, 13:55:00-000, 191, 152, 39, 7, 1347.43, 2, 1350.00, 181
3, 13:56:00-000, 203, 171, 32, 18, 1348.50, 14, 1351.64, 163
3, 13:57:00-000, 208, 161, 47, 8, 1350.12, 13, 1352.08, 197
3, 13:58:00-000, 157, 119, 38, 10, 1348.30, 8, 1351.25, 134
3, 13:59:00-000, 174, 95, 79, 6, 1348.50, 8, 1350.00, 165
3, 14:00:00-000, 164, 137, 27, 5, 1348.60, 10, 1350.80, 145
3, 14:01:00-000, 230, 204, 26, 1, 1349.00, 3, 1351.33, 224
3, 14:02:00-000, 202, 148, 54, 12, 1348.83, 22, 1351.09, 170
3, 14:03:00-000, 189, 165, 24, 13, 1350.08, 7, 1351.71, 166
3, 14:04:00-000, 228, 158, 70, 28, 1348.89, 22, 1350.91, 182
3, 14:05:00-000, 174, 113, 61, 6, 1344.67, 5, 1350.00, 162
3, 14:06:00-000, 199, 139, 60, 19, 1348.52, 11, 1351.82, 165
3, 14:07:00-000, 174, 127, 47, 0, 0.00, 19, 1351.52, 155
3, 14:08:00-000, 187, 145, 42, 10, 1346.80, 8, 1350.38, 177
3, 14:09:00-000, 179, 164, 15, 3, 1349.00, 3, 1350.67, 166
3, 14:10:00-000, 215, 181, 34, 15, 1347.33, 10, 1352.20, 183
3, 14:11:00-000, 180, 146, 34, 4, 1351.75, 5, 1352.00, 184
3, 14:12:00-000, 218, 133, 85, 21, 1347.14, 7, 1351.57, 190
3, 14:13:00-000, 195, 125, 70, 8, 1349.12, 19, 1351.47, 168
3, 14:14:00-000, 217, 177, 40, 15, 1349.40, 10, 1353.10, 190
3, 14:15:00-000, 173, 121, 52, 0, 0.00, 2, 1351.00, 173
3, 14:16:00-000, 183, 132, 51, 13, 1348.54, 9, 1352.67, 162
3, 14:17:00-000, 220, 177, 43, 7, 1351.00, 1, 1353.00, 203
3, 14:18:00-000, 191, 137, 54, 11, 1348.54, 9, 1351.55, 178
3, 14:19:00-000, 240, 163, 77, 2, 1348.00, 12, 1351.25, 222
3, 14:20:00-000, 192, 162, 30, 3, 1349.33, 6, 1351.50, 184
3, 14:21:00-000, 191, 156, 35, 17, 1349.29, 14, 1351.07, 153
3, 14:22:00-000, 195, 151, 44, 9, 1348.11, 4, 1350.25, 193
3, 14:23:00-000, 201, 158, 43, 13, 1350.62, 10, 1352.60, 178
3, 14:24:00-000, 201, 113, 88, 10, 1347.10, 24, 1350.41, 168
3, 14:25:00-000, 217, 156, 61, 13, 1348.77, 17, 1351.70, 178
3, 14:26:00-000, 191, 167, 24, 20, 1349.60, 20, 1353.00, 153
3, 14:27:00-000, 194, 180, 14, 4, 1352.50, 5, 1353.20, 191
3, 14:28:00-000, 235, 193, 42, 18, 1349.05, 13, 1349.07, 198
3, 14:29:00-000, 197, 155, 42, 16, 1349.12, 8, 1351.75, 179
3, 14:30:00-000, 205, 150, 55, 28, 1347.57, 20, 1351.90, 156
3, 14:31:00-000, 213, 132, 81, 12, 1353.91, 18, 1351.22, 183
3, 14:32:00-000, 195, 124, 71, 11, 1348.18, 31, 1351.87, 151
3, 14:33:00-000, 215, 184, 31, 5, 1348.40, 7, 1351.00, 202
3, 14:34:00-000, 203, 168, 35, 23, 1348.08, 15, 1351.93, 156
3, 14:35:00-000, 200, 157, 43, 6, 1351.00, 7, 1352.00, 195
3, 14:36:00-000, 218, 169, 49, 24, 1349.41, 12, 1352.33, 178
3, 14:37:00-000, 183, 143, 40, 3, 1348.00, 7, 1352.71, 171
3, 14:38:00-000, 203, 155, 48, 9, 1349.11, 21, 1351.90, 183
3, 14:39:00-000, 193, 150, 43, 11, 1348.63, 1, 1350.00, 183
3, 14:40:00-000, 203, 149, 54, 25, 1349.24, 22, 1351.13, 153
3, 14:41:00-000, 200, 153, 47, 11, 1348.82, 7, 1351.29, 180
3, 14:42:00-000, 216, 172, 44, 4, 1347.25, 11, 1351.18, 197
3, 14:43:00-000, 187, 118, 69, 3, 1347.33, 0, 0.00, 190
3, 14:44:00-000, 185, 117, 68, 16, 1346.62, 9, 1350.33, 157
3, 14:45:00-000, 211, 128, 83, 2, 1346.50, 12, 1351.91, 202
3, 14:46:00-000, 179, 143, 36, 8, 1350.87, 12, 1353.25, 156
3, 14:47:00-000, 193, 175, 18, 5, 1349.20, 1, 1351.00, 184
3, 14:48:00-000, 198, 130, 68, 20, 1348.55, 18, 1351.28, 165
3, 14:49:00-000, 227, 143, 84, 9, 1348.33, 14, 1350.50, 205
3, 14:50:00-000, 199, 152, 47, 9, 1350.67, 4, 1351.00, 182
3, 14:51:00-000, 196, 151, 45, 6, 1348.00, 4, 1351.25, 189
3, 14:52:00-000, 189, 105, 84, 12, 1347.16, 23, 1351.48, 152
3, 14:53:00-000, 235, 189, 46, 9, 1351.89, 11, 1351.64, 211
3, 14:54:00-000, 203, 171, 32, 15, 1349.86, 2, 1351.50, 192
3, 14:55:00-000, 207, 150, 57, 5, 1349.00, 2, 1351.00, 199
3, 14:56:00-000, 206, 136, 70, 9, 1348.00, 10, 1351.50, 188
3, 14:57:00-000, 223, 140, 83, 20, 1348.95, 12, 1350.67, 189
3, 14:58:00-000, 202, 119, 83, 10, 1349.90, 24, 1351.50, 162
3, 14:59:00-000, 215, 151, 64, 10, 1347.30, 5, 1349.80, 199
3, 15:00:00-000, 191, 125, 66, 18, 1348.11, 15, 1351.06, 162
3, 15:01:00-000, 202, 120, 82, 5, 1347.40, 0, 0.00, 196
3, 15:02:00-000, 223, 135, 88, 1, 1349.00, 15, 1351.40, 206
3, 15:03:00-000, 217, 186, 31, 8, 1348.13, 11, 1350.91, 203
3, 15:04:00-000, 170, 127, 43, 19, 1352.00, 15, 1351.67, 133
3, 15:05:00-000, 204, 142, 62, 7, 1348.86, 14, 1350.64, 187
3, 15:06:00-000, 214, 184, 30, 5, 1346.20, 12, 1352.50, 186
3, 15:07:00-000, 162, 144, 18, 13, 1351.23, 6, 1353.17, 153
3, 15:08:00-000, 213, 155, 58, 25, 1350.08, 15, 1353.13, 173
3, 15:09:00-000, 194, 120, 74, 5, 1350.40, 12, 1353.00, 173
3, 15:10:00-000, 198, 134, 64, 21, 1347.28, 11, 1351.82, 167
3, 15:11:00-000, 192, 143, 49, 1, 1349.00, 8, 1351.37, 181
3, 15:12:00-000, 206, 149, 57, 17, 1347.06, 1, 1351.00, 193
3, 15:13:00-000, 190, 100, 90, 6, 1348.17, 7, 1350.57, 181
3, 15:14:00-000, 223, 153, 70, 8, 1348.12, 29, 1351.00, 177
3, 15:15:00-000, 189, 140, 49, 15, 1349.06, 3, 1351.00, 175
3, 15:16:00-000, 191, 106, 85, 9, 1348.00, 9, 1350.55, 174
3, 15:17:00-000, 182, 96, 86, 14, 1348.43, 7, 1350.57, 164
3, 15:18:00-000, 180, 98, 82, 13, 1349.85, 14, 1351.86, 144
3, 15:19:00-000, 199, 123, 76, 2, 1349.00, 8, 1351.50, 194
3, 15:20:00-000, 221, 133, 88, 18, 1349.05, 18, 1351.72, 185
3, 15:21:00-000, 189, 130, 59, 12, 1347.50, 9, 1350.55, 172
3, 15:22:00-000, 198, 135, 63, 18, 1347.44, 15, 1349.80, 157
3, 15:23:00-000, 196, 106, 90, 7, 1348.71, 8, 1350.50, 188
3, 15:24:00-000, 210, 127, 83, 8, 1346.62, 13, 1351.69, 186
3, 15:25:00-000, 188, 111, 77, 11, 1350.73, 9, 1353.00, 172
3, 15:26:00-000, 203, 134, 69, 7, 1346.86, 11, 1351.45, 181
3, 15:27:00-000, 216, 133, 83, 4, 1349.50, 8, 1352.00, 202
3, 15:28:00-000, 231, 159, 72, 26, 1348.03, 33, 1350.90, 176
3, 15:29:00-000, 185, 142, 43, 11, 1349.36, 12, 1351.66, 158
3, 15:30:00-000, 172, 136, 36, 23, 1347.56, 9, 1352.33, 141
3, 15:31:00-000, 198, 128, 70, 3, 1348.67, 10, 1350.80, 181
3, 15:32:00-000, 225, 197, 28, 14, 1347.93, 8, 1350.75, 212
3, 15:33:00-000, 240, 148, 92, 17, 1346.41, 2, 1350.50, 213
3, 15:34:00-000, 226, 143, 83, 3, 1349.00, 16, 1351.87, 207
3, 15:35:00-000, 222, 168, 54, 24, 1350.75, 28, 1351.85, 158
3, 15:36:00-000, 214, 186, 28, 16, 1350.31, 8, 1352.62, 208
3, 15:37:00-000, 171, 107, 64, 20, 1349.75, 8, 1350.37, 145
3, 15:38:00-000, 153, 83, 70, 7, 1348.86, 14, 1351.21, 130
3, 15:39:00-000, 193, 101, 92, 4, 1348.00, 9, 1350.78, 180
3, 15:40:00-000, 233, 161, 72, 9, 1349.55, 19, 1351.21, 201
3, 15:41:00-000, 210, 167, 43, 4, 1350.25, 10, 1351.10, 198
3, 15:42:00-000, 209, 202, 7, 12, 1349.75, 2, 1351.00, 192
3, 15:43:00-000, 190, 148, 42, 17, 1348.18, 8, 1350.12, 160
3, 15:44:00-000, 164, 111, 53, 2, 1348.00, 9, 1351.00, 164
3, 15:45:00-000, 177, 130, 47, 2, 1348.50, 4, 1351.50, 167
3, 15:46:00-000, 191, 170, 21, 22, 1348.36, 5, 1352.20, 162
3, 15:47:00-000, 183, 115, 68, 1, 1348.00, 3, 1350.00, 181
3, 15:48:00-000, 213, 120, 93, 3, 1347.00, 13, 1350.69, 190
3, 15:49:00-000, 207, 160, 47, 6, 1347.33, 10, 1351.10, 201
3, 15:50:00-000, 202, 197, 5, 4, 1348.75, 2, 1352.50, 198
3, 15:51:00-000, 187, 136, 51, 11, 1347.91, 1, 1350.00, 171
3, 15:52:00-000, 203, 122, 81, 4, 1347.75, 6, 1350.33, 196
3, 15:53:00-000, 206, 124, 82, 14, 1347.00, 10, 1350.20, 179
3, 15:54:00-000, 213, 119, 94, 13, 1347.46, 9, 1350.22, 191
3, 15:55:00-000, 225, 118, 107, 10, 1351.00, 12, 1351.50, 199
3, 15:56:00-000, 206, 134, 72, 25, 1348.84, 16, 1352.18, 167
3, 15:57:00-000, 179, 97, 82, 4, 1347.25, 5, 1350.60, 175
3, 15:58:00-000, 205, 117, 88, 15, 1349.66, 9, 1351.89, 178
3, 15:59:00-000, 190, 93, 97, 4, 1351.00, 32, 1351.65, 158
3, 16:00:00-000, 236, 163, 73, 10, 1351.00, 15, 1352.80, 206
3, 16:01:00-000, 193, 142, 51, 9, 1350.11, 10, 1352.00, 179
3, 16:02:00-000, 204, 132, 72, 15, 1348.13, 11, 1349.91, 174
3, 16:03:00-000, 225, 166, 59, 5, 1348.40, 7, 1350.43, 212
3, 16:04:00-000, 219, 164, 55, 15, 1346.53, 7, 1351.71, 195
3, 16:05:00-000, 215, 126, 89, 15, 1348.73, 20, 1351.35, 184
3, 16:06:00-000, 197, 113, 84, 22, 1348.72, 24, 1351.71, 147
3, 16:07:00-000, 216, 167, 49, 4, 1352.75, 12, 1351.25, 204
3, 16:08:00-000, 201, 135, 66, 18, 1349.50, 10, 1351.10, 171
3, 16:09:00-000, 204, 146, 58, 11, 1349.54, 16, 1352.06, 171
3, 16:10:00-000, 180, 159, 21, 16, 1348.37, 7, 1351.14, 163
3, 16:11:00-000, 194, 142, 52, 3, 1349.67, 10, 1352.30, 184
3, 16:12:00-000, 216, 140, 76, 11, 1348.73, 5, 1351.60, 191
3, 16:13:00-000, 182, 104, 78, 1, 1349.00, 6, 1350.00, 186
3, 16:14:00-000, 193, 127, 66, 17, 1347.88, 8, 1350.50, 152
3, 16:15:00-000, 182, 132, 50, 5, 1348.40, 8, 1351.25, 179
3, 16:16:00-000, 225, 162, 63, 23, 1349.13, 24, 1351.75, 179
3, 16:17:00-000, 208, 137, 71, 15, 1348.26, 11, 1351.09, 184
3, 16:18:00-000, 233, 161, 72, 9, 1349.11, 19, 1351.94, 205
3, 16:19:00-000, 214, 181, 33, 6, 1347.67, 9, 1350.44, 198
3, 16:20:00-000, 200, 160, 40, 26, 1348.92, 21, 1353.33, 157
3, 16:21:00-000, 194, 137, 57, 16, 1347.19, 8, 1352.12, 170
3, 16:22:00-000, 165, 80, 85, 7, 1347.57, 23, 1350.86, 133
3, 16:23:00-000, 223, 196, 27, 6, 1351.33, 7, 1352.71, 212
3, 16:24:00-000, 164, 136, 28, 6, 1346.00, 2, 1351.50, 151
3, 16:25:00-000, 195, 163, 32, 15, 1347.06, 13, 1352.00, 163
3, 16:26:00-000, 230, 181, 49, 15, 1347.80, 12, 1351.00, 203
3, 16:27:00-000, 178, 143, 35, 2, 1348.50, 0, 0.00, 185
3, 16:28:00-000, 233, 160, 73, 21, 1347.52, 13, 1351.92, 200
3, 16:29:00-000, 215, 151, 64, 15, 1348.80, 13, 1351.31, 184
4, 09:03:00-000, 275, 275, 0, 0, 0.00, 0, 0.00, 274
4, 09:04:00-000, 0, 0, 0, 0, 0.00, 0, 0.00, 1
4, 09:06:00-000, 260, 260, 0, 259, 1351.00, 0, 0.00, 0
4, 09:07:00-000, 11, 11, 0, 10, 1351.00, 0, 0.00, 2
4, 09:08:00-000, 41, 32, 9, 9, 1357.78, 9, 1357.78, 20
4, 09:09:00-000, 93, 77, 16, 16, 1368.69, 16, 1368.69, 39
4, 09:10:00-000, 98, 86, 12, 12, 1409.75, 12, 1409.75, 80
4, 09:11:00-000, 60, 54, 6, 6, 1435.50, 6, 1435.50, 50
4, 09:12:00-000, 84, 71, 13, 13, 1492.23, 13, 1492.23, 56
4, 09:13:00-000, 99, 81, 18, 72, 1415.39, 16, 1393.43, 24
4, 09:14:00-000, 78, 72, 6, 60, 1354.32, 6, 1353.67, 5
4, 09:15:00-000, 72, 69, 3, 54, 1356.51, 3, 1355.67, 27
4, 09:16:00-000, 68, 46, 22, 41, 1353.85, 22, 1352.77, 4
4, 09:17:00-000, 91, 43, 48, 41, 1354.26, 47, 1353.74, 4
4, 09:18:00-000, 95, 64, 31, 48, 1352.78, 28, 1352.74, 1
4, 09:19:00-000, 66, 37, 29, 34, 1369.02, 30, 1371.19, 19
4, 09:20:00-000, 78, 46, 32, 33, 1360.39, 27, 1361.18, 3
4, 09:21:00-000, 103, 45, 58, 46, 1375.34, 55, 1375.43, 16
4, 09:22:00-000, 72, 36, 36, 33, 1350.39, 29, 1352.30, 1
4, 09:23:00-000, 90, 32, 58, 34, 1351.58, 61, 1351.82, 7
4, 09:24:00-000, 83, 49, 34, 41, 1359.09, 24, 1356.20, 8
4, 09:25:00-000, 98, 44, 54, 35, 1351.85, 58, 1351.11, 11
4, 09:26:00-000, 73, 36, 37, 40, 1350.97, 35, 1350.71, 1
4, 09:27:00-000, 103, 50, 53, 50, 1352.19, 29, 1351.41, 15
4, 09:28:00-000, 68, 31, 37, 31, 1350.12, 36, 1350.21, 1
4, 09:29:00-000, 71, 41, 30, 40, 1355.12, 31, 1352.67, 8
4, 09:30:00-000, 94, 48, 46, 49, 1354.60, 41, 1353.21, 3
4, 09:31:00-000, 89, 30, 59, 27, 1350.00, 48, 1349.47, 6
4, 09:32:00-000, 82, 43, 39, 37, 1352.78, 48, 1352.43, 6
4, 09:33:00-000, 59, 31, 28, 27, 1351.66, 22, 1351.09, 4
4, 09:34:00-000, 98, 38, 60, 34, 1350.76, 49, 1350.76, 9
4, 09:35:00-000, 70, 42, 28, 43, 1350.46, 30, 1350.26, 9
4, 09:36:00-000, 92, 47, 45, 35, 1352.11, 34, 1352.26, 7
4, 09:37:00-000, 67, 26, 41, 27, 1350.77, 35, 1350.85, 14
4, 09:38:00-000, 100, 48, 52, 44, 1350.79, 45, 1350.75, 8
4, 09:39:00-000, 63, 34, 29, 32, 1352.87, 25, 1352.67, 12
4, 09:40:00-000, 72, 38, 34, 37, 1349.72, 31, 1350.54, 5
4, 09:41:00-000, 103, 54, 49, 41, 1351.45, 46, 1351.08, 10
4, 09:42:00-000, 79, 50, 29, 43, 1351.55, 28, 1351.53, 6
4, 09:43:00-000, 68, 27, 41, 30, 1351.09, 37, 1351.13, 10
4, 09:44:00-000, 100, 50, 50, 48, 1349.91, 53, 1349.47, 0
4, 09:45:00-000, 107, 55, 52, 55, 1350.64, 45, 1350.62, 4
4, 09:46:00-000, 62, 31, 31, 33, 1354.33, 27, 1354.40, 0
4, 09:47:00-000, 97, 51, 46, 51, 1354.70, 28, 1351.75, 18
4, 09:48:00-000, 61, 25, 36, 24, 1350.45, 33, 1352.23, 9
4, 09:49:00-000, 96, 47, 49, 40, 1350.24, 42, 1349.92, 3
4, 09:50:00-000, 119, 42, 77, 48, 1349.45, 60, 1349.63, 19
4, 09:51:00-000, 65, 28, 37, 23, 1349.95, 30, 1349.83, 8
4, 09:52:00-000, 61, 34, 27, 34, 1351.38, 24, 1351.79, 7
4, 09:53:00-000, 105, 49, 56, 45, 1350.17, 51, 1350.35, 6
4, 09:54:00-000, 91, 51, 40, 54, 1349.75, 39, 1349.89, 1
4, 09:55:00-000, 71, 50, 21, 41, 1350.41, 20, 1349.60, 7
4, 09:56:00-000, 100, 54, 46, 53, 1353.03, 30, 1353.46, 8
4, 09:57:00-000, 100, 56, 44, 54, 1350.95, 44, 1350.88, 17
4, 09:58:00-000, 78, 27, 51, 29, 1351.24, 35, 1351.57, 11
4, 09:59:00-000, 83, 32, 51, 26, 1348.03, 44, 1348.72, 11
4, 10:00:00-000, 89, 26, 63, 29, 1348.86, 64, 1349.96, 0
4, 10:01:00-000, 77, 41, 36, 41, 1353.46, 32, 1351.49, 8
4, 10:02:00-000, 77, 39, 38, 34, 1351.37, 34, 1351.46, 3
4, 10:03:00-000, 83, 40, 43, 41, 1352.92, 37, 1352.91, 9
4, 10:04:00-000, 56, 34, 22, 31, 1352.51, 17, 1352.64, 4
4, 10:05:00-000, 91, 36, 55, 34, 1350.23, 49, 1349.85, 4
4, 10:06:00-000, 78, 22, 56, 24, 1349.54, 45, 1349.64, 9
4, 10:07:00-000, 66, 20, 46, 21, 1349.52, 34, 1349.26, 14
4, 10:08:00-000, 73, 35, 38, 31, 1350.86, 42, 1351.16, 3
4, 10:09:00-000, 65, 24, 41, 25, 1350.07, 30, 1351.00, 2
4, 10:10:00-000, 90, 47, 43, 44, 1348.85, 50, 1349.43, 5
4, 10:11:00-000, 94, 55, 39, 40, 1350.52, 36, 1350.69, 10
4, 10:12:00-000, 75, 43, 32, 36, 1350.08, 38, 1350.49, 0
4, 10:13:00-000, 95, 31, 64, 33, 1350.51, 56, 1350.67, 9
4, 10:14:00-000, 79, 53, 26, 54, 1352.12, 33, 1352.33, 0
4, 10:15:00-000, 84, 43, 41, 38, 1351.25, 39, 1350.61, 0
4, 10:16:00-000, 73, 35, 38, 33, 1351.18, 30, 1351.73, 8
4, 10:17:00-000, 92, 47, 45, 49, 1352.36, 35, 1352.11, 4
4, 10:18:00-000, 77, 38, 39, 36, 1351.16, 48, 1351.97, 0
4, 10:19:00-000, 72, 30, 42, 30, 1351.43, 20, 1348.00, 16
4, 10:20:00-000, 86, 46, 40, 45, 1351.08, 46, 1350.60, 6
4, 10:21:00-000, 75, 35, 40, 32, 1348.74, 38, 1348.15, 3
4, 10:22:00-000, 70, 40, 30, 40, 1352.54, 29, 1353.17, 2
4, 10:23:00-000, 97, 55, 42, 54, 1350.08, 42, 1349.85, 3
4, 10:24:00-000, 59, 28, 31, 28, 1352.64, 26, 1352.03, 3
4, 10:25:00-000, 83, 33, 50, 32, 1349.52, 41, 1349.92, 5
4, 10:26:00-000, 73, 25, 48, 20, 1348.20, 32, 1348.81, 6
4, 10:27:00-000, 74, 33, 41, 32, 1349.87, 41, 1350.46, 16
4, 10:28:00-000, 97, 60, 37, 60, 1350.59, 45, 1351.84, 0
4, 10:29:00-000, 79, 50, 29, 38, 1352.57, 29, 1352.93, 0
4, 10:30:00-000, 75, 46, 29, 53, 1353.25, 29, 1353.58, 3
4, 10:31:00-000, 90, 39, 51, 39, 1350.81, 47, 1351.52, 2
4, 10:32:00-000, 70, 23, 47, 23, 1350.34, 34, 1350.08, 6
4, 10:33:00-000, 120, 53, 67, 49, 1350.40, 71, 1350.00, 2
4, 10:34:00-000, 78, 42, 36, 43, 1351.25, 37, 1349.94, 1
4, 10:35:00-000, 80, 39, 41, 37, 1350.02, 29, 1350.34, 3
4, 10:36:00-000, 79, 39, 40, 38, 1348.89, 48, 1349.95, 5
4, 10:37:00-000, 94, 57, 37, 45, 1351.44, 36, 1351.61, 5
4, 10:38:00-000, 74, 36, 38, 45, 1351.35, 28, 1351.21, 6
4, 10:39:00-000, 89, 35, 54, 33, 1349.90, 40, 1349.59, 9
4, 10:40:00-000, 93, 38, 55, 40, 1349.87, 53, 1350.10, 10
4, 10:41:00-000, 96, 46, 50, 40, 1348.94, 36, 1349.30, 6
4, 10:42:00-000, 88, 45, 43, 48, 1350.95, 57, 1351.25, 2
4, 10:43:00-000, 65, 37, 28, 32, 1351.59, 22, 1351.22, 1
4, 10:44:00-000, 72, 35, 37, 33, 1349.63, 38, 1349.20, 3
4, 10:45:00-000, 100, 47, 53, 53, 1350.08, 49, 1349.89, 2
4, 10:46:00-000, 67, 31, 36, 31, 1350.38, 34, 1350.08, 3
4, 10:47:00-000, 100, 59, 41, 48, 1349.95, 39, 1350.27, 4
4, 10:48:00-000, 49, 14, 35, 24, 1349.45, 26, 1350.84, 8
4, 10:49:00-000, 77, 40, 37, 33, 1350.96, 34, 1351.52, 4
4, 10:50:00-000, 110, 54, 56, 61, 1350.61, 56, 1350.58, 1
4, 10:51:00-000, 93, 45, 48, 40, 1349.89, 36, 1350.61, 4
4, 10:52:00-000, 86, 39, 47, 41, 1351.36, 51, 1349.83, 6
4, 10:53:00-000, 78, 31, 47, 28, 1349.49, 32, 1349.81, 3
4, 10:54:00-000, 83, 38, 45, 31, 1350.12, 49, 1350.42, 2
4, 10:55:00-000, 85, 44, 41, 45, 1351.92, 38, 1351.60, 6
4, 10:56:00-000, 82, 41, 41, 41, 1351.63, 50, 1352.33, 1
4, 10:57:00-000, 79, 45, 34, 41, 1350.36, 34, 1350.35, 4
4, 10:58:00-000, 68, 32, 36, 29, 1352.17, 34, 1351.43, 8
4, 10:59:00-000, 83, 34, 49, 34, 1352.46, 33, 1352.42, 9
4, 11:00:00-000, 81, 49, 32, 40, 1351.12, 33, 1351.72, 6
4, 11:01:00-000, 95, 32, 63, 37, 1350.53, 43, 1350.99, 7
4, 11:02:00-000, 69, 44, 25, 36, 1350.77, 37, 1350.34, 3
4, 11:03:00-000, 73, 46, 27, 42, 1350.49, 29, 1350.48, 13
4, 11:04:00-000, 108, 46, 62, 35, 1348.82, 43, 1348.85, 7
4, 11:05:00-000, 69, 36, 33, 36, 1351.11, 36, 1350.91, 19
4, 11:06:00-000, 73, 40, 33, 40, 1350.27, 27, 1350.59, 7
4, 11:07:00-000, 71, 28, 43, 27, 1348.25, 32, 1348.68, 2
4, 11:08:00-000, 67, 27, 40, 28, 1349.28, 41, 1349.38, 7
4, 11:09:00-000, 89, 41, 48, 33, 1350.60, 36, 1350.74, 6
4, 11:10:00-000, 71, 41, 30, 43, 1350.71, 32, 1351.68, 6
4, 11:11:00-000, 60, 36, 24, 35, 1351.16, 26, 1351.07, 2
4, 11:12:00-000, 86, 48, 38, 46, 1351.64, 32, 1350.87, 2
4, 11:13:00-000, 80, 42, 38, 37, 1352.62, 30, 1353.16, 13
4, 11:14:00-000, 77, 28, 49, 26, 1349.69, 29, 1349.82, 15
4, 11:15:00-000, 91, 33, 58, 33, 1349.57, 54, 1348.47, 12
4, 11:16:00-000, 95, 48, 47, 48, 1350.68, 50, 1351.09, 1
4, 11:17:00-000, 52, 26, 26, 22, 1350.81, 13, 1351.46, 2
4, 11:18:00-000, 92, 44, 48, 44, 1348.08, 57, 1349.00, 5
4, 11:19:00-000, 79, 39, 40, 41, 1351.67, 24, 1352.08, 11
4, 11:20:00-000, 62, 41, 21, 33, 1353.30, 24, 1353.00, 5
4, 11:21:00-000, 74, 32, 42, 29, 1351.37, 36, 1350.88, 4
4, 11:22:00-000, 80, 36, 44, 35, 1350.85, 39, 1351.61, 6
4, 11:23:00-000, 111, 47, 64, 44, 1351.13, 52, 1350.66, 9
4, 11:24:00-000, 72, 19, 53, 27, 1347.18, 47, 1348.59, 10
4, 11:25:00-000, 77, 39, 38, 38, 1349.89, 35, 1349.62, 7
4, 11:26:00-000, 85, 47, 38, 40, 1351.09, 41, 1350.97, 3
4, 11:27:00-000, 115, 69, 46, 60, 1351.89, 39, 1350.66, 12
4, 11:28:00-000, 87, 45, 42, 47, 1349.95, 42, 1349.30, 2
4, 11:29:00-000, 78, 33, 45, 33, 1349.69, 39, 1349.38, 3
4, 11:30:00-000, 110, 60, 50, 55, 1350.79, 43, 1350.83, 6
4, 11:31:00-000, 82, 46, 36, 43, 1351.09, 36, 1351.10, 10
4, 11:32:00-000, 69, 29, 40, 32, 1349.34, 28, 1349.82, 7
4, 11:33:00-000, 90, 47, 43, 39, 1349.02, 41, 1349.97, 10
4, 11:34:00-000, 117, 66, 51, 71, 1350.51, 45, 1351.32, 0
4, 11:35:00-000, 77, 41, 36, 37, 1351.02, 36, 1351.24, 8
4, 11:36:00-000, 82, 35, 47, 28, 1350.64, 37, 1350.48, 1
4, 11:37:00-000, 77, 34, 43, 36, 1352.55, 28, 1350.49, 22
4, 11:38:00-000, 93, 42, 51, 30, 1349.83, 48, 1350.07, 12
4, 11:39:00-000, 83, 47, 36, 51, 1350.78, 37, 1351.29, 8
4, 11:40:00-000, 85, 26, 59, 20, 1349.35, 26, 1349.88, 17
4, 11:41:00-000, 92, 43, 49, 46, 1349.84, 48, 1349.62, 11
4, 11:42:00-000, 75, 31, 44, 27, 1352.03, 41, 1351.70, 8
4, 11:43:00-000, 69, 32, 37, 26, 1352.96, 30, 1352.79, 2
4, 11:44:00-000, 71, 38, 33, 46, 1350.86, 35, 1351.45, 9
4, 11:45:00-000, 100, 42, 58, 43, 1353.53, 45, 1353.77, 2
4, 11:46:00-000, 68, 35, 33, 34, 1352.46, 34, 1352.55, 3
4, 11:47:00-000, 71, 31, 40, 31, 1351.22, 34, 1351.79, 11
4, 11:48:00-000, 102, 48, 54, 41, 1350.50, 47, 1350.54, 5
4, 11:49:00-000, 76, 34, 42, 38, 1350.55, 30, 1350.93, 7
4, 11:50:00-000, 75, 35, 40, 35, 1350.28, 48, 1350.59, 2
4, 11:51:00-000, 84, 41, 43, 40, 1350.64, 37, 1351.48, 2
4, 11:52:00-000, 77, 32, 45, 24, 1348.79, 39, 1348.53, 8
4, 11:53:00-000, 95, 44, 51, 41, 1351.24, 35, 1350.99, 24
4, 11:54:00-000, 62, 34, 28, 35, 1350.79, 27, 1351.07, 1
4, 11:55:00-000, 73, 26, 47, 26, 1349.57, 33, 1350.02, 12
4, 11:56:00-000, 104, 56, 48, 52, 1351.18, 52, 1350.80, 3
4, 11:57:00-000, 71, 36, 35, 38, 1350.02, 32, 1349.71, 4
4, 11:58:00-000, 58, 22, 36, 21, 1349.81, 36, 1350.24, 3
4, 11:59:00-000, 95, 64, 31, 57, 1352.74, 28, 1352.14, 3
4, 12:00:00-000, 97, 36, 61, 43, 1350.71, 62, 1349.99, 1
4, 12:01:00-000, 80, 28, 52, 28, 1348.85, 28, 1348.28, 12
4, 12:02:00-000, 94, 56, 38, 56, 1350.93, 44, 1350.22, 5
4, 12:03:00-000, 82, 27, 55, 27, 1349.10, 41, 1349.24, 6
4, 12:04:00-000, 68, 42, 26, 33, 1352.39, 28, 1351.35, 9
4, 12:05:00-000, 87, 41, 46, 41, 1349.38, 43, 1349.90, 5
4, 12:06:00-000, 87, 35, 52, 35, 1347.34, 49, 1348.54, 5
4, 12:07:00-000, 79, 30, 49, 30, 1345.70, 40, 1347.24, 8
4, 12:08:00-000, 84, 36, 48, 34, 1349.35, 52, 1349.76, 2
4, 12:09:00-000, 96, 56, 40, 49, 1349.11, 31, 1349.25, 1
4, 12:10:00-000, 92, 52, 40, 52, 1348.72, 48, 1349.20, 3
4, 12:11:00-000, 72, 43, 29, 43, 1351.60, 19, 1352.58, 10
4, 12:12:00-000, 79, 32, 47, 31, 1351.83, 41, 1351.99, 2
4, 12:13:00-000, 82, 48, 34, 41, 1350.11, 32, 1350.43, 15
4, 12:14:00-000, 87, 42, 45, 37, 1349.40, 42, 1349.90, 2
4, 12:15:00-000, 63, 37, 26, 39, 1351.43, 26, 1351.15, 5
4, 12:16:00-000, 85, 31, 54, 31, 1348.80, 46, 1348.88, 5
4, 12:17:00-000, 94, 28, 66, 27, 1350.51, 55, 1350.67, 3
4, 12:18:00-000, 78, 42, 36, 43, 1350.62, 44, 1351.29, 6
4, 12:19:00-000, 84, 42, 42, 41, 1350.99, 36, 1350.88, 5
4, 12:20:00-000, 71, 36, 35, 36, 1351.10, 13, 1350.61, 7
4, 12:21:00-000, 84, 38, 46, 34, 1349.61, 42, 1350.61, 12
4, 12:22:00-000, 64, 39, 25, 32, 1352.68, 32, 1352.06, 6
4, 12:23:00-000, 98, 60, 38, 56, 1353.43, 23, 1352.26, 19
4, 12:24:00-000, 71, 33, 38, 33, 1350.57, 33, 1351.36, 6
4, 12:25:00-000, 75, 35, 40, 33, 1350.51, 35, 1350.05, 9
4, 12:26:00-000, 111, 31, 80, 31, 1347.86, 62, 1348.12, 11
4, 12:27:00-000, 80, 27, 53, 28, 1349.10, 33, 1348.90, 11
4, 12:28:00-000, 84, 41, 43, 39, 1350.61, 43, 1350.32, 14
4, 12:29:00-000, 90, 38, 52, 40, 1350.47, 52, 1350.40, 0
4, 12:30:00-000, 69, 40, 29, 29, 1352.51, 23, 1351.21, 11
4, 12:31:00-000, 81, 49, 32, 52, 1351.28, 33, 1351.99, 3
4, 12:32:00-000, 74, 40, 34, 34, 1351.58, 34, 1351.26, 3
4, 12:33:00-000, 106, 51, 55, 40, 1351.04, 54, 1351.84, 8
4, 12:34:00-000, 72, 41, 31, 47, 1350.44, 26, 1350.19, 3
4, 12:35:00-000, 98, 62, 36, 55, 1353.34, 38, 1352.86, 4
4, 12:36:00-000, 68, 42, 26, 47, 1351.31, 20, 1351.10, 5
4, 12:37:00-000, 79, 28, 51, 29, 1350.24, 39, 1350.76, 3
4, 12:38:00-000, 80, 39, 41, 37, 1350.32, 52, 1350.91, 3
4, 12:39:00-000, 83, 35, 48, 33, 1351.08, 39, 1351.07, 0
4, 12:40:00-000, 88, 33, 55, 33, 1350.18, 55, 1350.50, 2
4, 12:41:00-000, 73, 45, 28, 44, 1352.52, 30, 1352.06, 7
4, 12:42:00-000, 76, 38, 38, 34, 1351.73, 38, 1352.05, 2
4, 12:43:00-000, 77, 35, 42, 34, 1351.76, 26, 1352.30, 7
4, 12:44:00-000, 107, 54, 53, 49, 1352.52, 59, 1352.09, 8
4, 12:45:00-000, 71, 26, 45, 20, 1349.20, 23, 1348.47, 13
4, 12:46:00-000, 101, 42, 59, 36, 1349.55, 56, 1349.54, 5
4, 12:47:00-000, 71, 44, 27, 47, 1351.03, 26, 1351.30, 18
4, 12:48:00-000, 87, 32, 55, 32, 1347.99, 46, 1348.77, 0
4, 12:49:00-000, 101, 56, 45, 53, 1349.84, 39, 1350.20, 8
4, 12:50:00-000, 77, 39, 38, 39, 1351.84, 41, 1351.56, 5
4, 12:51:00-000, 110, 51, 59, 48, 1351.70, 49, 1351.72, 3
4, 12:52:00-000, 91, 52, 39, 48, 1349.99, 43, 1351.46, 11
4, 12:53:00-000, 81, 31, 50, 27, 1348.99, 40, 1349.79, 6
4, 12:54:00-000, 103, 60, 43, 61, 1351.14, 48, 1351.20, 1
4, 12:55:00-000, 93, 54, 39, 53, 1350.63, 35, 1351.36, 3
4, 12:56:00-000, 98, 38, 60, 39, 1349.45, 60, 1349.65, 2
4, 12:57:00-000, 88, 34, 54, 32, 1349.34, 33, 1350.11, 13
4, 12:58:00-000, 67, 25, 42, 26, 1349.88, 40, 1350.87, 5
4, 12:59:00-000, 79, 43, 36, 44, 1349.49, 33, 1349.81, 8
4, 13:00:00-000, 100, 60, 40, 49, 1351.71, 34, 1351.88, 7
4, 13:01:00-000, 79, 22, 57, 26, 1348.00, 44, 1348.79, 8
4, 13:02:00-000, 75, 34, 41, 22, 1348.41, 44, 1349.01, 2
4, 13:03:00-000, 91, 51, 40, 49, 1350.60, 46, 1351.21, 16
4, 13:04:00-000, 85, 42, 43, 37, 1350.99, 29, 1351.10, 9
4, 13:05:00-000, 85, 47, 38, 42, 1350.47, 32, 1350.59, 6
4, 13:06:00-000, 81, 34, 47, 38, 1349.18, 47, 1349.67, 0
4, 13:07:00-000, 71, 37, 34, 35, 1349.48, 35, 1349.28, 9
4, 13:08:00-000, 65, 30, 35, 31, 1352.45, 30, 1351.79, 5
4, 13:09:00-000, 80, 42, 38, 35, 1350.85, 37, 1351.13, 6
4, 13:10:00-000, 90, 49, 41, 46, 1350.51, 39, 1350.53, 8
4, 13:11:00-000, 60, 27, 33, 25, 1349.96, 27, 1349.62, 3
4, 13:12:00-000, 83, 50, 33, 43, 1351.53, 36, 1351.24, 5
4, 13:13:00-000, 91, 40, 51, 44, 1350.88, 44, 1350.77, 3
4, 13:14:00-000, 82, 40, 42, 36, 1352.19, 39, 1352.20, 8
4, 13:15:00-000, 87, 36, 51, 33, 1349.97, 38, 1350.10, 11
4, 13:16:00-000, 83, 43, 40, 39, 1350.53, 50, 1349.57, 0
4, 13:17:00-000, 65, 37, 28, 39, 1353.63, 21, 1352.90, 3
4, 13:18:00-000, 119, 63, 56, 61, 1350.87, 58, 1350.80, 2
4, 13:19:00-000, 91, 48, 43, 43, 1351.23, 43, 1350.48, 3
4, 13:20:00-000, 75, 40, 35, 43, 1351.67, 33, 1351.57, 3
4, 13:21:00-000, 72, 31, 41, 29, 1351.24, 41, 1351.09, 3
4, 13:22:00-000, 76, 25, 51, 26, 1350.46, 52, 1350.86, 0
4, 13:23:00-000, 78, 28, 50, 28, 1352.32, 30, 1351.89, 6
4, 13:24:00-000, 75, 43, 32, 39, 1351.40, 36, 1351.69, 7
4, 13:25:00-000, 85, 39, 46, 42, 1351.83, 36, 1352.38, 2
4, 13:26:00-000, 88, 48, 40, 46, 1349.95, 42, 1350.28, 10
4, 13:27:00-000, 79, 32, 47, 29, 1351.27, 27, 1351.36, 4
4, 13:28:00-000, 92, 53, 39, 51, 1352.13, 51, 1350.87, 9
4, 13:29:00-000, 63, 24, 39, 21, 1349.80, 20, 1350.20, 8
4, 13:30:00-000, 70, 40, 30, 38, 1350.33, 45, 1350.57, 2
4, 13:31:00-000, 81, 32, 49, 27, 1351.88, 18, 1351.27, 18
4, 13:32:00-000, 88, 55, 33, 54, 1354.60, 45, 1352.99, 1
4, 13:33:00-000, 97, 55, 42, 48, 1352.99, 31, 1353.12, 12
4, 13:34:00-000, 83, 36, 47, 41, 1350.60, 52, 1350.68, 1
4, 13:35:00-000, 77, 31, 46, 29, 1349.30, 32, 1349.65, 9
4, 13:36:00-000, 95, 36, 59, 38, 1347.89, 55, 1349.34, 1
4, 13:37:00-000, 71, 42, 29, 39, 1349.89, 31, 1349.93, 1
4, 13:38:00-000, 81, 50, 31, 54, 1350.71, 35, 1350.88, 0
4, 13:39:00-000, 74, 30, 44, 30, 1348.13, 35, 1348.79, 4
4, 13:40:00-000, 85, 48, 37, 41, 1350.53, 32, 1350.31, 7
4, 13:41:00-000, 74, 33, 41, 33, 1351.15, 43, 1351.25, 5
4, 13:42:00-000, 67, 31, 36, 28, 1349.49, 27, 1350.11, 2
4, 13:43:00-000, 85, 47, 38, 43, 1350.32, 40, 1350.09, 11
4, 13:44:00-000, 65, 34, 31, 34, 1349.93, 24, 1350.41, 0
4, 13:45:00-000, 91, 36, 55, 33, 1349.02, 39, 1348.35, 10
4, 13:46:00-000, 75, 37, 38, 42, 1348.59, 46, 1349.06, 9
4, 13:47:00-000, 93, 40, 53, 40, 1349.42, 30, 1347.90, 9
4, 13:48:00-000, 86, 57, 29, 48, 1352.57, 42, 1351.18, 3
4, 13:49:00-000, 66, 28, 38, 33, 1350.99, 28, 1350.96, 4
4, 13:50:00-000, 104, 50, 54, 49, 1350.52, 57, 1351.06, 1
4, 13:51:00-000, 76, 45, 31, 38, 1352.70, 30, 1351.73, 4
4, 13:52:00-000, 69, 33, 36, 40, 1349.49, 25, 1349.52, 7
4, 13:53:00-000, 79, 42, 37, 36, 1351.63, 37, 1350.97, 0
4, 13:54:00-000, 81, 36, 45, 41, 1350.77, 49, 1351.40, 2
4, 13:55:00-000, 98, 31, 67, 29, 1349.86, 46, 1349.75, 2
4, 13:56:00-000, 87, 47, 40, 49, 1351.79, 58, 1352.09, 0
4, 13:57:00-000, 70, 34, 36, 34, 1351.14, 30, 1351.33, 1
4, 13:58:00-000, 61, 32, 29, 32, 1349.71, 33, 1350.45, 2
4, 13:59:00-000, 94, 43, 51, 36, 1349.63, 39, 1349.56, 2
4, 14:00:00-000, 73, 29, 44, 30, 1349.63, 42, 1349.82, 9
4, 14:01:00-000, 92, 44, 48, 42, 1350.68, 39, 1350.71, 6
4, 14:02:00-000, 75, 31, 44, 32, 1352.30, 43, 1352.41, 2
4, 14:03:00-000, 100, 44, 56, 47, 1350.97, 50, 1351.15, 10
4, 14:04:00-000, 85, 37, 48, 35, 1351.05, 41, 1351.41, 4
4, 14:05:00-000, 90, 44, 46, 38, 1350.07, 49, 1350.17, 3
4, 14:06:00-000, 73, 41, 32, 41, 1351.58, 20, 1351.85, 19
4, 14:07:00-000, 93, 51, 42, 49, 1351.46, 35, 1351.42, 2
4, 14:08:00-000, 90, 43, 47, 46, 1350.16, 53, 1350.41, 0
4, 14:09:00-000, 67, 38, 29, 39, 1350.35, 24, 1350.16, 1
4, 14:10:00-000, 92, 37, 55, 35, 1350.14, 47, 1349.37, 13
4, 14:11:00-000, 82, 46, 36, 46, 1352.73, 30, 1352.63, 4
4, 14:12:00-000, 74, 30, 44, 30, 1350.49, 34, 1349.55, 1
4, 14:13:00-000, 98, 53, 45, 51, 1349.40, 54, 1348.99, 3
4, 14:14:00-000, 86, 41, 45, 42, 1351.52, 41, 1351.77, 1
4, 14:15:00-000, 64, 24, 40, 24, 1349.66, 36, 1349.16, 1
4, 14:16:00-000, 82, 38, 44, 37, 1350.72, 40, 1350.12, 0
4, 14:17:00-000, 81, 41, 40, 38, 1350.62, 33, 1350.21, 8
4, 14:18:00-000, 84, 43, 41, 42, 1351.85, 48, 1351.66, 7
4, 14:19:00-000, 71, 31, 40, 28, 1350.42, 39, 1349.97, 3
4, 14:20:00-000, 88, 36, 52, 38, 1350.60, 48, 1350.51, 4
4, 14:21:00-000, 85, 45, 40, 46, 1352.99, 25, 1353.24, 10
4, 14:22:00-000, 79, 36, 43, 36, 1350.35, 48, 1350.43, 0
4, 14:23:00-000, 76, 34, 42, 34, 1351.70, 29, 1351.48, 1
4, 14:24:00-000, 94, 32, 62, 28, 1348.17, 59, 1348.46, 7
4, 14:25:00-000, 84, 50, 34, 45, 1351.19, 38, 1351.81, 8
4, 14:26:00-000, 85, 49, 36, 50, 1352.49, 32, 1352.31, 4
4, 14:27:00-000, 98, 48, 50, 42, 1353.09, 38, 1352.97, 10
4, 14:28:00-000, 73, 33, 40, 37, 1349.10, 37, 1348.78, 9
4, 14:29:00-000, 85, 44, 41, 44, 1351.33, 42, 1351.78, 0
4, 14:30:00-000, 77, 41, 36, 38, 1351.63, 34, 1350.44, 3
4, 14:31:00-000, 78, 38, 40, 37, 1350.18, 35, 1350.74, 6
4, 14:32:00-000, 97, 56, 41, 54, 1351.39, 33, 1350.09, 4
4, 14:33:00-000, 73, 33, 40, 29, 1350.72, 37, 1350.75, 5
4, 14:34:00-000, 70, 43, 27, 36, 1351.24, 34, 1351.85, 8
4, 14:35:00-000, 102, 43, 59, 38, 1350.71, 56, 1349.96, 1
4, 14:36:00-000, 84, 57, 27, 57, 1352.02, 27, 1352.26, 6
4, 14:37:00-000, 68, 30, 38, 21, 1351.52, 32, 1351.18, 3
4, 14:38:00-000, 74, 39, 35, 45, 1349.90, 39, 1350.94, 3
4, 14:39:00-000, 86, 36, 50, 34, 1350.44, 46, 1350.99, 2
4, 14:40:00-000, 88, 56, 32, 56, 1351.99, 33, 1352.57, 1
4, 14:41:00-000, 73, 31, 42, 33, 1351.21, 32, 1350.96, 4
4, 14:42:00-000, 84, 52, 32, 51, 1350.23, 40, 1350.07, 2
4, 14:43:00-000, 86, 28, 58, 24, 1349.45, 40, 1350.59, 0
4, 14:44:00-000, 78, 28, 50, 32, 1348.71, 52, 1349.45, 11
4, 14:45:00-000, 93, 39, 54, 35, 1350.02, 45, 1349.39, 5
4, 14:46:00-000, 83, 35, 48, 36, 1350.16, 51, 1351.27, 2
4, 14:47:00-000, 94, 40, 54, 38, 1349.97, 42, 1350.16, 8
4, 14:48:00-000, 97, 47, 50, 50, 1350.85, 41, 1350.85, 2
4, 14:49:00-000, 82, 42, 40, 42, 1349.83, 39, 1349.89, 6
4, 14:50:00-000, 85, 48, 37, 39, 1350.15, 47, 1349.93, 2
4, 14:51:00-000, 84, 28, 56, 28, 1349.42, 34, 1349.85, 9
4, 14:52:00-000, 94, 61, 33, 52, 1350.59, 52, 1350.97, 3
4, 14:53:00-000, 104, 71, 33, 70, 1352.89, 32, 1352.28, 3
4, 14:54:00-000, 57, 30, 27, 33, 1348.81, 23, 1349.30, 2
4, 14:55:00-000, 78, 42, 36, 38, 1349.55, 36, 1349.66, 2
4, 14:56:00-000, 93, 48, 45, 52, 1350.65, 43, 1350.50, 1
4, 14:57:00-000, 76, 47, 29, 43, 1350.58, 35, 1350.54, 0
4, 14:58:00-000, 88, 50, 38, 44, 1350.95, 33, 1351.72, 5
4, 14:59:00-000, 84, 36, 48, 33, 1349.27, 38, 1349.52, 14
4, 15:00:00-000, 104, 50, 54, 55, 1349.95, 45, 1350.28, 6
4, 15:01:00-000, 69, 22, 47, 22, 1349.09, 39, 1347.61, 7
4, 15:02:00-000, 97, 45, 52, 45, 1350.81, 44, 1351.01, 0
4, 15:03:00-000, 74, 30, 44, 28, 1349.60, 44, 1349.95, 12
4, 15:04:00-000, 79, 33, 46, 31, 1349.57, 45, 1349.53, 1
4, 15:05:00-000, 74, 40, 34, 41, 1350.12, 34, 1349.70, 4
4, 15:06:00-000, 80, 32, 48, 29, 1349.06, 40, 1349.34, 3
4, 15:07:00-000, 74, 38, 36, 39, 1354.17, 23, 1353.30, 8
4, 15:08:00-000, 77, 37, 40, 37, 1353.78, 46, 1353.66, 3
4, 15:09:00-000, 76, 45, 31, 43, 1351.62, 32, 1351.12, 1
4, 15:10:00-000, 86, 39, 47, 38, 1348.86, 48, 1349.39, 2
4, 15:11:00-000, 88, 51, 37, 43, 1349.92, 35, 1350.22, 2
4, 15:12:00-000, 91, 28, 63, 36, 1347.85, 57, 1347.95, 1
4, 15:13:00-000, 76, 43, 33, 39, 1349.99, 28, 1350.78, 7
4, 15:14:00-000, 104, 60, 44, 57, 1350.97, 43, 1351.99, 8
4, 15:15:00-000, 92, 32, 60, 33, 1350.84, 50, 1351.01, 3
4, 15:16:00-000, 79, 36, 43, 35, 1349.94, 46, 1350.71, 3
4, 15:17:00-000, 77, 33, 44, 29, 1350.37, 40, 1350.77, 7
4, 15:18:00-000, 75, 44, 31, 48, 1351.18, 28, 1351.67, 0
4, 15:19:00-000, 93, 36, 57, 28, 1350.49, 43, 1350.37, 12
4, 15:20:00-000, 103, 49, 54, 46, 1350.23, 63, 1350.43, 0
4, 15:21:00-000, 107, 53, 54, 57, 1350.51, 56, 1350.83, 3
4, 15:22:00-000, 73, 40, 33, 34, 1348.14, 30, 1349.26, 3
4, 15:23:00-000, 96, 48, 48, 46, 1350.97, 48, 1351.22, 7
4, 15:24:00-000, 90, 42, 48, 27, 1350.81, 44, 1351.04, 6
4, 15:25:00-000, 81, 30, 51, 38, 1350.86, 40, 1350.19, 9
4, 15:26:00-000, 66, 37, 29, 33, 1349.18, 34, 1349.43, 4
4, 15:27:00-000, 103, 58, 45, 55, 1351.75, 40, 1351.89, 4
4, 15:28:00-000, 100, 58, 42, 53, 1350.99, 44, 1350.90, 6
4, 15:29:00-000, 55, 33, 22, 36, 1352.08, 23, 1352.00, 0
4, 15:30:00-000, 105, 57, 48, 55, 1351.75, 39, 1351.20, 1
4, 15:31:00-000, 89, 39, 50, 39, 1350.07, 39, 1350.12, 9
4, 15:32:00-000, 76, 36, 40, 36, 1350.74, 42, 1350.37, 7
4, 15:33:00-000, 78, 24, 54, 24, 1347.62, 47, 1348.03, 5
4, 15:34:00-000, 105, 59, 46, 52, 1351.95, 50, 1350.95, 4
4, 15:35:00-000, 89, 49, 40, 55, 1351.79, 37, 1350.94, 0
4, 15:36:00-000, 105, 70, 35, 53, 1352.14, 39, 1352.04, 8
4, 15:37:00-000, 62, 34, 28, 39, 1351.94, 22, 1351.54, 4
4, 15:38:00-000, 104, 45, 59, 41, 1349.24, 52, 1349.49, 2
4, 15:39:00-000, 56, 28, 28, 32, 1348.56, 23, 1348.52, 6
4, 15:40:00-000, 85, 42, 43, 41, 1350.70, 48, 1350.41, 1
4, 15:41:00-000, 87, 46, 41, 44, 1351.90, 41, 1352.19, 2
4, 15:42:00-000, 58, 28, 30, 29, 1349.79, 26, 1350.46, 1
4, 15:43:00-000, 69, 30, 39, 28, 1349.67, 25, 1350.08, 9
4, 15:44:00-000, 82, 34, 48, 33, 1350.99, 49, 1351.42, 5
4, 15:45:00-000, 98, 44, 54, 39, 1351.30, 43, 1350.76, 5
4, 15:46:00-000, 63, 26, 37, 31, 1350.25, 35, 1350.48, 10
4, 15:47:00-000, 74, 34, 40, 34, 1349.52, 35, 1349.68, 3
4, 15:48:00-000, 90, 39, 51, 37, 1349.51, 50, 1349.37, 4
4, 15:49:00-000, 75, 36, 39, 38, 1350.10, 41, 1348.94, 0
4, 15:50:00-000, 66, 31, 35, 21, 1349.95, 30, 1351.33, 2
4, 15:51:00-000, 79, 52, 27, 48, 1348.91, 29, 1349.27, 7
4, 15:52:00-000, 98, 48, 50, 47, 1349.97, 43, 1349.99, 7
4, 15:53:00-000, 82, 36, 46, 38, 1348.28, 34, 1348.49, 5
4, 15:54:00-000, 72, 38, 34, 39, 1349.58, 45, 1350.21, 3
4, 15:55:00-000, 65, 32, 33, 33, 1350.81, 24, 1350.83, 4
4, 15:56:00-000, 91, 49, 42, 51, 1352.58, 36, 1352.30, 0
4, 15:57:00-000, 91, 33, 58, 33, 1350.63, 40, 1350.47, 11
4, 15:58:00-000, 77, 35, 42, 33, 1349.06, 50, 1349.97, 4
4, 15:59:00-000, 99, 66, 33, 59, 1352.00, 33, 1351.75, 7
4, 16:00:00-000, 86, 41, 45, 43, 1351.43, 35, 1351.08, 2
4, 16:01:00-000, 71, 33, 38, 29, 1350.17, 31, 1351.15, 10
4, 16:02:00-000, 65, 23, 42, 27, 1348.18, 40, 1348.57, 7
4, 16:03:00-000, 92, 48, 44, 48, 1349.99, 37, 1349.96, 2
4, 16:04:00-000, 85, 32, 53, 31, 1349.67, 42, 1349.56, 5
4, 16:05:00-000, 73, 38, 35, 39, 1350.05, 47, 1350.33, 4
4, 16:06:00-000, 83, 40, 43, 38, 1350.73, 38, 1350.68, 2
4, 16:07:00-000, 81, 34, 47, 29, 1352.10, 49, 1351.99, 1
4, 16:08:00-000, 65, 22, 43, 25, 1350.55, 41, 1350.60, 3
4, 16:09:00-000, 67, 28, 39, 28, 1351.39, 29, 1351.17, 2
4, 16:10:00-000, 101, 50, 51, 46, 1349.38, 57, 1350.27, 1
4, 16:11:00-000, 55, 35, 20, 36, 1351.52, 19, 1351.00, 1
4, 16:12:00-000, 57, 21, 36, 23, 1348.13, 34, 1349.08, 1
4, 16:13:00-000, 77, 30, 47, 29, 1349.41, 42, 1347.21, 3
4, 16:14:00-000, 106, 65, 41, 59, 1349.11, 38, 1349.86, 5
4, 16:15:00-000, 71, 37, 34, 39, 1350.99, 30, 1351.39, 6
4, 16:16:00-000, 78, 46, 32, 37, 1350.70, 35, 1350.34, 5
4, 16:17:00-000, 84, 46, 38, 44, 1349.70, 22, 1349.90, 4
4, 16:18:00-000, 88, 49, 39, 51, 1352.20, 59, 1351.86, 1
4, 16:19:00-000, 73, 32, 41, 29, 1349.68, 29, 1350.34, 1
4, 16:20:00-000, 96, 54, 42, 54, 1352.20, 52, 1351.95, 1
4, 16:21:00-000, 75, 39, 36, 34, 1349.84, 27, 1350.55, 0
4, 16:22:00-000, 108, 64, 44, 63, 1349.59, 49, 1350.20, 7
4, 16:23:00-000, 73, 34, 39, 35, 1350.71, 33, 1351.08, 0
4, 16:24:00-000, 61, 25, 36, 32, 1349.65, 37, 1349.50, 2
4, 16:25:00-000, 83, 46, 37, 38, 1350.15, 36, 1351.16, 3
4, 16:26:00-000, 112, 47, 65, 52, 1350.45, 58, 1350.78, 8
4, 16:27:00-000, 75, 27, 48, 27, 1346.14, 34, 1346.32, 4
4, 16:28:00-000, 83, 47, 36, 39, 1350.66, 46, 1349.64, 1
4, 16:29:00-000, 95, 43, 52, 46, 1350.25, 45, 1350.86, 7
5, 09:13:00-000, 10221, 5580, 4641, 3824, 1348.14, 3750, 1350.02, 0
5, 09:14:00-000, 0, 0, 0, 1, 1347.00, 5, 1357.00, 639
5, 09:15:00-000, 0, 0, 0, 0, 0.00, 52, 1357.00, 1942
5, 09:16:00-000, 0, 0, 0, 0, 0.00, 0, 0.00, 8
5, 09:26:00-000, 10160, 5446, 4714, 3628, 1348.36, 3716, 1348.47, 0
5, 09:27:00-000, 0, 0, 0, 16, 1348.00, 34, 1356.00, 0
5, 09:28:00-000, 0, 0, 0, 46, 1347.00, 96, 1356.00, 1980
5, 09:29:00-000, 18, 11, 7, 7, 1350.00, 7, 1350.71, 644
5, 09:30:00-000, 64, 35, 29, 22, 1351.81, 29, 1354.27, 1
5, 09:31:00-000, 0, 0, 0, 3, 1348.00, 0, 0.00, 1
5, 09:32:00-000, 171, 77, 94, 51, 1349.20, 79, 1350.62, 11
5, 09:33:00-000, 419, 248, 171, 177, 1350.12, 157, 1350.12, 23
5, 09:34:00-000, 600, 326, 274, 228, 1348.26, 228, 1349.57, 34
5, 09:35:00-000, 0, 0, 0, 7, 1346.00, 23, 1357.00, 62
5, 09:36:00-000, 951, 496, 455, 388, 1349.34, 464, 1351.75, 89
5, 09:37:00-000, 1071, 584, 487, 410, 1349.16, 455, 1350.22, 71
5, 09:38:00-000, 1364, 736, 628, 509, 1348.89, 521, 1350.05, 100
5, 09:39:00-000, 0, 0, 0, 43, 1347.00, 12, 1357.83, 138
5, 09:40:00-000, 1258, 658, 600, 478, 1349.03, 512, 1350.13, 227
5, 09:41:00-000, 1290, 713, 577, 492, 1349.49, 489, 1349.97, 207
5, 09:42:00-000, 1145, 648, 497, 481, 1348.76, 435, 1349.26, 205
5, 09:43:00-000, 0, 0, 0, 38, 1346.00, 15, 1357.00, 194
5, 09:44:00-000, 1000, 525, 475, 405, 1349.26, 350, 1349.60, 168
5, 09:45:00-000, 858, 466, 392, 335, 1349.21, 378, 1350.64, 150
5, 09:46:00-000, 910, 450, 460, 334, 1348.24, 406, 1350.24, 102
5, 09:47:00-000, 0, 0, 0, 18, 1346.00, 91, 1357.09, 109
5, 09:48:00-000, 942, 538, 404, 367, 1349.24, 394, 1350.31, 108
5, 09:49:00-000, 1006, 475, 531, 394, 1348.41, 445, 1349.00, 84
5, 09:50:00-000, 933, 473, 460, 395, 1348.42, 335, 1348.76, 147
5, 09:51:00-000, 0, 0, 0, 15, 1345.00, 30, 1355.00, 121
5, 09:52:00-000, 1056, 569, 487, 425, 1348.88, 412, 1349.94, 133
5, 09:53:00-000, 1160, 627, 533, 465, 1348.42, 430, 1348.87, 143
5, 09:54:00-000, 1021, 528, 493, 449, 1348.43, 456, 1349.27, 181
5, 09:55:00-000, 0, 0, 0, 3, 1345.00, 12, 1356.00, 155
5, 09:56:00-000, 1046, 592, 454, 415, 1349.30, 395, 1350.23, 119
5, 09:57:00-000, 1118, 612, 506, 443, 1349.52, 429, 1349.91, 139
5, 09:58:00-000, 949, 489, 460, 429, 1348.61, 406, 1349.54, 175
5, 09:59:00-000, 0, 0, 0, 22, 1345.82, 0, 0.00, 125
5, 10:00:00-000, 1025, 545, 480, 407, 1349.12, 402, 1350.64, 128
5, 10:01:00-000, 1031, 553, 478, 386, 1349.18, 424, 1350.55, 175
5, 10:02:00-000, 966, 473, 493, 439, 1348.28, 401, 1349.00, 140
5, 10:03:00-000, 0, 0, 0, 12, 1345.00, 44, 1357.02, 124
5, 10:04:00-000, 1055, 523, 532, 394, 1348.79, 464, 1350.27, 100
5, 10:05:00-000, 1076, 561, 515, 433, 1349.21, 420, 1349.65, 119
5, 10:06:00-000, 1009, 542, 467, 393, 1349.46, 362, 1349.55, 148
5, 10:07:00-000, 0, 0, 0, 16, 1346.69, 30, 1356.00, 159
5, 10:08:00-000, 951, 488, 463, 346, 1348.65, 365, 1349.51, 145
5, 10:09:00-000, 1022, 519, 503, 392, 1348.14, 346, 1348.37, 177
5, 10:10:00-000, 1093, 554, 539, 487, 1348.23, 505, 1349.52, 174
5, 10:11:00-000, 0, 0, 0, 2, 1345.00, 11, 1357.00, 156
5, 10:12:00-000, 1000, 487, 513, 386, 1348.13, 449, 1349.69, 151
5, 10:13:00-000, 1067, 539, 528, 376, 1348.89, 371, 1348.99, 122
5, 10:14:00-000, 978, 522, 456, 409, 1349.24, 405, 1350.52, 156
5, 10:15:00-000, 0, 0, 0, 22, 1346.00, 29, 1356.00, 165
5, 10:16:00-000, 961, 517, 444, 403, 1349.17, 352, 1349.67, 151
5, 10:17:00-000, 967, 475, 492, 416, 1348.74, 433, 1349.69, 126
5, 10:18:00-000, 1130, 526, 604, 425, 1348.82, 481, 1348.94, 127
5, 10:19:00-000, 0, 0, 0, 21, 1345.00, 9, 1356.00, 110
5, 10:20:00-000, 1049, 498, 551, 403, 1347.89, 449, 1348.70, 136
5, 10:21:00-000, 1010, 557, 453, 405, 1348.51, 396, 1349.15, 124
5, 10:22:00-000, 1062, 572, 490, 425, 1349.32, 448, 1350.44, 129
5, 10:23:00-000, 0, 0, 0, 16, 1347.00, 11, 1357.00, 165
5, 10:24:00-000, 1042, 558, 484, 416, 1348.87, 432, 1350.12, 153
5, 10:25:00-000, 1121, 590, 531, 426, 1348.53, 413, 1349.14, 163
5, 10:26:00-000, 1015, 506, 509, 452, 1347.77, 381, 1348.77, 104
5, 10:27:00-000, 0, 0, 0, 0, 0.00, 16, 1355.00, 198
5, 10:28:00-000, 923, 478, 445, 366, 1348.16, 352, 1349.14, 157
5, 10:29:00-000, 916, 488, 428, 369, 1349.28, 372, 1350.40, 154
5, 10:30:00-000, 1031, 563, 468, 386, 1349.59, 469, 1350.82, 128
5, 10:31:00-000, 0, 0, 0, 11, 1348.00, 17, 1357.70, 111
5, 10:32:00-000, 1125, 561, 564, 432, 1348.81, 434, 1349.29, 138
5, 10:33:00-000, 1062, 539, 523, 382, 1349.20, 386, 1349.48, 195
5, 10:34:00-000, 1017, 525, 492, 436, 1348.18, 410, 1349.73, 187
5, 10:35:00-000, 0, 0, 0, 0, 0.00, 15, 1356.60, 167
5, 10:36:00-000, 1067, 536, 531, 425, 1348.45, 366, 1349.31, 177
5, 10:37:00-000, 1042, 550, 492, 362, 1348.60, 366, 1348.85, 178
5, 10:38:00-000, 987, 518, 469, 397, 1349.09, 415, 1350.09, 209
5, 10:39:00-000, 0, 0, 0, 8, 1346.00, 19, 1355.94, 186
5, 10:40:00-000, 901, 406, 495, 325, 1348.94, 378, 1349.63, 158
5, 10:41:00-000, 1009, 457, 552, 340, 1348.57, 402, 1348.96, 142
5, 10:42:00-000, 1090, 609, 481, 454, 1349.31, 394, 1350.07, 172
5, 10:43:00-000, 0, 0, 0, 36, 1347.00, 41, 1355.70, 152
5, 10:44:00-000, 1012, 532, 480, 387, 1348.67, 358, 1349.70, 169
5, 10:45:00-000, 1104, 598, 506, 470, 1349.19, 400, 1349.78, 197
5, 10:46:00-000, 1055, 533, 522, 405, 1348.20, 390, 1349.49, 132
5, 10:47:00-000, 1, 1, 0, 28, 1345.21, 0, 0.00, 162
5, 10:48:00-000, 952, 500, 452, 385, 1348.64, 379, 1349.75, 213
5, 10:49:00-000, 1025, 497, 528, 360, 1348.99, 397, 1349.24, 184
5, 10:50:00-000, 1062, 507, 555, 447, 1348.00, 504, 1349.42, 138
5, 10:51:00-000, 0, 0, 0, 24, 1345.00, 4, 1356.00, 138
5, 10:52:00-000, 1030, 521, 509, 430, 1348.21, 424, 1349.48, 91
5, 10:53:00-000, 1029, 546, 483, 368, 1349.15, 424, 1350.01, 132
5, 10:54:00-000, 923, 447, 476, 400, 1348.58, 340, 1349.64, 134
5, 10:55:00-000, 1, 0, 1, 13, 1345.00, 6, 1355.17, 137
5, 10:56:00-000, 1108, 599, 509, 431, 1348.77, 419, 1349.51, 179
5, 10:57:00-000, 1109, 594, 515, 421, 1348.79, 422, 1349.39, 203
5, 10:58:00-000, 924, 498, 426, 399, 1348.57, 350, 1349.68, 159
5, 10:59:00-000, 0, 0, 0, 12, 1345.00, 9, 1356.00, 171
5, 11:00:00-000, 1075, 496, 579, 422, 1347.98, 468, 1349.08, 139
5, 11:01:00-000, 1112, 600, 512, 397, 1348.66, 392, 1349.09, 167
5, 11:02:00-000, 922, 455, 467, 395, 1348.52, 440, 1350.43, 147
5, 11:03:00-000, 0, 0, 0, 28, 1345.00, 7, 1356.00, 150
5, 11:04:00-000, 1002, 502, 500, 410, 1348.85, 448, 1349.69, 112
5, 11:05:00-000, 1156, 589, 567, 449, 1348.27, 428, 1348.62, 123
5, 11:06:00-000, 1056, 542, 514, 429, 1348.32, 450, 1349.22, 139
5, 11:07:00-000, 0, 0, 0, 13, 1345.00, 0, 0.00, 166
5, 11:08:00-000, 930, 456, 474, 408, 1347.68, 342, 1348.42, 153
5, 11:09:00-000, 1008, 531, 477, 419, 1348.54, 375, 1348.90, 147
5, 11:10:00-000, 1035, 556, 479, 401, 1349.51, 393, 1350.76, 122
5, 11:11:00-000, 0, 0, 0, 49, 1346.14, 19, 1356.00, 143
5, 11:12:00-000, 1201, 551, 650, 438, 1348.76, 502, 1349.66, 149
5, 11:13:00-000, 1012, 506, 506, 375, 1348.80, 395, 1349.44, 203
5, 11:14:00-000, 1066, 548, 518, 396, 1349.05, 415, 1349.59, 179
5, 11:15:00-000, 0, 0, 0, 45, 1345.06, 12, 1355.00, 149
5, 11:16:00-000, 1035, 540, 495, 412, 1349.07, 430, 1349.92, 180
5, 11:17:00-000, 1024, 530, 494, 424, 1348.54, 390, 1349.02, 153
5, 11:18:00-000, 1101, 591, 510, 451, 1349.02, 416, 1349.24, 142
5, 11:19:00-000, 0, 0, 0, 19, 1346.00, 21, 1356.33, 154
5, 11:20:00-000, 976, 471, 505, 376, 1348.76, 442, 1349.80, 132
5, 11:21:00-000, 1067, 558, 509, 412, 1349.40, 410, 1350.05, 139
5, 11:22:00-000, 1084, 572, 512, 407, 1349.06, 434, 1350.01, 156
5, 11:23:00-000, 0, 0, 0, 62, 1345.67, 17, 1357.00, 133
5, 11:24:00-000, 973, 471, 502, 387, 1347.86, 417, 1349.54, 127
5, 11:25:00-000, 1049, 551, 498, 392, 1349.06, 358, 1349.57, 157
5, 11:26:00-000, 1049, 543, 506, 432, 1348.55, 435, 1349.76, 182
5, 11:27:00-000, 0, 0, 0, 8, 1346.00, 19, 1356.00, 142
5, 11:28:00-000, 1034, 586, 448, 428, 1349.36, 380, 1349.96, 168
5, 11:29:00-000, 998, 452, 546, 375, 1348.04, 391, 1348.86, 167
5, 11:30:00-000, 953, 476, 477, 335, 1348.62, 392, 1349.67, 139
5, 11:31:00-000, 0, 0, 0, 23, 1346.30, 8, 1356.00, 166
5, 11:32:00-000, 1041, 489, 552, 365, 1348.53, 411, 1350.22, 179
5, 11:33:00-000, 1036, 571, 465, 449, 1349.98, 383, 1350.58, 165
5, 11:34:00-000, 1032, 472, 560, 353, 1348.56, 407, 1349.39, 163
5, 11:35:00-000, 1, 0, 1, 18, 1346.00, 49, 1354.75, 167
5, 11:36:00-000, 1076, 567, 509, 394, 1349.33, 430, 1350.27, 186
5, 11:37:00-000, 1118, 600, 518, 431, 1348.96, 408, 1349.47, 176
5, 11:38:00-000, 1017, 464, 553, 418, 1348.20, 459, 1349.99, 134
5, 11:39:00-000, 1, 1, 0, 17, 1345.59, 13, 1355.84, 184
5, 11:40:00-000, 1018, 531, 487, 459, 1348.38, 383, 1349.71, 130
5, 11:41:00-000, 934, 527, 407, 403, 1348.76, 315, 1348.87, 147
5, 11:42:00-000, 1049, 556, 493, 406, 1348.68, 433, 1349.73, 148
5, 11:43:00-000, 1, 0, 1, 18, 1346.44, 48, 1357.47, 144
5, 11:44:00-000, 1041, 553, 488, 437, 1349.42, 375, 1350.57, 121
5, 11:45:00-000, 1034, 538, 496, 359, 1349.15, 403, 1349.84, 147
5, 11:46:00-000, 1040, 521, 519, 359, 1348.90, 393, 1349.51, 200
5, 11:47:00-000, 0, 0, 0, 9, 1346.00, 74, 1356.60, 185
5, 11:48:00-000, 1085, 549, 536, 413, 1349.23, 392, 1350.03, 176
5, 11:49:00-000, 1059, 519, 540, 371, 1348.21, 402, 1348.64, 190
5, 11:50:00-000, 1076, 553, 523, 424, 1348.72, 393, 1349.79, 158
5, 11:51:00-000, 0, 0, 0, 1, 1345.00, 7, 1355.00, 178
5, 11:52:00-000, 1049, 502, 547, 449, 1348.33, 432, 1349.37, 223
5, 11:53:00-000, 1009, 538, 471, 396, 1349.17, 371, 1349.84, 166
5, 11:54:00-000, 1050, 582, 468, 395, 1349.90, 451, 1350.85, 138
5, 11:55:00-000, 0, 0, 0, 42, 1346.28, 13, 1357.00, 158
5, 11:56:00-000, 1047, 560, 487, 406, 1349.32, 388, 1349.94, 154
5, 11:57:00-000, 991, 456, 535, 405, 1348.27, 407, 1349.13, 151
5, 11:58:00-000, 995, 515, 480, 372, 1348.28, 374, 1349.90, 134
5, 11:59:00-000, 0, 0, 0, 8, 1344.12, 45, 1353.88, 130
5, 12:00:00-000, 1031, 519, 512, 386, 1349.55, 415, 1349.82, 189
5, 12:01:00-000, 1131, 544, 587, 455, 1348.07, 492, 1349.14, 178
5, 12:02:00-000, 1029, 515, 514, 398, 1348.43, 402, 1349.63, 138
5, 12:03:00-000, 1, 0, 1, 26, 1344.23, 40, 1354.72, 135
5, 12:04:00-000, 1038, 525, 513, 463, 1348.79, 469, 1350.57, 140
5, 12:05:00-000, 1020, 469, 551, 360, 1348.12, 384, 1348.50, 110
5, 12:06:00-000, 905, 440, 465, 372, 1348.10, 376, 1349.30, 124
5, 12:07:00-000, 1, 1, 0, 24, 1343.96, 24, 1355.00, 147
5, 12:08:00-000, 1058, 612, 446, 452, 1349.43, 337, 1349.80, 154
5, 12:09:00-000, 1068, 567, 501, 483, 1348.02, 401, 1348.11, 131
5, 12:10:00-000, 1133, 594, 539, 439, 1348.71, 429, 1349.23, 163
5, 12:11:00-000, 2, 2, 0, 38, 1346.84, 6, 1356.00, 156
5, 12:12:00-000, 1022, 504, 518, 366, 1348.51, 450, 1349.98, 180
5, 12:13:00-000, 1044, 527, 517, 405, 1348.54, 379, 1349.13, 179
5, 12:14:00-000, 1007, 552, 455, 427, 1349.13, 406, 1349.53, 147
5, 12:15:00-000, 5, 5, 0, 37, 1345.40, 0, 0.00, 153
5, 12:16:00-000, 1051, 559, 492, 397, 1348.98, 405, 1349.88, 131
5, 12:17:00-000, 992, 503, 489, 392, 1348.82, 371, 1349.48, 173
5, 12:18:00-000, 953, 474, 479, 338, 1348.89, 416, 1350.06, 158
5, 12:19:00-000, 0, 0, 0, 18, 1346.05, 13, 1355.00, 170
5, 12:20:00-000, 1001, 464, 537, 321, 1349.15, 343, 1348.68, 161
5, 12:21:00-000, 980, 484, 496, 322, 1348.73, 345, 1348.88, 203
5, 12:22:00-000, 1029, 527, 502, 406, 1348.81, 357, 1348.70, 222
5, 12:23:00-000, 2, 2, 0, 1, 1354.00, 16, 1354.00, 244
5, 12:24:00-000, 993, 548, 445, 373, 1349.52, 340, 1349.42, 225
5, 12:25:00-000, 976, 482, 494, 398, 1349.07, 348, 1348.94, 165
5, 12:26:00-000, 1026, 544, 482, 407, 1348.81, 374, 1348.84, 210
5, 12:27:00-000, 0, 0, 0, 0, 0.00, 0, 0.00, 197
5, 12:28:00-000, 1131, 550, 581, 433, 1349.30, 414, 1349.04, 193
5, 12:29:00-000, 981, 496, 485, 347, 1348.95, 341, 1349.22, 186
5, 12:30:00-000, 1018, 542, 476, 404, 1348.99, 373, 1349.30, 241
5, 12:31:00-000, 0, 0, 0, 1, 1346.00, 22, 1355.00, 174
5, 12:32:00-000, 954, 425, 529, 335, 1348.72, 404, 1349.35, 186
5, 12:33:00-000, 1070, 575, 495, 388, 1348.97, 393, 1349.66, 156
5, 12:34:00-000, 1011, 539, 472, 421, 1349.31, 350, 1349.59, 196
5, 12:35:00-000, 6, 1, 5, 20, 1346.00, 0, 0.00, 192
5, 12:36:00-000, 997, 510, 487, 398, 1349.33, 373, 1349.75, 192
5, 12:37:00-000, 1051, 545, 506, 374, 1349.16, 360, 1349.53, 166
5, 12:38:00-000, 982, 471, 511, 376, 1348.52, 406, 1349.20, 198
5, 12:39:00-000, 0, 0, 0, 0, 0.00, 34, 1355.00, 204
5, 12:40:00-000, 1091, 592, 499, 417, 1349.70, 371, 1349.50, 142
5, 12:41:00-000, 1022, 521, 501, 402, 1348.84, 367, 1349.42, 176
5, 12:42:00-000, 1065, 562, 503, 407, 1348.88, 416, 1349.46, 239
5, 12:43:00-000, 0, 0, 0, 21, 1346.52, 0, 0.00, 165
5, 12:44:00-000, 1015, 517, 498, 374, 1348.68, 403, 1349.36, 190
5, 12:45:00-000, 1021, 488, 533, 344, 1348.93, 388, 1349.64, 172
5, 12:46:00-000, 886, 494, 392, 413, 1348.54, 340, 1349.46, 170
5, 12:47:00-000, 1, 1, 0, 1, 1346.00, 21, 1356.00, 190
5, 12:48:00-000, 901, 487, 414, 403, 1348.47, 352, 1350.03, 121
5, 12:49:00-000, 1037, 529, 508, 408, 1348.80, 419, 1349.19, 130
5, 12:50:00-000, 1114, 516, 598, 380, 1348.61, 447, 1349.72, 96
5, 12:51:00-000, 0, 0, 0, 0, 0.00, 15, 1355.00, 160
5, 12:52:00-000, 1020, 498, 522, 367, 1348.62, 404, 1349.51, 230
5, 12:53:00-000, 1097, 534, 563, 431, 1348.04, 428, 1348.76, 189
5, 12:54:00-000, 1068, 552, 516, 410, 1349.30, 379, 1350.06, 151
5, 12:55:00-000, 0, 0, 0, 0, 0.00, 7, 1356.00, 197
5, 12:56:00-000, 1052, 536, 516, 424, 1348.94, 429, 1349.65, 212
5, 12:57:00-000, 1033, 533, 500, 377, 1349.20, 376, 1349.68, 159
5, 12:58:00-000, 1060, 548, 512, 397, 1348.62, 353, 1349.25, 157
5, 12:59:00-000, 0, 0, 0, 52, 1345.36, 0, 0.00, 195
5, 13:00:00-000, 929, 479, 450, 366, 1348.38, 394, 1349.99, 204
5, 13:01:00-000, 962, 520, 442, 358, 1348.98, 339, 1349.80, 133
5, 13:02:00-000, 1010, 457, 553, 431, 1347.79, 379, 1349.30, 165
5, 13:03:00-000, 0, 0, 0, 20, 1344.00, 6, 1354.00, 153
5, 13:04:00-000, 1038, 525, 513, 424, 1348.89, 425, 1349.66, 149
5, 13:05:00-000, 1072, 573, 499, 371, 1349.10, 378, 1349.88, 199
5, 13:06:00-000, 916, 499, 417, 358, 1349.70, 378, 1350.56, 154
5, 13:07:00-000, 2, 2, 0, 7, 1347.43, 13, 1356.00, 197
5, 13:08:00-000, 1060, 549, 511, 385, 1348.24, 403, 1349.43, 173
5, 13:09:00-000, 991, 479, 512, 442, 1348.22, 385, 1348.88, 169
5, 13:10:00-000, 1102, 563, 539, 470, 1348.43, 418, 1348.94, 150
5, 13:11:00-000, 1, 1, 0, 1, 1349.00, 10, 1355.00, 137
5, 13:12:00-000, 1089, 567, 522, 396, 1349.14, 439, 1350.15, 139
5, 13:13:00-000, 1010, 575, 435, 370, 1350.45, 334, 1350.61, 222
5, 13:14:00-000, 993, 546, 447, 449, 1349.54, 399, 1350.79, 189
5, 13:15:00-000, 1, 1, 0, 33, 1346.75, 0, 0.00, 169
5, 13:16:00-000, 1039, 546, 493, 427, 1348.66, 404, 1349.86, 122
5, 13:17:00-000, 959, 550, 409, 396, 1349.49, 363, 1350.34, 125
5, 13:18:00-000, 1110, 606, 504, 421, 1348.96, 439, 1350.45, 172
5, 13:19:00-000, 0, 0, 0, 0, 0.00, 45, 1357.70, 139
5, 13:20:00-000, 956, 519, 437, 381, 1349.68, 386, 1350.59, 186
5, 13:21:00-000, 1020, 483, 537, 407, 1348.50, 413, 1348.92, 149
5, 13:22:00-000, 1038, 500, 538, 342, 1348.40, 438, 1349.80, 93
5, 13:23:00-000, 2, 2, 0, 24, 1346.75, 53, 1355.59, 150
5, 13:24:00-000, 1025, 557, 468, 388, 1348.80, 366, 1349.24, 189
5, 13:25:00-000, 972, 472, 500, 328, 1348.93, 373, 1349.52, 164
5, 13:26:00-000, 1055, 560, 495, 451, 1348.71, 394, 1348.91, 199
5, 13:27:00-000, 0, 0, 0, 34, 1345.00, 21, 1355.90, 145
5, 13:28:00-000, 1027, 523, 504, 446, 1348.32, 414, 1349.77, 184
5, 13:29:00-000, 1030, 547, 483, 413, 1349.47, 392, 1349.99, 134
5, 13:30:00-000, 970, 475, 495, 407, 1348.29, 402, 1348.87, 139
5, 13:31:00-000, 1, 1, 0, 13, 1345.00, 4, 1356.00, 123
5, 13:32:00-000, 1027, 480, 547, 400, 1348.68, 514, 1350.36, 131
5, 13:33:00-000, 1153, 612, 541, 384, 1349.42, 433, 1350.04, 108
5, 13:34:00-000, 1086, 568, 518, 439, 1349.55, 410, 1350.28, 137
5, 13:35:00-000, 3, 2, 1, 67, 1345.56, 8, 1354.50, 190
5, 13:36:00-000, 990, 492, 498, 433, 1347.83, 389, 1349.29, 148
5, 13:37:00-000, 990, 531, 459, 365, 1349.24, 385, 1349.86, 162
5, 13:38:00-000, 920, 401, 519, 330, 1348.25, 376, 1348.96, 139
5, 13:39:00-000, 6, 0, 6, 18, 1345.00, 36, 1353.33, 160
5, 13:40:00-000, 1005, 504, 501, 385, 1348.23, 415, 1349.25, 135
5, 13:41:00-000, 1100, 583, 517, 404, 1348.97, 437, 1349.30, 172
5, 13:42:00-000, 1098, 559, 539, 430, 1348.67, 462, 1349.92, 137
5, 13:43:00-000, 0, 0, 0, 50, 1345.35, 14, 1355.93, 162
5, 13:44:00-000, 1046, 564, 482, 451, 1348.34, 393, 1349.90, 153
5, 13:45:00-000, 1109, 544, 565, 408, 1348.92, 431, 1349.62, 123
5, 13:46:00-000, 917, 475, 442, 356, 1348.54, 328, 1349.55, 180
5, 13:47:00-000, 1, 1, 0, 5, 1345.00, 30, 1355.50, 171
5, 13:48:00-000, 902, 464, 438, 406, 1348.41, 356, 1349.72, 132
5, 13:49:00-000, 937, 508, 429, 330, 1349.68, 348, 1349.85, 167
5, 13:50:00-000, 985, 468, 517, 363, 1349.65, 394, 1350.35, 158
5, 13:51:00-000, 1, 0, 1, 56, 1345.49, 12, 1355.25, 137
5, 13:52:00-000, 986, 517, 469, 372, 1348.32, 382, 1349.67, 175
5, 13:53:00-000, 970, 483, 487, 368, 1349.19, 377, 1349.80, 143
5, 13:54:00-000, 993, 545, 448, 409, 1348.97, 355, 1349.66, 175
5, 13:55:00-000, 3, 2, 1, 21, 1345.23, 19, 1354.73, 148
5, 13:56:00-000, 1113, 564, 549, 437, 1348.51, 443, 1349.58, 145
5, 13:57:00-000, 996, 503, 493, 344, 1349.35, 375, 1349.82, 197
5, 13:58:00-000, 981, 452, 529, 377, 1347.93, 358, 1348.99, 190
5, 13:59:00-000, 2, 0, 2, 1, 1345.00, 50, 1353.27, 134
5, 14:00:00-000, 1022, 535, 487, 415, 1348.51, 404, 1349.89, 203
5, 14:01:00-000, 989, 566, 423, 418, 1349.51, 336, 1349.70, 151
5, 14:02:00-000, 1054, 591, 463, 408, 1348.94, 433, 1350.88, 116
5, 14:03:00-000, 1, 1, 0, 21, 1347.00, 7, 1356.00, 152
5, 14:04:00-000, 1023, 533, 490, 452, 1348.61, 417, 1349.76, 194
5, 14:05:00-000, 1019, 506, 513, 388, 1348.47, 414, 1349.36, 123
5, 14:06:00-000, 1013, 514, 499, 366, 1348.57, 374, 1348.97, 152
5, 14:07:00-000, 1, 1, 0, 0, 0.00, 12, 1355.00, 168
5, 14:08:00-000, 1035, 541, 494, 390, 1349.37, 413, 1350.29, 190
5, 14:09:00-000, 1028, 503, 525, 368, 1349.16, 418, 1349.78, 170
5, 14:10:00-000, 1105, 571, 534, 426, 1348.76, 403, 1349.70, 130
5, 14:11:00-000, 0, 0, 0, 52, 1345.30, 36, 1356.00, 170
5, 14:12:00-000, 1052, 499, 553, 396, 1348.61, 437, 1349.72, 191
5, 14:13:00-000, 1027, 539, 488, 400, 1349.56, 394, 1350.35, 182
5, 14:14:00-000, 1057, 593, 464, 424, 1349.42, 392, 1350.80, 141
5, 14:15:00-000, 4, 0, 4, 37, 1346.00, 8, 1353.00, 140
5, 14:16:00-000, 931, 530, 401, 393, 1349.87, 362, 1350.32, 164
5, 14:17:00-000, 981, 497, 484, 378, 1349.16, 382, 1349.87, 176
5, 14:18:00-000, 1062, 557, 505, 439, 1349.15, 400, 1349.79, 140
5, 14:19:00-000, 0, 0, 0, 27, 1346.00, 26, 1356.00, 134
5, 14:20:00-000, 979, 492, 487, 373, 1349.63, 382, 1350.23, 189
5, 14:21:00-000, 1049, 596, 453, 418, 1349.39, 369, 1349.61, 118
5, 14:22:00-000, 1038, 491, 547, 387, 1348.44, 403, 1348.59, 183
5, 14:23:00-000, 4, 2, 2, 22, 1345.45, 45, 1354.82, 167
5, 14:24:00-000, 969, 475, 494, 367, 1348.50, 431, 1349.57, 143
5, 14:25:00-000, 979, 502, 477, 390, 1349.21, 385, 1349.78, 142
5, 14:26:00-000, 1021, 512, 509, 360, 1348.87, 398, 1349.39, 159
5, 14:27:00-000, 1, 1, 0, 0, 0.00, 39, 1356.00, 137
5, 14:28:00-000, 1094, 558, 536, 457, 1348.45, 444, 1349.35, 177
5, 14:29:00-000, 1070, 546, 524, 393, 1349.29, 397, 1349.58, 155
5, 14:30:00-000, 876, 440, 436, 359, 1348.99, 354, 1350.25, 161
5, 14:31:00-000, 3, 2, 1, 2, 1345.00, 43, 1356.57, 170
5, 14:32:00-000, 1047, 524, 523, 399, 1349.55, 432, 1350.06, 132
5, 14:33:00-000, 1090, 567, 523, 407, 1349.24, 373, 1349.04, 150
5, 14:34:00-000, 1078, 529, 549, 461, 1348.80, 425, 1349.72, 176
5, 14:35:00-000, 0, 0, 0, 32, 1345.31, 52, 1355.34, 157
5, 14:36:00-000, 1014, 502, 512, 390, 1348.73, 447, 1350.00, 162
5, 14:37:00-000, 985, 548, 437, 419, 1349.22, 363, 1349.59, 111
5, 14:38:00-000, 973, 496, 477, 421, 1348.37, 397, 1349.76, 122
5, 14:39:00-000, 8, 8, 0, 29, 1346.51, 7, 1356.00, 114
5, 14:40:00-000, 975, 486, 489, 335, 1349.67, 405, 1351.31, 136
5, 14:41:00-000, 975, 480, 495, 380, 1348.46, 405, 1349.07, 150
5, 14:42:00-000, 985, 520, 465, 390, 1348.87, 371, 1349.98, 175
5, 14:43:00-000, 2, 1, 1, 8, 1346.87, 20, 1355.50, 130
5, 14:44:00-000, 1006, 497, 509, 431, 1348.36, 440, 1349.86, 148
5, 14:45:00-000, 1078, 570, 508, 382, 1349.36, 380, 1349.77, 131
5, 14:46:00-000, 1002, 512, 490, 412, 1349.65, 393, 1350.59, 162
5, 14:47:00-000, 3, 2, 1, 19, 1347.47, 16, 1355.62, 195
5, 14:48:00-000, 1079, 596, 483, 418, 1349.47, 392, 1350.66, 150
5, 14:49:00-000, 1075, 536, 539, 420, 1349.03, 410, 1349.32, 148
5, 14:50:00-000, 983, 507, 476, 391, 1348.30, 379, 1348.68, 199
5, 14:51:00-000, 5, 5, 0, 63, 1344.97, 31, 1354.74, 161
5, 14:52:00-000, 1046, 539, 507, 421, 1348.57, 415, 1349.20, 138
5, 14:53:00-000, 983, 513, 470, 380, 1349.70, 434, 1350.86, 144
5, 14:54:00-000, 1095, 550, 545, 383, 1348.17, 438, 1349.49, 120
5, 14:55:00-000, 1, 0, 1, 2, 1345.00, 1, 1352.00, 137
5, 14:56:00-000, 1084, 553, 531, 428, 1348.33, 408, 1348.97, 221
5, 14:57:00-000, 997, 437, 560, 351, 1348.70, 434, 1349.31, 173
5, 14:58:00-000, 1023, 540, 483, 429, 1349.63, 447, 1351.24, 174
5, 14:59:00-000, 0, 0, 0, 24, 1344.92, 12, 1356.00, 110
5, 15:00:00-000, 1056, 513, 543, 422, 1348.64, 439, 1349.81, 135
5, 15:01:00-000, 1038, 523, 515, 370, 1348.51, 396, 1349.33, 153
5, 15:02:00-000, 957, 512, 445, 413, 1348.87, 373, 1350.59, 143
5, 15:03:00-000, 1, 1, 0, 6, 1346.83, 2, 1355.00, 151
5, 15:04:00-000, 1011, 517, 494, 400, 1349.63, 414, 1350.10, 167
5, 15:05:00-000, 1033, 546, 487, 407, 1348.86, 377, 1349.94, 149
5, 15:06:00-000, 1004, 488, 516, 440, 1348.16, 407, 1349.26, 153
5, 15:07:00-000, 1, 0, 1, 1, 1349.00, 44, 1355.63, 158
5, 15:08:00-000, 1045, 551, 494, 383, 1349.61, 383, 1350.28, 116
5, 15:09:00-000, 960, 498, 462, 332, 1349.24, 361, 1350.03, 182
5, 15:10:00-000, 1071, 571, 500, 553, 1348.21, 416, 1349.46, 170
5, 15:11:00-000, 1, 1, 0, 10, 1345.40, 18, 1356.00, 138
5, 15:12:00-000, 1156, 567, 589, 464, 1348.88, 456, 1349.80, 143
5, 15:13:00-000, 1003, 543, 460, 370, 1348.59, 342, 1348.95, 164
5, 15:14:00-000, 1091, 521, 570, 397, 1349.27, 489, 1350.55, 147
5, 15:15:00-000, 1, 1, 0, 19, 1346.16, 15, 1355.60, 173
5, 15:16:00-000, 1012, 503, 509, 404, 1348.66, 428, 1350.57, 160
5, 15:17:00-000, 993, 528, 465, 340, 1348.71, 351, 1349.01, 176
5, 15:18:00-000, 1014, 520, 494, 415, 1349.48, 420, 1350.08, 163
5, 15:19:00-000, 1, 0, 1, 20, 1345.50, 5, 1355.00, 187
5, 15:20:00-000, 1039, 522, 517, 423, 1348.25, 407, 1348.86, 140
5, 15:21:00-000, 995, 500, 495, 371, 1348.53, 379, 1348.85, 157
5, 15:22:00-000, 1092, 515, 577, 419, 1348.38, 436, 1348.97, 171
5, 15:23:00-000, 0, 0, 0, 23, 1345.00, 14, 1355.00, 155
5, 15:24:00-000, 1061, 537, 524, 405, 1348.61, 443, 1349.90, 168
5, 15:25:00-000, 991, 505, 486, 387, 1348.63, 387, 1349.25, 156
5, 15:26:00-000, 943, 462, 481, 398, 1348.21, 358, 1349.45, 175
5, 15:27:00-000, 1, 0, 1, 7, 1345.00, 21, 1355.42, 113
5, 15:28:00-000, 1094, 558, 536, 469, 1349.01, 405, 1349.74, 143
5, 15:29:00-000, 1024, 526, 498, 424, 1348.60, 393, 1349.19, 161
5, 15:30:00-000, 941, 463, 478, 397, 1348.35, 338, 1349.22, 159
5, 15:31:00-000, 0, 0, 0, 19, 1344.00, 26, 1354.23, 137
5, 15:32:00-000, 925, 467, 458, 385, 1348.46, 349, 1349.33, 158
5, 15:33:00-000, 1025, 548, 477, 460, 1348.87, 386, 1349.79, 124
5, 15:34:00-000, 1039, 539, 500, 401, 1349.07, 439, 1350.05, 109
5, 15:35:00-000, 1, 1, 0, 1, 1348.00, 53, 1356.43, 141
5, 15:36:00-000, 1001, 498, 503, 391, 1348.54, 427, 1349.74, 127
5, 15:37:00-000, 1081, 569, 512, 435, 1349.84, 425, 1350.94, 129
5, 15:38:00-000, 1026, 513, 513, 420, 1348.71, 427, 1349.67, 145
5, 15:39:00-000, 3, 3, 0, 0, 0.00, 18, 1355.11, 146
5, 15:40:00-000, 974, 496, 478, 344, 1349.10, 323, 1348.89, 161
5, 15:41:00-000, 945, 447, 498, 301, 1349.29, 364, 1349.01, 198
5, 15:42:00-000, 1008, 509, 499, 382, 1348.78, 330, 1348.80, 221
5, 15:43:00-000, 8, 5, 3, 16, 1347.00, 16, 1353.06, 161
5, 15:44:00-000, 970, 477, 493, 276, 1348.83, 399, 1348.92, 236
5, 15:45:00-000, 1014, 507, 507, 340, 1348.68, 384, 1348.51, 235
5, 15:46:00-000, 1048, 507, 541, 390, 1349.12, 406, 1348.54, 210
5, 15:47:00-000, 0, 0, 0, 5, 1346.40, 0, 0.00, 206
5, 15:48:00-000, 1127, 620, 507, 479, 1349.27, 376, 1349.60, 202
5, 15:49:00-000, 1080, 531, 549, 413, 1349.28, 423, 1349.02, 222
5, 15:50:00-000, 1039, 488, 551, 370, 1348.76, 385, 1349.24, 181
5, 15:51:00-000, 1, 0, 1, 0, 0.00, 46, 1353.93, 169
5, 15:52:00-000, 1087, 585, 502, 410, 1348.92, 425, 1349.41, 182
5, 15:53:00-000, 982, 479, 503, 353, 1348.54, 329, 1348.52, 185
5, 15:54:00-000, 1088, 529, 559, 380, 1348.51, 420, 1349.20, 211
5, 15:55:00-000, 3, 1, 2, 39, 1345.17, 21, 1354.00, 195
5, 15:56:00-000, 1084, 585, 499, 446, 1348.82, 420, 1349.85, 170
5, 15:57:00-000, 1082, 509, 573, 406, 1348.51, 418, 1348.77, 212
5, 15:58:00-000, 1003, 554, 449, 401, 1349.63, 337, 1350.27, 149
5, 15:59:00-000, 1, 0, 1, 20, 1347.40, 0, 0.00, 147
5, 16:00:00-000, 1004, 547, 457, 387, 1350.02, 339, 1350.26, 230
5, 16:01:00-000, 953, 472, 481, 370, 1349.09, 372, 1349.34, 183
5, 16:02:00-000, 1028, 476, 552, 386, 1348.10, 381, 1348.85, 187
5, 16:03:00-000, 1, 1, 0, 9, 1345.00, 49, 1354.61, 163
5, 16:04:00-000, 975, 485, 490, 364, 1348.30, 372, 1349.38, 184
5, 16:05:00-000, 1109, 551, 558, 430, 1348.37, 436, 1348.90, 187
5, 16:06:00-000, 1048, 562, 486, 434, 1348.81, 428, 1350.17, 137
5, 16:07:00-000, 5, 5, 0, 14, 1346.29, 3, 1356.00, 138
5, 16:08:00-000, 1030, 516, 514, 409, 1348.75, 427, 1349.81, 181
5, 16:09:00-000, 966, 478, 488, 358, 1349.18, 325, 1349.35, 159
5, 16:10:00-000, 1068, 519, 549, 383, 1349.08, 433, 1350.07, 166
5, 16:11:00-000, 3, 0, 3, 14, 1345.50, 41, 1355.24, 173
5, 16:12:00-000, 1043, 550, 493, 471, 1348.62, 404, 1349.69, 164
5, 16:13:00-000, 997, 515, 482, 372, 1348.97, 356, 1349.13, 149
5, 16:14:00-000, 1021, 544, 477, 455, 1348.83, 411, 1349.80, 160
5, 16:15:00-000, 1, 0, 1, 7, 1346.00, 1, 1350.00, 151
5, 16:16:00-000, 1002, 498, 504, 417, 1349.08, 399, 1349.91, 160
5, 16:17:00-000, 1022, 510, 512, 428, 1349.07, 387, 1349.56, 131
5, 16:18:00-000, 1004, 489, 515, 417, 1348.45, 428, 1349.18, 141
5, 16:19:00-000, 1, 1, 0, 1, 1349.00, 17, 1355.65, 109
5, 16:20:00-000, 949, 458, 491, 364, 1348.69, 418, 1350.00, 142
5, 16:21:00-000, 1053, 518, 535, 400, 1348.19, 418, 1348.60, 129
5, 16:22:00-000, 1027, 572, 455, 443, 1348.38, 413, 1349.91, 126
5, 16:23:00-000, 3, 3, 0, 31, 1345.12, 15, 1357.00, 137
5, 16:24:00-000, 1076, 550, 526, 473, 1348.51, 443, 1349.56, 157
5, 16:25:00-000, 1045, 587, 458, 430, 1349.45, 387, 1350.06, 123
5, 16:26:00-000, 1004, 492, 512, 399, 1347.93, 430, 1349.89, 120
5, 16:27:00-000, 2, 2, 0, 53, 1344.10, 0, 0.00, 95
5, 16:28:00-000, 955, 465, 490, 331, 1347.48, 409, 1348.97, 154
5, 16:29:00-000, 1033, 514, 519, 389, 1348.91, 459, 1349.50, 168
6, 12:20:00-000, 6959, 3506, 3453, 1562, 1347.83, 1609, 1348.53, 0
6, 12:21:00-000, 0, 0, 0, 69, 1347.00, 69, 1353.87, 0
6, 12:22:00-000, 0, 0, 0, 154, 1346.04, 169, 1354.00, 0
6, 12:23:00-000, 0, 0, 0, 27, 1346.00, 33, 1354.00, 0
6, 12:24:00-000, 0, 0, 0, 45, 1346.00, 26, 1355.00, 0
6, 12:25:00-000, 0, 0, 0, 18, 1346.00, 39, 1355.00, 0
6, 12:26:00-000, 0, 0, 0, 21, 1345.00, 14, 1355.00, 0
6, 12:27:00-000, 0, 0, 0, 25, 1345.00, 22, 1355.00, 0
6, 12:28:00-000, 0, 0, 0, 15, 1345.00, 55, 1355.00, 0
6, 12:29:00-000, 0, 0, 0, 0, 0.00, 15, 1355.00, 0
6, 12:30:00-000, 0, 0, 0, 0, 0.00, 67, 1355.00, 0
6, 12:32:00-000, 0, 0, 0, 9, 1345.00, 0, 0.00, 0
6, 12:34:00-000, 0, 0, 0, 0, 0.00, 57, 1356.00, 0
6, 12:35:00-000, 0, 0, 0, 54, 1345.00, 30, 1356.00, 0
6, 12:36:00-000, 0, 0, 0, 0, 0.00, 35, 1356.00, 0
6, 12:37:00-000, 0, 0, 0, 15, 1345.00, 0, 0.00, 0
6, 12:38:00-000, 0, 0, 0, 56, 1345.00, 0, 0.00, 0
6, 12:40:00-000, 0, 0, 0, 0, 0.00, 45, 1356.00, 126
6, 12:41:00-000, 0, 0, 0, 0, 0.00, 1, 1356.00, 119
6, 12:42:00-000, 0, 0, 0, 47, 1345.00, 4, 1356.00, 107
6, 12:43:00-000, 0, 0, 0, 0, 0.00, 42, 1356.00, 126
6, 12:44:00-000, 0, 0, 0, 0, 0.00, 8, 1356.00, 113
6, 12:45:00-000, 0, 0, 0, 0, 0.00, 8, 1356.00, 157
6, 12:46:00-000, 0, 0, 0, 11, 1345.00, 0, 0.00, 116
6, 12:47:00-000, 0, 0, 0, 0, 0.00, 8, 1357.00, 127
6, 12:48:00-000, 0, 0, 0, 4, 1344.00, 19, 1357.00, 129
6, 12:49:00-000, 0, 0, 0, 0, 0.00, 0, 0.00, 118
6, 12:50:00-000, 0, 0, 0, 13, 1344.00, 10, 1357.00, 116
6, 12:51:00-000, 0, 0, 0, 0, 0.00, 0, 0.00, 117
6, 12:52:00-000, 0, 0, 0, 0, 0.00, 0, 0.00, 135
6, 12:53:00-000, 0, 0, 0, 0, 0.00, 0, 0.00, 112
6, 12:54:00-000, 0, 0, 0, 24, 1344.00, 0, 0.00, 115
6, 12:55:00-000, 0, 0, 0, 10, 1344.00, 0, 0.00, 110
6, 12:56:00-000, 0, 0, 0, 0, 0.00, 0, 0.00, 120
6, 12:57:00-000, 0, 0, 0, 0, 0.00, 0, 0.00, 110
6, 12:58:00-000, 0, 0, 0, 0, 0.00, 0, 0.00, 102
6, 12:59:00-000, 0, 0, 0, 0, 0.00, 0, 0.00, 120
6, 15:40:00-000, 6955, 3546, 3409, 1534, 1347.97, 1633, 1348.51, 0
6, 15:41:00-000, 0, 0, 0, 131, 1347.00, 20, 1354.00, 0
6, 15:42:00-000, 0, 0, 0, 52, 1347.00, 128, 1354.00, 0
6, 15:43:00-000, 0, 0, 0, 0, 0.00, 79, 1354.00, 0
6, 15:44:00-000, 0, 0, 0, 122, 1346.00, 0, 0.00, 0
6, 15:45:00-000, 0, 0, 0, 117, 1346.00, 48, 1355.00, 0
6, 15:46:00-000, 0, 0, 0, 39, 1345.07, 129, 1355.00, 0
6, 15:47:00-000, 0, 0, 0, 0, 0.00, 17, 1355.00, 0
6, 15:48:00-000, 0, 0, 0, 0, 0.00, 34, 1355.00, 0
6, 15:49:00-000, 0, 0, 0, 16, 1345.00, 18, 1355.00, 0
6, 15:50:00-000, 0, 0, 0, 33, 1345.00, 0, 0.00, 0
6, 15:51:00-000, 0, 0, 0, 7, 1345.00, 0, 0.00, 0
6, 15:52:00-000, 0, 0, 0, 21, 1345.00, 8, 1356.00, 0
6, 15:53:00-000, 0, 0, 0, 31, 1345.00, 0, 0.00, 0
6, 15:54:00-000, 0, 0, 0, 54, 1345.00, 0, 0.00, 0
6, 15:55:00-000, 0, 0, 0, 61, 1345.00, 0, 0.00, 0
6, 15:56:00-000, 0, 0, 0, 0, 0.00, 6, 1356.00, 0
6, 15:57:00-000, 0, 0, 0, 0, 0.00, 3, 1356.00, 0
6, 15:58:00-000, 0, 0, 0, 4, 1344.00, 82, 1356.00, 0
6, 15:59:00-000, 0, 0, 0, 0, 0.00, 18, 1356.00, 0
6, 16:00:00-000, 2, 1, 1, 1, 1349.00, 21, 1355.90, 137
6, 16:01:00-000, 0, 0, 0, 0, 0.00, 17, 1356.00, 130
6, 16:02:00-000, 0, 0, 0, 0, 0.00, 11, 1356.00, 132
6, 16:03:00-000, 0, 0, 0, 9, 1344.00, 9, 1356.00, 105
6, 16:04:00-000, 0, 0, 0, 4, 1344.00, 4, 1356.00, 125
6, 16:05:00-000, 0, 0, 0, 0, 0.00, 29, 1356.00, 110
6, 16:06:00-000, 0, 0, 0, 14, 1344.00, 4, 1356.00, 123
6, 16:07:00-000, 0, 0, 0, 0, 0.00, 0, 0.00, 129
6, 16:08:00-000, 0, 0, 0, 0, 0.00, 0, 0.00, 111
6, 16:09:00-000, 0, 0, 0, 0, 0.00, 0, 0.00, 97
6, 16:10:00-000, 0, 0, 0, 0, 0.00, 0, 0.00, 117
6, 16:11:00-000, 0, 0, 0, 0, 0.00, 0, 0.00, 123
6, 16:12:00-000, 0, 0, 0, 0, 0.00, 7, 1357.00, 124
6, 16:13:00-000, 0, 0, 0, 5, 1344.00, 0, 0.00, 123
6, 16:14:00-000, 0, 0, 0, 4, 1344.00, 0, 0.00, 100
6, 16:15:00-000, 0, 0, 0, 0, 0.00, 0, 0.00, 127
6, 16:16:00-000, 0, 0, 0, 0, 0.00, 0, 0.00, 126
6, 16:17:00-000, 0, 0, 0, 0, 0.00, 0, 0.00, 110
6, 16:18:00-000, 0, 0, 0, 13, 1344.00, 0, 0.00, 114
6, 16:19:00-000, 0, 0, 0, 0, 0.00, 0, 0.00, 97
6, 16:20:00-000, 20, 6, 14, 2, 1349.00, 9, 1351.11, 0
6, 16:21:00-000, 0, 0, 0, 1, 1344.00, 0, 0.00, 0
6, 16:23:00-000, 0, 0, 0, 0, 0.00, 2, 1357.00, 0
6, 16:26:00-000, 0, 0, 0, 0, 0.00, 2, 1358.00, 0
7, 09:06:00-000, 10101, 6969, 3132, 0, 0.00, 0, 0.00, 9296
7, 09:07:00-000, 22528, 10870, 11658, 0, 0.00, 0, 0.00, 23333
7, 09:17:00-000, 5532, 2595, 2937, 18, 1353.94, 18, 1353.00, 5496
7, 09:22:00-000, 10894, 5883, 5011, 0, 0.00, 0, 0.00, 10894
7, 09:23:00-000, 8096, 3579, 4517, 15, 1353.06, 17, 1350.88, 8064
7, 09:24:00-000, 4, 4, 0, 2, 1363.00, 0, 0.00, 2
7, 09:32:00-000, 950, 30, 920, 21, 1354.67, 21, 1351.00, 908
7, 09:35:00-000, 856, 840, 16, 0, 0.00, 0, 0.00, 856
7, 09:36:00-000, 4653, 3404, 1249, 0, 0.00, 0, 0.00, 4653
7, 09:46:00-000, 8350, 5449, 2901, 0, 0.00, 0, 0.00, 7428
7, 09:47:00-000, 4603, 4531, 72, 3, 1358.00, 3, 1351.00, 5519
7, 09:49:00-000, 1821, 11, 1810, 0, 0.00, 0, 0.00, 1817
7, 09:50:00-000, 1747, 1650, 97, 65, 1349.00, 65, 1347.51, 1621
7, 09:51:00-000, 15420, 6452, 8968, 0, 0.00, 0, 0.00, 15420
7, 09:52:00-000, 1087, 1077, 10, 10, 1354.40, 10, 1351.00, 1067
7, 09:53:00-000, 15489, 10911, 4578, 1, 1348.00, 1, 1349.00, 14418
7, 09:54:00-000, 8534, 6597, 1937, 10, 1349.20, 10, 1349.60, 9576
7, 09:55:00-000, 0, 0, 0, 0, 0.00, 0, 0.00, 7
7, 09:58:00-000, 1285, 1280, 5, 0, 0.00, 0, 0.00, 1285
7, 09:59:00-000, 2241, 21, 2220, 0, 0.00, 0, 0.00, 1130
7, 10:00:00-000, 1047, 67, 980, 37, 1353.05, 37, 1351.75, 2084
7, 10:02:00-000, 1050, 63, 987, 0, 0.00, 0, 0.00, 1050
7, 10:04:00-000, 1247, 1230, 17, 17, 1345.47, 17, 1351.59, 1213
7, 10:05:00-000, 12393, 4685, 7708, 7, 1350.57, 7, 1349.14, 11280
7, 10:06:00-000, 5326, 2872, 2454, 38, 1348.00, 38, 1347.89, 6349
7, 10:08:00-000, 5112, 2184, 2928, 0, 0.00, 0, 0.00, 4093
7, 10:09:00-000, 7755, 4461, 3294, 66, 1348.95, 66, 1348.89, 8642
7, 10:10:00-000, 9783, 2883, 6900, 2, 1351.50, 2, 1352.00, 9779
7, 10:11:00-000, 1485, 1467, 18, 7, 1353.00, 7, 1352.00, 1471
7, 10:12:00-000, 8915, 5423, 3492, 21, 1351.85, 37, 1352.00, 8857
7, 10:13:00-000, 6106, 3397, 2709, 61, 1350.96, 63, 1352.97, 5982
7, 10:14:00-000, 3059, 89, 2970, 18, 1354.39, 0, 0.00, 3041
7, 10:15:00-000, 9146, 3317, 5829, 28, 1351.28, 28, 1351.93, 9090
7, 10:17:00-000, 6224, 1359, 4865, 8, 1355.13, 8, 1353.00, 6208
7, 10:18:00-000, 19222, 8844, 10378, 0, 0.00, 0, 0.00, 19222
7, 10:20:00-000, 5462, 1619, 3843, 46, 1351.30, 46, 1351.87, 5370
7, 10:21:00-000, 7011, 5419, 1592, 0, 0.00, 0, 0.00, 6280
7, 10:22:00-000, 895, 880, 15, 15, 1349.00, 15, 1351.67, 1596
7, 10:23:00-000, 944, 940, 4, 0, 0.00, 0, 0.00, 944
7, 10:24:00-000, 1175, 1160, 15, 0, 0.00, 0, 0.00, 1175
7, 10:25:00-000, 3922, 1364, 2558, 1, 1348.00, 1, 1345.00, 3920
7, 10:27:00-000, 14091, 6422, 7669, 0, 0.00, 0, 0.00, 14091
7, 10:28:00-000, 2909, 1260, 1649, 43, 1349.46, 97, 1350.21, 2769
7, 10:29:00-000, 171, 171, 0, 54, 1355.75, 0, 0.00, 117
7, 10:32:00-000, 25695, 19108, 6587, 9, 1349.44, 9, 1352.00, 25677
7, 10:33:00-000, 8083, 5427, 2656, 17, 1347.18, 17, 1349.00, 8049
7, 10:34:00-000, 9173, 2978, 6195, 0, 0.00, 0, 0.00, 9173
7, 10:35:00-000, 12648, 4145, 8503, 12, 1348.00, 12, 1350.33, 12624
7, 10:36:00-000, 5273, 2006, 3267, 3, 1351.33, 3, 1351.00, 5267
7, 10:37:00-000, 3800, 3028, 772, 3, 1349.33, 3, 1350.00, 3794
7, 10:38:00-000, 15990, 7262, 8728, 29, 1347.00, 29, 1351.58, 15931
7, 10:39:00-000, 194, 12, 182, 2, 1349.00, 2, 1348.00, 191
7, 10:40:00-000, 19170, 9489, 9681, 5, 1348.60, 5, 1348.00, 19160
7, 10:41:00-000, 14065, 7899, 6166, 18, 1349.89, 18, 1350.00, 14020
7, 10:42:00-000, 25976, 18826, 7150, 11, 1348.64, 4, 1349.75, 25882
7, 10:43:00-000, 9447, 5773, 3674, 0, 0.00, 7, 1349.71, 9528
7, 10:44:00-000, 4851, 2987, 1864, 6, 1349.17, 6, 1349.83, 4839
7, 10:45:00-000, 4694, 2175, 2519, 0, 0.00, 0, 0.00, 4694
7, 10:46:00-000, 5329, 3976, 1353, 23, 1350.09, 8, 1350.75, 5293
7, 10:47:00-000, 5102, 1260, 3842, 73, 1351.19, 88, 1350.14, 4946
7, 10:48:00-000, 10057, 7330, 2727, 0, 0.00, 0, 0.00, 10057
7, 10:49:00-000, 2092, 2075, 17, 5, 1350.60, 5, 1351.00, 2082
7, 10:50:00-000, 6226, 1963, 4263, 24, 1348.29, 24, 1349.87, 6178
7, 10:51:00-000, 17287, 6404, 10883, 10, 1348.00, 10, 1348.90, 17263
7, 10:52:00-000, 664, 17, 647, 8, 1349.00, 8, 1346.37, 652
7, 10:53:00-000, 8594, 4234, 4360, 0, 0.00, 0, 0.00, 8594
7, 10:55:00-000, 9880, 8536, 1344, 2, 1355.00, 2, 1352.00, 9876
7, 10:56:00-000, 13609, 7211, 6398, 5, 1352.00, 5, 1352.00, 13584
7, 10:57:00-000, 9005, 4303, 4702, 1, 1349.00, 1, 1349.00, 9018
7, 10:58:00-000, 3525, 25, 3500, 0, 0.00, 0, 0.00, 3525
7, 11:00:00-000, 8270, 2552, 5718, 12, 1350.83, 12, 1352.17, 8246
7, 11:01:00-000, 7458, 4972, 2486, 2, 1350.00, 2, 1351.00, 7454
7, 11:03:00-000, 20352, 16446, 3906, 3, 1353.00, 3, 1351.00, 20346
7, 11:04:00-000, 6904, 4510, 2394, 0, 0.00, 0, 0.00, 6904
7, 11:05:00-000, 5569, 3793, 1776, 0, 0.00, 0, 0.00, 5569
7, 11:07:00-000, 8272, 5145, 3127, 27, 1349.00, 27, 1345.41, 8218
7, 11:08:00-000, 2256, 1369, 887, 67, 1347.22, 67, 1346.53, 2122
7, 11:09:00-000, 17074, 8347, 8727, 13, 1346.15, 13, 1349.00, 17048
7, 11:10:00-000, 8128, 4351, 3777, 21, 1348.38, 21, 1350.71, 8086
7, 11:11:00-000, 3489, 2767, 722, 0, 0.00, 0, 0.00, 3489
7, 11:12:00-000, 6397, 3766, 2631, 10, 1353.50, 10, 1350.00, 6377
7, 11:15:00-000, 9949, 1797, 8152, 0, 0.00, 0, 0.00, 9018
7, 11:16:00-000, 4789, 3560, 1229, 29, 1350.31, 29, 1349.24, 5662
7, 11:17:00-000, 11511, 5954, 5557, 3, 1349.00, 3, 1352.00, 11389
7, 11:18:00-000, 4089, 4050, 39, 24, 1346.46, 24, 1350.62, 4157
7, 11:19:00-000, 1385, 1380, 5, 0, 0.00, 0, 0.00, 1385
7, 11:20:00-000, 1067, 7, 1060, 2, 1353.00, 2, 1352.00, 1063
7, 11:21:00-000, 1135, 21, 1114, 9, 1351.00, 9, 1348.11, 1117
7, 11:23:00-000, 6510, 1637, 4873, 0, 0.00, 0, 0.00, 6490
7, 11:24:00-000, 13949, 7589, 6360, 35, 1347.42, 35, 1347.11, 13899
7, 11:25:00-000, 12590, 1213, 11377, 11, 1349.27, 11, 1352.00, 12568
7, 11:26:00-000, 9714, 4082, 5632, 23, 1349.56, 23, 1351.91, 9668
7, 11:27:00-000, 3129, 1107, 2022, 0, 0.00, 0, 0.00, 3107
7, 11:28:00-000, 1432, 2, 1430, 0, 0.00, 0, 0.00, 1454
7, 11:29:00-000, 4628, 4500, 128, 59, 1347.59, 59, 1346.27, 4510
7, 11:30:00-000, 12100, 7417, 4683, 13, 1349.69, 13, 1350.77, 12074
7, 11:31:00-000, 11976, 8032, 3944, 8, 1349.25, 8, 1351.12, 11960
7, 11:32:00-000, 15101, 8874, 6227, 20, 1349.00, 20, 1348.65, 15061
7, 11:33:00-000, 5214, 3713, 1501, 14, 1350.64, 14, 1350.00, 5186
7, 11:34:00-000, 9312, 4431, 4881, 13, 1350.85, 8, 1350.88, 9291
7, 11:35:00-000, 12721, 8834, 3887, 6, 1352.00, 11, 1350.09, 12704
7, 11:39:00-000, 8243, 5194, 3049, 0, 0.00, 0, 0.00, 7084
7, 11:40:00-000, 14940, 8927, 6013, 0, 0.00, 0, 0.00, 15672
7, 11:41:00-000, 15001, 7933, 7068, 4, 1349.00, 4, 1346.50, 15420
7, 11:42:00-000, 8205, 3624, 4581, 0, 0.00, 0, 0.00, 8197
7, 11:43:00-000, 4343, 4320, 23, 0, 0.00, 0, 0.00, 4351
7, 11:44:00-000, 4567, 3040, 1527, 0, 0.00, 0, 0.00, 4567
7, 11:45:00-000, 705, 700, 5, 0, 0.00, 0, 0.00, 705
7, 11:48:00-000, 6135, 5015, 1120, 2, 1350.00, 2, 1351.00, 6131
7, 11:49:00-000, 6105, 3166, 2939, 18, 1348.83, 18, 1349.39, 6069
7, 11:50:00-000, 19108, 13348, 5760, 4, 1350.00, 4, 1352.00, 19100
7, 11:51:00-000, 15513, 4847, 10666, 8, 1345.13, 8, 1352.12, 15497
7, 11:52:00-000, 2520, 2500, 20, 0, 0.00, 0, 0.00, 2520
7, 11:53:00-000, 6563, 4438, 2125, 2, 1345.50, 2, 1348.00, 6559
7, 11:54:00-000, 16221, 4616, 11605, 1, 1351.00, 1, 1352.00, 16219
7, 11:56:00-000, 9603, 5628, 3975, 4, 1352.00, 4, 1352.00, 9595
7, 11:57:00-000, 1741, 422, 1319, 0, 0.00, 0, 0.00, 1741
7, 11:58:00-000, 19487, 7032, 12455, 11, 1350.45, 11, 1350.82, 19465
7, 11:59:00-000, 5565, 5323, 242, 0, 0.00, 0, 0.00, 5565
7, 12:00:00-000, 13578, 7339, 6239, 46, 1348.36, 46, 1349.39, 13486
7, 12:02:00-000, 11413, 4043, 7370, 9, 1348.67, 9, 1351.00, 11395
7, 12:03:00-000, 16558, 9102, 7456, 0, 0.00, 0, 0.00, 15638
7, 12:04:00-000, 8317, 1006, 7311, 38, 1353.47, 38, 1352.00, 9145
7, 12:05:00-000, 19000, 7778, 11222, 37, 1348.89, 37, 1348.35, 18942
7, 12:06:00-000, 10895, 8690, 2205, 82, 1346.21, 53, 1345.60, 10758
7, 12:07:00-000, 33, 2, 31, 2, 1350.00, 31, 1343.97, 2
7, 12:08:00-000, 11002, 4087, 6915, 38, 1349.29, 37, 1349.35, 10927
7, 12:09:00-000, 1483, 1480, 3, 0, 0.00, 1, 1345.00, 1482
7, 12:10:00-000, 16196, 6182, 10014, 13, 1351.46, 13, 1350.38, 16170
7, 12:11:00-000, 7736, 3796, 3940, 1, 1353.00, 1, 1352.00, 7734
7, 12:12:00-000, 10347, 6310, 4037, 18, 1349.33, 18, 1350.33, 10311
7, 12:13:00-000, 20208, 10631, 9577, 0, 0.00, 0, 0.00, 20208
7, 12:14:00-000, 9683, 5596, 4087, 28, 1348.07, 28, 1349.21, 9627
7, 12:15:00-000, 11948, 3937, 8011, 8, 1354.00, 8, 1352.12, 11932
7, 12:16:00-000, 11667, 5796, 5871, 0, 0.00, 0, 0.00, 11667
7, 12:17:00-000, 6810, 2798, 4012, 56, 1353.64, 56, 1351.98, 6698
7, 12:18:00-000, 9348, 7481, 1867, 15, 1350.13, 17, 1349.47, 9316
7, 12:19:00-000, 11643, 3087, 8556, 5, 1350.60, 3, 1350.33, 10841
7, 12:20:00-000, 4, 0, 4, 4, 1349.00, 4, 1349.75, 790
7, 12:21:00-000, 950, 20, 930, 0, 0.00, 0, 0.00, 950
7, 12:24:00-000, 6378, 2961, 3417, 0, 0.00, 0, 0.00, 6378
7, 12:28:00-000, 5757, 3207, 2550, 0, 0.00, 0, 0.00, 4954
7, 12:29:00-000, 2020, 1930, 90, 3, 1351.00, 3, 1351.00, 2817
7, 12:31:00-000, 2230, 2216, 14, 10, 1352.20, 10, 1351.00, 2210
7, 12:33:00-000, 2611, 2589, 22, 9, 1350.11, 9, 1351.00, 2593
7, 12:36:00-000, 1014, 14, 1000, 0, 0.00, 0, 0.00, 1014
7, 12:37:00-000, 6350, 2191, 4159, 1, 1350.00, 1, 1349.00, 6348
7, 12:38:00-000, 10518, 8449, 2069, 0, 0.00, 1, 1351.00, 10500
7, 12:39:00-000, 2839, 2110, 729, 1, 1351.00, 0, 0.00, 2855
7, 12:42:00-000, 6163, 3417, 2746, 17, 1354.29, 17, 1351.00, 6129
7, 12:44:00-000, 133, 130, 3, 1, 1348.00, 1, 1354.00, 131
7, 12:46:00-000, 401, 1, 400, 0, 0.00, 0, 0.00, 0
7, 12:47:00-000, 1208, 8, 1200, 0, 0.00, 0, 0.00, 1609
7, 12:48:00-000, 7858, 3479, 4379, 38, 1349.55, 38, 1347.42, 7782
7, 12:50:00-000, 603, 3, 600, 0, 0.00, 0, 0.00, 603
7, 12:51:00-000, 9732, 5344, 4388, 0, 0.00, 0, 0.00, 9732
7, 12:52:00-000, 3108, 910, 2198, 37, 1352.35, 37, 1351.67, 3034
7, 12:53:00-000, 13138, 9120, 4018, 8, 1347.75, 8, 1351.00, 11918
7, 12:54:00-000, 2475, 2455, 20, 20, 1350.20, 16, 1351.94, 3643
7, 12:55:00-000, 7415, 1989, 5426, 0, 0.00, 4, 1347.00, 7411
7, 12:56:00-000, 6488, 3705, 2783, 10, 1349.40, 10, 1352.00, 6468
7, 12:57:00-000, 19621, 8726, 10895, 0, 0.00, 0, 0.00, 19618
7, 12:58:00-000, 14402, 9613, 4789, 45, 1348.00, 27, 1350.18, 14333
7, 12:59:00-000, 13039, 7327, 5712, 5, 1350.20, 23, 1347.22, 13011
7, 13:00:00-000, 8789, 4988, 3801, 19, 1349.89, 19, 1351.84, 8726
7, 13:01:00-000, 12251, 4837, 7414, 0, 0.00, 0, 0.00, 12276
7, 13:03:00-000, 102, 1, 101, 1, 1348.00, 1, 1351.00, 100
7, 13:04:00-000, 7647, 7082, 565, 0, 0.00, 0, 0.00, 7640
7, 13:05:00-000, 9460, 5280, 4180, 3, 1348.33, 3, 1347.33, 9461
7, 13:06:00-000, 1173, 21, 1152, 2, 1347.00, 2, 1350.00, 1169
7, 13:07:00-000, 1779, 19, 1760, 0, 0.00, 0, 0.00, 1779
7, 13:08:00-000, 3150, 1296, 1854, 36, 1351.61, 28, 1352.64, 3086
7, 13:09:00-000, 1967, 1295, 672, 3, 1351.00, 11, 1350.73, 1953
7, 13:10:00-000, 5883, 2470, 3413, 8, 1348.75, 8, 1350.25, 5867
7, 13:11:00-000, 10331, 4084, 6247, 7, 1350.00, 7, 1350.00, 10317
7, 13:12:00-000, 3526, 563, 2963, 35, 1353.17, 28, 1352.11, 3463
7, 13:13:00-000, 9, 0, 9, 0, 0.00, 7, 1350.71, 2
7, 13:15:00-000, 2186, 6, 2180, 0, 0.00, 0, 0.00, 1363
7, 13:16:00-000, 4769, 2769, 2000, 11, 1350.55, 11, 1352.82, 5570
7, 13:18:00-000, 3408, 1501, 1907, 12, 1351.08, 12, 1352.17, 3384
7, 13:21:00-000, 1133, 1130, 3, 0, 0.00, 0, 0.00, 1133
7, 13:22:00-000, 7510, 5256, 2254, 14, 1351.21, 24, 1350.75, 7472
7, 13:23:00-000, 1072, 1060, 12, 10, 1354.00, 0, 0.00, 1062
7, 13:24:00-000, 924, 4, 920, 0, 0.00, 0, 0.00, 924
7, 13:26:00-000, 15535, 10895, 4640, 20, 1351.50, 20, 1351.35, 15495
7, 13:27:00-000, 11465, 8970, 2495, 3, 1351.00, 3, 1346.33, 11455
7, 13:28:00-000, 6589, 27, 6562, 15, 1348.80, 15, 1348.93, 6563
7, 13:29:00-000, 1001, 1000, 1, 0, 0.00, 0, 0.00, 1001
7, 13:30:00-000, 20234, 10025, 10209, 22, 1355.00, 22, 1351.00, 20190
7, 13:31:00-000, 16635, 10230, 6405, 3, 1351.33, 3, 1351.67, 16629
7, 13:32:00-000, 2080, 1212, 868, 38, 1352.89, 38, 1351.76, 2004
7, 13:33:00-000, 280, 5, 275, 5, 1349.00, 5, 1352.20, 270
7, 13:34:00-000, 1059, 19, 1040, 0, 0.00, 0, 0.00, 1059
7, 13:35:00-000, 3610, 1383, 2227, 1, 1353.00, 1, 1353.00, 3608
7, 13:36:00-000, 6028, 5129, 899, 21, 1350.19, 21, 1351.33, 5759
7, 13:37:00-000, 9092, 852, 8240, 17, 1353.00, 15, 1351.53, 9287
7, 13:38:00-000, 21067, 9739, 11328, 14, 1348.14, 15, 1350.46, 21038
7, 13:39:00-000, 9914, 5862, 4052, 2, 1347.50, 3, 1348.00, 9909
7, 13:40:00-000, 11467, 6396, 5071, 11, 1349.00, 14, 1351.57, 11442
7, 13:41:00-000, 3712, 2130, 1582, 4, 1351.75, 1, 1350.00, 2686
7, 13:42:00-000, 6151, 1462, 4689, 3, 1350.00, 3, 1348.00, 7166
7, 13:43:00-000, 5334, 1426, 3908, 0, 0.00, 0, 0.00, 5334
7, 13:44:00-000, 5791, 2713, 3078, 13, 1348.15, 13, 1349.46, 5765
7, 13:45:00-000, 15077, 9119, 5958, 12, 1347.75, 12, 1349.00, 15049
7, 13:46:00-000, 3115, 1358, 1757, 10, 1346.60, 10, 1351.40, 3099
7, 13:47:00-000, 3696, 1610, 2086, 2, 1354.00, 2, 1353.00, 3692
7, 13:48:00-000, 723, 709, 14, 14, 1351.93, 14, 1351.21, 695
7, 13:49:00-000, 8178, 3364, 4814, 4, 1349.00, 4, 1350.25, 8170
7, 13:50:00-000, 4434, 2623, 1811, 12, 1350.25, 12, 1348.67, 4410
7, 13:51:00-000, 3290, 2049, 1241, 0, 0.00, 0, 0.00, 3290
7, 13:52:00-000, 4208, 2378, 1830, 13, 1347.54, 13, 1348.08, 4182
7, 13:53:00-000, 8738, 6127, 2611, 4, 1351.50, 4, 1348.50, 8730
7, 13:54:00-000, 16228, 9985, 6243, 25, 1348.12, 25, 1352.00, 16178
7, 13:55:00-000, 8852, 3028, 5824, 0, 0.00, 0, 0.00, 8852
7, 13:56:00-000, 3450, 587, 2863, 13, 1350.61, 13, 1351.54, 3424
7, 13:57:00-000, 8390, 5827, 2563, 0, 0.00, 0, 0.00, 8390
7, 13:58:00-000, 19611, 9076, 10535, 29, 1349.79, 29, 1350.55, 19553
7, 13:59:00-000, 13038, 5386, 7652, 6, 1349.33, 6, 1348.50, 13021
7, 14:00:00-000, 11171, 4017, 7154, 45, 1349.51, 45, 1349.17, 9745
7, 14:01:00-000, 15931, 9679, 6252, 0, 0.00, 0, 0.00, 17272
7, 14:02:00-000, 779, 9, 770, 0, 0.00, 0, 0.00, 779
7, 14:04:00-000, 3667, 3620, 47, 0, 0.00, 0, 0.00, 3667
7, 14:05:00-000, 10761, 5171, 5590, 0, 0.00, 0, 0.00, 10636
7, 14:06:00-000, 10568, 4915, 5653, 12, 1352.75, 12, 1352.00, 10669
7, 14:07:00-000, 8139, 5669, 2470, 7, 1353.71, 7, 1352.86, 8125
7, 14:08:00-000, 2580, 830, 1750, 7, 1350.29, 7, 1350.14, 2566
7, 14:09:00-000, 9297, 4418, 4879, 0, 0.00, 0, 0.00, 9297
7, 14:10:00-000, 1067, 1063, 4, 3, 1354.00, 3, 1352.00, 1061
7, 14:11:00-000, 2253, 1523, 730, 0, 0.00, 0, 0.00, 2253
7, 14:12:00-000, 947, 7, 940, 0, 0.00, 0, 0.00, 947
7, 14:13:00-000, 8382, 6140, 2242, 0, 0.00, 0, 0.00, 8382
7, 14:15:00-000, 761, 21, 740, 0, 0.00, 0, 0.00, 761
7, 14:17:00-000, 717, 711, 6, 6, 1354.67, 6, 1352.00, 705
7, 14:18:00-000, 4582, 2916, 1666, 11, 1349.91, 35, 1352.00, 4536
7, 14:19:00-000, 6658, 1638, 5020, 39, 1351.61, 15, 1351.93, 6604
7, 14:20:00-000, 3624, 1057, 2567, 36, 1350.89, 40, 1352.00, 3548
7, 14:21:00-000, 2261, 1013, 1248, 4, 1353.75, 0, 0.00, 2248
7, 14:22:00-000, 14344, 10555, 3789, 17, 1352.94, 17, 1351.41, 14319
7, 14:23:00-000, 13842, 7990, 5852, 0, 0.00, 0, 0.00, 13832
7, 14:24:00-000, 1833, 872, 961, 6, 1348.00, 6, 1351.00, 1831
7, 14:25:00-000, 12491, 7507, 4984, 28, 1353.35, 28, 1352.14, 12435
7, 14:26:00-000, 752, 1, 751, 1, 1348.00, 1, 1354.00, 750
7, 14:28:00-000, 82, 80, 2, 0, 0.00, 0, 0.00, 82
7, 14:29:00-000, 9518, 5823, 3695, 47, 1352.55, 47, 1351.17, 9424
7, 14:30:00-000, 5212, 4286, 926, 35, 1348.34, 44, 1350.79, 5133
7, 14:31:00-000, 7795, 5492, 2303, 9, 1352.33, 0, 0.00, 7786
7, 14:33:00-000, 4062, 21, 4041, 1, 1350.00, 1, 1349.00, 4060
7, 14:34:00-000, 2105, 2075, 30, 16, 1351.62, 16, 1351.62, 2073
7, 14:35:00-000, 1578, 819, 759, 41, 1352.12, 41, 1351.85, 1496
7, 14:36:00-000, 7439, 1065, 6374, 2, 1356.00, 2, 1350.00, 6225
7, 14:37:00-000, 5977, 3595, 2382, 4, 1349.00, 4, 1351.00, 7179
7, 14:39:00-000, 10735, 6752, 3983, 2, 1348.50, 2, 1349.50, 10731
7, 14:40:00-000, 2930, 1988, 942, 30, 1354.03, 30, 1352.60, 2870
7, 14:41:00-000, 6410, 2773, 3637, 7, 1347.00, 7, 1351.71, 6396
7, 14:42:00-000, 11018, 7554, 3464, 15, 1351.60, 15, 1351.40, 10988
7, 14:43:00-000, 4253, 2654, 1599, 12, 1347.58, 12, 1351.50, 4229
7, 14:44:00-000, 3577, 1263, 2314, 0, 0.00, 1, 1352.00, 3576
7, 14:45:00-000, 5823, 4865, 958, 3, 1350.67, 2, 1351.00, 5818
7, 14:48:00-000, 6614, 1648, 4966, 0, 0.00, 0, 0.00, 6614
7, 14:49:00-000, 5757, 3281, 2476, 5, 1351.00, 5, 1347.00, 5747
7, 14:50:00-000, 15295, 8429, 6866, 16, 1350.56, 16, 1351.44, 15263
7, 14:51:00-000, 6477, 3410, 3067, 0, 0.00, 0, 0.00, 5298
7, 14:52:00-000, 11759, 8518, 3241, 6, 1351.17, 6, 1350.67, 12926
7, 14:53:00-000, 2604, 1210, 1394, 4, 1345.00, 4, 1351.00, 2596
7, 14:54:00-000, 6967, 2193, 4774, 4, 1348.00, 4, 1347.75, 6959
7, 14:55:00-000, 6238, 2587, 3651, 2, 1350.00, 2, 1348.50, 6234
7, 14:56:00-000, 17463, 12148, 5315, 12, 1349.33, 12, 1349.67, 16245
7, 14:57:00-000, 7354, 6230, 1124, 29, 1349.00, 29, 1348.03, 8490
7, 14:58:00-000, 3171, 3170, 1, 0, 0.00, 1, 1351.00, 3170
7, 14:59:00-000, 5702, 1122, 4580, 7, 1350.00, 6, 1346.67, 5689
7, 15:00:00-000, 12916, 2933, 9983, 9, 1349.22, 9, 1348.00, 12898
7, 15:01:00-000, 2216, 771, 1445, 0, 0.00, 0, 0.00, 2216
7, 15:02:00-000, 4328, 2361, 1967, 19, 1348.68, 19, 1350.10, 4290
7, 15:03:00-000, 10961, 3987, 6974, 17, 1352.00, 17, 1350.41, 10927
7, 15:04:00-000, 8871, 5116, 3755, 6, 1350.33, 6, 1352.00, 8859
7, 15:05:00-000, 1178, 74, 1104, 31, 1351.06, 14, 1351.86, 1133
7, 15:06:00-000, 44, 0, 44, 0, 0.00, 17, 1345.70, 27
7, 15:07:00-000, 907, 900, 7, 0, 0.00, 0, 0.00, 907
7, 15:10:00-000, 7998, 5303, 2695, 53, 1349.33, 53, 1348.98, 7892
7, 15:11:00-000, 10676, 4414, 6262, 2, 1352.00, 2, 1350.00, 10672
7, 15:12:00-000, 3680, 2714, 966, 24, 1347.83, 24, 1349.12, 3632
7, 15:13:00-000, 6871, 2530, 4341, 11, 1348.45, 11, 1349.09, 6849
7, 15:14:00-000, 3133, 2165, 968, 30, 1353.36, 30, 1351.80, 3073
7, 15:15:00-000, 963, 960, 3, 0, 0.00, 0, 0.00, 963
7, 15:16:00-000, 13812, 8608, 5204, 2, 1351.00, 2, 1351.00, 13808
7, 15:17:00-000, 8024, 3062, 4962, 9, 1350.78, 9, 1352.67, 8006
7, 15:18:00-000, 10717, 7458, 3259, 1, 1353.00, 4, 1351.00, 9504
7, 15:19:00-000, 4398, 3241, 1157, 3, 1351.00, 0, 0.00, 5603
7, 15:20:00-000, 3847, 1066, 2781, 0, 0.00, 0, 0.00, 3847
7, 15:21:00-000, 18624, 9083, 9541, 9, 1348.33, 9, 1351.00, 18606
7, 15:22:00-000, 2898, 1814, 1084, 22, 1348.04, 22, 1348.73, 2854
7, 15:23:00-000, 10295, 3107, 7188, 4, 1350.00, 4, 1349.75, 10287
7, 15:24:00-000, 830, 830, 0, 0, 0.00, 0, 0.00, 830
7, 15:26:00-000, 19897, 15189, 4708, 6, 1349.50, 8, 1350.75, 19883
7, 15:27:00-000, 6513, 3409, 3104, 2, 1352.00, 0, 0.00, 6511
7, 15:28:00-000, 9243, 9177, 66, 2, 1352.00, 4, 1350.50, 9237
7, 15:29:00-000, 12496, 7560, 4936, 7, 1353.29, 5, 1351.00, 12484
7, 15:30:00-000, 9228, 5633, 3595, 0, 0.00, 2, 1350.00, 9217
7, 15:31:00-000, 11816, 7880, 3936, 7, 1351.43, 5, 1351.00, 11813
7, 15:32:00-000, 18853, 8621, 10232, 26, 1351.42, 26, 1351.42, 17937
7, 15:33:00-000, 12349, 7783, 4566, 7, 1347.00, 7, 1348.00, 13199
7, 15:34:00-000, 942, 52, 890, 28, 1353.75, 28, 1353.00, 886
7, 15:37:00-000, 4937, 1794, 3143, 4, 1349.50, 6, 1351.33, 4927
7, 15:38:00-000, 8853, 2386, 6467, 7, 1349.14, 4, 1347.75, 8842
7, 15:39:00-000, 13196, 8045, 5151, 0, 0.00, 1, 1348.00, 13195
7, 15:40:00-000, 3481, 31, 3450, 0, 0.00, 0, 0.00, 1960
7, 15:41:00-000, 1203, 3, 1200, 0, 0.00, 0, 0.00, 2724
7, 15:42:00-000, 7832, 4799, 3033, 0, 0.00, 0, 0.00, 7823
7, 15:43:00-000, 0, 0, 0, 0, 0.00, 0, 0.00, 9
7, 15:44:00-000, 977, 17, 960, 0, 0.00, 0, 0.00, 977
7, 15:46:00-000, 4339, 1530, 2809, 0, 0.00, 0, 0.00, 4339
7, 15:47:00-000, 12185, 3193, 8992, 1, 1348.00, 0, 0.00, 12184
7, 15:48:00-000, 2799, 2043, 756, 1, 1349.00, 2, 1348.00, 2796
7, 15:49:00-000, 1189, 1180, 9, 0, 0.00, 5, 1350.00, 1184
7, 15:50:00-000, 753, 748, 5, 6, 1350.83, 1, 1349.00, 746
7, 15:52:00-000, 1874, 863, 1011, 0, 0.00, 0, 0.00, 1874
7, 15:54:00-000, 11674, 4699, 6975, 10, 1351.00, 11, 1352.00, 11653
7, 15:55:00-000, 1, 1, 0, 1, 1352.00, 0, 0.00, 0
7, 15:56:00-000, 282, 12, 270, 0, 0.00, 0, 0.00, 282
7, 15:58:00-000, 2740, 1768, 972, 0, 0.00, 0, 0.00, 1779
7, 15:59:00-000, 6696, 2667, 4029, 3, 1352.00, 3, 1351.00, 7651
7, 16:00:00-000, 995, 990, 5, 0, 0.00, 0, 0.00, 995
7, 16:02:00-000, 827, 820, 7, 7, 1346.86, 7, 1347.29, 813
7, 16:04:00-000, 509, 9, 500, 0, 0.00, 0, 0.00, 509
7, 16:05:00-000, 7410, 5014, 2396, 1, 1351.00, 1, 1350.00, 7408
7, 16:06:00-000, 2652, 22, 2630, 0, 0.00, 0, 0.00, 2652
7, 16:07:00-000, 1189, 9, 1180, 0, 0.00, 0, 0.00, 1189
7, 16:08:00-000, 3997, 36, 3961, 1, 1349.00, 1, 1348.00, 3995
7, 16:09:00-000, 5266, 52, 5214, 11, 1348.73, 11, 1351.55, 5244
7, 16:10:00-000, 1437, 17, 1420, 0, 0.00, 0, 0.00, 1437
7, 16:11:00-000, 9905, 6053, 3852, 0, 0.00, 0, 0.00, 9188
7, 16:12:00-000, 4947, 2243, 2704, 1, 1347.00, 1, 1347.00, 5662
7, 16:13:00-000, 1755, 1740, 15, 0, 0.00, 0, 0.00, 917
7, 16:14:00-000, 7054, 4513, 2541, 11, 1348.27, 11, 1346.18, 7870
7, 16:15:00-000, 7609, 3237, 4372, 1, 1350.00, 1, 1348.00, 7607
7, 16:16:00-000, 7493, 4811, 2682, 8, 1348.37, 3, 1351.33, 7482
7, 16:17:00-000, 13606, 8017, 5589, 4, 1350.75, 9, 1349.22, 12277
7, 16:18:00-000, 7737, 4047, 3690, 8, 1348.13, 12, 1351.67, 9033
7, 16:19:00-000, 9049, 3218, 5831, 4, 1352.00, 0, 0.00, 9045
7, 16:20:00-000, 12358, 8761, 3597, 41, 1350.87, 41, 1352.00, 12276
7, 16:21:00-000, 9940, 5064, 4876, 13, 1348.23, 13, 1344.92, 9394
7, 16:22:00-000, 16287, 10865, 5422, 36, 1352.16, 36, 1351.44, 16735
7, 16:23:00-000, 7524, 3877, 3647, 1, 1349.00, 1, 1349.00, 6717
7, 16:24:00-000, 3726, 2133, 1593, 16, 1352.88, 16, 1344.00, 4499
7, 16:25:00-000, 6126, 3150, 2976, 20, 1353.80, 20, 1351.40, 6086
7, 16:26:00-000, 6669, 4249, 2420, 7, 1349.71, 6, 1351.00, 6656
7, 16:27:00-000, 8451, 3049, 5402, 5, 1349.00, 6, 1344.83, 8440
7, 16:28:00-000, 18025, 10507, 7518, 8, 1349.38, 9, 1349.89, 18008
7, 16:29:00-000, 5742, 1429, 4313, 11, 1348.63, 10, 1351.30, 5721
9, 09:06:00-000, 2990, 2120, 870, 0, 0.00, 0, 0.00, 2990
9, 09:07:00-000, 15300, 5900, 9400, 0, 0.00, 0, 0.00, 15300
9, 09:17:00-000, 2790, 1880, 910, 0, 0.00, 0, 0.00, 2790
9, 09:22:00-000, 4090, 0, 4090, 0, 0.00, 0, 0.00, 4090
9, 09:23:00-000, 5090, 2140, 2950, 0, 0.00, 0, 0.00, 5090
9, 09:36:00-000, 1440, 1440, 0, 0, 0.00, 0, 0.00, 1440
9, 09:46:00-000, 3190, 2360, 830, 0, 0.00, 0, 0.00, 3190
9, 09:47:00-000, 810, 0, 810, 0, 0.00, 0, 0.00, 810
9, 09:49:00-000, 5030, 1160, 3870, 0, 0.00, 0, 0.00, 5030
9, 09:51:00-000, 9720, 3550, 6170, 0, 0.00, 0, 0.00, 9720
9, 09:53:00-000, 5580, 2720, 2860, 0, 0.00, 0, 0.00, 5580
9, 09:54:00-000, 4230, 3040, 1190, 0, 0.00, 0, 0.00, 4230
9, 09:55:00-000, 2240, 840, 1400, 0, 0.00, 0, 0.00, 2240
9, 09:58:00-000, 2370, 1180, 1190, 0, 0.00, 0, 0.00, 2370
9, 10:02:00-000, 1490, 1490, 0, 0, 0.00, 0, 0.00, 1490
9, 10:04:00-000, 871, 870, 1, 1, 1348.00, 1, 1350.00, 869
9, 10:05:00-000, 5790, 4090, 1700, 0, 0.00, 0, 0.00, 5790
9, 10:06:00-000, 4940, 0, 4940, 0, 0.00, 0, 0.00, 4940
9, 10:08:00-000, 4810, 1160, 3650, 0, 0.00, 0, 0.00, 4810
9, 10:09:00-000, 960, 960, 0, 0, 0.00, 0, 0.00, 960
9, 10:10:00-000, 5030, 1200, 3830, 0, 0.00, 0, 0.00, 5030
9, 10:13:00-000, 3460, 2670, 790, 0, 0.00, 0, 0.00, 3460
9, 10:14:00-000, 2691, 1091, 1600, 1, 1354.00, 1, 1353.00, 2689
9, 10:15:00-000, 2820, 1030, 1790, 0, 0.00, 0, 0.00, 2820
9, 10:17:00-000, 4907, 1560, 3347, 40, 1353.47, 40, 1349.00, 4827
9, 10:18:00-000, 15487, 4767, 10720, 7, 1352.86, 17, 1353.00, 15463
9, 10:19:00-000, 970, 970, 0, 10, 1356.00, 0, 0.00, 960
9, 10:20:00-000, 1180, 1180, 0, 0, 0.00, 0, 0.00, 1180
9, 10:21:00-000, 3570, 1400, 2170, 0, 0.00, 0, 0.00, 3570
9, 10:23:00-000, 1150, 0, 1150, 0, 0.00, 0, 0.00, 1150
9, 10:25:00-000, 6008, 4640, 1368, 38, 1348.00, 38, 1346.26, 5932
9, 10:26:00-000, 920, 0, 920, 0, 0.00, 0, 0.00, 920
9, 10:27:00-000, 11090, 4980, 6110, 0, 0.00, 0, 0.00, 11090
9, 10:28:00-000, 263, 230, 33, 17, 1346.00, 12, 1349.17, 234
9, 10:29:00-000, 2655, 0, 2655, 0, 0.00, 5, 1351.00, 2650
9, 10:32:00-000, 11910, 8610, 3300, 0, 0.00, 0, 0.00, 11910
9, 10:33:00-000, 4630, 2750, 1880, 0, 0.00, 0, 0.00, 4630
9, 10:34:00-000, 5810, 1600, 4210, 0, 0.00, 0, 0.00, 5810
9, 10:35:00-000, 9370, 4700, 4670, 0, 0.00, 0, 0.00, 9370
9, 10:36:00-000, 6340, 1950, 4390, 0, 0.00, 0, 0.00, 6340
9, 10:37:00-000, 3221, 1, 3220, 1, 1351.00, 1, 1351.00, 3219
9, 10:38:00-000, 3600, 2040, 1560, 0, 0.00, 0, 0.00, 3600
9, 10:39:00-000, 2700, 2700, 0, 0, 0.00, 0, 0.00, 2700
9, 10:40:00-000, 6600, 5750, 850, 0, 0.00, 0, 0.00, 6600
9, 10:41:00-000, 5720, 1040, 4680, 0, 0.00, 0, 0.00, 5720
9, 10:42:00-000, 11377, 2647, 8730, 3, 1352.33, 27, 1352.00, 10117
9, 10:43:00-000, 6844, 4634, 2210, 24, 1354.91, 0, 0.00, 8050
9, 10:44:00-000, 2520, 1530, 990, 0, 0.00, 0, 0.00, 2520
9, 10:45:00-000, 2180, 0, 2180, 0, 0.00, 0, 0.00, 1910
9, 10:46:00-000, 2260, 1290, 970, 0, 0.00, 0, 0.00, 2530
9, 10:47:00-000, 5240, 0, 5240, 0, 0.00, 0, 0.00, 3800
9, 10:48:00-000, 2550, 0, 2550, 0, 0.00, 0, 0.00, 2960
9, 10:49:00-000, 930, 930, 0, 0, 0.00, 0, 0.00, 1960
9, 10:50:00-000, 990, 990, 0, 0, 0.00, 0, 0.00, 990
9, 10:51:00-000, 5680, 930, 4750, 0, 0.00, 0, 0.00, 4750
9, 10:52:00-000, 1580, 0, 1580, 0, 0.00, 0, 0.00, 2510
9, 10:53:00-000, 1920, 1040, 880, 0, 0.00, 0, 0.00, 1920
9, 10:55:00-000, 1120, 1120, 0, 0, 0.00, 0, 0.00, 1120
9, 10:56:00-000, 3720, 0, 3720, 0, 0.00, 0, 0.00, 3720
9, 10:57:00-000, 6870, 4700, 2170, 0, 0.00, 0, 0.00, 6870
9, 10:58:00-000, 1030, 1030, 0, 0, 0.00, 0, 0.00, 1030
9, 11:00:00-000, 3590, 1170, 2420, 0, 0.00, 0, 0.00, 3590
9, 11:01:00-000, 7570, 4990, 2580, 0, 0.00, 0, 0.00, 7570
9, 11:02:00-000, 1080, 1080, 0, 0, 0.00, 0, 0.00, 1080
9, 11:03:00-000, 14010, 3710, 10300, 0, 0.00, 0, 0.00, 14010
9, 11:04:00-000, 3660, 3660, 0, 0, 0.00, 0, 0.00, 3660
9, 11:05:00-000, 1050, 0, 1050, 0, 0.00, 0, 0.00, 1050
9, 11:06:00-000, 1306, 1300, 6, 6, 1348.00, 6, 1346.33, 1294
9, 11:07:00-000, 5270, 1710, 3560, 0, 0.00, 0, 0.00, 5270
9, 11:08:00-000, 2739, 2700, 39, 39, 1346.46, 39, 1344.74, 2661
9, 11:09:00-000, 7500, 3120, 4380, 0, 0.00, 0, 0.00, 7500
9, 11:10:00-000, 3200, 2010, 1190, 0, 0.00, 0, 0.00, 3200
9, 11:11:00-000, 2700, 1230, 1470, 0, 0.00, 0, 0.00, 2700
9, 11:12:00-000, 4911, 1611, 3300, 17, 1350.18, 17, 1353.00, 4877
9, 11:13:00-000, 1469, 19, 1450, 19, 1355.00, 19, 1353.00, 1431
9, 11:15:00-000, 5300, 3260, 2040, 0, 0.00, 0, 0.00, 5300
9, 11:16:00-000, 5820, 5020, 800, 0, 0.00, 0, 0.00, 5820
9, 11:17:00-000, 5594, 3810, 1784, 15, 1348.00, 15, 1346.27, 5564
9, 11:18:00-000, 2062, 1362, 700, 2, 1353.00, 22, 1351.00, 2038
9, 11:19:00-000, 1121, 31, 1090, 20, 1355.55, 0, 0.00, 1101
9, 11:20:00-000, 758, 18, 740, 18, 1355.66, 18, 1352.00, 722
9, 11:23:00-000, 3560, 1130, 2430, 0, 0.00, 0, 0.00, 3560
9, 11:24:00-000, 3070, 700, 2370, 0, 0.00, 0, 0.00, 3070
9, 11:25:00-000, 3880, 1060, 2820, 0, 0.00, 0, 0.00, 3880
9, 11:26:00-000, 2470, 2470, 0, 0, 0.00, 0, 0.00, 2470
9, 11:27:00-000, 2050, 1180, 870, 0, 0.00, 0, 0.00, 2050
9, 11:28:00-000, 1688, 1680, 8, 8, 1350.00, 8, 1348.13, 1672
9, 11:29:00-000, 2009, 79, 1930, 36, 1352.39, 36, 1352.00, 1937
9, 11:30:00-000, 7261, 1840, 5421, 31, 1347.00, 4, 1350.75, 7226
9, 11:31:00-000, 3832, 2440, 1392, 0, 0.00, 27, 1348.70, 3805
9, 11:32:00-000, 920, 920, 0, 0, 0.00, 0, 0.00, 920
9, 11:33:00-000, 7300, 6320, 980, 0, 0.00, 0, 0.00, 7300
9, 11:34:00-000, 8230, 4870, 3360, 0, 0.00, 0, 0.00, 8230
9, 11:35:00-000, 5429, 2699, 2730, 9, 1351.44, 9, 1352.00, 5411
9, 11:38:00-000, 1214, 1200, 14, 14, 1349.00, 1, 1353.00, 1199
9, 11:39:00-000, 12973, 9060, 3913, 0, 0.00, 13, 1350.69, 12960
9, 11:40:00-000, 2500, 2500, 0, 0, 0.00, 0, 0.00, 2500
9, 11:41:00-000, 10895, 3905, 6990, 5, 1350.80, 5, 1352.00, 9815
9, 11:42:00-000, 4928, 2760, 2168, 21, 1348.00, 21, 1347.52, 5956
9, 11:44:00-000, 2553, 3, 2550, 2, 1352.50, 2, 1352.00, 2549
9, 11:45:00-000, 2203, 23, 2180, 14, 1353.50, 14, 1352.00, 2175
9, 11:48:00-000, 3220, 3220, 0, 0, 0.00, 0, 0.00, 3220
9, 11:49:00-000, 1510, 1510, 0, 0, 0.00, 0, 0.00, 1510
9, 11:50:00-000, 11300, 3770, 7530, 0, 0.00, 0, 0.00, 11300
9, 11:51:00-000, 3320, 1100, 2220, 0, 0.00, 0, 0.00, 3320
9, 11:52:00-000, 1271, 41, 1230, 22, 1349.45, 22, 1352.00, 1227
9, 11:53:00-000, 1930, 1930, 0, 0, 0.00, 0, 0.00, 1930
9, 11:54:00-000, 8174, 4940, 3234, 4, 1345.00, 4, 1350.75, 8166
9, 11:56:00-000, 2970, 1860, 1110, 0, 0.00, 0, 0.00, 2970
9, 11:57:00-000, 3970, 0, 3970, 0, 0.00, 0, 0.00, 3250
9, 11:58:00-000, 11060, 3490, 7570, 0, 0.00, 0, 0.00, 11320
9, 11:59:00-000, 4160, 960, 3200, 0, 0.00, 0, 0.00, 4620
9, 12:00:00-000, 8415, 6750, 1665, 25, 1348.80, 15, 1350.33, 8375
9, 12:01:00-000, 1550, 1540, 10, 0, 0.00, 10, 1346.00, 1540
9, 12:02:00-000, 6838, 5570, 1268, 6, 1348.00, 6, 1346.67, 6826
9, 12:03:00-000, 5790, 820, 4970, 0, 0.00, 0, 0.00, 5790
9, 12:04:00-000, 3710, 10, 3700, 7, 1355.14, 7, 1352.71, 3696
9, 12:05:00-000, 5250, 880, 4370, 0, 0.00, 0, 0.00, 5250
9, 12:06:00-000, 3321, 3320, 1, 1, 1348.00, 1, 1345.00, 3319
9, 12:08:00-000, 5450, 3322, 2128, 40, 1346.05, 4, 1349.75, 5406
9, 12:09:00-000, 1017, 61, 956, 32, 1352.34, 68, 1349.48, 917
9, 12:10:00-000, 9300, 5020, 4280, 0, 0.00, 0, 0.00, 9300
9, 12:11:00-000, 6590, 3450, 3140, 0, 0.00, 0, 0.00, 6590
9, 12:12:00-000, 4255, 3400, 855, 5, 1345.00, 5, 1351.00, 4245
9, 12:13:00-000, 10630, 4280, 6350, 10, 1351.80, 10, 1352.00, 10610
9, 12:14:00-000, 5769, 909, 4860, 9, 1350.00, 9, 1352.00, 5751
9, 12:15:00-000, 6766, 1676, 5090, 16, 1353.87, 16, 1352.00, 5584
9, 12:16:00-000, 6076, 2186, 3890, 6, 1352.33, 6, 1355.00, 7214
9, 12:17:00-000, 6370, 2180, 4190, 0, 0.00, 0, 0.00, 6370
9, 12:18:00-000, 1235, 1161, 74, 15, 1351.33, 15, 1352.13, 1205
9, 12:19:00-000, 5330, 3230, 2100, 0, 0.00, 0, 0.00, 5330
9, 12:21:00-000, 1540, 10, 1530, 10, 1353.00, 10, 1352.00, 1520
9, 12:24:00-000, 1370, 1370, 0, 0, 0.00, 0, 0.00, 1370
9, 12:28:00-000, 4780, 3880, 900, 0, 0.00, 0, 0.00, 4780
9, 12:29:00-000, 1059, 29, 1030, 17, 1354.41, 17, 1352.00, 1025
9, 12:31:00-000, 2200, 0, 2200, 0, 0.00, 0, 0.00, 2200
9, 12:32:00-000, 1110, 0, 1110, 0, 0.00, 0, 0.00, 1110
9, 12:37:00-000, 1870, 1870, 0, 0, 0.00, 0, 0.00, 1870
9, 12:38:00-000, 5490, 10, 5480, 9, 1351.00, 10, 1353.00, 4250
9, 12:39:00-000, 4941, 2361, 2580, 11, 1352.73, 10, 1352.00, 6141
9, 12:41:00-000, 1990, 1230, 760, 0, 0.00, 0, 0.00, 1990
9, 12:42:00-000, 2175, 5, 2170, 5, 1355.00, 5, 1352.00, 2165
9, 12:46:00-000, 1030, 1030, 0, 0, 0.00, 0, 0.00, 1030
9, 12:48:00-000, 4680, 2160, 2520, 0, 0.00, 0, 0.00, 4680
9, 12:51:00-000, 4030, 2720, 1310, 0, 0.00, 0, 0.00, 4030
9, 12:53:00-000, 8500, 6040, 2460, 0, 0.00, 0, 0.00, 8500
9, 12:54:00-000, 5005, 985, 4020, 25, 1353.40, 25, 1351.60, 4955
9, 12:55:00-000, 3620, 2330, 1290, 0, 0.00, 0, 0.00, 3620
9, 12:56:00-000, 4487, 3107, 1380, 7, 1350.00, 7, 1353.00, 4473
9, 12:57:00-000, 11520, 6220, 5300, 0, 0.00, 0, 0.00, 11520
9, 12:58:00-000, 4913, 2413, 2500, 2, 1351.00, 3, 1354.00, 4908
9, 12:59:00-000, 8001, 3121, 4880, 1, 1352.00, 0, 0.00, 8000
9, 13:00:00-000, 4095, 1305, 2790, 3, 1353.33, 3, 1352.00, 4089
9, 13:01:00-000, 5441, 2391, 3050, 1, 1350.00, 1, 1351.00, 5439
9, 13:04:00-000, 3390, 1290, 2100, 0, 0.00, 0, 0.00, 2100
9, 13:05:00-000, 6600, 2593, 4007, 10, 1349.20, 10, 1350.90, 7870
9, 13:07:00-000, 3300, 1820, 1480, 0, 0.00, 0, 0.00, 1820
9, 13:08:00-000, 1232, 1230, 2, 2, 1348.00, 2, 1350.00, 2708
9, 13:09:00-000, 2271, 1, 2270, 1, 1352.00, 1, 1350.00, 2269
9, 13:10:00-000, 3520, 1220, 2300, 0, 0.00, 0, 0.00, 3520
9, 13:11:00-000, 5940, 5940, 0, 0, 0.00, 0, 0.00, 5940
9, 13:15:00-000, 1170, 1170, 0, 0, 0.00, 0, 0.00, 1170
9, 13:16:00-000, 3298, 2410, 888, 8, 1349.00, 8, 1349.37, 3282
9, 13:18:00-000, 5540, 1740, 3800, 0, 0.00, 0, 0.00, 5540
9, 13:21:00-000, 1210, 0, 1210, 0, 0.00, 0, 0.00, 1210
9, 13:22:00-000, 6490, 3490, 3000, 10, 1353.30, 10, 1352.00, 6470
9, 13:24:00-000, 2930, 950, 1980, 0, 0.00, 0, 0.00, 2930
9, 13:26:00-000, 8290, 4240, 4050, 0, 0.00, 0, 0.00, 8290
9, 13:27:00-000, 3830, 2590, 1240, 0, 0.00, 0, 0.00, 3830
9, 13:28:00-000, 1880, 850, 1030, 0, 0.00, 0, 0.00, 1880
9, 13:30:00-000, 11772, 4572, 7200, 2, 1356.00, 2, 1352.00, 11768
9, 13:31:00-000, 8080, 2740, 5340, 0, 0.00, 0, 0.00, 8080
9, 13:35:00-000, 1680, 1680, 0, 0, 0.00, 0, 0.00, 1680
9, 13:36:00-000, 5169, 9, 5160, 9, 1349.78, 9, 1352.00, 5151
9, 13:37:00-000, 8100, 4010, 4090, 29, 1345.14, 29, 1347.24, 8042
9, 13:38:00-000, 2310, 1030, 1280, 0, 0.00, 0, 0.00, 2310
9, 13:39:00-000, 4853, 740, 4113, 2, 1346.00, 2, 1346.50, 4849
9, 13:40:00-000, 6730, 1350, 5380, 0, 0.00, 0, 0.00, 6200
9, 13:41:00-000, 2480, 1910, 570, 0, 0.00, 0, 0.00, 3010
9, 13:42:00-000, 2120, 820, 1300, 0, 0.00, 0, 0.00, 2120
9, 13:43:00-000, 2291, 1181, 1110, 1, 1351.00, 1, 1351.00, 2289
9, 13:44:00-000, 2640, 1740, 900, 0, 0.00, 0, 0.00, 2640
9, 13:45:00-000, 8340, 4750, 3590, 0, 0.00, 0, 0.00, 8340
9, 13:46:00-000, 3451, 3450, 1, 1, 1348.00, 1, 1350.00, 3449
9, 13:47:00-000, 3000, 3000, 0, 0, 0.00, 0, 0.00, 3000
9, 13:48:00-000, 2221, 821, 1400, 1, 1356.00, 1, 1353.00, 2219
9, 13:49:00-000, 2570, 1280, 1290, 0, 0.00, 0, 0.00, 2570
9, 13:50:00-000, 3776, 840, 2936, 26, 1347.15, 26, 1347.92, 3724
9, 13:51:00-000, 800, 800, 0, 0, 0.00, 0, 0.00, 800
9, 13:53:00-000, 4759, 2019, 2740, 25, 1353.68, 25, 1352.00, 4709
9, 13:54:00-000, 5060, 2660, 2400, 0, 0.00, 0, 0.00, 5060
9, 13:55:00-000, 3370, 1220, 2150, 0, 0.00, 0, 0.00, 2070
9, 13:56:00-000, 2477, 1430, 1047, 13, 1350.92, 13, 1352.23, 3751
9, 13:57:00-000, 4200, 2110, 2090, 0, 0.00, 0, 0.00, 4200
9, 13:58:00-000, 4840, 1990, 2850, 0, 0.00, 0, 0.00, 4840
9, 13:59:00-000, 5740, 3220, 2520, 0, 0.00, 0, 0.00, 4220
9, 14:00:00-000, 4305, 2681, 1624, 15, 1348.20, 15, 1347.27, 5795
9, 14:01:00-000, 11190, 3080, 8110, 0, 0.00, 0, 0.00, 11190
9, 14:04:00-000, 3710, 1320, 2390, 0, 0.00, 0, 0.00, 2820
9, 14:05:00-000, 8060, 3230, 4830, 0, 0.00, 0, 0.00, 8950
9, 14:07:00-000, 4580, 4580, 0, 0, 0.00, 0, 0.00, 4580
9, 14:09:00-000, 5430, 1930, 3500, 0, 0.00, 0, 0.00, 5430
9, 14:10:00-000, 2235, 1040, 1195, 3, 1348.00, 3, 1346.67, 2229
9, 14:11:00-000, 5020, 1150, 3870, 0, 0.00, 0, 0.00, 5020
9, 14:12:00-000, 3247, 2030, 1217, 17, 1348.00, 17, 1346.70, 3213
9, 14:13:00-000, 7915, 3710, 4205, 19, 1348.00, 19, 1348.26, 7877
9, 14:17:00-000, 1412, 1390, 22, 17, 1349.00, 17, 1350.53, 1378
9, 14:19:00-000, 5480, 3210, 2270, 0, 0.00, 0, 0.00, 5480
9, 14:20:00-000, 840, 840, 0, 0, 0.00, 0, 0.00, 840
9, 14:22:00-000, 8460, 750, 7710, 0, 0.00, 0, 0.00, 8460
9, 14:23:00-000, 9620, 830, 8790, 0, 0.00, 0, 0.00, 9620
9, 14:24:00-000, 1940, 820, 1120, 0, 0.00, 0, 0.00, 1940
9, 14:25:00-000, 2630, 1370, 1260, 0, 0.00, 0, 0.00, 2630
9, 14:26:00-000, 1045, 5, 1040, 5, 1351.20, 5, 1352.00, 1035
9, 14:28:00-000, 169, 9, 160, 9, 1348.00, 9, 1354.00, 151
9, 14:29:00-000, 5560, 2580, 2980, 10, 1348.00, 10, 1351.20, 5540
9, 14:30:00-000, 750, 0, 750, 0, 0.00, 0, 0.00, 750
9, 14:31:00-000, 5977, 2420, 3557, 7, 1346.00, 7, 1349.00, 5963
9, 14:32:00-000, 1085, 5, 1080, 5, 1351.00, 5, 1353.00, 1075
9, 14:33:00-000, 1629, 919, 710, 19, 1353.31, 19, 1352.00, 1591
9, 14:34:00-000, 1230, 1230, 0, 0, 0.00, 0, 0.00, 1230
9, 14:36:00-000, 3530, 1021, 2509, 10, 1345.70, 16, 1350.37, 3504
9, 14:37:00-000, 3630, 1050, 2580, 10, 1352.00, 4, 1352.00, 3616
9, 14:39:00-000, 8030, 5810, 2220, 0, 0.00, 0, 0.00, 6910
9, 14:40:00-000, 5116, 2496, 2620, 6, 1355.00, 6, 1352.00, 6224
9, 14:41:00-000, 2620, 1440, 1180, 0, 0.00, 0, 0.00, 2620
9, 14:42:00-000, 9186, 2846, 6340, 26, 1355.69, 26, 1352.00, 9134
9, 14:43:00-000, 1280, 1280, 0, 0, 0.00, 0, 0.00, 1280
9, 14:45:00-000, 1950, 1950, 0, 0, 0.00, 0, 0.00, 1950
9, 14:48:00-000, 5255, 985, 4270, 4, 1352.25, 4, 1352.00, 5247
9, 14:49:00-000, 3670, 0, 3670, 0, 0.00, 0, 0.00, 3670
9, 14:50:00-000, 4460, 2510, 1950, 0, 0.00, 0, 0.00, 4460
9, 14:51:00-000, 5720, 3430, 2290, 0, 0.00, 0, 0.00, 5720
9, 14:52:00-000, 6371, 5210, 1161, 12, 1345.33, 12, 1350.00, 6347
9, 14:54:00-000, 3960, 790, 3170, 0, 0.00, 0, 0.00, 3960
9, 14:55:00-000, 6130, 4280, 1850, 0, 0.00, 0, 0.00, 5360
9, 14:56:00-000, 2309, 929, 1380, 2, 1352.00, 9, 1354.00, 3068
9, 14:57:00-000, 6370, 2640, 3730, 10, 1352.90, 7, 1352.00, 6353
9, 14:58:00-000, 2868, 1498, 1370, 7, 1351.71, 4, 1349.00, 2857
9, 14:59:00-000, 3831, 761, 3070, 1, 1356.00, 0, 0.00, 3830
9, 15:00:00-000, 5270, 1870, 3400, 0, 0.00, 0, 0.00, 5270
9, 15:02:00-000, 2200, 2200, 0, 0, 0.00, 0, 0.00, 2200
9, 15:03:00-000, 6930, 2050, 4880, 0, 0.00, 0, 0.00, 6930
9, 15:04:00-000, 2553, 2460, 93, 51, 1347.74, 51, 1348.66, 2451
9, 15:05:00-000, 1230, 1230, 0, 0, 0.00, 0, 0.00, 1230
9, 15:06:00-000, 1110, 0, 1110, 0, 0.00, 0, 0.00, 1110
9, 15:07:00-000, 1192, 2, 1190, 2, 1356.00, 2, 1352.00, 1188
9, 15:08:00-000, 1485, 5, 1480, 5, 1356.00, 5, 1352.00, 1475
9, 15:10:00-000, 3141, 2321, 820, 1, 1349.00, 1, 1351.00, 3139
9, 15:11:00-000, 3490, 1310, 2180, 0, 0.00, 0, 0.00, 3490
9, 15:12:00-000, 1180, 0, 1180, 0, 0.00, 0, 0.00, 1180
9, 15:13:00-000, 6100, 2960, 3140, 0, 0.00, 0, 0.00, 4690
9, 15:14:00-000, 0, 0, 0, 0, 0.00, 0, 0.00, 1410
9, 15:15:00-000, 3926, 1120, 2806, 26, 1348.00, 26, 1346.31, 3874
9, 15:16:00-000, 8222, 2412, 5810, 2, 1351.00, 2, 1352.00, 8218
9, 15:17:00-000, 8783, 3403, 5380, 3, 1351.00, 3, 1353.00, 8777
9, 15:18:00-000, 5565, 3326, 2239, 23, 1349.43, 23, 1350.91, 5519
9, 15:19:00-000, 8477, 5170, 3307, 7, 1349.00, 7, 1347.43, 6953
9, 15:20:00-000, 9466, 1546, 7920, 6, 1351.67, 6, 1351.67, 10964
9, 15:21:00-000, 13990, 5180, 8810, 0, 0.00, 0, 0.00, 13990
9, 15:22:00-000, 3156, 3110, 46, 30, 1348.00, 30, 1347.30, 3096
9, 15:23:00-000, 1270, 0, 1270, 0, 0.00, 0, 0.00, 1270
9, 15:24:00-000, 3330, 3330, 0, 0, 0.00, 0, 0.00, 3330
9, 15:26:00-000, 8453, 5310, 3143, 3, 1348.00, 3, 1347.67, 8447
9, 15:27:00-000, 1240, 0, 1240, 0, 0.00, 0, 0.00, 1240
9, 15:28:00-000, 11723, 5351, 6372, 13, 1351.38, 13, 1351.69, 11697
9, 15:29:00-000, 11920, 5080, 6840, 0, 0.00, 0, 0.00, 11920
9, 15:30:00-000, 4750, 3460, 1290, 0, 0.00, 0, 0.00, 3380
9, 15:31:00-000, 3755, 3710, 45, 23, 1346.30, 13, 1348.77, 5089
9, 15:32:00-000, 8400, 3720, 4680, 0, 0.00, 10, 1349.00, 8390
9, 15:33:00-000, 6641, 6640, 1, 1, 1347.00, 1, 1344.00, 6639
9, 15:34:00-000, 2240, 1360, 880, 0, 0.00, 0, 0.00, 2240
9, 15:37:00-000, 3420, 3420, 0, 0, 0.00, 0, 0.00, 3420
9, 15:38:00-000, 5015, 2305, 2710, 5, 1351.80, 5, 1353.00, 5005
9, 15:39:00-000, 8330, 1950, 6380, 0, 0.00, 0, 0.00, 8330
9, 15:41:00-000, 1020, 0, 1020, 0, 0.00, 0, 0.00, 1020
9, 15:42:00-000, 2410, 1280, 1130, 0, 0.00, 0, 0.00, 1280
9, 15:43:00-000, 3660, 900, 2760, 0, 0.00, 0, 0.00, 4790
9, 15:46:00-000, 2420, 1060, 1360, 0, 0.00, 0, 0.00, 2420
9, 15:47:00-000, 2100, 2100, 0, 0, 0.00, 0, 0.00, 2100
9, 15:48:00-000, 3410, 1460, 1950, 10, 1350.80, 10, 1352.60, 3390
9, 15:52:00-000, 2570, 0, 2570, 0, 0.00, 0, 0.00, 2570
9, 15:54:00-000, 3210, 2090, 1120, 0, 0.00, 0, 0.00, 3210
9, 15:57:00-000, 1470, 1470, 0, 0, 0.00, 0, 0.00, 1470
9, 15:58:00-000, 4050, 2600, 1450, 0, 0.00, 0, 0.00, 4050
9, 15:59:00-000, 6120, 3850, 2270, 0, 0.00, 0, 0.00, 6120
9, 16:00:00-000, 950, 0, 950, 0, 0.00, 0, 0.00, 950
9, 16:04:00-000, 2460, 970, 1490, 0, 0.00, 0, 0.00, 2460
9, 16:05:00-000, 7420, 3570, 3850, 0, 0.00, 0, 0.00, 7420
9, 16:06:00-000, 4020, 2470, 1550, 0, 0.00, 0, 0.00, 4020
9, 16:07:00-000, 998, 38, 960, 16, 1350.62, 18, 1350.00, 964
9, 16:08:00-000, 5953, 2163, 3790, 2, 1353.50, 0, 0.00, 5951
9, 16:09:00-000, 1810, 900, 910, 0, 0.00, 0, 0.00, 1810
9, 16:10:00-000, 1549, 1387, 162, 13, 1351.54, 13, 1352.85, 1523
9, 16:11:00-000, 1560, 1560, 0, 0, 0.00, 0, 0.00, 1560
9, 16:12:00-000, 5180, 2610, 2570, 0, 0.00, 0, 0.00, 5180
9, 16:13:00-000, 3390, 3390, 0, 0, 0.00, 0, 0.00, 3390
9, 16:14:00-000, 5261, 1111, 4150, 1, 1351.00, 1, 1352.00, 5259
9, 16:15:00-000, 5310, 2430, 2880, 0, 0.00, 0, 0.00, 5310
9, 16:16:00-000, 4085, 915, 3170, 5, 1355.00, 5, 1353.00, 4075
9, 16:17:00-000, 11500, 5680, 5820, 0, 0.00, 0, 0.00, 11500
9, 16:18:00-000, 2014, 1294, 720, 4, 1353.00, 4, 1352.00, 716
9, 16:19:00-000, 12960, 3170, 9790, 0, 0.00, 0, 0.00, 14250
9, 16:20:00-000, 5120, 1110, 4010, 0, 0.00, 0, 0.00, 5120
9, 16:21:00-000, 3280, 2160, 1120, 19, 1346.26, 19, 1345.26, 3242
9, 16:22:00-000, 9290, 4350, 4940, 0, 0.00, 0, 0.00, 9290
9, 16:23:00-000, 2210, 880, 1330, 0, 0.00, 0, 0.00, 2210
9, 16:24:00-000, 1941, 21, 1920, 14, 1352.36, 14, 1352.00, 1913
9, 16:25:00-000, 1380, 0, 1380, 0, 0.00, 0, 0.00, 1380
9, 16:26:00-000, 1190, 1190, 0, 0, 0.00, 0, 0.00, 1190
9, 16:27:00-000, 1670, 0, 1670, 0, 0.00, 0, 0.00, 1670
9, 16:28:00-000, 8123, 2163, 5960, 3, 1351.00, 3, 1350.00, 8117
9, 16:29:00-000, 5690, 2254, 3436, 51, 1351.99, 48, 1350.48, 5591
